"","unique_id","start","end","width","names","nmismatch","pos_mismatch","seq_score","GU","V","guide_score","c_box_start","c_box_end","d_prime_box_start","d_prime_box_end","c_prime_box_start","c_prime_box_end","d_box_start","d_box_end","c_box_seq","d_prime_box_seq","c_prime_box_seq","d_box_seq","box_score","c_d_prime_dist","d_prime_c_prime_dist","c_prime_d_dist","c_d_dist","dist_score","motif_dist_score","match_score","met_site","rRNA"
"47396","ENSG00000288088.1_128347",128339,128347,9,"ENSG00000288088.1",0,NA,"VVVVVVVVV",0,9,1,52,58,92,95,101,107,133,136,"ATGATGA","CTGA","ATGTTCA","CTGA",2.85472972972973,34,6,26,75,1.23229966701458,5.06595779963653,9.06595779963653,101,"ENSG00000079974.19"
"38663","ENSG00000250754.6_53493",53485,53493,9,"ENSG00000250754.6",0,NA,"VVVVVVVVV",0,9,1,115,121,133,136,157,163,175,178,"ATGATGA","ATGT","GTGGAGA","CTGA",2.654877930183,12,21,12,54,2.1966741110205,4.97396507806012,8.97396507806013,101,"ENSG00000079974.19"
"4603","ENSG00000101306.11_4589",4581,4589,9,"ENSG00000101306.11",0,NA,"VVVVVVVVV",0,9,1,106,112,133,136,152,158,171,174,"ATGGTGA","CTGA","CTGCAGA","CTGA",2.70044995374697,21,16,13,59,1.81754338453652,4.95513576904575,8.95513576904575,101,"ENSG00000079974.19"
"20547","ENSG00000165072.10_17940",17932,17940,9,"ENSG00000165072.10",0,NA,"VVVVVVVVV",0,9,1,41,47,68,71,77,83,133,136,"ATGATGA","ATGA","GAGATGG","CTGA",2.74562480972838,21,6,50,86,1.3960723862386,4.92505944610695,8.92505944610695,101,"ENSG00000079974.19"
"42140","ENSG00000260896.6_50059",50051,50059,9,"ENSG00000260896.6",0,NA,"VVVVVUVVV",1,8,0.922153209109731,114,120,133,136,147,153,188,191,"GTGATGA","CTGA","TTGCTGA","CTGA",2.83782383079975,13,11,35,68,1.88374587211287,5.20064285269447,8.88925568913339,101,"ENSG00000079974.19"
"46152","ENSG00000286221.1_164271",164263,164271,9,"ENSG00000286221.1",0,NA,"VVVVVUVVV",1,8,0.922153209109731,114,120,133,136,147,153,188,191,"GTGATGA","CTGA","TTGCTGA","CTGA",2.83782383079975,13,11,35,68,1.88374587211287,5.20064285269447,8.88925568913339,101,"ENSG00000079974.19"
"23364","ENSG00000172766.19_61681",61673,61681,9,"ENSG00000172766.19",0,NA,"VVVVVVVVV",0,9,1,90,96,133,136,145,151,162,165,"CTGATAA","CTGA","TTCATGA","CTGA",2.62362611817887,37,9,11,66,1.94061037428869,4.85786279053696,8.85786279053696,101,"ENSG00000079974.19"
"20274","ENSG00000164588.8_247058",247050,247058,9,"ENSG00000164588.8",0,NA,"VVVVVVVVV",0,9,1,93,99,133,136,141,147,167,170,"CTGATGA","TAGA","ATGATGA","CTGA",2.67499051581075,34,5,20,68,1.45998410005734,4.82331355136559,8.82331355136559,101,"ENSG00000079974.19"
"10685","ENSG00000132356.12_34857",34849,34857,9,"ENSG00000132356.12",0,NA,"VVVVVVVVV",0,9,1,83,89,105,108,116,122,133,136,"TTTATGA","ATGA","GTGGAAA","CTGA",2.46764619817752,16,8,11,44,2.81900123054908,4.81749397126647,8.81749397126647,101,"ENSG00000079974.19"
"24776","ENSG00000177990.12_50171",50163,50171,9,"ENSG00000177990.12",0,NA,"VVVVVVVVV",0,9,1,79,85,103,106,111,117,133,136,"TTGATGT","ATGA","TTGGAGA","CTGA",2.53434354125101,18,5,16,48,2.35817836532336,4.81345049341585,8.81345049341585,101,"ENSG00000079974.19"
"25829","ENSG00000182923.20_1637",1629,1637,9,"ENSG00000182923.20",0,NA,"VVVVVVVVV",0,9,1,77,83,97,100,111,117,133,136,"ATTTTGA","CTGT","GTGATCA","CTGA",2.50246548860965,14,11,16,50,2.55828385585067,4.81034677831209,8.81034677831209,101,"ENSG00000079974.19"
"47575","ENSG00000288700.2_1615",1607,1615,9,"ENSG00000288700.2",0,NA,"VVVVVVVVV",0,9,1,77,83,97,100,111,117,133,136,"ATTTTGA","CTGT","GTGATCA","CTGA",2.50246548860965,14,11,16,50,2.55828385585067,4.81034677831209,8.81034677831209,101,"ENSG00000079974.19"
"13713","ENSG00000143248.13_136429",136421,136429,9,"ENSG00000143248.13",1,7,"VVVVVVMVV",0,8,0.885300207039338,62,68,79,82,113,119,133,136,"ATGATGA","CTGA","ATGATTT","CTGA",2.86528716216216,11,31,14,65,1.88859682590505,5.24762781007987,8.78882863823722,101,"ENSG00000079974.19"
"17590","ENSG00000154529.15_68840",68832,68840,9,"ENSG00000154529.15",0,NA,"VVVVVVVVV",0,9,1,96,102,133,136,141,147,156,159,"ATAATGA","CTAA","ATAAAGA","CTGA",2.5754324092352,31,5,9,54,1.96223732444314,4.78294667983612,8.78294667983612,101,"ENSG00000079974.19"
"43980","ENSG00000276386.1_67242",67234,67242,9,"ENSG00000276386.1",0,NA,"VVVVVVVVV",0,9,1,96,102,133,136,141,147,156,159,"ATAATGA","CTAA","ATAAAGA","CTGA",2.5754324092352,31,5,9,54,1.96223732444314,4.78294667983612,8.78294667983612,101,"ENSG00000079974.19"
"25963","ENSG00000183117.20_1370182",1370174,1370182,9,"ENSG00000183117.20",0,NA,"VVVVVVVVV",0,9,1,115,121,133,136,137,143,155,158,"ATGCTGA","GTCA","TTGTTGA","CTGA",2.50120767762606,12,1,12,34,2.45063011842546,4.78133699231646,8.78133699231646,101,"ENSG00000079974.19"
"34897","ENSG00000234352.9_340567",340559,340567,9,"ENSG00000234352.9",0,NA,"VVVVVVVVV",0,9,1,114,120,133,136,138,144,156,159,"TTGATGA","GTTA","ATGTTTT","CTGA",2.46366551455033,13,2,12,36,2.58148029888515,4.7514792656385,8.7514792656385,101,"ENSG00000079974.19"
"26863","ENSG00000185053.14_859516",859508,859516,9,"ENSG00000185053.14",0,NA,"VVVVVVVVV",0,9,1,112,118,133,136,145,151,199,202,"ATGTTGA","CTTA","ATAAAGA","CTGA",2.56680394546212,15,9,48,81,1.86390280901529,4.74398227802402,8.74398227802402,101,"ENSG00000079974.19"
"10463","ENSG00000131149.19_155378",155370,155378,9,"ENSG00000131149.19",0,NA,"VVVVVVVVV",0,9,1,80,86,94,97,116,122,133,136,"GTGATGG","CTGG","GTGAAAT","CTGA",2.53991411415238,8,19,11,47,2.04241620696589,4.74379424199543,8.74379424199543,101,"ENSG00000079974.19"
"28629","ENSG00000196277.16_352326",352318,352326,9,"ENSG00000196277.16",0,NA,"VVVVVVVVV",0,9,1,111,117,133,136,159,165,173,176,"ATGATGA","CTAA","TTGAAGA","ATGA",2.54606309890259,16,23,8,56,1.99114662565238,4.74122515458407,8.74122515458407,101,"ENSG00000079974.19"
"35503","ENSG00000236204.7_277250",277242,277250,9,"ENSG00000236204.7",1,6,"VVVVVMVVV",0,8,0.902691511387163,114,120,133,136,163,169,180,183,"ATGATGA","CTTA","TTGGTGA","CTGA",2.76781418073267,13,27,11,60,2.06896943300712,5.13026599280623,8.74103203835489,101,"ENSG00000079974.19"
"26161","ENSG00000183580.10_119954",119946,119954,9,"ENSG00000183580.10",0,NA,"VVVVVVVVV",0,9,1,92,98,133,136,181,187,200,203,"GTGATGA","TTGA","ATGATCT","CTGA",2.70017552464002,35,45,13,102,0.930445487326202,4.73290391289825,8.73290391289825,101,"ENSG00000079974.19"
"40185","ENSG00000255227.1_5111",5103,5111,9,"ENSG00000255227.1",0,NA,"VVVVVVVVV",0,9,1,88,94,101,104,112,118,133,136,"ATCAAGA","TTGA","TTAATGA","CTGA",2.46810542746098,7,8,15,39,2.46028092755748,4.72857927765767,8.72857927765767,101,"ENSG00000079974.19"
"25711","ENSG00000182621.18_468465",468457,468465,9,"ENSG00000182621.18",0,NA,"VVVVVVVVV",0,9,1,96,102,133,136,149,155,181,184,"AGGATGA","CTGA","GTGAAAG","CTGA",2.69133792843655,31,13,26,79,0.962614715003814,4.72621689281187,8.72621689281187,101,"ENSG00000079974.19"
"42132","ENSG00000260876.6_72658",72650,72658,9,"ENSG00000260876.6",1,3,"VVMVVVVVV",0,8,0.882815734989648,92,98,106,109,114,120,133,136,"GTGATGA","ATGA","ATGAATA","CTGA",2.70760404593353,8,5,13,35,2.71335586697867,5.19101237663388,8.72227531659248,101,"ENSG00000079974.19"
"11128","ENSG00000134020.8_218558",218550,218558,9,"ENSG00000134020.8",0,NA,"VVVVVVVVV",0,9,1,94,100,133,136,150,156,167,170,"ATGCTGA","GTGA","GTTATGT","CTGA",2.58829605668096,33,14,11,67,1.62547757780939,4.72019615558728,8.72019615558728,101,"ENSG00000079974.19"
"43472","ENSG00000271955.2_127798",127790,127798,9,"ENSG00000271955.2",0,NA,"VVVVVVVVV",0,9,1,116,122,133,136,183,189,198,201,"ATGTTCA","CTGG","CTGATGA","CTGA",2.53293384083036,11,47,9,76,1.97509530895228,4.715330228622,8.715330228622,101,"ENSG00000079974.19"
"11558","ENSG00000135324.6_44344",44336,44344,9,"ENSG00000135324.6",0,NA,"VVVVVVVVV",0,9,1,86,92,133,136,143,149,164,167,"ATGATGT","CTAA","AGGAAAA","CTGA",2.55442513034375,41,7,15,72,1.81807475304537,4.71189390550092,8.71189390550092,101,"ENSG00000079974.19"
"20569","ENSG00000165091.18_201192",201184,201192,9,"ENSG00000165091.18",0,NA,"VVVVVVVVV",0,9,1,87,93,102,105,112,118,133,136,"TGGATGA","GTGA","GAAATGT","CTGA",2.41463858657853,9,7,15,40,2.68646914050784,4.69601492942451,8.69601492942451,101,"ENSG00000079974.19"
"42831","ENSG00000267098.2_206987",206979,206987,9,"ENSG00000267098.2",1,6,"VVVVVMVVV",0,8,0.902691511387163,115,121,133,136,153,159,169,172,"TTGATGA","CAGA","GTGAAAA","CTGA",2.68607718623453,12,17,10,48,2.4300940229878,5.08431881613783,8.69508486168649,101,"ENSG00000079974.19"
"31397","ENSG00000223704.2_95292",95284,95292,9,"ENSG00000223704.2",0,NA,"VVVVVVVVV",0,9,1,94,100,133,136,157,163,174,177,"CTGATGA","GTGA","CAGAAGA","CTGA",2.62984540198604,33,21,11,74,1.24108401099396,4.69334667272522,8.69334667272522,101,"ENSG00000079974.19"
"36201","ENSG00000238280.2_12018",12010,12018,9,"ENSG00000238280.2",0,NA,"VVVVVUVVV",1,8,0.922153209109731,114,120,133,136,152,158,167,170,"GTGATGA","CTAA","TTCTTGA","CTGA",2.62634590653631,13,16,9,47,2.48565864088016,4.99865783778056,8.68727067421948,101,"ENSG00000079974.19"
"3537","ENSG00000085511.20_110410",110402,110410,9,"ENSG00000085511.20",0,NA,"VVVVUVVVV",1,8,0.889855072463768,116,122,133,136,142,148,158,161,"ATGAAGA","CAGA","ATGAGAA","CTGA",2.61570105851895,11,6,10,36,3.06115136982541,5.1247896066546,8.68420989650968,101,"ENSG00000079974.19"
"32818","ENSG00000228033.6_232031",232023,232031,9,"ENSG00000228033.6",0,NA,"VVVVVVVVV",0,9,1,93,99,133,136,143,149,193,196,"ATGTTGA","ATGA","ATGTTGA","CTGA",2.6565233582416,34,7,44,94,1.02125774949624,4.68285336777673,8.68285336777673,101,"ENSG00000079974.19"
"36782","ENSG00000242908.6_46904",46896,46904,9,"ENSG00000242908.6",0,NA,"VVVVVVVVV",0,9,1,39,45,59,62,113,119,133,136,"TTGATGA","CTGA","GTGATAG","CAGA",2.53026620780348,14,51,14,88,1.8359336653647,4.67609376268031,8.67609376268031,101,"ENSG00000079974.19"
"34179","ENSG00000232053.7_183897",183889,183897,9,"ENSG00000232053.7",0,NA,"VVVVVVVVV",0,9,1,47,53,62,65,73,79,133,136,"ATGCTGA","CTTA","GAGAAGT","CTGA",2.5302029588898,9,8,54,80,1.82380321402032,4.67295573498808,8.67295573498808,101,"ENSG00000079974.19"
"13458","ENSG00000141449.16_88639",88631,88639,9,"ENSG00000141449.16",0,NA,"VVVVVVVVV",0,9,1,63,69,99,102,114,120,133,136,"ATGATAA","CCGA","TTAATGG","CTGA",2.54367944940665,30,12,13,64,1.72852182573354,4.67159620544447,8.67159620544447,101,"ENSG00000079974.19"
"26761","ENSG00000185008.19_335309",335301,335309,9,"ENSG00000185008.19",0,NA,"VVVVVUVVV",1,8,0.922153209109731,116,122,133,136,139,145,154,157,"ATGTTGA","AGGA","GTGCTGA","CTGA",2.55007484151461,11,3,9,32,2.93087201071515,4.98284273853648,8.6714555749754,101,"ENSG00000079974.19"
"38088","ENSG00000249484.9_601054",601046,601054,9,"ENSG00000249484.9",1,8,"VVVVVVVMV",0,8,0.884057971014493,112,118,133,136,144,150,160,163,"ATGATGA","ATGG","TGGATGA","CTGA",2.641160931739,15,8,10,42,2.91350402497271,5.13031089247484,8.66654277653281,101,"ENSG00000079974.19"
"38018","ENSG00000249346.8_10213",10205,10213,9,"ENSG00000249346.8",1,1,"MVVVVVVVV",0,8,0.90600414078675,113,119,133,136,175,181,194,197,"ATGATGA","CTGG","CTGTGGA","CTGA",2.73506314903765,14,39,13,75,1.89206260550141,5.03145423310477,8.65547079625177,101,"ENSG00000079974.19"
"24988","ENSG00000179008.9_20652",20644,20652,9,"ENSG00000179008.9",0,NA,"VVVVVUVVV",1,8,0.922153209109731,72,78,107,110,115,121,133,136,"ATGATGG","CTGT","ATGATGT","CTGA",2.68751336287771,29,5,12,55,1.94813932145658,4.96622376849366,8.65483660493258,101,"ENSG00000079974.19"
"41211","ENSG00000258692.2_1994",1986,1994,9,"ENSG00000258692.2",0,NA,"VVVVVUVVV",1,8,0.922153209109731,72,78,107,110,115,121,133,136,"ATGATGG","CTGT","ATGATGT","CTGA",2.68751336287771,29,5,12,55,1.94813932145658,4.96622376849366,8.65483660493258,101,"ENSG00000079974.19"
"35975","ENSG00000237525.7_52511",52503,52511,9,"ENSG00000237525.7",0,NA,"VVVVVVVVV",0,9,1,86,92,105,108,113,119,133,136,"TTGATGT","CGGA","GTGTTGA","ATGA",2.36928758931302,13,5,14,41,2.82260799461697,4.65446464750927,8.65446464750927,101,"ENSG00000079974.19"
"39595","ENSG00000253891.2_1655",1647,1655,9,"ENSG00000253891.2",0,NA,"VVVVVVVVV",0,9,1,112,118,133,136,170,176,186,189,"GGGATGA","CTGT","TTCAGGA","CTGA",2.49964798779903,15,34,10,68,1.9335456103633,4.64946638225588,8.64946638225588,101,"ENSG00000079974.19"
"19564","ENSG00000163297.18_215692",215684,215692,9,"ENSG00000163297.18",0,NA,"VVVVVVVVV",0,9,1,78,84,98,101,111,117,133,136,"TTGAAAA","CAGA","CTGTTGA","CTGA",2.39486013555647,14,10,16,49,2.62183404791356,4.64689207123917,8.64689207123917,101,"ENSG00000079974.19"
"30953","ENSG00000214900.13_97256",97248,97256,9,"ENSG00000214900.13",0,NA,"VVVVVVVVV",0,9,1,114,120,133,136,142,148,159,162,"GGGATGG","GTTA","AGGATGA","CTGA",2.3365319744294,13,6,11,39,3.01000559323771,4.64672135569177,8.64672135569177,101,"ENSG00000079974.19"
"13989","ENSG00000144227.5_38146",38138,38146,9,"ENSG00000144227.5",0,NA,"VVVUVVVVV",1,8,0.880745341614907,114,120,133,136,144,150,158,161,"CTCATGA","CTGA","GTCAAGA","CTGA",2.6206813619371,13,8,8,38,3.0222337442241,5.12336070595119,8.64634207241081,101,"ENSG00000079974.19"
"46551","ENSG00000286803.1_10174",10166,10174,9,"ENSG00000286803.1",0,NA,"VVVVVVVVV",0,9,1,115,121,133,136,137,143,152,155,"CTGATGT","GTTA","ATCTTGA","CTGA",2.39160317786643,12,1,9,31,2.63618269851883,4.64505097107376,8.64505097107376,101,"ENSG00000079974.19"
"31145","ENSG00000216863.11_99912",99904,99912,9,"ENSG00000216863.11",1,1,"MVVVVVVVV",0,8,0.90600414078675,115,121,133,136,143,149,179,182,"GTGATGA","CAGA","TTGAAGC","CTGA",2.6923860157945,12,7,30,58,2.1267246601037,5.0189911913501,8.6430077544971,101,"ENSG00000079974.19"
"47277","ENSG00000287918.2_9391",9383,9391,9,"ENSG00000287918.2",1,1,"MVVVVVVVV",0,8,0.90600414078675,29,35,57,60,75,81,133,136,"CTGATGA","CTGA","CTGATGA","CTGA",2.87403947481356,22,15,52,98,0.892440192661992,5.01317583952143,8.63719240266843,101,"ENSG00000079974.19"
"24603","ENSG00000177119.17_67341",67333,67341,9,"ENSG00000177119.17",0,NA,"UVVVVVVVV",1,8,0.902691511387163,82,88,100,103,112,118,133,136,"ATGTTGA","ATGA","TTGAAGT","CTGA",2.59951322310647,12,9,15,45,2.77385574891908,5.02598597574055,8.6367520212892,101,"ENSG00000079974.19"
"32766","ENSG00000227790.8_50874",50866,50874,9,"ENSG00000227790.8",0,NA,"VVVVVVVVV",0,9,1,89,95,107,110,114,120,133,136,"GTGTTGA","CTGA","GTGGTTT","TTGA",2.35565408780718,12,4,13,38,2.8168696944754,4.63030756996416,8.63030756996416,101,"ENSG00000079974.19"
"7644","ENSG00000115252.19_102259",102251,102259,9,"ENSG00000115252.19",0,NA,"VVVVVVVVV",0,9,1,115,121,133,136,138,144,155,158,"GTGTTTA","ATGA","AAGAAGA","CTGA",2.37428481897898,12,2,11,34,2.67787429758514,4.62660993936126,8.62660993936126,101,"ENSG00000079974.19"
"41796","ENSG00000259754.2_127431",127423,127431,9,"ENSG00000259754.2",1,1,"MVVVVVVVV",0,8,0.90600414078675,69,75,95,98,109,115,133,136,"ATTATGA","CTGA","TTGAAAA","CTGA",2.70680706288504,20,11,18,58,1.96149797857975,5.00171959945335,8.62573616260034,101,"ENSG00000079974.19"
"28900","ENSG00000196660.12_216071",216063,216071,9,"ENSG00000196660.12",0,NA,"VVVVVVVVV",0,9,1,115,121,133,136,168,174,183,186,"TTGATGT","CACA","TTGAGGA","CTGA",2.46962159151654,12,32,9,62,2.03397494294151,4.62452972159628,8.62452972159628,101,"ENSG00000079974.19"
"39449","ENSG00000253608.2_51771",51763,51771,9,"ENSG00000253608.2",1,1,"MVVVVVVVV",0,8,0.90600414078675,86,92,106,109,114,120,133,136,"GTGATGA","TTTA","ATGACAA","CTGA",2.57271943510242,14,5,13,41,2.83865348206628,4.99752909568728,8.62154565883427,101,"ENSG00000079974.19"
"21990","ENSG00000169504.15_53131",53123,53131,9,"ENSG00000169504.15",0,NA,"VVVVVUVVV",1,8,0.922153209109731,116,122,133,136,141,147,175,178,"GTGATGA","CTGT","TTCAGGA","CTGA",2.64361411341653,11,5,28,53,2.08094361560833,4.92625942626297,8.61487226270189,101,"ENSG00000079974.19"
"19670","ENSG00000163590.14_294774",294766,294774,9,"ENSG00000163590.14",0,NA,"VVVVVVVVV",0,9,1,114,120,133,136,148,154,166,169,"AACATGA","CTGA","GTGAAGT","ATGA",2.35949974353071,13,12,12,46,2.7236491260237,4.6134118540571,8.6134118540571,101,"ENSG00000079974.19"
"26018","ENSG00000183166.11_248897",248889,248897,9,"ENSG00000183166.11",0,NA,"VVVVVVVVV",0,9,1,112,118,133,136,151,157,165,168,"ATCATGC","TTGC","CTGATTA","CTGA",2.40067383815877,15,15,8,47,2.44623091881144,4.61268079330081,8.61268079330081,101,"ENSG00000079974.19"
"2036","ENSG00000069329.18_20809",20801,20809,9,"ENSG00000069329.18",0,NA,"VVVVVVVVV",0,9,1,90,96,133,136,144,150,169,172,"GTGATGG","CTTA","AAGATTA","CTGA",2.52832392963118,37,8,19,73,1.56619864595445,4.60542287754058,8.60542287754058,101,"ENSG00000079974.19"
"47233","ENSG00000287880.1_23223",23215,23223,9,"ENSG00000287880.1",0,NA,"VVVVVVVVV",0,9,1,113,119,133,136,144,150,161,164,"ATAAAGA","GTTA","ATGTTTA","CTGA",2.31998012573879,14,8,11,42,2.95372298478643,4.6050642890946,8.6050642890946,101,"ENSG00000079974.19"
"20273","ENSG00000164588.8_229441",229433,229441,9,"ENSG00000164588.8",0,NA,"VVVVVVVVV",0,9,1,110,116,133,136,142,148,170,173,"AAGAAGA","CTCA","ATGAGTA","CTGA",2.44026259798071,17,6,22,54,2.14648041520163,4.60372443376826,8.60372443376826,101,"ENSG00000079974.19"
"9465","ENSG00000124784.9_27810",27802,27810,9,"ENSG00000124784.9",0,NA,"VVVVVVVVV",0,9,1,89,95,133,136,145,151,160,163,"GTGAAGA","CTAA","GTCTAGA","CTGA",2.46814356384429,38,9,9,65,1.95216182271021,4.6016130620847,8.6016130620847,101,"ENSG00000079974.19"
"43529","ENSG00000272168.10_839425",839417,839425,9,"ENSG00000272168.10",0,NA,"VVVVVVVVV",0,9,1,102,108,133,136,155,161,176,179,"AAGATGG","ATGA","ATGAAGA","CTGA",2.56332350701423,25,19,15,68,1.31159802484584,4.60010535123518,8.60010535123518,101,"ENSG00000079974.19"
"16021","ENSG00000150637.9_123399",123391,123399,9,"ENSG00000150637.9",1,8,"VVVVVVVMV",0,8,0.884057971014493,83,89,102,105,115,121,133,136,"ATGATGA","CTGA","CTGATAT","CTTA",2.60780646718147,13,10,12,44,2.86058706384062,5.06149087792927,8.59772276198724,101,"ENSG00000079974.19"
"6461","ENSG00000109944.11_51070",51062,51070,9,"ENSG00000109944.11",1,1,"MVVVVVVVV",0,8,0.90600414078675,88,94,110,113,116,122,133,136,"GTGAAGA","CTGA","AGCATGA","CTGA",2.59811810972935,16,3,11,39,2.56934992786291,4.97253433151464,8.59655089466164,101,"ENSG00000079974.19"
"6452","ENSG00000109917.11_14004",13996,14004,9,"ENSG00000109917.11",1,1,"MVVVVVVVV",0,8,0.90600414078675,115,121,133,136,151,157,204,207,"ATGATGA","CTGG","TGGATGA","CTGA",2.74942125714576,12,15,47,83,1.55878137774891,4.97206410634682,8.59608066949382,101,"ENSG00000079974.19"
"30495","ENSG00000205293.5_20339",20331,20339,9,"ENSG00000205293.5",0,NA,"VVVVVVVVV",0,9,1,85,91,133,136,146,152,177,180,"TTGATGA","CTGT","GTCAGGG","CTGA",2.57945055412683,42,10,25,86,1.17199897146717,4.59208399974484,8.59208399974484,101,"ENSG00000079974.19"
"45884","ENSG00000286021.3_66263",66255,66263,9,"ENSG00000286021.3",0,NA,"VVVVVVVVV",0,9,1,109,115,133,136,147,153,186,189,"CTGATGA","TTAA","AGGAGGA","CTGA",2.51773419033634,18,11,33,71,1.57738037816369,4.59056874510149,8.59056874510149,101,"ENSG00000079974.19"
"16329","ENSG00000151322.20_800587",800579,800587,9,"ENSG00000151322.20",1,1,"MVVVVVVVV",0,8,0.90600414078675,91,97,105,108,114,120,133,136,"ATGACGA","CTTA","CTGCTGG","CTGA",2.56583179741428,8,6,13,36,2.73662182296588,4.96054178476527,8.58455834791227,101,"ENSG00000079974.19"
"30459","ENSG00000205035.9_240032",240024,240032,9,"ENSG00000205035.9",1,8,"VVVVVVVMV",0,8,0.884057971014493,73,79,101,104,113,119,133,136,"ATCATGA","CTGA","CTGTTGT","CTGA",2.70483445469111,22,9,14,54,2.15904595693058,5.04781891371782,8.58405079777579,101,"ENSG00000079974.19"
"48091","ENSG00000290401.1_242304",242296,242304,9,"ENSG00000290401.1",1,8,"VVVVVVVMV",0,8,0.884057971014493,73,79,101,104,113,119,133,136,"ATCATGA","CTGA","CTGTTGT","CTGA",2.70483445469111,22,9,14,54,2.15904595693058,5.04781891371782,8.58405079777579,101,"ENSG00000079974.19"
"1758","ENSG00000065883.18_138049",138041,138049,9,"ENSG00000065883.18",0,NA,"VVVVVVVVV",0,9,1,108,114,133,136,143,149,159,162,"GTCATGA","AAGA","AAGCAGA","CTGA",2.36075068561939,19,7,10,45,2.58282920340033,4.5802917768824,8.5802917768824,101,"ENSG00000079974.19"
"24686","ENSG00000177565.19_80988",80980,80988,9,"ENSG00000177565.19",0,NA,"UVVVVVVVV",1,8,0.902691511387163,112,118,133,136,146,152,160,163,"TTGATGA","TTAA","ATCATGA","CTGA",2.56051377081661,15,10,8,42,2.8052555133981,4.96883682971054,8.57960287525919,101,"ENSG00000079974.19"
"15481","ENSG00000148484.18_72783",72775,72783,9,"ENSG00000148484.18",0,NA,"VVVVVVVVV",0,9,1,88,94,110,113,116,122,133,136,"ATATTGA","CTGG","GTTCTGT","CTGA",2.36234838240086,16,3,11,39,2.56934992786291,4.57958478596717,8.57958478596717,101,"ENSG00000079974.19"
"31906","ENSG00000225213.2_3697",3689,3697,9,"ENSG00000225213.2",0,NA,"VVVVVVVVV",0,9,1,88,94,110,113,116,122,133,136,"ATATTGA","CTGG","GTTCTGT","CTGA",2.36234838240086,16,3,11,39,2.56934992786291,4.57958478596717,8.57958478596717,101,"ENSG00000079974.19"
"39836","ENSG00000254303.1_110900",110892,110900,9,"ENSG00000254303.1",0,NA,"VVVVVVVVV",0,9,1,115,121,133,136,157,163,172,175,"ATAATCA","CAGA","GTGTTTT","CTGA",2.41146831042152,12,21,9,51,2.23763145653293,4.57852171483577,8.57852171483577,101,"ENSG00000079974.19"
"39823","ENSG00000254275.6_156511",156503,156511,9,"ENSG00000254275.6",0,NA,"VVVVVVVVV",0,9,1,98,104,133,136,139,145,156,159,"ATGACGT","CAGA","GTCTTGA","CTGA",2.48478353195922,29,3,11,52,1.74552188404582,4.57768635761016,8.57768635761016,101,"ENSG00000079974.19"
"23977","ENSG00000174607.11_77683",77675,77683,9,"ENSG00000174607.11",0,NA,"VVVVVVVVV",0,9,1,114,120,133,136,143,149,169,172,"AAGATGG","CAAA","ATGCAGA","CTGA",2.36956674180096,13,7,20,49,2.51321678215748,4.57758209854097,8.57758209854097,101,"ENSG00000079974.19"
"5165","ENSG00000103544.16_105642",105634,105642,9,"ENSG00000103544.16",0,NA,"VVVVVVVVV",0,9,1,44,50,68,71,80,86,133,136,"TTAATGA","CAGA","TTGAAAA","CTGA",2.50170373594938,18,9,47,83,1.62173203420698,4.57493923513405,8.57493923513405,101,"ENSG00000079974.19"
"6010","ENSG00000107736.22_115171",115163,115171,9,"ENSG00000107736.22",0,NA,"VVVVVVVVV",0,9,1,75,81,100,103,112,118,133,136,"ACCATGT","TTGA","CTGATCA","CTGA",2.39308134727635,19,9,15,52,2.34479655289162,4.57466805035015,8.57466805035015,101,"ENSG00000079974.19"
"7943","ENSG00000116117.19_934028",934020,934028,9,"ENSG00000116117.19",1,6,"VVVVVMVVV",0,8,0.902691511387163,79,85,99,102,114,120,133,136,"ATGATCA","CAGA","ATAATGT","CTGA",2.57979446340937,14,12,13,48,2.65071350396686,4.96233581500734,8.57310186055599,101,"ENSG00000079974.19"
"21791","ENSG00000168959.15_225370",225362,225370,9,"ENSG00000168959.15",1,8,"VVVVVVVMV",0,8,0.884057971014493,73,79,101,104,113,119,133,136,"ATCATGA","CTGA","TTGTTGT","CTGA",2.69723310333975,22,9,14,54,2.15904595693058,5.0351499947989,8.57138187885687,101,"ENSG00000079974.19"
"26562","ENSG00000184408.10_412652",412644,412652,9,"ENSG00000184408.10",0,NA,"VVVVVVVVV",0,9,1,115,121,133,136,141,147,167,170,"ATGAATA","ATGC","CTGATGC","CTGA",2.37071638270277,12,5,20,46,2.45213813458746,4.56422850481814,8.56422850481814,101,"ENSG00000079974.19"
"665","ENSG00000023171.20_216105",216097,216105,9,"ENSG00000023171.20",0,NA,"VVVVVVVVV",0,9,1,115,121,133,136,147,153,207,210,"AGGATGA","TTGT","TTGGTGG","CTGA",2.46252044543415,12,11,54,86,1.836181673098,4.56324616066475,8.56324616066475,101,"ENSG00000079974.19"
"39884","ENSG00000254394.2_298196",298188,298196,9,"ENSG00000254394.2",0,NA,"VVVVVVVVV",0,9,1,102,108,133,136,158,164,174,177,"GTGATTA","ATGA","TTGCAGA","CTGA",2.53095383803332,25,22,10,66,1.37525188536716,4.56206936806399,8.56206936806399,101,"ENSG00000079974.19"
"13564","ENSG00000142166.15_22238",22230,22238,9,"ENSG00000142166.15",1,6,"VVVVVMVVV",0,8,0.902691511387163,64,70,80,83,87,93,133,136,"ATAATGA","CTGA","CTGATCT","CTGA",2.70329546863377,10,4,40,63,1.77749926077412,4.94986726291648,8.56063330846514,101,"ENSG00000079974.19"
"7311","ENSG00000113494.17_28144",28136,28144,9,"ENSG00000113494.17",0,NA,"VVVVVVVVV",0,9,1,54,60,97,100,110,116,133,136,"TTGATGA","CTGA","TTGGTGT","TTGA",2.49630143946371,37,10,17,73,1.60010990213313,4.56052987463947,8.56052987463947,101,"ENSG00000079974.19"
"22722","ENSG00000171204.13_1878",1870,1878,9,"ENSG00000171204.13",0,NA,"VVVVVVVVV",0,9,1,87,93,104,107,113,119,133,136,"GTAAAGA","CTAA","AGGAAAA","CTGA",2.3053072757213,11,6,14,40,2.86308628654337,4.55795036450468,8.55795036450468,101,"ENSG00000079974.19"
"14431","ENSG00000144962.7_14462",14454,14462,9,"ENSG00000144962.7",1,7,"VVVVVVMVV",0,8,0.885300207039338,115,121,133,136,145,151,169,172,"AAGATGT","CTGA","GTGACTA","CTGA",2.62079759055103,12,9,18,48,2.5886365687257,5.01515512643314,8.55635595459049,101,"ENSG00000079974.19"
"42056","ENSG00000260551.1_2261",2253,2261,9,"ENSG00000260551.1",1,8,"VVVVVVVMV",0,8,0.884057971014493,116,122,133,136,142,148,164,167,"ATGATGA","CAAA","ATCATGG","CTGA",2.60085453100159,11,6,16,42,2.73454992187137,5.01839503213716,8.55462691619513,101,"ENSG00000079974.19"
"1792","ENSG00000066032.19_56238",56230,56238,9,"ENSG00000066032.19",1,1,"MVVVVVVVV",0,8,0.90600414078675,114,120,133,136,144,150,167,170,"ATTAAGT","CTGA","TTGATGA","CTGA",2.55521723425967,13,8,17,47,2.68264508947955,4.92935666280266,8.55337322594966,101,"ENSG00000079974.19"
"18248","ENSG00000156687.11_178199",178191,178199,9,"ENSG00000156687.11",1,6,"VVVVVMVVV",0,8,0.902691511387163,11,17,33,36,83,89,133,136,"ATGATGA","CTGC","TTGATGA","CTGA",2.83663331275581,16,47,44,116,0.848767008376045,4.93991394002036,8.55067998556902,101,"ENSG00000079974.19"
"5799","ENSG00000106714.18_65572",65564,65572,9,"ENSG00000106714.18",0,NA,"VVVVVVVVV",0,9,1,116,122,133,136,141,147,156,159,"ATCAGTA","CTAA","ATAAAGA","CTGA",2.26844581784494,11,5,9,34,3.07159814051807,4.54864256487108,8.54864256487108,101,"ENSG00000079974.19"
"44681","ENSG00000283378.1_65628",65620,65628,9,"ENSG00000283378.1",0,NA,"VVVVVVVVV",0,9,1,116,122,133,136,141,147,156,159,"ATCAGTA","CTAA","ATAAAGA","CTGA",2.26844581784494,11,5,9,34,3.07159814051807,4.54864256487108,8.54864256487108,101,"ENSG00000079974.19"
"31453","ENSG00000223786.1_108987",108979,108987,9,"ENSG00000223786.1",0,NA,"UVVVVVVVV",1,8,0.902691511387163,109,115,133,136,148,154,162,165,"GCGATGA","CTGA","GTAAAAA","CTGA",2.60009638034294,18,12,8,47,2.41512840328347,4.9372760680591,8.54804211360775,101,"ENSG00000079974.19"
"12759","ENSG00000138835.24_50949",50941,50949,9,"ENSG00000138835.24",0,NA,"VVVVVVVVV",0,9,1,114,120,133,136,171,177,210,213,"ATGATGT","TTGT","TTGATAA","CTGA",2.5649571932264,13,35,33,90,1.09149797338865,4.5478031487245,8.5478031487245,101,"ENSG00000079974.19"
"30557","ENSG00000205726.15_12078",12070,12078,9,"ENSG00000205726.15",1,6,"VVVVVMVVV",0,8,0.902691511387163,110,116,133,136,141,147,167,170,"ATTATGA","GAGA","GTGATGA","CTGA",2.63136436424147,17,5,20,51,2.2033348791655,4.93644099352716,8.54720703907581,101,"ENSG00000079974.19"
"19697","ENSG00000163618.18_224579",224571,224579,9,"ENSG00000163618.18",0,NA,"VVVVVVVVV",0,9,1,73,79,94,97,102,108,133,136,"GTGAGAA","CAGA","GTGCTGT","CTGA",2.41102634366648,15,5,25,54,2.11407273456934,4.54689542308648,8.54689542308648,101,"ENSG00000079974.19"
"36184","ENSG00000238186.1_1177",1169,1177,9,"ENSG00000238186.1",0,NA,"VVVVVUVVV",1,8,0.922153209109731,112,118,133,136,151,157,169,172,"ATTATGT","TTGA","GGGATGA","CTGA",2.55085573025142,15,15,12,51,2.42184094375225,4.85688645302376,8.54549928946268,101,"ENSG00000079974.19"
"39363","ENSG00000253521.2_18824",18816,18824,9,"ENSG00000253521.2",0,NA,"VVVVVVVVV",0,9,1,83,89,101,104,115,121,133,136,"TTGATGG","CTGA","AGGATAG","CTGG",2.3065657842034,12,11,12,44,2.80200557223349,4.54477770006404,8.54477770006404,101,"ENSG00000079974.19"
"15158","ENSG00000147202.19_815387",815379,815387,9,"ENSG00000147202.19",0,NA,"VVVVVVVVV",0,9,1,101,107,133,136,143,149,165,168,"CTGATGT","TTGG","GTGCTGG","CTGA",2.44174926419055,26,7,16,58,1.89209237051764,4.54260519961367,8.54260519961367,101,"ENSG00000079974.19"
"29271","ENSG00000197584.13_324921",324913,324921,9,"ENSG00000197584.13",0,NA,"VVVVVVVVV",0,9,1,82,88,106,109,114,120,133,136,"ATGGTTA","CTGA","GTTATGA","CTGT",2.34673652190854,18,5,13,45,2.52296193527474,4.54196802033292,8.54196802033292,101,"ENSG00000079974.19"
"43896","ENSG00000275163.1_178730",178722,178730,9,"ENSG00000275163.1",0,NA,"VVVVVVVVV",0,9,1,82,88,106,109,114,120,133,136,"ATGGTTA","CTGA","GTTATGA","CTGT",2.34673652190854,18,5,13,45,2.52296193527474,4.54196802033292,8.54196802033292,101,"ENSG00000079974.19"
"20962","ENSG00000166069.14_29473",29465,29473,9,"ENSG00000166069.14",0,NA,"VVVVVVVVV",0,9,1,106,112,133,136,146,152,165,168,"AGGATTA","CTGT","ATGTGGC","CTGA",2.39057935450448,21,10,13,53,2.22730030358685,4.54112400007085,8.54112400007085,101,"ENSG00000079974.19"
"22274","ENSG00000170153.11_136337",136329,136337,9,"ENSG00000170153.11",0,NA,"VVVVVVVVV",0,9,1,113,119,133,136,150,156,174,177,"ATGAAGA","CAGT","ATTATAC","CTGA",2.38981904383844,14,14,18,55,2.2227923270347,4.53872982148941,8.53872982148941,101,"ENSG00000079974.19"
"13723","ENSG00000143294.15_34494",34486,34494,9,"ENSG00000143294.15",0,NA,"VVVVVVVVV",0,9,1,87,93,133,136,142,148,163,166,"ATGATGG","GTAA","TAGATTA","CTGA",2.4522335156024,40,6,15,70,1.80232544946796,4.53763722170432,8.53763722170432,101,"ENSG00000079974.19"
"27368","ENSG00000186088.16_101989",101981,101989,9,"ENSG00000186088.16",0,NA,"VVVVUVVVV",1,8,0.889855072463768,113,119,133,136,147,153,161,164,"CTCATGA","CTGA","GTGCTAG","CTGA",2.56704960518034,14,11,8,42,2.79655794474881,4.9775554948211,8.53697578467617,101,"ENSG00000079974.19"
"47715","ENSG00000289084.1_885255",885247,885255,9,"ENSG00000289084.1",1,8,"VVVVVVVMV",0,8,0.884057971014493,112,118,133,136,137,143,154,157,"ATCATGA","CTGA","GTTTGGA","CTGA",2.65078040063705,15,1,11,36,2.32352610950047,4.9988488617702,8.53508074582817,101,"ENSG00000079974.19"
"17220","ENSG00000153707.19_1567754",1567746,1567754,9,"ENSG00000153707.19",1,8,"VVVVVVVMV",0,8,0.884057971014493,76,82,103,106,110,116,133,136,"ATGAAGA","CTGA","TTGAAGC","CTGA",2.70624022487555,21,4,17,51,1.94565680554601,4.99681457617908,8.53304646023705,101,"ENSG00000079974.19"
"42187","ENSG00000261008.9_425648",425640,425648,9,"ENSG00000261008.9",0,NA,"VVVVVVVVV",0,9,1,111,117,133,136,145,151,186,189,"ATTATGT","TTAA","GTGGTGA","CTGA",2.44284064382582,16,9,35,69,1.84151010551367,4.53177859942145,8.53177859942145,101,"ENSG00000079974.19"
"1588","ENSG00000062716.13_100930",100922,100930,9,"ENSG00000062716.13",0,NA,"VVVVVVVVV",0,9,1,115,121,133,136,146,152,181,184,"AGAGTGA","CTGA","CTGAATA","CTGA",2.41180632379027,12,10,29,60,2.04729525640206,4.53150102041763,8.53150102041763,101,"ENSG00000079974.19"
"11826","ENSG00000136153.20_214572",214564,214572,9,"ENSG00000136153.20",0,NA,"VVVVVVVVV",0,9,1,85,91,133,136,141,147,162,165,"ATGATTT","CTAA","TTGATTT","CTGA",2.45589992244354,42,5,15,71,1.74923029475855,4.53047411109553,8.53047411109553,101,"ENSG00000079974.19"
"35318","ENSG00000235703.7_217269",217261,217269,9,"ENSG00000235703.7",0,NA,"VVVVVVVVV",0,9,1,48,54,64,67,113,119,133,136,"ATGATGT","CTGG","GTGATCA","CTGC",2.44932527700391,10,46,14,79,1.79276193620265,4.53039927905717,8.53039927905717,101,"ENSG00000079974.19"
"9722","ENSG00000126775.9_22638",22630,22638,9,"ENSG00000126775.9",1,7,"VVVVVVMVV",0,8,0.885300207039338,82,88,94,97,112,118,133,136,"TTGCTGA","CTGA","CTGATGA","CTGA",2.71172472534284,6,15,15,45,1.86438742379247,4.98563806485286,8.52683889301021,101,"ENSG00000079974.19"
"14804","ENSG00000145934.17_1115159",1115151,1115159,9,"ENSG00000145934.17",1,6,"VVVVVMVVV",0,8,0.902691511387163,112,118,133,136,146,152,166,169,"AAGAGGA","CAGA","GTGAGGA","CTGA",2.54633135139122,15,10,14,48,2.68088650240767,4.91410721125394,8.5248732568026,101,"ENSG00000079974.19"
"13247","ENSG00000140832.11_11886",11878,11886,9,"ENSG00000140832.11",0,NA,"VVVVVVVVV",0,9,1,109,115,133,136,144,150,192,195,"AAGATGA","GGGA","CTGGTGG","CTGA",2.46455600044339,18,8,42,77,1.66670341736455,4.52426918841346,8.52426918841346,101,"ENSG00000079974.19"
"33100","ENSG00000228689.8_18824",18816,18824,9,"ENSG00000228689.8",0,NA,"VVVVVVVVV",0,9,1,85,91,133,136,146,152,164,167,"ATAATGA","AGGA","GTGGTTG","CTGA",2.43579946433786,42,10,12,73,1.85695422302086,4.52390432965165,8.52390432965165,101,"ENSG00000079974.19"
"18246","ENSG00000156675.16_33816",33808,33816,9,"ENSG00000156675.16",0,NA,"VVVVVVVVV",0,9,1,97,103,133,136,141,147,157,160,"ATGATGG","GTAA","ATTATTT","CTGA",2.41802743452132,30,5,10,54,1.97507828177788,4.52381529464667,8.52381529464667,101,"ENSG00000079974.19"
"15989","ENSG00000150527.18_61647",61639,61647,9,"ENSG00000150527.18",0,NA,"VVVVVVVVV",0,9,1,82,88,102,105,110,116,133,136,"GTGATGG","CTGT","ATGTGGA","CAGA",2.32417285970062,14,5,17,45,2.59899857656282,4.52337107697508,8.52337107697508,101,"ENSG00000079974.19"
"10499","ENSG00000131374.15_273028",273020,273028,9,"ENSG00000131374.15",0,NA,"VVVVVVVVV",0,9,1,111,117,133,136,140,146,157,160,"ATAATAA","CACA","AAGAGGA","CTGA",2.30903835037137,16,4,11,40,2.69455314292949,4.52203553635133,8.52203553635133,101,"ENSG00000079974.19"
"6063","ENSG00000107882.12_104474",104466,104474,9,"ENSG00000107882.12",0,NA,"VVVVVVVVV",0,9,1,109,115,133,136,141,147,186,189,"ATGATGT","CACA","GTGCCAA","CTGA",2.46918767135785,18,5,39,71,1.62271818958328,4.52099233299224,8.52099233299224,101,"ENSG00000079974.19"
"3037","ENSG00000080493.19_329333",329325,329333,9,"ENSG00000080493.19",0,NA,"VVVVVUVVV",1,8,0.922153209109731,91,97,133,136,143,149,158,161,"ATAATGT","CTGA","CTGACAA","CTGA",2.59631000972744,36,7,9,61,2.00467448296862,4.82835197028789,8.51696480672681,101,"ENSG00000079974.19"
"47367","ENSG00000288043.1_9745",9737,9745,9,"ENSG00000288043.1",1,2,"VMVVVVVVV",0,8,0.884057971014493,113,119,133,136,175,181,192,195,"ATGTTGA","CTGA","AAGAAGA","CTGA",2.69426003499971,14,39,11,73,1.95870497037854,4.98010963426082,8.5163415183188,101,"ENSG00000079974.19"
"6581","ENSG00000110841.14_19424",19416,19424,9,"ENSG00000110841.14",0,NA,"VVVVVVVVV",0,9,1,61,67,76,79,115,121,133,136,"GTGATGA","CTTA","GTGTTCA","CAGA",2.43783516404207,9,36,12,66,1.8106642081548,4.51572465877549,8.51572465877549,101,"ENSG00000079974.19"
"18631","ENSG00000157890.19_89455",89447,89455,9,"ENSG00000157890.19",0,NA,"VVVVVVUVV",1,8,0.886128364389234,115,121,133,136,142,148,158,161,"GTGATGA","CTCC","GTGCAGT","CTGA",2.52149038612228,12,6,10,37,3.06278955962705,4.96818136677723,8.51269482433416,101,"ENSG00000079974.19"
"2355","ENSG00000073734.10_60528",60520,60528,9,"ENSG00000073734.10",0,NA,"VVVVVVVVV",0,9,1,116,122,133,136,179,185,199,202,"GTTATGT","CAGA","GTAATAA","CTGA",2.42987653869214,11,43,14,77,1.85014241732739,4.51232983548541,8.51232983548541,101,"ENSG00000079974.19"
"40961","ENSG00000258202.1_24905",24897,24905,9,"ENSG00000258202.1",0,NA,"VVVVVVVVV",0,9,1,72,78,90,93,104,110,133,136,"GTTTTGA","TTGA","GTAATTA","CTGA",2.37826964955181,12,11,23,55,2.19397689199859,4.51227697225266,8.51227697225266,101,"ENSG00000079974.19"
"18474","ENSG00000157445.15_715663",715655,715663,9,"ENSG00000157445.15",0,NA,"VVVVVVVVV",0,9,1,109,115,133,136,146,152,173,176,"ATGCTGT","TTCA","CTGGTGA","CTGA",2.40321730971185,18,10,21,58,2.02484598552418,4.51157367923412,8.51157367923412,101,"ENSG00000079974.19"
"3009","ENSG00000080224.18_878045",878037,878045,9,"ENSG00000080224.18",0,NA,"VVVVVVVVV",0,9,1,60,66,93,96,106,112,133,136,"CTCAGGA","CTGA","GTGATTT","CTGA",2.48627220860592,27,10,21,67,1.46116632284926,4.50907859505552,8.50907859505552,101,"ENSG00000079974.19"
"8256","ENSG00000117616.18_39554",39546,39554,9,"ENSG00000117616.18",0,NA,"VVVVVVVVV",0,9,1,114,120,133,136,147,153,170,173,"CAAATGA","CTCA","AAGAGGA","CTGA",2.3257154246606,13,11,17,50,2.52909524765885,4.50846618634905,8.50846618634905,101,"ENSG00000079974.19"
"42936","ENSG00000267374.3_289002",288994,289002,9,"ENSG00000267374.3",1,2,"VMVVVVVVV",0,8,0.884057971014493,72,78,87,90,96,102,133,136,"ATGCTGA","CTGA","TTGGAGA","CTGA",2.69270972410307,9,6,31,55,1.92726554963831,4.96966592758136,8.50589781163933,101,"ENSG00000079974.19"
"17933","ENSG00000155849.16_575733",575725,575733,9,"ENSG00000155849.16",0,NA,"VVVVVVVVV",0,9,1,87,93,133,136,142,148,200,203,"GTGTTGA","TTGA","ATGAGGC","CTGA",2.55490853261271,40,6,52,107,0.986845512917795,4.5048922659173,8.5048922659173,101,"ENSG00000079974.19"
"28851","ENSG00000196586.17_140913",140905,140913,9,"ENSG00000196586.17",1,7,"VVVVVVMVV",0,8,0.885300207039338,81,87,102,105,112,118,133,136,"ATGATGA","CAGA","ATGATGC","CAGA",2.56682690507198,15,7,15,46,2.73068460625846,4.96071599335124,8.50191682150859,101,"ENSG00000079974.19"
"42198","ENSG00000261083.3_14508",14500,14508,9,"ENSG00000261083.3",0,NA,"VVVVVVVVV",0,9,1,62,68,91,94,99,105,133,136,"CTGATGA","CTAA","TTGATGA","GTGA",2.49373312390919,23,5,28,65,1.37897872965703,4.50096655559625,8.50096655559625,101,"ENSG00000079974.19"
"15759","ENSG00000149403.13_326433",326425,326433,9,"ENSG00000149403.13",1,8,"VVVVVVVMV",0,8,0.884057971014493,105,111,133,136,145,151,168,171,"GTGATGA","CTGG","GTCAGGA","CTGA",2.68057279064821,22,9,17,57,1.98521013848261,4.96392385236766,8.50015573642564,101,"ENSG00000079974.19"
"28634","ENSG00000196277.16_534948",534940,534948,9,"ENSG00000196277.16",0,NA,"VVVVVVVVV",0,9,1,83,89,97,100,111,117,133,136,"ATAATGA","CTGG","ATGAATA","CTGT",2.34955552886833,8,11,16,44,2.33344045056286,4.49928599408793,8.49928599408793,101,"ENSG00000079974.19"
"41816","ENSG00000259786.7_236747",236739,236747,9,"ENSG00000259786.7",0,NA,"VVVVVVVVV",0,9,1,112,118,133,136,186,192,209,212,"ATGTTGA","ATAA","GTAATAA","CTGA",2.45771435289709,15,50,17,91,1.60797339481546,4.49818393686567,8.49818393686568,101,"ENSG00000079974.19"
"9663","ENSG00000126016.17_23293",23285,23293,9,"ENSG00000126016.17",0,NA,"VVVVVVVVV",0,9,1,109,115,133,136,176,182,196,199,"ATGATTT","CTTA","ATGGTAA","CTGA",2.46686432473695,18,40,14,81,1.54512020584195,4.49772059268873,8.49772059268873,101,"ENSG00000079974.19"
"38671","ENSG00000250802.7_75761",75753,75761,9,"ENSG00000250802.7",0,NA,"VVVVVVVVV",0,9,1,115,121,133,136,163,169,190,193,"ATGTTGA","CCTA","GGGAAGA","CTGA",2.46604877853048,12,27,21,69,1.54806264437625,4.49709695864486,8.49709695864486,101,"ENSG00000079974.19"
"45025","ENSG00000284762.1_75717",75709,75717,9,"ENSG00000284762.1",0,NA,"VVVVVVVVV",0,9,1,115,121,133,136,163,169,190,193,"ATGTTGA","CCTA","GGGAAGA","CTGA",2.46604877853048,12,27,21,69,1.54806264437625,4.49709695864486,8.49709695864486,101,"ENSG00000079974.19"
"19977","ENSG00000164100.9_207316",207308,207316,9,"ENSG00000164100.9",0,NA,"VVVVVVVVV",0,9,1,114,120,133,136,145,151,160,163,"TTCCTGA","TTGA","GATACGA","CTGA",2.25061695495531,13,9,9,40,2.9779462793036,4.49551482808474,8.49551482808474,101,"ENSG00000079974.19"
"7259","ENSG00000113396.13_98698",98690,98698,9,"ENSG00000113396.13",0,NA,"VVVVVVVVV",0,9,1,92,98,133,136,170,176,185,188,"GTGATGA","TTGT","ATTATTA","CTGA",2.54186107752708,35,34,9,87,1.0314108492929,4.49428784153502,8.49428784153502,101,"ENSG00000079974.19"
"26558","ENSG00000184408.10_275670",275662,275670,9,"ENSG00000184408.10",1,1,"MVVVVVVVV",0,8,0.90600414078675,111,117,133,136,147,153,162,165,"CTGATGA","ATGG","CTGACAA","CTGA",2.52026797412012,16,11,9,45,2.67763915973854,4.86985641346817,8.49387297661517,101,"ENSG00000079974.19"
"8696","ENSG00000120278.17_57391",57383,57391,9,"ENSG00000120278.17",0,NA,"VVVVVUVVV",1,8,0.922153209109731,102,108,133,136,148,154,203,206,"ATGATCA","CTGA","GTGAAGG","CTGA",2.74127957571192,25,12,49,95,0.940737405997673,4.80398364435261,8.49259648079153,101,"ENSG00000079974.19"
"22063","ENSG00000169760.18_583265",583257,583265,9,"ENSG00000169760.18",1,1,"MVVVVVVVV",0,8,0.90600414078675,93,99,133,136,141,147,159,162,"GTGAGGA","GTGA","GTGAAGA","CTGA",2.63574087491133,34,5,12,60,1.90161226399014,4.86830452418308,8.49232108733008,101,"ENSG00000079974.19"
"18006","ENSG00000155975.10_33209",33201,33209,9,"ENSG00000155975.10",0,NA,"UVVVVVVVV",1,8,0.902691511387163,112,118,133,136,150,156,164,167,"AAGATGA","TTGA","ATGTTTT","CTGA",2.54959420275709,15,14,8,46,2.51654657535864,4.87846031510148,8.48922636065014,101,"ENSG00000079974.19"
"22983","ENSG00000171862.13_72853",72845,72853,9,"ENSG00000171862.13",0,NA,"UVVVVVVVV",1,8,0.902691511387163,111,117,133,136,175,181,191,194,"GTGTTGA","CTGA","CTGTAGA","CTGA",2.64906021715081,16,39,10,74,1.84690554691813,4.87682674864755,8.48759279419621,101,"ENSG00000079974.19"
"31542","ENSG00000224063.6_414859",414851,414859,9,"ENSG00000224063.6",0,NA,"VVVVVVVVV",0,9,1,111,117,133,136,160,166,177,180,"TTGAGGT","TTGA","CTGCAGA","CTGA",2.396306542302,16,24,11,60,1.97033452326677,4.4864278679867,8.48642786798669,101,"ENSG00000079974.19"
"44385","ENSG00000281566.4_231079",231071,231079,9,"ENSG00000281566.4",1,7,"VVVVVVMVV",0,8,0.885300207039338,112,118,133,136,142,148,161,164,"ATGAAGA","TTGC","CTGAAGA","CTGA",2.54331644768784,15,6,13,43,2.82479659184204,4.94505989410692,8.48626072226427,101,"ENSG00000079974.19"
"11452","ENSG00000134987.13_14123",14115,14123,9,"ENSG00000134987.13",1,1,"MVVVVVVVV",0,8,0.90600414078675,105,111,133,136,148,154,164,167,"ATAATGA","CTGG","ATGAGAA","CTGA",2.60178767172547,22,12,10,53,2.10301346877982,4.86206615340408,8.48608271655108,101,"ENSG00000079974.19"
"10031","ENSG00000128881.18_103100",103092,103100,9,"ENSG00000128881.18",0,NA,"VVVVVVVVV",0,9,1,99,105,133,136,141,147,158,161,"ATCATGA","TGGA","ATTCTAA","CTGA",2.39232546964223,28,5,11,53,1.99537299314042,4.48605236435548,8.48605236435548,101,"ENSG00000079974.19"
"23951","ENSG00000174485.16_127654",127646,127654,9,"ENSG00000174485.16",0,NA,"VVVVVVVVV",0,9,1,108,114,133,136,142,148,180,183,"CTGTTGA","TTAA","ATGATGT","CTGA",2.44383544155227,19,6,32,66,1.65100146955291,4.48580943664201,8.48580943664201,101,"ENSG00000079974.19"
"45727","ENSG00000285838.2_37939",37931,37939,9,"ENSG00000285838.2",1,8,"VVVVVVVMV",0,8,0.884057971014493,110,116,133,136,141,147,165,168,"ATGATGA","AGGA","AAGAGGA","CTGA",2.6210175092176,17,5,18,49,2.32371445514976,4.94929112915011,8.48552301320808,101,"ENSG00000079974.19"
"39602","ENSG00000253901.1_194064",194056,194064,9,"ENSG00000253901.1",0,NA,"VVVVVVVVV",0,9,1,85,91,133,136,145,151,190,193,"CTGAGGA","TTGA","ATAATGA","CTGA",2.54454958289023,42,9,39,99,0.976263849891377,4.48498193395656,8.48498193395656,101,"ENSG00000079974.19"
"43385","ENSG00000271774.1_53551",53543,53551,9,"ENSG00000271774.1",1,1,"MVVVVVVVV",0,8,0.90600414078675,96,102,110,113,115,121,133,136,"AGGATGA","CTGG","GAGAAAA","CTGA",2.53746526666339,8,2,12,31,2.52611419901312,4.8606373275256,8.4846538906726,101,"ENSG00000079974.19"
"45072","ENSG00000284977.3_454653",454645,454653,9,"ENSG00000284977.3",1,1,"MVVVVVVVV",0,8,0.90600414078675,62,68,88,91,96,102,133,136,"ATAATGA","TTGA","ATGAAGA","CTGA",2.68642418950107,20,5,31,65,1.52897558497705,4.85961754541272,8.48363410855971,101,"ENSG00000079974.19"
"3802","ENSG00000089101.19_86594",86586,86594,9,"ENSG00000089101.19",0,NA,"VVVVVVVVV",0,9,1,101,107,133,136,142,148,156,159,"TTGATGG","CAAA","ATTATTA","CTGA",2.37532572061039,26,6,8,49,2.09874975761848,4.48356364042194,8.48356364042194,101,"ENSG00000079974.19"
"8567","ENSG00000119640.9_15840",15832,15840,9,"ENSG00000119640.9",0,NA,"VVVVVVVVV",0,9,1,114,120,133,136,142,148,159,162,"AGGCTGA","GGGA","AGGCTGG","CTGA",2.2382192521743,13,6,11,39,3.01000559323771,4.48286681859993,8.48286681859993,101,"ENSG00000079974.19"
"33578","ENSG00000230426.5_183945",183937,183945,9,"ENSG00000230426.5",1,1,"MVVVVVVVV",0,8,0.90600414078675,71,77,105,108,116,122,133,136,"ATGATGA","CTGA","ATGCTAA","CTTA",2.60738416988417,28,8,11,56,2.0503920809058,4.85823830336673,8.48225486651373,101,"ENSG00000079974.19"
"14717","ENSG00000145757.16_10579",10571,10579,9,"ENSG00000145757.16",0,NA,"UVVVVVVVV",1,8,0.902691511387163,107,113,133,136,144,150,164,167,"ATGATGT","CTGC","GTAAGAA","CTGA",2.5704417727684,20,8,14,51,2.34882965321937,4.87127703458551,8.48204308013416,101,"ENSG00000079974.19"
"7117","ENSG00000112893.10_124218",124210,124218,9,"ENSG00000112893.10",1,8,"VVVVVVVMV",0,8,0.884057971014493,79,85,100,103,115,121,133,136,"ATGATAC","CTGA","TTGGAGA","CTGA",2.57203223645311,15,12,12,48,2.6352298265801,4.94552785073354,8.48175973479151,101,"ENSG00000079974.19"
"45506","ENSG00000285673.1_177393",177385,177393,9,"ENSG00000285673.1",1,1,"MVVVVVVVV",0,8,0.90600414078675,110,116,133,136,143,149,184,187,"ATGATGT","CAGA","TTGAAAA","CTGA",2.6428469963587,17,7,35,68,1.80801809480701,4.85674951763291,8.48076608077991,101,"ENSG00000079974.19"
"21644","ENSG00000168671.10_34500",34492,34500,9,"ENSG00000168671.10",1,1,"MVVVVVVVV",0,8,0.90600414078675,93,99,111,114,116,122,133,136,"GTGAAGA","CTCA","GTAATAA","CTGA",2.51187432526904,12,2,11,34,2.67787429758514,4.85592578317802,8.47994234632502,101,"ENSG00000079974.19"
"41219","ENSG00000258700.6_421816",421808,421816,9,"ENSG00000258700.6",0,NA,"VVVVVVVVV",0,9,1,79,85,100,103,111,117,133,136,"TAGAAGA","TTGA","GAGATTT","CTGA",2.28878523968322,15,8,16,48,2.65648061531143,4.47876221996656,8.47876221996656,101,"ENSG00000079974.19"
"43530","ENSG00000272168.10_896061",896053,896061,9,"ENSG00000272168.10",1,8,"VVVVVVVMV",0,8,0.884057971014493,80,86,103,106,109,115,133,136,"ATGTTGG","CTGA","CTGAAGA","CTGA",2.65072973688226,17,3,18,47,2.09470646197714,4.94155951029805,8.47779139435602,101,"ENSG00000079974.19"
"10014","ENSG00000128815.20_274529",274521,274529,9,"ENSG00000128815.20",0,NA,"VVVVVVVVV",0,9,1,116,122,133,136,155,161,177,180,"ATGCTGT","CCCA","GTGCAGA","CTGA",2.37676585434534,11,19,16,55,2.05610697856568,4.47530316855032,8.47530316855032,101,"ENSG00000079974.19"
"36976","ENSG00000244005.13_992",984,992,9,"ENSG00000244005.13",1,8,"VVVVVVVMV",0,8,0.884057971014493,65,71,85,88,110,116,133,136,"GTGATCA","CTGA","GTGAAGG","CTGA",2.6834108389441,14,22,17,62,1.86501814913626,4.93860593552423,8.4748378195822,101,"ENSG00000079974.19"
"159","ENSG00000005812.11_21674",21666,21674,9,"ENSG00000005812.11",0,NA,"VVVVVVVVV",0,9,1,21,27,65,68,79,85,133,136,"GTGATGA","CTTA","AAAATTA","CTGA",2.55834071423512,38,11,48,106,0.842008379259623,4.47440328520678,8.47440328520678,101,"ENSG00000079974.19"
"33903","ENSG00000231424.3_472181",472173,472181,9,"ENSG00000231424.3",0,NA,"VVVVVVVVV",0,9,1,53,59,86,89,101,107,133,136,"ATGATGA","CTGA","AAGCTAA","CTCA",2.51885255791506,27,12,26,74,1.10487759999355,4.47430699652349,8.47430699652348,101,"ENSG00000079974.19"
"42088","ENSG00000260661.1_83017",83009,83017,9,"ENSG00000260661.1",0,NA,"VVVVVVVVV",0,9,1,76,82,92,95,101,107,133,136,"CTCATGA","CAGT","CTGGTAA","CTGA",2.36338180252161,10,6,26,51,2.13993326297355,4.47395298661274,8.47395298661274,101,"ENSG00000079974.19"
"12858","ENSG00000139220.17_298509",298501,298509,9,"ENSG00000139220.17",0,NA,"VVVVVVVVV",0,9,1,81,87,97,100,108,114,133,136,"ATTTTGA","TTGG","TTGATAT","CTGA",2.31140423805998,10,8,19,46,2.48533929826746,4.4736752213335,8.4736752213335,101,"ENSG00000079974.19"
"1361","ENSG00000054392.13_197572",197564,197572,9,"ENSG00000054392.13",0,NA,"VVVVVVVVV",0,9,1,75,81,89,92,101,107,133,136,"CTGGTGA","AGGA","ATGTAGA","CTGA",2.39609815399435,8,9,26,52,1.91833355542576,4.47308031218035,8.47308031218035,101,"ENSG00000079974.19"
"41911","ENSG00000259986.2_247721",247713,247721,9,"ENSG00000259986.2",0,NA,"VVVVVVVVV",0,9,1,106,112,133,136,142,148,169,172,"ATAAAGA","GAGA","ATGATAA","CTGA",2.40503894081169,21,6,21,57,1.85390159055066,4.47187363232381,8.47187363232381,101,"ENSG00000079974.19"
"163","ENSG00000005884.18_17281",17273,17281,9,"ENSG00000005884.18",0,NA,"VVVVVVVVV",0,9,1,112,118,133,136,145,151,189,192,"ATGATTA","TTGA","GTGAAGT","GTGA",2.3986298160559,15,9,38,71,1.89028522018117,4.47028766513845,8.47028766513845,101,"ENSG00000079974.19"
"17603","ENSG00000154639.19_48391",48383,48391,9,"ENSG00000154639.19",0,NA,"VVVVVVVVV",0,9,1,115,121,133,136,147,153,199,202,"TTGCTGT","CAGA","ATGAAAA","CTGA",2.40524739737722,12,11,46,78,1.84118854135177,4.4690427976333,8.4690427976333,101,"ENSG00000079974.19"
"20863","ENSG00000165899.12_116662",116654,116662,9,"ENSG00000165899.12",0,NA,"UVVVVVVVV",1,8,0.902691511387163,115,121,133,136,182,188,204,207,"CTGTTGA","CTGA","CTGCTGA","CTGA",2.65064748278624,12,46,16,83,1.76079715992268,4.85794509462441,8.46871114017306,101,"ENSG00000079974.19"
"26454","ENSG00000184304.17_172602",172594,172602,9,"ENSG00000184304.17",0,NA,"UVVVVVVVV",1,8,0.902691511387163,111,117,133,136,147,153,164,167,"TTGAGGA","CATA","GTGATGA","CTGA",2.51542815958198,16,11,11,47,2.66153838573431,4.85776486240354,8.46853090795219,101,"ENSG00000079974.19"
"37859","ENSG00000248975.2_277747",277739,277747,9,"ENSG00000248975.2",0,NA,"UVVVVVVVV",1,8,0.902691511387163,111,117,133,136,147,153,164,167,"TTGAGGA","CATA","GTGATGA","CTGA",2.51542815958198,16,11,11,47,2.66153838573431,4.85776486240354,8.46853090795219,101,"ENSG00000079974.19"
"13629","ENSG00000142698.15_3006",2998,3006,9,"ENSG00000142698.15",1,8,"VVVVVVVMV",0,8,0.884057971014493,116,122,133,136,147,153,163,166,"TTCATGA","CAGA","GTGAGGC","CTGA",2.53322583011482,11,11,10,41,2.83404292477404,4.93055378138488,8.46678566544285,101,"ENSG00000079974.19"
"25822","ENSG00000182901.18_481682",481674,481682,9,"ENSG00000182901.18",1,5,"VVVVMVVVV",0,8,0.886542443064182,113,119,133,136,144,150,161,164,"AAGATGA","TTGG","GTGGAGA","CTGA",2.50847491936231,14,8,11,42,2.95372298478643,4.91922227846713,8.46539205072385,101,"ENSG00000079974.19"
"14596","ENSG00000145416.14_676533",676525,676533,9,"ENSG00000145416.14",0,NA,"UVVVVVVVV",1,8,0.902691511387163,116,122,133,136,138,144,164,167,"ATGATGA","ATGT","TTGTTGC","CTGA",2.6075806328857,11,2,20,42,2.0338548930404,4.85443144473627,8.46519749028492,101,"ENSG00000079974.19"
"45426","ENSG00000285572.2_17607",17599,17607,9,"ENSG00000285572.2",1,6,"VVVVVMVVV",0,8,0.902691511387163,28,34,79,82,89,95,133,136,"ATGTTGA","CTGA","TTGAGGA","CTGA",2.75760462959431,45,7,38,99,1.03053970586509,4.85364264245679,8.46440868800544,101,"ENSG00000079974.19"
"32715","ENSG00000227646.7_105683",105675,105683,9,"ENSG00000227646.7",1,2,"VMVVVVVVV",0,8,0.884057971014493,111,117,133,136,144,150,164,167,"ATGTTAA","CTGA","ATGATCT","CTGA",2.55195478647313,16,8,14,47,2.69866055829866,4.92792311702989,8.46415500108786,101,"ENSG00000079974.19"
"19203","ENSG00000162496.9_44956",44948,44956,9,"ENSG00000162496.9",1,8,"VVVVVVVMV",0,8,0.884057971014493,108,114,133,136,146,152,177,180,"CTGTTGA","CTGA","GTGATGT","CTGA",2.69414410440787,19,10,25,63,1.74808001679988,4.92726017821308,8.46349206227105,101,"ENSG00000079974.19"
"31607","ENSG00000224184.7_791405",791397,791405,9,"ENSG00000224184.7",1,7,"VVVVVVMVV",0,8,0.885300207039338,114,120,133,136,180,186,194,197,"AGGATGA","CTCA","ATGATGT","CTGA",2.65576981965192,13,44,8,74,1.9789830527142,4.92102879593175,8.4622296240891,101,"ENSG00000079974.19"
"46349","ENSG00000286481.2_800428",800420,800428,9,"ENSG00000286481.2",0,NA,"VVVVVVVVV",0,9,1,82,88,133,136,143,149,162,165,"GAAATGA","ATGA","GTCATAA","CTGA",2.38868256402466,45,7,13,74,1.91934906486995,4.46097487292526,8.46097487292526,101,"ENSG00000079974.19"
"38420","ENSG00000250149.2_143615",143607,143615,9,"ENSG00000250149.2",0,NA,"UVVVVVVVV",1,8,0.902691511387163,113,119,133,136,142,148,159,162,"ATGATGA","ATGT","GTGATGT","CAGA",2.46511562323319,14,6,11,40,2.96660043579519,4.85017614767078,8.46094219321944,101,"ENSG00000079974.19"
"27244","ENSG00000185774.16_310861",310853,310861,9,"ENSG00000185774.16",0,NA,"VVVVVVVVV",0,9,1,116,122,133,136,140,146,155,158,"ATGATAA","TGGA","CTGGTGT","CTCA",2.22239981082609,11,4,9,33,3.01944027565145,4.45885975362301,8.45885975362301,101,"ENSG00000079974.19"
"33265","ENSG00000229150.3_614",606,614,9,"ENSG00000229150.3",1,1,"MVVVVVVVV",0,8,0.90600414078675,47,53,62,65,116,122,133,136,"GTGATGA","CAGA","GTCATCT","CTGA",2.62692993471342,9,51,11,80,1.82268195762721,4.83388704726251,8.45790361040951,101,"ENSG00000079974.19"
"48309","ENSG00000290929.1_755",747,755,9,"ENSG00000290929.1",1,1,"MVVVVVVVV",0,8,0.90600414078675,47,53,62,65,116,122,133,136,"GTGATGA","CAGA","GTCATCT","CTGA",2.62692993471342,9,51,11,80,1.82268195762721,4.83388704726251,8.45790361040951,101,"ENSG00000079974.19"
"7826","ENSG00000115841.21_116405",116397,116405,9,"ENSG00000115841.21",0,NA,"VVVVVUVVV",1,8,0.922153209109731,57,63,81,84,115,121,133,136,"TTGATGG","CTGA","ATCATTA","CTGA",2.61146443285205,18,31,12,70,1.66687001967446,4.76915822633869,8.45777106277762,101,"ENSG00000079974.19"
"34702","ENSG00000233842.2_17031",17023,17031,9,"ENSG00000233842.2",1,8,"VVVVVVVMV",0,8,0.884057971014493,60,66,95,98,108,114,133,136,"ATGATGA","CTTA","ATTAAGA","CTGA",2.72220607262456,29,10,19,67,1.53207362340383,4.9200285268919,8.45626041094987,101,"ENSG00000079974.19"
"16054","ENSG00000150672.19_1645094",1645086,1645094,9,"ENSG00000150672.19",1,3,"VVMVVVVVV",0,8,0.882815734989648,114,120,133,136,143,149,160,163,"CTTATGA","ATGA","ATGCTGC","CTGA",2.50214702310265,13,7,11,40,3.01450882069823,4.92387224367898,8.45513518363757,101,"ENSG00000079974.19"
"8386","ENSG00000118507.18_69587",69579,69587,9,"ENSG00000118507.18",1,1,"MVVVVVVVV",0,8,0.90600414078675,110,116,133,136,140,146,188,191,"ATGATGA","GTGT","GTGTAGA","CTGA",2.65703539897845,17,4,42,72,1.60645238601118,4.83000542813355,8.45402199128055,101,"ENSG00000079974.19"
"22042","ENSG00000169752.17_116638",116630,116638,9,"ENSG00000169752.17",1,8,"VVVVVVVMV",0,8,0.884057971014493,84,90,96,99,116,122,133,136,"CTGATGA","CTGA","GCAATTA","CTGA",2.66331312346221,6,17,11,43,1.91372603659764,4.91728671491975,8.45351859897772,101,"ENSG00000079974.19"
"42195","ENSG00000261064.1_5890",5882,5890,9,"ENSG00000261064.1",1,8,"VVVVVVVMV",0,8,0.884057971014493,116,122,133,136,165,171,179,182,"ATGAAGA","TTGA","TTGATGG","CTGA",2.64756151331041,11,29,8,57,2.01621196836424,4.91665551427508,8.45288739833305,101,"ENSG00000079974.19"
"47696","ENSG00000289083.1_5178",5170,5178,9,"ENSG00000289083.1",1,8,"VVVVVVVMV",0,8,0.884057971014493,116,122,133,136,165,171,179,182,"ATGAAGA","TTGA","TTGATGG","CTGA",2.64756151331041,11,29,8,57,2.01621196836424,4.91665551427508,8.45288739833305,101,"ENSG00000079974.19"
"47815","ENSG00000289397.1_5905",5897,5905,9,"ENSG00000289397.1",1,8,"VVVVVVVMV",0,8,0.884057971014493,116,122,133,136,165,171,179,182,"ATGAAGA","TTGA","TTGATGG","CTGA",2.64756151331041,11,29,8,57,2.01621196836424,4.91665551427508,8.45288739833305,101,"ENSG00000079974.19"
"17508","ENSG00000154258.17_69788",69780,69788,9,"ENSG00000154258.17",0,NA,"VVVVVVVVV",0,9,1,109,115,133,136,149,155,165,168,"AGGATTA","AAGA","ATCATTA","CTGA",2.31715512066488,18,13,10,50,2.36124505747974,4.45223646547807,8.45223646547807,101,"ENSG00000079974.19"
"24516","ENSG00000176769.9_10596",10588,10596,9,"ENSG00000176769.9",0,NA,"VVVVVVVVV",0,9,1,116,122,133,136,184,190,207,210,"GTGCTGA","ATAA","GTGGTGC","CTGA",2.42025476469208,11,48,17,85,1.67378085060676,4.45220315380516,8.45220315380516,101,"ENSG00000079974.19"
"1719","ENSG00000065609.15_129540",129532,129540,9,"ENSG00000065609.15",0,NA,"VVVVVVVVV",0,9,1,116,122,133,136,179,185,214,217,"ATTATGT","CTTA","ATGAAGT","CTGA",2.50192632525193,11,43,29,92,1.12780176379002,4.45182764970072,8.45182764970072,101,"ENSG00000079974.19"
"21291","ENSG00000166974.13_70095",70087,70095,9,"ENSG00000166974.13",0,NA,"UVVVVVVVV",1,8,0.902691511387163,115,121,133,136,142,148,190,193,"TTAATGA","CCGA","CTGATGA","CTGA",2.60466341105001,12,6,42,69,1.99764454234412,4.84051682066939,8.45128286621804,101,"ENSG00000079974.19"
"15235","ENSG00000147481.17_324438",324430,324438,9,"ENSG00000147481.17",1,1,"MVVVVVVVV",0,8,0.90600414078675,103,109,133,136,141,147,163,166,"ATCATGA","ATGA","ATGATAT","CTGA",2.61008764279786,24,5,16,54,1.90808296050353,4.82716681145565,8.45118337460265,101,"ENSG00000079974.19"
"1043","ENSG00000046653.15_58923",58915,58923,9,"ENSG00000046653.15",0,NA,"VVVVVVVVV",0,9,1,107,113,133,136,146,152,196,199,"GAGATGA","CTAC","CTGAGGA","CTGA",2.46103253901975,20,10,44,83,1.39767555765206,4.45113978777927,8.45113978777927,101,"ENSG00000079974.19"
"38450","ENSG00000250195.1_12756",12748,12756,9,"ENSG00000250195.1",1,8,"VVVVVVVMV",0,8,0.884057971014493,54,60,78,81,114,120,133,136,"AAGATGA","CTGA","CTGTTGT","CTGA",2.7062458872952,18,33,13,73,1.61465458433601,4.91407345824267,8.45030534230064,101,"ENSG00000079974.19"
"42457","ENSG00000263438.6_30258",30250,30258,9,"ENSG00000263438.6",1,8,"VVVVVVVMV",0,8,0.884057971014493,115,121,133,136,143,149,161,164,"TTAATGA","CAGA","TTGAGAA","CTGA",2.498325357571,12,7,12,40,2.99132810114279,4.91170762123737,8.44793950529534,101,"ENSG00000079974.19"
"31912","ENSG00000225249.6_137706",137698,137706,9,"ENSG00000225249.6",0,NA,"VVVVVVVVV",0,9,1,99,105,133,136,149,155,189,192,"TTGATGA","TGGA","GTAAAGA","CTGA",2.54307696213684,28,13,34,84,0.835755610983594,4.4474005063073,8.4474005063073,101,"ENSG00000079974.19"
"17538","ENSG00000154358.23_114343",114335,114343,9,"ENSG00000154358.23",0,NA,"VVVVVVUVV",1,8,0.886128364389234,116,122,133,136,139,145,155,158,"CTGAGGT","CTGA","TTGAGGT","CTGA",2.50891175446795,11,3,10,33,2.88390446837489,4.90249570787363,8.44700916543057,101,"ENSG00000079974.19"
"17661","ENSG00000154678.18_531093",531085,531093,9,"ENSG00000154678.18",0,NA,"VVVVVVVVV",0,9,1,75,81,92,95,98,104,133,136,"ATGACGT","TTCA","GTGGAGA","CTGA",2.39408263472281,11,3,29,52,1.82491758824859,4.44636712160017,8.44636712160017,101,"ENSG00000079974.19"
"2183","ENSG00000071051.14_63960",63952,63960,9,"ENSG00000071051.14",1,5,"VVVVMVUVV",1,7,0.772670807453416,83,89,101,104,109,115,133,136,"ATGATGT","CTGA","GTGCTGA","CTGA",2.82671386541799,12,5,18,44,2.57637255898621,5.35528291544321,8.44596614525687,101,"ENSG00000079974.19"
"27120","ENSG00000185565.12_831117",831109,831117,9,"ENSG00000185565.12",1,3,"VVMVVVVVV",0,8,0.882815734989648,77,83,106,109,114,120,133,136,"ATGTTGA","CTGA","GGGTTTA","CTGA",2.62922625121593,23,5,13,50,2.12435866656067,4.91313341866672,8.44439635862531,101,"ENSG00000079974.19"
"30039","ENSG00000198963.11_148458",148450,148458,9,"ENSG00000198963.11",0,NA,"VVVVVVVVV",0,9,1,86,92,133,136,140,146,155,158,"CTGATGG","AAGA","CTTATAA","CTGA",2.39057792817599,41,4,9,63,1.83733870868522,4.44363122413129,8.44363122413129,101,"ENSG00000079974.19"
"41561","ENSG00000259240.1_212632",212624,212632,9,"ENSG00000259240.1",1,8,"VVVVVVVMV",0,8,0.884057971014493,86,92,102,105,112,118,133,136,"CTGCTGT","CTGA","GTGTGGA","CTGA",2.53028738865895,10,7,15,41,2.7605648588743,4.90728686248349,8.44351874654146,101,"ENSG00000079974.19"
"11237","ENSG00000134324.12_71993",71985,71993,9,"ENSG00000134324.12",0,NA,"VVVVVUVVV",1,8,0.922153209109731,99,105,133,136,141,147,160,163,"ATGTTGA","CTGG","GGGCTGA","CTGA",2.5636137245779,28,5,13,55,1.92859536160333,4.754838381364,8.44345121780293,101,"ENSG00000079974.19"
"42414","ENSG00000262655.4_215994",215986,215994,9,"ENSG00000262655.4",0,NA,"VVVVVVVVV",0,9,1,56,62,75,78,111,117,133,136,"ATGATGA","ATTA","CAGATGA","CTAA",2.39842330513286,13,33,16,71,1.7833162920874,4.44320124824329,8.44320124824329,101,"ENSG00000079974.19"
"29476","ENSG00000198018.7_39836",39828,39836,9,"ENSG00000198018.7",0,NA,"VVVVVVVVV",0,9,1,115,121,133,136,147,153,183,186,"TAGATGT","ATGA","TTGTTTA","CTGA",2.37150159070837,12,11,30,62,1.96182597146913,4.4429591440479,8.4429591440479,101,"ENSG00000079974.19"
"27245","ENSG00000185774.16_326235",326227,326235,9,"ENSG00000185774.16",0,NA,"VVVVVVVVV",0,9,1,99,105,133,136,180,186,197,200,"ATTATGA","CTGC","AGGTTGT","CTGA",2.5050113215868,28,44,11,92,1.06703809593187,4.4417783932943,8.4417783932943,101,"ENSG00000079974.19"
"19196","ENSG00000162437.15_52372",52364,52372,9,"ENSG00000162437.15",0,NA,"VVVVVVVVV",0,9,1,41,47,75,78,116,122,133,136,"ATGATGC","CTGA","GTGTTCA","GTGA",2.50370162590633,28,38,11,86,1.07483925132194,4.4415458560077,8.4415458560077,101,"ENSG00000079974.19"
"11979","ENSG00000136770.11_17458",17450,17458,9,"ENSG00000136770.11",0,NA,"VVVVVVVVV",0,9,1,113,119,133,136,142,148,161,164,"ATGAAGG","CTGG","ATGTGGA","CTTA",2.23150859703126,14,6,13,42,2.88424365300399,4.4402419083031,8.4402419083031,101,"ENSG00000079974.19"
"11838","ENSG00000136161.13_43328",43320,43328,9,"ENSG00000136161.13",0,NA,"VVVVVUVVV",1,8,0.922153209109731,35,41,53,56,84,90,133,136,"ATGATGA","CTGA","GTGGTGA","TTGA",2.68801278957529,12,28,43,92,1.08474542669552,4.7512076726327,8.43982050907162,101,"ENSG00000079974.19"
"38147","ENSG00000249693.3_14601",14593,14601,9,"ENSG00000249693.3",0,NA,"VVVVVUVVV",1,8,0.922153209109731,49,55,77,80,92,98,133,136,"GTGATGA","CTAA","GTTAGGA","CTGA",2.67659928491469,22,12,35,78,1.1559493748985,4.74998615191577,8.4385989883547,101,"ENSG00000079974.19"
"31930","ENSG00000225315.2_21719",21711,21719,9,"ENSG00000225315.2",0,NA,"VVVVVVVVV",0,9,1,87,93,107,110,114,120,133,136,"GTAATGT","CTGA","ATGCAGC","CTGG",2.25001221890557,14,4,13,40,2.753905864183,4.43849683088836,8.43849683088836,101,"ENSG00000079974.19"
"42537","ENSG00000264031.1_143547",143539,143547,9,"ENSG00000264031.1",0,NA,"VVVVVVVVV",0,9,1,106,112,133,136,182,188,201,204,"GTGGTGC","CTTA","ATGATGT","CTGA",2.46341531512394,21,46,13,89,1.33106836140692,4.43845928222497,8.43845928222497,101,"ENSG00000079974.19"
"17377","ENSG00000154001.14_105164",105156,105164,9,"ENSG00000154001.14",1,8,"VVVVVVVMV",0,8,0.884057971014493,113,119,133,136,152,158,179,182,"ATGATGA","GAGA","ATGTGGA","CTGA",2.65428703108615,14,16,21,60,1.91281586387973,4.90201568444686,8.43824756850483,101,"ENSG00000079974.19"
"46211","ENSG00000286291.1_1765",1757,1765,9,"ENSG00000286291.1",0,NA,"VVVVVVVVV",0,9,1,116,122,133,136,147,153,171,174,"CAGATTA","TGGA","TTGAAGA","CTGA",2.29551806105156,11,11,18,49,2.44715686390202,4.43765265106144,8.43765265106144,101,"ENSG00000079974.19"
"28167","ENSG00000188316.15_37105",37097,37105,9,"ENSG00000188316.15",0,NA,"VVVVVVVVV",0,9,1,102,108,133,136,137,143,153,156,"ATGAAGA","GAGA","GAGAAAA","CTGA",2.43654076947521,25,1,10,45,1.50346212777013,4.43676681440122,8.43676681440122,101,"ENSG00000079974.19"
"21582","ENSG00000168405.18_105940",105932,105940,9,"ENSG00000168405.18",1,8,"VVVVVVVMV",0,8,0.884057971014493,62,68,89,92,110,116,133,136,"ATGAGGA","CTGA","GGGAAGA","CTGA",2.71778679261477,21,18,17,65,1.48017418398824,4.89968820035502,8.43592008441299,101,"ENSG00000079974.19"
"27551","ENSG00000186481.17_11885",11877,11885,9,"ENSG00000186481.17",1,3,"VVMVVVVVV",0,8,0.882815734989648,59,65,104,107,111,117,133,136,"TTGATGA","CAGA","GTTATGA","CTGA",2.70296907812642,39,4,16,68,1.59834447724507,4.9045345828553,8.4357975228139,101,"ENSG00000079974.19"
"30657","ENSG00000206192.7_3256",3248,3256,9,"ENSG00000206192.7",1,3,"VVMVVVVVV",0,8,0.882815734989648,59,65,104,107,111,117,133,136,"TTGATGA","CAGA","GTTATGA","CTGA",2.70296907812642,39,4,16,68,1.59834447724507,4.9045345828553,8.4357975228139,101,"ENSG00000079974.19"
"31100","ENSG00000215559.9_11896",11888,11896,9,"ENSG00000215559.9",1,3,"VVMVVVVVV",0,8,0.882815734989648,59,65,104,107,111,117,133,136,"TTGATGA","CAGA","GTTATGA","CTGA",2.70296907812642,39,4,16,68,1.59834447724507,4.9045345828553,8.4357975228139,101,"ENSG00000079974.19"
"48120","ENSG00000290461.1_12183",12175,12183,9,"ENSG00000290461.1",1,3,"VVMVVVVVV",0,8,0.882815734989648,59,65,104,107,111,117,133,136,"TTGATGA","CAGA","GTTATGA","CTGA",2.70296907812642,39,4,16,68,1.59834447724507,4.9045345828553,8.4357975228139,101,"ENSG00000079974.19"
"48550","ENSG00000291280.1_12422",12414,12422,9,"ENSG00000291280.1",1,3,"VVMVVVVVV",0,8,0.882815734989648,59,65,104,107,111,117,133,136,"TTGATGA","CAGA","GTTATGA","CTGA",2.70296907812642,39,4,16,68,1.59834447724507,4.9045345828553,8.4357975228139,101,"ENSG00000079974.19"
"23039","ENSG00000172014.14_11102",11094,11102,9,"ENSG00000172014.14",1,3,"VVMVVVVVV",0,8,0.882815734989648,55,61,70,73,111,117,133,136,"TTGATGA","ATGA","GTTATGA","CTGA",2.70171751367085,9,38,16,72,1.60581697664513,4.90431676694604,8.43557970690463,101,"ENSG00000079974.19"
"26016","ENSG00000183148.9_11109",11101,11109,9,"ENSG00000183148.9",1,3,"VVMVVVVVV",0,8,0.882815734989648,55,61,70,73,111,117,133,136,"TTGATGA","ATGA","GTTATGA","CTGA",2.70171751367085,9,38,16,72,1.60581697664513,4.90431676694604,8.43557970690463,101,"ENSG00000079974.19"
"35710","ENSG00000236816.5_11108",11100,11108,9,"ENSG00000236816.5",1,3,"VVMVVVVVV",0,8,0.882815734989648,55,61,70,73,111,117,133,136,"TTGATGA","ATGA","GTTATGA","CTGA",2.70171751367085,9,38,16,72,1.60581697664513,4.90431676694604,8.43557970690463,101,"ENSG00000079974.19"
"36362","ENSG00000240240.10_11104",11096,11104,9,"ENSG00000240240.10",1,3,"VVMVVVVVV",0,8,0.882815734989648,55,61,70,73,111,117,133,136,"TTGATGA","ATGA","GTTATGA","CTGA",2.70171751367085,9,38,16,72,1.60581697664513,4.90431676694604,8.43557970690463,101,"ENSG00000079974.19"
"43966","ENSG00000276203.7_11222",11214,11222,9,"ENSG00000276203.7",1,3,"VVMVVVVVV",0,8,0.882815734989648,55,61,70,73,111,117,133,136,"TTGATGA","ATGA","GTTATGA","CTGA",2.70171751367085,9,38,16,72,1.60581697664513,4.90431676694604,8.43557970690463,101,"ENSG00000079974.19"
"48326","ENSG00000290971.1_37730",37722,37730,9,"ENSG00000290971.1",1,3,"VVMVVVVVV",0,8,0.882815734989648,55,61,70,73,111,117,133,136,"TTGATGA","ATGA","GTTATGA","CTGA",2.70171751367085,9,38,16,72,1.60581697664513,4.90431676694604,8.43557970690463,101,"ENSG00000079974.19"
"48328","ENSG00000290972.1_11383",11375,11383,9,"ENSG00000290972.1",1,3,"VVMVVVVVV",0,8,0.882815734989648,55,61,70,73,111,117,133,136,"TTGATGA","ATGA","GTTATGA","CTGA",2.70171751367085,9,38,16,72,1.60581697664513,4.90431676694604,8.43557970690463,101,"ENSG00000079974.19"
"48485","ENSG00000291166.1_33446",33438,33446,9,"ENSG00000291166.1",1,3,"VVMVVVVVV",0,8,0.882815734989648,55,61,70,73,111,117,133,136,"TTGATGA","ATGA","GTTATGA","CTGA",2.70171751367085,9,38,16,72,1.60581697664513,4.90431676694604,8.43557970690463,101,"ENSG00000079974.19"
"48558","ENSG00000291287.1_11221",11213,11221,9,"ENSG00000291287.1",1,3,"VVMVVVVVV",0,8,0.882815734989648,55,61,70,73,111,117,133,136,"TTGATGA","ATGA","GTTATGA","CTGA",2.70171751367085,9,38,16,72,1.60581697664513,4.90431676694604,8.43557970690463,101,"ENSG00000079974.19"
"30960","ENSG00000214942.6_71107",71099,71107,9,"ENSG00000214942.6",0,NA,"VVVVVVVVV",0,9,1,86,92,106,109,112,118,133,136,"ATGAAAA","CTGA","CTGCTAA","CGGA",2.28536958059607,14,3,15,41,2.50604058718248,4.43545944778907,8.43545944778907,101,"ENSG00000079974.19"
"6258","ENSG00000109063.15_23519",23511,23519,9,"ENSG00000109063.15",0,NA,"VVVVVVVVV",0,9,1,111,117,133,136,141,147,186,189,"ATAATAA","TTGA","ATGCTTT","CTGA",2.39209191394747,16,5,39,69,1.79425226507122,4.43538292284691,8.43538292284691,101,"ENSG00000079974.19"
"9317","ENSG00000124151.19_108702",108694,108702,9,"ENSG00000124151.19",1,5,"VVVVMVVVV",0,8,0.886542443064182,109,115,133,136,138,144,154,157,"ATGATTA","GTGA","GTCAGGA","CTGA",2.59773680035335,18,2,10,39,2.2363636083945,4.88865223602088,8.43482200827761,101,"ENSG00000079974.19"
"33226","ENSG00000229089.9_11228",11220,11228,9,"ENSG00000229089.9",1,3,"VVMVVVVVV",0,8,0.882815734989648,53,59,68,71,111,117,133,136,"TTGATGA","ATGA","GTTATGA","CTGA",2.70171751367085,9,40,16,74,1.60216961160135,4.90340492568509,8.43466786564368,101,"ENSG00000079974.19"
"44040","ENSG00000277112.4_11094",11086,11094,9,"ENSG00000277112.4",1,3,"VVMVVVVVV",0,8,0.882815734989648,53,59,68,71,111,117,133,136,"TTGATGA","ATGA","GTTATGA","CTGA",2.70171751367085,9,40,16,74,1.60216961160135,4.90340492568509,8.43466786564368,101,"ENSG00000079974.19"
"46835","ENSG00000287270.1_10452",10444,10452,9,"ENSG00000287270.1",1,1,"MVVVUVVVV",1,7,0.795859213250517,98,104,110,113,115,121,133,136,"ATGATGA","CTGA","GAGACTA","CTGA",2.78885135135135,6,2,12,29,2.41149641393193,5.25095968906857,8.43439654207064,101,"ENSG00000079974.19"
"21226","ENSG00000166840.14_68306",68298,68306,9,"ENSG00000166840.14",0,NA,"VVVVVVVVV",0,9,1,90,96,133,136,165,171,186,189,"ATGAAGT","ATGA","GTGAAAA","CTGA",2.52815660272462,37,29,15,90,0.88271924969423,4.43427415029792,8.43427415029792,101,"ENSG00000079974.19"
"20123","ENSG00000164318.18_162170",162162,162170,9,"ENSG00000164318.18",0,NA,"VVVVVVVVV",0,9,1,92,98,109,112,116,122,133,136,"AAGATTA","ATGA","GTGGTGT","CTTA",2.22044249684538,11,4,11,35,2.92998831380578,4.43323457319374,8.43323457319374,101,"ENSG00000079974.19"
"15762","ENSG00000149403.13_388795",388787,388795,9,"ENSG00000149403.13",0,NA,"VVVVVVVVV",0,9,1,113,119,133,136,146,152,167,170,"GTGATAG","ATGT","ATGAATT","CTGA",2.25745743055493,14,10,15,48,2.68104352732841,4.43268993275699,8.43268993275699,101,"ENSG00000079974.19"
"34127","ENSG00000231918.1_724250",724242,724250,9,"ENSG00000231918.1",0,NA,"VVVVVVVVV",0,9,1,79,85,99,102,110,116,133,136,"ATTTTTA","ATGA","GTGAATC","CTGA",2.26184913214536,14,8,17,48,2.64998840369942,4.43224565450045,8.43224565450045,101,"ENSG00000079974.19"
"5185","ENSG00000103647.13_75713",75705,75713,9,"ENSG00000103647.13",0,NA,"VVVVVVVVV",0,9,1,72,78,91,94,102,108,133,136,"ATAATAA","CTCA","GTGATGA","CTTA",2.32072857850403,13,8,25,55,2.25534054482111,4.43171610037866,8.43171610037866,101,"ENSG00000079974.19"
"1935","ENSG00000067798.16_371098",371090,371098,9,"ENSG00000067798.16",1,6,"VVVVVMVVV",0,8,0.902691511387163,110,116,133,136,143,149,160,163,"ATGTTGA","GTGT","TTTATGA","CTGA",2.48009610965384,17,7,11,44,2.74945851448307,4.8208581447105,8.43162419025916,101,"ENSG00000079974.19"
"23206","ENSG00000172318.6_351418",351410,351418,9,"ENSG00000172318.6",0,NA,"VVVVVVVVV",0,9,1,85,91,107,110,112,118,133,136,"AGGAGCA","CTGA","ATAATTT","CTGA",2.3286137562227,16,2,15,42,2.19763696984283,4.43043216949854,8.43043216949854,101,"ENSG00000079974.19"
"22335","ENSG00000170365.10_19121",19113,19121,9,"ENSG00000170365.10",1,7,"VVVVVVMVV",0,8,0.885300207039338,73,79,92,95,103,109,133,136,"ATGATGG","CAGA","GTGTTTC","CTGA",2.58848121120163,13,8,24,54,2.29615737194282,4.88817469498842,8.42937552314577,101,"ENSG00000079974.19"
"33866","ENSG00000231304.2_955933",955925,955933,9,"ENSG00000231304.2",1,1,"MVVVVVVVV",0,8,0.90600414078675,112,118,133,136,152,158,175,178,"AGGATGA","CTCA","TTGATCT","CTGA",2.56835427911138,15,16,17,57,2.09572262416231,4.80452112122622,8.42853768437321,101,"ENSG00000079974.19"
"8572","ENSG00000119650.13_81517",81509,81517,9,"ENSG00000119650.13",0,NA,"UVVVVVVVV",1,8,0.902691511387163,110,116,133,136,142,148,158,161,"ATGATGT","CTGA","GTGCAGT","CTGT",2.47650874958788,17,6,10,42,2.7561906869595,4.81656225438634,8.42732829993499,101,"ENSG00000079974.19"
"20406","ENSG00000164796.18_542805",542797,542805,9,"ENSG00000164796.18",1,2,"UMVVVVVVV",1,7,0.786749482401656,93,99,111,114,116,122,133,136,"ATGATGA","TTGA","GTGGTAA","CTGA",2.76606791005649,12,2,11,34,2.67787429758514,5.27958175782377,8.42657968743039,101,"ENSG00000079974.19"
"967","ENSG00000042753.12_9962",9954,9962,9,"ENSG00000042753.12",0,NA,"VVVVVVVVV",0,9,1,116,122,133,136,144,150,180,183,"AAAATGA","ATTA","GTGGTGG","CTGA",2.34274385990353,11,8,30,58,2.08801447155862,4.42657671772888,8.42657671772888,101,"ENSG00000079974.19"
"35811","ENSG00000237283.2_3483",3475,3483,9,"ENSG00000237283.2",0,NA,"VVVVVVVVV",0,9,1,113,119,133,136,144,150,202,205,"GCAATGA","TCGA","GTGATAA","CTGA",2.36313026777724,14,8,52,83,1.95205863569821,4.42656510521995,8.42656510521995,101,"ENSG00000079974.19"
"21820","ENSG00000169071.15_70356",70348,70356,9,"ENSG00000169071.15",1,8,"VVVVVVVMV",0,8,0.884057971014493,50,56,68,71,86,92,133,136,"GTGATGA","TTGA","CTGAGAA","CTGA",2.69764174085624,12,15,41,77,1.57076900254042,4.88876181872884,8.42499370278681,101,"ENSG00000079974.19"
"36221","ENSG00000238755.3_450727",450719,450727,9,"ENSG00000238755.3",0,NA,"VVVVVVVVV",0,9,1,74,80,91,94,111,117,133,136,"AGGAAGA","CTGA","TTAATGA","CTCA",2.33070435987581,11,17,16,53,2.16161434199125,4.42491085195749,8.42491085195749,101,"ENSG00000079974.19"
"7523","ENSG00000114646.10_5772",5764,5772,9,"ENSG00000114646.10",0,NA,"VVVVVUVVV",1,8,0.922153209109731,71,77,88,91,96,102,133,136,"ATGATGA","CTTA","TTGATGT","ATGA",2.53886871741221,11,5,31,56,2.01343110448701,4.73480563847543,8.42341847491436,101,"ENSG00000079974.19"
"43855","ENSG00000274461.2_186532",186524,186532,9,"ENSG00000274461.2",0,NA,"VVVVVVVVV",0,9,1,108,114,133,136,183,189,205,208,"ATCATGT","CTTC","TTGATGA","CTGA",2.45271878657056,19,47,16,91,1.33709322218432,4.42213794983034,8.42213794983034,101,"ENSG00000079974.19"
"16304","ENSG00000151320.11_44706",44698,44706,9,"ENSG00000151320.11",1,2,"VMVVVVVVV",0,8,0.884057971014493,110,116,133,136,146,152,167,170,"AAGATGA","CTGG","CAGAGGA","CTGA",2.56039687417069,17,10,15,51,2.47077564839222,4.88502203571587,8.42125391977384,101,"ENSG00000079974.19"
"22281","ENSG00000170153.11_288187",288179,288187,9,"ENSG00000170153.11",1,2,"VMVVVVVVV",0,8,0.884057971014493,88,94,133,136,150,156,166,169,"ATGATGA","AAGA","CTGGTGA","CTGA",2.68718023796638,39,14,10,72,1.62484555129138,4.88484511776681,8.42107700182478,101,"ENSG00000079974.19"
"9837","ENSG00000127663.15_3268",3260,3268,9,"ENSG00000127663.15",0,NA,"VVUVVVVVV",1,8,0.883643892339545,107,113,133,136,144,150,159,162,"GTGAGGA","CTGA","AGGGTGC","CTGA",2.5598335963875,20,8,9,46,2.47974039119164,4.8863244251104,8.42089999446858,101,"ENSG00000079974.19"
"11631","ENSG00000135577.5_30249",30241,30249,9,"ENSG00000135577.5",0,NA,"VVVVVVVVV",0,9,1,91,97,133,136,148,154,206,209,"ATCATGA","ATTA","ATGATAA","CTGA",2.53626331001702,36,12,52,109,0.773564962550883,4.42049675733275,8.42049675733275,101,"ENSG00000079974.19"
"2022","ENSG00000069122.19_84445",84437,84445,9,"ENSG00000069122.19",0,NA,"VVVVVVVVV",0,9,1,88,94,104,107,114,120,133,136,"CTGAACA","CAGC","ATGGTAA","CTGA",2.21925815152996,10,7,13,39,2.88322692080825,4.41957031608534,8.41957031608533,101,"ENSG00000079974.19"
"35849","ENSG00000237356.7_168541",168533,168541,9,"ENSG00000237356.7",0,NA,"VVVVVVVVV",0,9,1,110,116,133,136,139,145,153,156,"ATGCCTA","ATGA","GAGGTGA","CTGA",2.27380667234258,17,3,8,37,2.51487483465362,4.41839649590104,8.41839649590104,101,"ENSG00000079974.19"
"29730","ENSG00000198648.12_18735",18727,18735,9,"ENSG00000198648.12",1,8,"VVVVVVVMV",0,8,0.884057971014493,114,120,133,136,141,147,159,162,"CTCATGT","CTGA","AAGATGT","CTGA",2.48962495708482,13,5,12,39,2.92994340408489,4.88186077949592,8.41809266355389,101,"ENSG00000079974.19"
"7689","ENSG00000115361.8_11732",11724,11732,9,"ENSG00000115361.8",1,2,"VMVVVVVVV",0,8,0.884057971014493,71,77,99,102,113,119,133,136,"TTGTTGA","CTGA","GTGATCT","CTGA",2.62248111732057,22,11,14,56,2.04348222181278,4.88167241765414,8.41790430171211,101,"ENSG00000079974.19"
"29066","ENSG00000197099.8_40778",40770,40778,9,"ENSG00000197099.8",0,NA,"VVVVVVVVV",0,9,1,111,117,133,136,156,162,185,188,"TTGATGG","ATGC","CTCATGA","CTGA",2.42894214993083,16,20,23,68,1.47460307782361,4.41688768600728,8.41688768600728,101,"ENSG00000079974.19"
"30300","ENSG00000204442.4_382948",382940,382948,9,"ENSG00000204442.4",0,NA,"VVVVVVVVV",0,9,1,113,119,133,136,141,147,158,161,"AAGATGG","CTGT","GTCTTGA","CTTA",2.21102517681383,14,5,11,39,2.92593659726229,4.41652611067196,8.41652611067196,101,"ENSG00000079974.19"
"39654","ENSG00000254039.1_6971",6963,6971,9,"ENSG00000254039.1",1,6,"VVVVVMVVV",0,8,0.902691511387163,112,118,133,136,142,148,198,201,"ATGTTGA","CTGT","GTGTTGG","CTGA",2.59844558788677,15,6,50,80,1.89572329627505,4.80467347054671,8.41543951609536,101,"ENSG00000079974.19"
"40218","ENSG00000255252.3_2015",2007,2015,9,"ENSG00000255252.3",1,1,"MVVVVUVVV",1,7,0.82815734989648,82,88,101,104,115,121,133,136,"ATGATGC","ATGA","GTGGTGG","CTGA",2.6419724298432,13,11,12,45,2.79479972865154,5.10198731523488,8.4146167148208,101,"ENSG00000079974.19"
"1473","ENSG00000057663.16_99104",99096,99104,9,"ENSG00000057663.16",1,1,"MVVVVVVVV",0,8,0.90600414078675,76,82,103,106,116,122,133,136,"ATGATAC","CTCA","GTGTTGA","CTGA",2.53012966820902,21,10,11,51,2.29426477930756,4.79044897517525,8.41446553832225,101,"ENSG00000079974.19"
"35396","ENSG00000235904.3_216482",216474,216482,9,"ENSG00000235904.3",0,NA,"UVVVVVVVV",1,8,0.902691511387163,115,121,133,136,140,146,191,194,"ATGATTA","ATGA","GGGAAGA","CTGA",2.60529216939574,12,4,45,70,1.84524024922053,4.80346367796469,8.41422972351335,101,"ENSG00000079974.19"
"8961","ENSG00000121904.19_162446",162438,162446,9,"ENSG00000121904.19",0,NA,"VVVVVVVVV",0,9,1,71,77,85,88,98,104,133,136,"ATGATGG","CTGT","ATGGGGA","ATGA",2.38170979144914,8,10,29,56,1.77829322089078,4.41408962430459,8.41408962430459,101,"ENSG00000079974.19"
"31557","ENSG00000224078.15_315026",315018,315026,9,"ENSG00000224078.15",0,NA,"VVVVVVVVV",0,9,1,113,119,133,136,141,147,171,174,"ATGGTGA","TTGA","AAGATCA","CTCA",2.3168738000969,14,5,24,52,2.20946136002723,4.41382167350164,8.41382167350164,101,"ENSG00000079974.19"
"39743","ENSG00000254180.2_103753",103745,103753,9,"ENSG00000254180.2",0,NA,"VVVUVVVVV",1,8,0.880745341614907,114,120,133,136,145,151,164,167,"AGGCTGA","CTGA","GAGAGGC","CTGA",2.50271319308017,13,9,13,44,2.87402150436547,4.88969403122498,8.4126753976846,101,"ENSG00000079974.19"
"23255","ENSG00000172403.11_206239",206231,206239,9,"ENSG00000172403.11",0,NA,"VVVVVVVVV",0,9,1,116,122,133,136,138,144,153,156,"GGGAAGA","CAGT","ATGTACA","CTGA",2.22556864091258,11,2,9,31,2.81035846144707,4.4118706835494,8.4118706835494,101,"ENSG00000079974.19"
"30670","ENSG00000206384.11_77359",77351,77359,9,"ENSG00000206384.11",0,NA,"VVVVVVVVV",0,9,1,55,61,106,109,116,122,133,136,"ATGATTG","CTGA","ATGAGCA","CTTA",2.34877460981245,45,7,11,72,1.98599143175767,4.41112220762684,8.41112220762684,101,"ENSG00000079974.19"
"42551","ENSG00000264151.6_23700",23692,23700,9,"ENSG00000264151.6",0,NA,"VVVVVVVVV",0,9,1,79,85,94,97,106,112,133,136,"AAGATGA","CTTA","GTGGAGG","GTGA",2.30861001976532,9,9,21,48,2.24898417012,4.40992940880554,8.40992940880554,101,"ENSG00000079974.19"
"3417","ENSG00000083535.16_157546",157538,157546,9,"ENSG00000083535.16",0,NA,"VVVVVVVVV",0,9,1,85,91,100,103,114,120,133,136,"TTGATGA","GTTA","CTGACTA","CTGC",2.25408539872021,9,11,13,42,2.6078945913203,4.4087826456971,8.4087826456971,101,"ENSG00000079974.19"
"4171","ENSG00000096264.14_13990",13982,13990,9,"ENSG00000096264.14",1,2,"VMVVVVVVV",0,8,0.884057971014493,109,115,133,136,141,147,155,158,"ATGATGA","CAAA","AGGTTCA","CTGA",2.53159777424483,18,5,8,40,2.6110837409858,4.87210055898784,8.40833244304581,101,"ENSG00000079974.19"
"31827","ENSG00000224942.1_506",498,506,9,"ENSG00000224942.1",0,NA,"VVVVVVVVV",0,9,1,98,104,133,136,150,156,164,167,"ATGATTA","CTAT","ATGCTAT","CTGA",2.39528039369638,29,14,8,60,1.66151009941268,4.40751151434714,8.40751151434714,101,"ENSG00000079974.19"
"2148","ENSG00000070756.17_22493",22485,22493,9,"ENSG00000070756.17",1,1,"MVVVVVVVV",0,8,0.90600414078675,92,98,109,112,116,122,133,136,"ATGGTGA","CATA","GCTATGA","CTGA",2.43051213028521,11,4,11,35,2.92998831380578,4.7833506289268,8.4073671920738,101,"ENSG00000079974.19"
"458","ENSG00000012174.12_36433",36425,36433,9,"ENSG00000012174.12",1,2,"VMVVVVVVV",0,8,0.884057971014493,112,118,133,136,148,154,164,167,"ATGAGGA","ATGG","CTGATCA","CTGA",2.52026529192134,15,12,10,46,2.67942335938739,4.87029799304908,8.40652987710705,101,"ENSG00000079974.19"
"37181","ENSG00000245832.7_152915",152907,152915,9,"ENSG00000245832.7",1,2,"VMVVVVVVV",0,8,0.884057971014493,115,121,133,136,149,155,176,179,"ATGATGA","GTTA","CAGAAGA","CTGA",2.59878902682407,12,13,21,55,2.15464568320691,4.86997646550851,8.40620834956648,101,"ENSG00000079974.19"
"43","ENSG00000002746.15_280956",280948,280956,9,"ENSG00000002746.15",0,NA,"VVVVVVUVV",1,8,0.886128364389234,114,120,133,136,165,171,181,184,"ATGATGT","AAGA","ATGATGT","CTGA",2.60806640068167,13,29,10,61,2.05684225260823,4.8609878976215,8.40550135517844,101,"ENSG00000079974.19"
"10069","ENSG00000129084.18_121098",121090,121098,9,"ENSG00000129084.18",0,NA,"UVVVVVVVV",1,8,0.902691511387163,114,120,133,136,146,152,170,173,"TTGATAA","CTTA","GTGTTGG","CTGA",2.49714217668911,13,10,18,50,2.53065735172939,4.79456796574753,8.40533401129618,101,"ENSG00000079974.19"
"33626","ENSG00000230513.4_6138",6130,6138,9,"ENSG00000230513.4",1,2,"VMVVVVVVV",0,8,0.884057971014493,111,117,133,136,151,157,166,169,"ATGATGT","CTAT","ATGATAA","CTGA",2.56249581836594,16,15,9,49,2.39154497835155,4.86871260853111,8.40494449258908,101,"ENSG00000079974.19"
"5540","ENSG00000105778.20_50390",50382,50390,9,"ENSG00000105778.20",0,NA,"VVVVVVVVV",0,9,1,116,122,133,136,148,154,168,171,"TTGATGA","CTTT","GTCATTA","GTGA",2.25022684875911,11,12,14,46,2.61612816994928,4.40441012375251,8.40441012375251,101,"ENSG00000079974.19"
"34062","ENSG00000231871.5_113236",113228,113236,9,"ENSG00000231871.5",0,NA,"VVVVVVVVV",0,9,1,108,114,133,136,182,188,196,199,"ACGATGG","AGGA","TTGATAA","CTGA",2.4085942201028,19,46,8,82,1.55909864479258,4.40409836136948,8.40409836136948,101,"ENSG00000079974.19"
"29092","ENSG00000197142.11_36031",36023,36031,9,"ENSG00000197142.11",1,5,"VVVVMVVVV",0,8,0.886542443064182,112,118,133,136,173,179,190,193,"GTGATGG","CTGA","GTTAGGG","CTGA",2.62833069484446,15,37,11,72,1.90870357214995,4.85772705111158,8.40389682336831,101,"ENSG00000079974.19"
"39708","ENSG00000254101.8_445747",445739,445747,9,"ENSG00000254101.8",1,6,"VVVVVMVVV",0,8,0.902691511387163,105,111,133,136,151,157,167,170,"ATGATGA","ATAA","ATACTGA","CTGA",2.59200161519467,22,15,10,56,1.89083282208511,4.79271089751239,8.40347694306105,101,"ENSG00000079974.19"
"32900","ENSG00000228255.1_20667",20659,20667,9,"ENSG00000228255.1",0,NA,"VVVVVVVVV",0,9,1,116,122,133,136,150,156,170,173,"ATTATAA","TTCA","TAGATTA","CTGA",2.27093066968438,11,14,14,48,2.47079738747633,4.40258379634305,8.40258379634305,101,"ENSG00000079974.19"
"29571","ENSG00000198286.11_43130",43122,43130,9,"ENSG00000198286.11",0,NA,"VVVVVVVVV",0,9,1,91,97,133,136,141,147,163,166,"ATTATGA","GTAA","ATCACGG","CTGA",2.38711479552382,36,5,16,66,1.69606041807424,4.40253976372492,8.40253976372492,101,"ENSG00000079974.19"
"42943","ENSG00000267374.3_412288",412280,412288,9,"ENSG00000267374.3",1,2,"VMVVVVVVV",0,8,0.884057971014493,115,121,133,136,151,157,176,179,"AGGAAGA","CTGA","ATCATGA","CTGA",2.5998585587175,12,15,19,55,2.129296359018,4.865421687617,8.40165357167498,101,"ENSG00000079974.19"
"6460","ENSG00000109944.11_44354",44346,44354,9,"ENSG00000109944.11",0,NA,"VVVVVVVVV",0,9,1,106,112,133,136,158,164,190,193,"ATGATAA","TTGC","GTGAGGT","CTGA",2.51318313644788,21,22,26,78,0.849717246577887,4.40106787239094,8.40106787239094,101,"ENSG00000079974.19"
"1936","ENSG00000067798.16_570058",570050,570058,9,"ENSG00000067798.16",0,NA,"VVVVVVUVV",1,8,0.886128364389234,80,86,105,108,116,122,133,136,"ATGAAGA","TTGA","TAAATGA","CTGA",2.53100745925636,19,8,11,47,2.55202089867251,4.85635099009539,8.40086444765233,101,"ENSG00000079974.19"
"18668","ENSG00000158019.21_423831",423823,423831,9,"ENSG00000158019.21",1,6,"VVVVVMVVV",0,8,0.902691511387163,112,118,133,136,156,162,181,184,"ATGCAGA","CTGA","TTGAAGA","CTGA",2.60925400303267,15,20,19,63,1.7627554087625,4.78944552391175,8.4002115694604,101,"ENSG00000079974.19"
"11655","ENSG00000135655.16_31779",31771,31779,9,"ENSG00000135655.16",1,3,"VVMVVVVVV",0,8,0.882815734989648,56,62,81,84,96,102,133,136,"CTGATGA","CTGA","GGGGAGA","CTGA",2.70385366400275,19,12,31,71,1.44986534085522,4.86888910855171,8.40015204851031,101,"ENSG00000079974.19"
"2708","ENSG00000077522.15_71179",71171,71179,9,"ENSG00000077522.15",1,5,"VVVVMVVVV",0,8,0.886542443064182,87,93,105,108,112,118,133,136,"CTGATGC","CGGA","ACGAGGA","CTGA",2.50895547009328,12,4,15,40,2.68813347869659,4.85362581982962,8.39979559208635,101,"ENSG00000079974.19"
"42152","ENSG00000260922.2_13941",13933,13941,9,"ENSG00000260922.2",0,NA,"VVVVVVVVV",0,9,1,96,102,133,136,158,164,179,182,"AAGATGG","CTGG","GTGTTTA","CTGA",2.48181590037756,31,22,15,77,1.0527289778385,4.39954207842222,8.39954207842222,101,"ENSG00000079974.19"
"14969","ENSG00000146416.19_63740",63732,63740,9,"ENSG00000146416.19",0,NA,"VVVUVVVVV",1,8,0.880745341614907,75,81,96,99,107,113,133,136,"TTTATGA","CAGA","ATGTTGA","CTGA",2.56391465452498,15,8,20,52,2.41280433582448,4.87639217483108,8.39937354129071,101,"ENSG00000079974.19"
"42097","ENSG00000260691.8_37765",37757,37765,9,"ENSG00000260691.8",1,3,"VVMVVVVVV",0,8,0.882815734989648,67,73,79,82,111,117,133,136,"GTGATGA","CTAA","GTTATGA","CTGA",2.72474117680658,6,29,16,60,1.307212521703,4.86803842510339,8.39930136506198,101,"ENSG00000079974.19"
"35629","ENSG00000236501.6_143307",143299,143307,9,"ENSG00000236501.6",0,NA,"UVVVVVVVV",1,8,0.902691511387163,105,111,133,136,145,151,161,164,"ATTATGA","CAGA","AAGAATA","CTGA",2.5296969505825,22,9,10,50,2.2883460544166,4.78824809790832,8.39901414345698,101,"ENSG00000079974.19"
"22505","ENSG00000170629.17_42368",42360,42368,9,"ENSG00000170629.17",0,NA,"VVVVVVVVV",0,9,1,79,85,103,106,111,117,133,136,"TTGATGT","ATGA","TTGGAGA","CTAA",2.28545961267958,18,5,16,48,2.35817836532336,4.39864394579681,8.39864394579681,101,"ENSG00000079974.19"
"28459","ENSG00000189212.15_43538",43530,43538,9,"ENSG00000189212.15",0,NA,"VVVVVVVVV",0,9,1,79,85,103,106,111,117,133,136,"TTGATGT","ATGA","TTGGAGA","CTAA",2.28545961267958,18,5,16,48,2.35817836532336,4.39864394579681,8.39864394579681,101,"ENSG00000079974.19"
"48462","ENSG00000291133.1_43745",43737,43745,9,"ENSG00000291133.1",0,NA,"VVVVVVVVV",0,9,1,79,85,103,106,111,117,133,136,"TTGATGT","ATGA","TTGGAGA","CTAA",2.28545961267958,18,5,16,48,2.35817836532336,4.39864394579681,8.39864394579681,101,"ENSG00000079974.19"
"48464","ENSG00000291139.1_45140",45132,45140,9,"ENSG00000291139.1",0,NA,"VVVVVVVVV",0,9,1,79,85,103,106,111,117,133,136,"TTGATGT","ATGA","TTGGAGA","CTAA",2.28545961267958,18,5,16,48,2.35817836532336,4.39864394579681,8.39864394579681,101,"ENSG00000079974.19"
"43479","ENSG00000271955.2_318244",318236,318244,9,"ENSG00000271955.2",1,5,"VVVVMVVVV",0,8,0.886542443064182,85,91,102,105,111,117,133,136,"ATGAAGT","ATGA","GTCAAGA","CTGA",2.50112957569759,11,6,16,42,2.73454992187137,4.85218677329716,8.39835654555389,101,"ENSG00000079974.19"
"4624","ENSG00000101349.17_115568",115560,115568,9,"ENSG00000101349.17",0,NA,"VVVVVVVVV",0,9,1,110,116,133,136,148,154,200,203,"ACAATGT","CTTA","ATGAAGA","CTGA",2.40975822648979,17,12,46,84,1.52680948435955,4.39796608190621,8.39796608190621,101,"ENSG00000079974.19"
"13945","ENSG00000144036.16_119388",119380,119388,9,"ENSG00000144036.16",1,2,"VMVVVVVVV",0,8,0.884057971014493,102,108,133,136,148,154,162,165,"ATGATAA","CTGA","AGGCAGA","CTGA",2.62923191363558,25,12,8,54,1.91784289674126,4.86151391357795,8.39774579763592,101,"ENSG00000079974.19"
"30727","ENSG00000212127.6_141734",141726,141734,9,"ENSG00000212127.6",0,NA,"VVVVVVVVV",0,9,1,69,75,101,104,116,122,133,136,"ATGAGGA","ATGA","ATGTTTA","ATGA",2.35566546334701,26,12,11,58,1.88519980947267,4.39740905794652,8.39740905794652,101,"ENSG00000079974.19"
"30730","ENSG00000212127.6_80857",80849,80857,9,"ENSG00000212127.6",0,NA,"VVVVVVVVV",0,9,1,69,75,101,104,116,122,133,136,"ATGAGGA","ATGA","ATGTTTA","ATGA",2.35566546334701,26,12,11,58,1.88519980947267,4.39740905794652,8.39740905794652,101,"ENSG00000079974.19"
"34077","ENSG00000231887.9_141769",141761,141769,9,"ENSG00000231887.9",0,NA,"VVVVVVVVV",0,9,1,69,75,101,104,116,122,133,136,"ATGAGGA","ATGA","ATGTTTA","ATGA",2.35566546334701,26,12,11,58,1.88519980947267,4.39740905794652,8.39740905794652,101,"ENSG00000079974.19"
"34085","ENSG00000231887.9_80892",80884,80892,9,"ENSG00000231887.9",0,NA,"VVVVVVVVV",0,9,1,69,75,101,104,116,122,133,136,"ATGAGGA","ATGA","ATGTTTA","ATGA",2.35566546334701,26,12,11,58,1.88519980947267,4.39740905794652,8.39740905794652,101,"ENSG00000079974.19"
"43945","ENSG00000275778.3_141761",141753,141761,9,"ENSG00000275778.3",0,NA,"VVVVVVVVV",0,9,1,69,75,101,104,116,122,133,136,"ATGAGGA","ATGA","ATGTTTA","ATGA",2.35566546334701,26,12,11,58,1.88519980947267,4.39740905794652,8.39740905794652,101,"ENSG00000079974.19"
"43952","ENSG00000275778.3_80884",80876,80884,9,"ENSG00000275778.3",0,NA,"VVVVVVVVV",0,9,1,69,75,101,104,116,122,133,136,"ATGAGGA","ATGA","ATGTTTA","ATGA",2.35566546334701,26,12,11,58,1.88519980947267,4.39740905794652,8.39740905794652,101,"ENSG00000079974.19"
"9483","ENSG00000124812.15_42683",42675,42683,9,"ENSG00000124812.15",1,3,"VVMVVVVVV",0,8,0.882815734989648,38,44,52,55,74,80,133,136,"ATGAGGA","CTGA","GTTATGA","CTGA",2.7612834142364,8,19,53,89,1.05508219989903,4.86590957370209,8.39717251366068,101,"ENSG00000079974.19"
"26559","ENSG00000184408.10_292004",291996,292004,9,"ENSG00000184408.10",0,NA,"VVVVVVUVV",1,8,0.886128364389234,69,75,86,89,115,121,133,136,"ATGATGT","CTGT","AAGATGG","CTGA",2.60589941830505,11,26,12,58,2.03717116337747,4.85245848801945,8.39697194557638,101,"ENSG00000079974.19"
"20955","ENSG00000166035.11_45901",45893,45901,9,"ENSG00000166035.11",1,8,"VVVVVVVMV",0,8,0.884057971014493,116,122,133,136,144,150,178,181,"ATGAAGG","CTGA","CTGAAGC","CTGA",2.59598695378512,11,8,28,56,2.13596270337371,4.86063559881863,8.3968674828766,101,"ENSG00000079974.19"
"20603","ENSG00000165152.9_44486",44478,44486,9,"ENSG00000165152.9",0,NA,"VVVVVVVVV",0,9,1,109,115,133,136,173,179,205,208,"GTGATTA","CTCA","TTGATCT","CTGA",2.50060551411491,18,37,26,90,0.916221164348053,4.3967311479452,8.3967311479452,101,"ENSG00000079974.19"
"356","ENSG00000009694.14_424954",424946,424954,9,"ENSG00000009694.14",0,NA,"VVVVVVVVV",0,9,1,91,97,133,136,145,151,173,176,"ATGATCT","CTGC","CTTATAA","CTGA",2.43207607821004,36,9,22,76,1.36429188026711,4.39453310041685,8.39453310041685,101,"ENSG00000079974.19"
"23737","ENSG00000173769.4_28269",28261,28269,9,"ENSG00000173769.4",0,NA,"VVVVVVVVV",0,9,1,71,77,90,93,107,113,133,136,"GTGATGA","CTGA","ATGGGGA","TTAA",2.31622634045226,13,14,20,56,2.13482934952756,4.39408457146899,8.39408457146899,101,"ENSG00000079974.19"
"28431","ENSG00000189108.13_438100",438092,438100,9,"ENSG00000189108.13",1,3,"VVMVVVVVV",0,8,0.882815734989648,76,82,101,104,112,118,133,136,"ATGATGA","CTGA","GTTAAAA","TTGA",2.56047900579151,19,8,15,51,2.38104187765839,4.86272547906711,8.3939884190257,101,"ENSG00000079974.19"
"37180","ENSG00000245768.7_82404",82396,82404,9,"ENSG00000245768.7",0,NA,"VVVVVUVVV",1,8,0.922153209109731,91,97,133,136,176,182,191,194,"CTGATGA","CTAA","ATAATGA","CTGA",2.67100749649607,36,40,9,94,1.01217045167926,4.70472177374659,8.39333461018551,101,"ENSG00000079974.19"
"15507","ENSG00000148513.20_21153",21145,21153,9,"ENSG00000148513.20",0,NA,"VVVVVVVVV",0,9,1,47,53,66,69,116,122,133,136,"ATGATTA","TTGA","GTCCTGA","CTTA",2.33827146663505,13,47,11,80,1.98308028590309,4.39288918253418,8.39288918253418,101,"ENSG00000079974.19"
"39377","ENSG00000253535.5_411438",411430,411438,9,"ENSG00000253535.5",0,NA,"VVVVVVVVV",0,9,1,113,119,133,136,147,153,167,170,"TTTATGT","CAAA","ATTATCA","CTGA",2.23489383892278,14,11,14,48,2.67218893375837,4.39287029831089,8.39287029831089,101,"ENSG00000079974.19"
"39481","ENSG00000253643.6_14221",14213,14221,9,"ENSG00000253643.6",0,NA,"VVVVVVVVV",0,9,1,113,119,133,136,147,153,167,170,"TTTATGT","CAAA","ATTATCA","CTGA",2.23489383892278,14,11,14,48,2.67218893375837,4.39287029831089,8.39287029831089,101,"ENSG00000079974.19"
"4726","ENSG00000101811.15_18260",18252,18260,9,"ENSG00000101811.15",0,NA,"VVVVVVVVV",0,9,1,73,79,102,105,116,122,133,136,"ATGATCA","CAGA","GTGAAAG","CTGT",2.32080556379548,23,11,11,54,2.09396216103424,4.39149981325102,8.39149981325102,101,"ENSG00000079974.19"
"7882","ENSG00000115956.10_8426",8418,8426,9,"ENSG00000115956.10",1,7,"VVVVVVMVV",0,8,0.885300207039338,102,108,133,136,140,146,169,172,"CTGATGC","CTGA","ATGATGG","CTGA",2.7049310138473,25,4,23,61,1.36818962082396,4.85026576161815,8.3914665897755,101,"ENSG00000079974.19"
"13070","ENSG00000140015.20_105130",105122,105130,9,"ENSG00000140015.20",0,NA,"VVVVVVVVV",0,9,1,107,113,133,136,184,190,200,203,"ATGATAA","TTGA","ATGATTA","CTTA",2.41104548006273,20,48,10,87,1.49170879961694,4.39133633334212,8.39133633334212,101,"ENSG00000079974.19"
"6125","ENSG00000108055.11_8532",8524,8532,9,"ENSG00000108055.11",1,2,"VMVVVVVVV",0,8,0.884057971014493,114,120,133,136,141,147,166,169,"ATGCTGA","GTGA","ATGGATA","CTGA",2.53677578641069,13,5,19,46,2.50647802784211,4.85457915097834,8.39081103503631,101,"ENSG00000079974.19"
"13400","ENSG00000141367.13_30119",30111,30119,9,"ENSG00000141367.13",0,NA,"VVVVVUVVV",1,8,0.922153209109731,92,98,108,111,114,120,133,136,"ATAATGC","CTCA","GTGACAG","CTGA",2.42049389888288,10,3,13,35,2.67095563339625,4.7018954064872,8.39050824292612,101,"ENSG00000079974.19"
"41475","ENSG00000259072.2_74554",74546,74554,9,"ENSG00000259072.2",0,NA,"VVVVVVVVV",0,9,1,112,118,133,136,146,152,175,178,"GTGATAT","CTAG","ATGAGGT","CTGA",2.30933118597889,15,10,23,57,2.16637127273645,4.39047812814893,8.39047812814892,101,"ENSG00000079974.19"
"18381","ENSG00000157168.20_642902",642894,642902,9,"ENSG00000157168.20",0,NA,"VVVVVVVVV",0,9,1,72,78,92,95,100,106,133,136,"TTGATGG","TTGA","GTGGAGA","TTGA",2.3193458081595,14,5,27,55,2.09896081090654,4.39031654965914,8.39031654965914,101,"ENSG00000079974.19"
"45826","ENSG00000285939.2_739195",739187,739195,9,"ENSG00000285939.2",1,7,"VVVVVVMVV",0,8,0.885300207039338,87,93,102,105,112,118,133,136,"TTGATGA","CTAT","ATGTTAA","CTGA",2.5064861433769,9,7,15,40,2.68646914050784,4.84909419075513,8.39029501891248,101,"ENSG00000079974.19"
"11784","ENSG00000136044.12_37371",37363,37371,9,"ENSG00000136044.12",0,NA,"VVVVVVUVV",1,8,0.886128364389234,70,76,92,95,113,119,133,136,"ATGATCA","GTGA","ATGGTGT","CTGA",2.59505847585737,16,18,14,57,2.08200548249184,4.84559883038524,8.39011228794218,101,"ENSG00000079974.19"
"17934","ENSG00000155849.16_91395",91387,91395,9,"ENSG00000155849.16",0,NA,"VVVVVVUVV",1,8,0.886128364389234,112,118,133,136,155,161,173,176,"TTGATGT","CTCA","ATGCTGA","CTGA",2.57874183895422,15,19,12,55,2.19031703231154,4.84548232300158,8.38999578055852,101,"ENSG00000079974.19"
"33207","ENSG00000229005.2_11426",11418,11426,9,"ENSG00000229005.2",0,NA,"VVVVVUVVV",1,8,0.922153209109731,116,122,133,136,147,153,162,165,"ATCATAA","ATGA","AGAATGA","CTGA",2.39430266454155,11,11,9,40,2.84164240492455,4.70091504213373,8.38952787857265,101,"ENSG00000079974.19"
"44555","ENSG00000282998.1_195286",195278,195286,9,"ENSG00000282998.1",1,2,"VMVVVVVVV",0,8,0.884057971014493,116,122,133,136,147,153,163,166,"ATGAGGA","CAGC","ATGATAT","CTGA",2.48626269577075,11,11,10,41,2.83404292477404,4.85228189081142,8.38851377486939,101,"ENSG00000079974.19"
"17804","ENSG00000155093.19_805351",805343,805351,9,"ENSG00000155093.19",0,NA,"VVVVUVVVV",1,8,0.889855072463768,116,122,133,136,144,150,179,182,"ATGATCA","CTGG","CTGTGGA","CTGA",2.5798055625874,11,8,29,57,2.1103799199347,4.82727091762934,8.38669120748442,101,"ENSG00000079974.19"
"39839","ENSG00000254313.1_101",93,101,9,"ENSG00000254313.1",0,NA,"UVVVVVVVV",1,8,0.902691511387163,76,82,103,106,114,120,133,136,"ATCATGG","CTGA","ATCAGGC","CTGA",2.51814537278987,21,8,13,51,2.31603847409212,4.77591857317281,8.38668461872146,101,"ENSG00000079974.19"
"10209","ENSG00000129824.16_59641",59633,59641,9,"ENSG00000129824.16",0,NA,"VVVVVVVVV",0,9,1,112,118,133,136,150,156,174,177,"ATTATGT","TTGT","GTCACAA","CTGA",2.30554803989523,15,14,18,56,2.16834432199952,4.38466614699193,8.38466614699193,101,"ENSG00000079974.19"
"42417","ENSG00000262655.4_57642",57634,57642,9,"ENSG00000262655.4",0,NA,"VVVVVVVVV",0,9,1,115,121,133,136,146,152,160,163,"ATGAGGC","GTCA","GTGAGGA","GTGA",2.19214853420625,12,10,8,39,2.92332041146315,4.38441099320953,8.38441099320953,101,"ENSG00000079974.19"
"12407","ENSG00000138101.20_198946",198938,198946,9,"ENSG00000138101.20",0,NA,"VVVVVVVVV",0,9,1,112,118,133,136,148,154,200,203,"ATGTTCA","CAGT","ATGATAA","CTGA",2.37840897021506,15,12,46,82,1.68128585324766,4.38433641367035,8.38433641367035,101,"ENSG00000079974.19"
"14161","ENSG00000144460.13_175686",175678,175686,9,"ENSG00000144460.13",0,NA,"VVVVVVVVV",0,9,1,110,116,133,136,183,189,200,203,"ATAATTT","ATGA","GTGGGGA","CTGA",2.36883190885291,17,47,11,84,1.74247107013373,4.38367094895494,8.38367094895494,101,"ENSG00000079974.19"
"25486","ENSG00000181826.10_6333",6325,6333,9,"ENSG00000181826.10",0,NA,"VVVVVVVVV",0,9,1,51,57,77,80,113,119,133,136,"AGGTTGA","TTGA","ATTCTGA","CTGA",2.42151384646573,20,33,14,76,1.3909093608566,4.38358375099036,8.38358375099036,101,"ENSG00000079974.19"
"2947","ENSG00000079691.19_180927",180919,180927,9,"ENSG00000079691.19",0,NA,"VVVVVVVVV",0,9,1,114,120,133,136,160,166,176,179,"CTGGTGA","GTTA","GTTAATA","CTGA",2.30841359051974,13,24,10,56,2.14228997892255,4.3829284789302,8.3829284789302,101,"ENSG00000079974.19"
"6491","ENSG00000110318.15_81601",81593,81601,9,"ENSG00000110318.15",0,NA,"VVVVVVVVV",0,9,1,110,116,133,136,149,155,176,179,"CTTATAA","CTAA","ATGAACA","CTGA",2.34319512166534,17,13,21,60,1.9094259006828,4.38268167794627,8.38268167794627,101,"ENSG00000079974.19"
"5086","ENSG00000103018.18_47108",47100,47108,9,"ENSG00000103018.18",0,NA,"VVVVVVVVV",0,9,1,85,91,102,105,113,119,133,136,"ATGATAA","CTGA","GTTATAA","TTAA",2.20180672058539,11,8,14,42,2.85020883553461,4.38223007652597,8.38223007652597,101,"ENSG00000079974.19"
"38974","ENSG00000251372.7_191889",191881,191889,9,"ENSG00000251372.7",1,8,"VVVVVVVMV",0,8,0.884057971014493,112,118,133,136,140,146,154,157,"AGGATGG","GTGA","ATGGTGG","CTGA",2.48300544938347,15,4,8,36,2.82996015901633,4.8458324553932,8.38206433945117,101,"ENSG00000079974.19"
"13931","ENSG00000143952.20_22094",22086,22094,9,"ENSG00000143952.20",0,NA,"UVVVVVVVV",1,8,0.902691511387163,105,111,133,136,152,158,210,213,"GTGATGA","CAGA","CTGCTGA","CTGA",2.73841642119991,22,16,52,99,0.827256953822676,4.77084160712219,8.38160765267084,101,"ENSG00000079974.19"
"16836","ENSG00000152402.11_327531",327523,327531,9,"ENSG00000152402.11",0,NA,"UVVVVVVVV",1,8,0.902691511387163,75,81,102,105,111,117,133,136,"CTGATTA","TTGA","GTGAAAA","CTGA",2.53904839318606,21,6,16,52,2.15242119564992,4.76985262088924,8.38061866643789,101,"ENSG00000079974.19"
"26825","ENSG00000185046.20_83224",83216,83224,9,"ENSG00000185046.20",0,NA,"VVVVVUVVV",1,8,0.922153209109731,115,121,133,136,184,190,213,216,"ATAATGT","CTGA","GTAAGGA","CTGA",2.61066811783555,12,48,23,92,1.36023993100533,4.69117351247725,8.37978634891617,101,"ENSG00000079974.19"
"88","ENSG00000004864.14_177245",177237,177245,9,"ENSG00000004864.14",0,NA,"VVVVVVVVV",0,9,1,65,71,86,89,113,119,133,136,"ATGATGT","TTGA","GGGTTGT","CTTA",2.33783486427757,15,24,14,62,1.9275043473159,4.3782675272916,8.3782675272916,101,"ENSG00000079974.19"
"44737","ENSG00000283491.1_7979",7971,7979,9,"ENSG00000283491.1",1,1,"MVVVVVVVV",0,8,0.90600414078675,35,41,57,60,75,81,133,136,"TTGATGC","CTGA","GTGGTTA","CTGA",2.64340316189513,16,15,52,92,1.39328416710323,4.7539929782677,8.3780095414147,101,"ENSG00000079974.19"
"30538","ENSG00000205659.12_14232",14224,14232,9,"ENSG00000205659.12",1,2,"VMVVVVVVV",0,8,0.884057971014493,90,96,133,136,140,146,157,160,"ATGATGA","GGGA","TTGAGGT","CTGA",2.63077632936441,37,4,11,61,1.82777566148344,4.84157113097821,8.37780301503618,101,"ENSG00000079974.19"
"18779","ENSG00000158467.17_42912",42904,42912,9,"ENSG00000158467.17",0,NA,"VVVVVUVVV",1,8,0.922153209109731,47,53,68,71,80,86,133,136,"GAGATGA","ATGA","ATGGTCA","CTGA",2.53378236566116,15,9,47,80,1.86484654425333,4.6891822454986,8.37779508193752,101,"ENSG00000079974.19"
"23883","ENSG00000174469.23_544993",544985,544993,9,"ENSG00000174469.23",0,NA,"VVVVVVVVV",0,9,1,78,84,98,101,109,115,133,136,"GTGATTA","CAGA","ATGGGAA","CTGG",2.23744188897538,14,8,18,49,2.58779318571819,4.37601811138851,8.37601811138851,101,"ENSG00000079974.19"
"34554","ENSG00000233417.2_43588",43580,43588,9,"ENSG00000233417.2",0,NA,"VVVVVUVVV",1,8,0.922153209109731,80,86,98,101,112,118,133,136,"ATTATTA","CTAA","GAGATCA","CTGA",2.41411811991059,12,11,15,47,2.65511872150141,4.68730988022633,8.37592271666526,101,"ENSG00000079974.19"
"6989","ENSG00000112419.15_289303",289295,289303,9,"ENSG00000112419.15",0,NA,"VVVVVVVVV",0,9,1,111,117,133,136,147,153,163,166,"ATGATGG","GTGG","AGGATTA","CTGT",2.22340055415445,16,11,10,46,2.67708203958406,4.37493810015343,8.37493810015343,101,"ENSG00000079974.19"
"40597","ENSG00000257065.1_19056",19048,19056,9,"ENSG00000257065.1",0,NA,"VVVVVVVVV",0,9,1,111,117,133,136,147,153,163,166,"ATGATGG","GTGG","AGGATTA","CTGT",2.22340055415445,16,11,10,46,2.67708203958406,4.37493810015343,8.37493810015343,101,"ENSG00000079974.19"
"14622","ENSG00000145526.12_265327",265319,265327,9,"ENSG00000145526.12",1,2,"VMVVVVVVV",0,8,0.884057971014493,112,118,133,136,143,149,158,161,"ATAATGA","CTGA","ATGACCA","CAGA",2.4615905941164,15,7,9,40,2.94121729565198,4.83795531410699,8.37418719816496,101,"ENSG00000079974.19"
"45596","ENSG00000285728.3_18956",18948,18956,9,"ENSG00000285728.3",0,NA,"VVVVVVVVV",0,9,1,67,73,86,89,98,104,133,136,"AGGATGA","TTTA","ATGAAGA","CTGT",2.30998111961181,13,9,29,60,2.09512994249798,4.37375101831085,8.37375101831085,101,"ENSG00000079974.19"
"35722","ENSG00000236869.3_37189",37181,37189,9,"ENSG00000236869.3",0,NA,"VVVVVUVVV",1,8,0.922153209109731,63,69,100,103,112,118,133,136,"GGGATGA","CTGA","AGCATTA","CTGA",2.54056378626333,31,9,15,64,1.79973061671077,4.68420563128324,8.37281846772216,101,"ENSG00000079974.19"
"17319","ENSG00000153904.21_77604",77596,77604,9,"ENSG00000153904.21",1,8,"VVVVVVVMV",0,8,0.884057971014493,109,115,133,136,142,148,157,160,"CTGAAGC","CTGA","ATGAACA","CTGA",2.50112056304717,18,6,9,42,2.66619820572753,4.83508382317716,8.37131570723513,101,"ENSG00000079974.19"
"44434","ENSG00000282057.1_77491",77483,77491,9,"ENSG00000282057.1",1,8,"VVVVVVVMV",0,8,0.884057971014493,109,115,133,136,142,148,157,160,"CTGAAGC","CTGA","ATGAACA","CTGA",2.50112056304717,18,6,9,42,2.66619820572753,4.83508382317716,8.37131570723513,101,"ENSG00000079974.19"
"40768","ENSG00000257588.1_4584",4576,4584,9,"ENSG00000257588.1",1,1,"MVVVVVVVV",0,8,0.90600414078675,108,114,133,136,143,149,202,205,"ATCATGG","CTGA","GTGTTGG","CTGA",2.61147307549257,19,7,53,88,1.57804008223791,4.74696514638043,8.37098170952743,101,"ENSG00000079974.19"
"41780","ENSG00000259712.1_17837",17829,17837,9,"ENSG00000259712.1",0,NA,"VVVVVVVVV",0,9,1,87,93,133,136,146,152,166,169,"GTGGTGA","ATGT","GGGAGGG","CTGA",2.35658076878377,40,10,14,73,1.77100394025465,4.37038559970328,8.37038559970328,101,"ENSG00000079974.19"
"31476","ENSG00000223812.8_131655",131647,131655,9,"ENSG00000223812.8",1,6,"VVVVVMVVV",0,8,0.902691511387163,116,122,133,136,139,145,172,175,"AAGATGG","GTGA","GTGAGGA","CTGA",2.57308232716104,11,3,27,50,1.88001228831467,4.75847361734706,8.36923966289571,101,"ENSG00000079974.19"
"5904","ENSG00000107186.17_155903",155895,155903,9,"ENSG00000107186.17",0,NA,"VVVVVVVVV",0,9,1,106,112,133,136,162,168,184,187,"AAGAAGA","CCGA","TTGATAT","CTGA",2.43039648577965,21,26,16,72,1.27267752773978,4.36883019156769,8.36883019156769,101,"ENSG00000079974.19"
"9485","ENSG00000124813.23_15551",15543,15551,9,"ENSG00000124813.23",0,NA,"VVVVVVUVV",1,8,0.886128364389234,102,108,133,136,149,155,171,174,"ATGATGT","TTGA","ATGGTGT","CTGA",2.65063650520421,25,13,16,63,1.62441926002522,4.82383232367999,8.36834578123693,101,"ENSG00000079974.19"
"24055","ENSG00000175029.17_68010",68002,68010,9,"ENSG00000175029.17",0,NA,"VVVVVUVVV",1,8,0.922153209109731,112,118,133,136,145,151,164,167,"AAGATGC","CGCA","CTGACGA","CTGA",2.39005323324975,15,9,13,46,2.78330205243867,4.67924756852592,8.36786040496485,101,"ENSG00000079974.19"
"22464","ENSG00000170615.15_41924",41916,41924,9,"ENSG00000170615.15",0,NA,"VVVVVVVVV",0,9,1,115,121,133,136,141,147,159,162,"ATGAAAA","TCGA","GTGAAGA","CTAA",2.17799892603753,12,5,12,38,2.94950207693477,4.36737372929624,8.36737372929624,101,"ENSG00000079974.19"
"19599","ENSG00000163412.13_73995",73987,73995,9,"ENSG00000163412.13",0,NA,"VVVVVVVVV",0,9,1,107,113,133,136,163,169,185,188,"TTGGTGA","TGGA","GTGAAGT","CTGA",2.41962488885678,20,27,16,72,1.33650565892067,4.36683456282481,8.36683456282481,101,"ENSG00000079974.19"
"45558","ENSG00000285708.1_73451",73443,73451,9,"ENSG00000285708.1",0,NA,"VVVVVVVVV",0,9,1,107,113,133,136,163,169,185,188,"TTGGTGA","TGGA","GTGAAGT","CTGA",2.41962488885678,20,27,16,72,1.33650565892067,4.36683456282481,8.36683456282481,101,"ENSG00000079974.19"
"26301","ENSG00000183801.8_1106",1098,1106,9,"ENSG00000183801.8",0,NA,"UVVVVVVVV",1,8,0.902691511387163,102,108,133,136,147,153,170,173,"ATGATAA","ATGA","CTGAGAA","CTGA",2.59782969633693,25,11,17,62,1.70444677076095,4.75582785325179,8.36659389880045,101,"ENSG00000079974.19"
"701","ENSG00000026652.15_126214",126206,126214,9,"ENSG00000026652.15",1,6,"VVVVVMVVV",0,8,0.902691511387163,92,98,133,136,147,153,164,167,"ATGATTG","CTGA","GCGATAA","CTGA",2.57880598046882,35,11,11,66,1.82947924170843,4.75537977787515,8.3661458234238,101,"ENSG00000079974.19"
"33220","ENSG00000229066.2_164024",164016,164024,9,"ENSG00000229066.2",0,NA,"UVVVVVVVV",1,8,0.902691511387163,83,89,104,107,114,120,133,136,"GTGCTGT","CTGA","AAAATGG","CTGA",2.42734877167217,15,7,13,44,2.83729252071384,4.75490441629874,8.36567046184739,101,"ENSG00000079974.19"
"17059","ENSG00000153064.12_139946",139938,139946,9,"ENSG00000153064.12",0,NA,"VVVVVVVVV",0,9,1,115,121,133,136,141,147,186,189,"TTTATGT","ATGG","ATGCTGA","CTGA",2.32587591533586,12,5,39,65,1.95649666036811,4.36558402398513,8.36558402398513,101,"ENSG00000079974.19"
"28565","ENSG00000196116.8_23772",23764,23772,9,"ENSG00000196116.8",0,NA,"VVVVVVVVV",0,9,1,115,121,133,136,142,148,191,194,"TTAATGT","GTTA","GTTATGA","CTGA",2.31757687562912,12,6,43,70,1.99510725174064,4.3614049389837,8.3614049389837,101,"ENSG00000079974.19"
"24090","ENSG00000175115.13_157109",157101,157109,9,"ENSG00000175115.13",1,8,"VVVVVVVMV",0,8,0.884057971014493,49,55,65,68,84,90,133,136,"TTGATGA","CTGA","GTTTTCA","CTGA",2.68159946069923,10,16,43,78,1.41912440841325,4.82411353660203,8.36034542066,101,"ENSG00000079974.19"
"1817","ENSG00000066117.15_14710",14702,14710,9,"ENSG00000066117.15",0,NA,"VVVVVVVVV",0,9,1,95,101,133,136,181,187,199,202,"ATGGAGA","CTGG","CTGGTGA","CTGA",2.46818913847098,32,45,12,98,0.984136825302323,4.35968277044388,8.35968277044388,101,"ENSG00000079974.19"
"38329","ENSG00000249995.1_1384",1376,1384,9,"ENSG00000249995.1",0,NA,"VVVVVUVVV",1,8,0.922153209109731,115,121,133,136,145,151,161,164,"CTGGAGA","CAGA","GCGAAGA","CTGA",2.35488643302543,12,9,10,40,2.98383131815811,4.67076855124857,8.35938138768749,101,"ENSG00000079974.19"
"26705","ENSG00000184903.10_767002",766994,767002,9,"ENSG00000184903.10",0,NA,"VVVVVVVVV",0,9,1,116,122,133,136,181,187,200,203,"CTGTTAA","CTGT","ATGACAA","CTGA",2.33102440876834,11,45,13,78,1.89653238467417,4.35917377744911,8.35917377744911,101,"ENSG00000079974.19"
"10415","ENSG00000131002.15_25268",25260,25268,9,"ENSG00000131002.15",0,NA,"VVVVVVVVV",0,9,1,114,120,133,136,141,147,174,177,"ATAATGG","GAGA","GGAAAGA","CTGA",2.29589341781869,13,5,27,54,2.13073181262197,4.35917198285331,8.35917198285331,101,"ENSG00000079974.19"
"48355","ENSG00000291033.1_25337",25329,25337,9,"ENSG00000291033.1",0,NA,"VVVVVVVVV",0,9,1,114,120,133,136,141,147,174,177,"ATAATGG","GAGA","GGAAAGA","CTGA",2.29589341781869,13,5,27,54,2.13073181262197,4.35917198285331,8.35917198285331,101,"ENSG00000079974.19"
"21171","ENSG00000166741.8_10237",10229,10237,9,"ENSG00000166741.8",0,NA,"VVVVVUVVV",1,8,0.922153209109731,107,113,133,136,154,160,173,176,"ATGCTGT","GTGA","GTTATGA","CTGA",2.53494235453138,20,18,13,60,1.7822280349655,4.67046093296035,8.35907376939927,101,"ENSG00000079974.19"
"37562","ENSG00000248475.5_22937",22929,22937,9,"ENSG00000248475.5",0,NA,"VVVVVVVVV",0,9,1,115,121,133,136,174,180,217,220,"ATGAGGG","CTGT","CTGCTGT","CTGA",2.45808731765465,12,38,37,96,1.04784164614193,4.35877260762656,8.35877260762656,101,"ENSG00000079974.19"
"35004","ENSG00000234678.2_10000",9992,10000,9,"ENSG00000234678.2",1,1,"MVVVVVVVV",0,8,0.90600414078675,115,121,133,136,144,150,176,179,"GTTAGGA","CTGA","GAGAGGA","CTGA",2.507350118732,12,8,26,55,2.22317001845266,4.7347093691665,8.3587259323135,101,"ENSG00000079974.19"
"19213","ENSG00000162551.14_1601",1593,1601,9,"ENSG00000162551.14",1,1,"MVVVVVVVV",0,8,0.90600414078675,95,101,133,136,157,163,175,178,"GTGATGA","GTGT","GTGAGGA","CTGA",2.65744368923766,32,21,12,74,1.21985107152646,4.73403558327772,8.35805214642471,101,"ENSG00000079974.19"
"46016","ENSG00000286122.1_111109",111101,111109,9,"ENSG00000286122.1",1,2,"UMVVVVVVV",1,7,0.786749482401656,115,121,133,136,143,149,157,160,"GTGATGT","CAGA","GTGATTA","CTGA",2.66394785418547,12,7,8,36,3.08286607336289,5.21062960864984,8.35762753825647,101,"ENSG00000079974.19"
"34360","ENSG00000232849.2_5430",5422,5430,9,"ENSG00000232849.2",1,2,"VMVVVVVVV",0,8,0.884057971014493,111,117,133,136,142,148,168,171,"TTGATGA","AGGA","ATGATAT","CTGA",2.54121494288981,16,6,20,51,2.33858155669799,4.82000362732418,8.35623551138215,101,"ENSG00000079974.19"
"38324","ENSG00000249988.1_69202",69194,69202,9,"ENSG00000249988.1",1,8,"VVVVVVVMV",0,8,0.884057971014493,7,13,23,26,73,79,133,136,"ATGATGA","ATGA","ATGTTAA","CTGA",2.75195926918784,10,47,54,120,0.92201258978441,4.81710192942583,8.3533338134838,101,"ENSG00000079974.19"
"18488","ENSG00000157483.9_148399",148391,148399,9,"ENSG00000157483.9",1,1,"MVVVVVVVV",0,8,0.90600414078675,109,115,133,136,144,150,164,167,"ATGATTT","ATGA","ATTATCA","CTGA",2.45861076454346,18,8,14,49,2.52554291813936,4.72907033710727,8.35308690025427,101,"ENSG00000079974.19"
"1483","ENSG00000058056.10_131910",131902,131910,9,"ENSG00000058056.10",1,1,"MVVVVVVVV",0,8,0.90600414078675,92,98,107,110,116,122,133,136,"AAGATTA","CTTA","TTAAGGA","CTGA",2.39664972499253,9,6,11,35,2.93749081376803,4.72878891176289,8.35280547490989,101,"ENSG00000079974.19"
"18818","ENSG00000158560.14_79627",79619,79627,9,"ENSG00000158560.14",0,NA,"VVVVVVVVV",0,9,1,114,120,133,136,149,155,167,170,"GCAGTGA","CTGG","TTGGAGA","CTGA",2.21398941122079,13,13,12,47,2.65060692815329,4.35263408407298,8.35263408407298,101,"ENSG00000079974.19"
"41359","ENSG00000258913.2_50760",50752,50760,9,"ENSG00000258913.2",0,NA,"UVVVVVVVV",1,8,0.902691511387163,85,91,133,136,148,154,170,173,"TTGATGG","CTGA","GTGTAGG","CTGA",2.61610970312232,42,12,16,79,1.52508628583409,4.74145440999572,8.35222045554437,101,"ENSG00000079974.19"
"40144","ENSG00000255101.1_9455",9447,9455,9,"ENSG00000255101.1",0,NA,"VVVVVUVVV",1,8,0.922153209109731,85,91,103,106,116,122,133,136,"ATATTCA","CTGA","CAGATAA","CTGA",2.36265264691297,12,10,11,42,2.90155585125339,4.66314337433496,8.35175621077388,101,"ENSG00000079974.19"
"2029","ENSG00000069188.17_47970",47962,47970,9,"ENSG00000069188.17",1,3,"VVMVVVVVV",0,8,0.882815734989648,88,94,106,109,116,122,133,136,"ATGCAGA","CAGA","TTGAGAA","CTGA",2.437633755595,12,7,11,39,3.03072645176272,4.82040453893234,8.35166747889093,101,"ENSG00000079974.19"
"46933","ENSG00000287383.1_102214",102206,102214,9,"ENSG00000287383.1",0,NA,"VVVVVVVVV",0,9,1,77,83,104,107,114,120,133,136,"ATGATAA","CTGG","ATCAAAA","CTTA",2.26137517850335,21,7,13,50,2.32968541968188,4.35137998575938,8.35137998575938,101,"ENSG00000079974.19"
"620","ENSG00000021645.20_244896",244888,244896,9,"ENSG00000021645.20",0,NA,"VVVVVVVVV",0,9,1,54,60,73,76,85,91,133,136,"GGGATGA","ATGA","TGGATGA","CTTA",2.31671465776777,13,9,42,73,1.95990010449409,4.35116612240313,8.35116612240313,101,"ENSG00000079974.19"
"3118","ENSG00000081189.16_94322",94314,94322,9,"ENSG00000081189.16",0,NA,"UVVVVVVVV",1,8,0.902691511387163,113,119,133,136,146,152,168,171,"ATAAAGA","CTGG","ATGAGAA","CTGA",2.45076438308751,14,10,16,49,2.62183404791356,4.74006581712423,8.35083186267289,101,"ENSG00000079974.19"
"29857","ENSG00000198815.9_62666",62658,62666,9,"ENSG00000198815.9",0,NA,"VVVVVVVVV",0,9,1,116,122,133,136,139,145,156,159,"ATGCTGT","CTGT","TAGAGGA","CTGT",2.18615740495638,11,3,11,34,2.8281652332091,4.35063698322958,8.35063698322958,101,"ENSG00000079974.19"
"34954","ENSG00000234464.2_110564",110556,110564,9,"ENSG00000234464.2",0,NA,"VVVVVVVVV",0,9,1,81,87,101,104,115,121,133,136,"CTGCTGA","TTGA","GTCAATA","CTTA",2.19611344101945,14,11,12,46,2.76117004326452,4.35048157918188,8.35048157918188,101,"ENSG00000079974.19"
"32403","ENSG00000226965.2_30626",30618,30626,9,"ENSG00000226965.2",1,6,"VVVVVMVVV",0,8,0.902691511387163,115,121,133,136,185,191,209,212,"ATGAAGA","TTGA","ATGGTAA","CTGA",2.59815272952663,12,49,18,88,1.63731177835662,4.7395824938002,8.35034853934886,101,"ENSG00000079974.19"
"35526","ENSG00000236234.1_4048",4040,4048,9,"ENSG00000236234.1",0,NA,"VVVVVVVVV",0,9,1,39,45,52,55,100,106,133,136,"ATCATGA","CTGA","GTGGAGA","CTGG",2.487351346583,7,45,27,88,0.817962647952674,4.3500762396265,8.3500762396265,101,"ENSG00000079974.19"
"39588","ENSG00000253875.2_23995",23987,23995,9,"ENSG00000253875.2",1,6,"VVVVVMVVV",0,8,0.902691511387163,116,122,133,136,165,171,185,188,"ATGAGGA","CAGT","ATGAAGA","CTGA",2.55719331428037,11,29,14,63,1.9074115226911,4.73884173780672,8.34960778335538,101,"ENSG00000079974.19"
"35340","ENSG00000235749.3_93142",93134,93142,9,"ENSG00000235749.3",1,1,"MVVVVVVVV",0,8,0.90600414078675,116,122,133,136,183,189,197,200,"ATCATCA","ATGA","GTGAAGA","CTGA",2.54140100229356,11,47,8,75,1.95661719530114,4.72482263598122,8.34883919912822,101,"ENSG00000079974.19"
"536","ENSG00000018189.13_10163",10155,10163,9,"ENSG00000018189.13",1,2,"VMVVVVVVV",0,8,0.884057971014493,74,80,99,102,111,117,133,136,"TTAATGA","CTGA","ATGGTTG","CTGA",2.54452330771138,19,9,16,53,2.28610474427883,4.81239836558867,8.34863024964665,101,"ENSG00000079974.19"
"7872","ENSG00000115935.19_21309",21301,21309,9,"ENSG00000115935.19",1,8,"VVVVVVVMV",0,8,0.884057971014493,109,115,133,136,147,153,208,211,"GTGATGA","GAGA","ATGAAGA","CTGA",2.66145207810212,18,11,55,93,1.5021890591391,4.81130072828831,8.34753261234628,101,"ENSG00000079974.19"
"41493","ENSG00000259103.2_12977",12969,12977,9,"ENSG00000259103.2",1,8,"UVVVVVVMV",1,7,0.786749482401656,86,92,101,104,115,121,133,136,"ATGATGG","CTGA","TTGTTAA","CTGA",2.72167240458525,9,11,12,41,2.65358613555105,5.19951720819651,8.34651513780314,101,"ENSG00000079974.19"
"47996","ENSG00000289953.1_56225",56217,56225,9,"ENSG00000289953.1",0,NA,"VVVVVVVVV",0,9,1,83,89,102,105,108,114,133,136,"CTGATGA","TTCA","TTGATTT","CTTA",2.26555520272634,13,3,19,44,2.28047304741369,4.34604359973066,8.34604359973066,101,"ENSG00000079974.19"
"17081","ENSG00000153093.20_273830",273822,273830,9,"ENSG00000153093.20",0,NA,"VVVVVUVVV",1,8,0.922153209109731,115,121,133,136,144,150,159,162,"ACGATGT","ATGC","TTCAGGA","CTGA",2.33720737528321,12,8,9,38,3.04524255703313,4.6566562647303,8.34526910116922,101,"ENSG00000079974.19"
"8396","ENSG00000118557.16_6041",6033,6041,9,"ENSG00000118557.16",0,NA,"VVVVVUVVV",1,8,0.922153209109731,69,75,88,91,98,104,133,136,"ATGATGA","AAGA","ATGAGGA","CTTA",2.47192927271541,13,7,29,58,2.14454649301031,4.65601874444493,8.34463158088385,101,"ENSG00000079974.19"
"33947","ENSG00000231607.15_114630",114622,114630,9,"ENSG00000231607.15",0,NA,"VVVVUVVVV",1,8,0.889855072463768,76,82,93,96,107,113,133,136,"ATGGTGT","CTGA","GGGATCG","CTGA",2.5220962515974,11,11,20,51,2.32677728791776,4.78518807464177,8.34460836449684,101,"ENSG00000079974.19"
"37450","ENSG00000248215.6_17124",17116,17124,9,"ENSG00000248215.6",0,NA,"VVVVVVVVV",0,9,1,98,104,133,136,149,155,198,201,"ATTTTGA","CAGA","CTGATTA","CTGA",2.492115769366,29,13,43,94,0.763983173329128,4.34452207560895,8.34452207560895,101,"ENSG00000079974.19"
"13854","ENSG00000143748.18_624",616,624,9,"ENSG00000143748.18",0,NA,"VVVVVVVVV",0,9,1,110,116,133,136,151,157,169,172,"TTCATGA","GTGT","AGAATGT","CTGA",2.26644228734176,17,15,12,53,2.26704246180077,4.34416442768647,8.34416442768647,101,"ENSG00000079974.19"
"47114","ENSG00000287693.1_13389",13381,13389,9,"ENSG00000287693.1",1,2,"VMVVVVVVV",0,8,0.884057971014493,86,92,99,102,114,120,133,136,"ATAATGA","CTCA","TTTATGC","CTGA",2.53597060309239,7,12,13,41,2.32089409421536,4.80684119537448,8.34307307943245,101,"ENSG00000079974.19"
"9110","ENSG00000122728.6_280",272,280,9,"ENSG00000122728.6",0,NA,"VVVVUVVVV",1,8,0.889855072463768,114,120,133,136,155,161,174,177,"ATGATGA","CTTG","GGGCTGG","CTGA",2.53454962706762,13,19,13,54,2.23757171141374,4.78364230629947,8.34306259615454,101,"ENSG00000079974.19"
"35309","ENSG00000235669.1_2309",2301,2309,9,"ENSG00000235669.1",0,NA,"UVVVVVVVV",1,8,0.902691511387163,40,46,62,65,76,82,133,136,"ATGTTGA","CTTA","GTGTTCA","CTGA",2.58791881032698,16,11,51,87,1.67494510353223,4.73193429309469,8.34270033864335,101,"ENSG00000079974.19"
"23430","ENSG00000172954.14_95837",95829,95837,9,"ENSG00000172954.14",0,NA,"VVVVVUVVV",1,8,0.922153209109731,113,119,133,136,145,151,160,163,"CTGATGT","TTGA","CTGTTGA","CTAA",2.35180556495986,14,9,9,41,2.93727423392056,4.6539945000799,8.34260733651882,101,"ENSG00000079974.19"
"37390","ENSG00000248079.4_149041",149033,149041,9,"ENSG00000248079.4",1,7,"VVVVVVMVV",0,8,0.885300207039338,115,121,133,136,185,191,200,203,"ATGGTGA","CTGG","GGGAGGA","CTGA",2.58078337305489,12,49,9,79,1.99983803963293,4.80126513166638,8.34246595982373,101,"ENSG00000079974.19"
"17558","ENSG00000154438.8_47580",47572,47580,9,"ENSG00000154438.8",0,NA,"VVVVVVVVV",0,9,1,107,113,133,136,146,152,163,166,"TTGATAA","ATGA","ATGACCA","TTGA",2.24911424390875,20,10,11,50,2.37511342598283,4.34230209634363,8.34230209634363,101,"ENSG00000079974.19"
"7144","ENSG00000112964.14_20925",20917,20925,9,"ENSG00000112964.14",0,NA,"VVVVVVVVV",0,9,1,93,99,133,136,141,147,156,159,"ATAATGA","ATGA","TTAATAA","TTGA",2.313875635505,34,5,9,57,1.94219060813275,4.34200704454153,8.34200704454153,101,"ENSG00000079974.19"
"7650","ENSG00000115252.19_293983",293975,293983,9,"ENSG00000115252.19",0,NA,"UVVVVVVVV",1,8,0.902691511387163,106,112,133,136,149,155,163,166,"AGGATGA","AGGA","GTGAAGG","CTGA",2.52603787008659,21,13,8,51,2.08458244839738,4.73120872891033,8.34197477445898,101,"ENSG00000079974.19"
"45124","ENSG00000285051.2_350879",350871,350879,9,"ENSG00000285051.2",1,2,"VMVVVVVVV",0,8,0.884057971014493,75,81,95,98,115,121,133,136,"ATGTTGA","CTGT","ATGTATA","CTGA",2.5308780203192,14,17,12,52,2.35036647833753,4.80572165344972,8.34195353750769,101,"ENSG00000079974.19"
"45206","ENSG00000285218.1_380650",380642,380650,9,"ENSG00000285218.1",1,2,"VMVVVVVVV",0,8,0.884057971014493,75,81,95,98,115,121,133,136,"ATGTTGA","CTGT","ATGTATA","CTGA",2.5308780203192,14,17,12,52,2.35036647833753,4.80572165344972,8.34195353750769,101,"ENSG00000079974.19"
"8562","ENSG00000119574.13_22959",22951,22959,9,"ENSG00000119574.13",0,NA,"VVVVVUVVV",1,8,0.922153209109731,100,106,133,136,145,151,167,170,"AGGATGG","CTCA","GGGATGA","CTGA",2.52017871072366,27,9,16,61,1.81173821815859,4.65323240574574,8.34184524218467,101,"ENSG00000079974.19"
"24726","ENSG00000177694.16_415095",415087,415095,9,"ENSG00000177694.16",0,NA,"VVVUVVVVV",1,8,0.880745341614907,100,106,133,136,140,146,162,165,"CTGATGA","CTAA","CTGAATA","CTGA",2.63637911811769,27,4,16,56,1.69894906238373,4.81870246245875,8.34168382891837,101,"ENSG00000079974.19"
"46934","ENSG00000287383.1_106743",106735,106743,9,"ENSG00000287383.1",0,NA,"VVVUVVVVV",1,8,0.880745341614907,109,115,133,136,165,171,182,185,"ATGATAA","CTGA","GTAACTA","CTGA",2.63387718390585,18,29,11,67,1.71339533469278,4.81814414018295,8.34112550664258,101,"ENSG00000079974.19"
"11487","ENSG00000135090.14_181820",181812,181820,9,"ENSG00000135090.14",1,8,"VVVVVVVMV",0,8,0.884057971014493,115,121,133,136,150,156,173,176,"CTGATGA","ATTA","GTGGTCA","CTGA",2.53443792473407,12,14,17,52,2.32085406700248,4.80427672464073,8.3405086086987,101,"ENSG00000079974.19"
"5851","ENSG00000107077.19_190402",190394,190402,9,"ENSG00000107077.19",1,1,"MVVVVVVVV",0,8,0.90600414078675,85,91,133,136,146,152,165,168,"AGGATGA","AAGA","ATGATCA","CTGA",2.55714992315969,42,10,13,74,1.81802327722529,4.7164223579058,8.3404389210528,101,"ENSG00000079974.19"
"31843","ENSG00000224972.1_8595",8587,8595,9,"ENSG00000224972.1",1,1,"MVVVVVVVV",0,8,0.90600414078675,85,91,133,136,146,152,165,168,"AGGATGA","AAGA","ATGATCA","CTGA",2.55714992315969,42,10,13,74,1.81802327722529,4.7164223579058,8.3404389210528,101,"ENSG00000079974.19"
"29179","ENSG00000197408.10_11101",11093,11101,9,"ENSG00000197408.10",0,NA,"VVVVVVVVV",0,9,1,111,117,133,136,142,148,157,160,"TTGAACA","CACA","ATGAATT","CTGA",2.17615387803736,16,6,9,40,2.85344667370478,4.34028479848846,8.34028479848846,101,"ENSG00000079974.19"
"5015","ENSG00000102755.12_17978",17970,17978,9,"ENSG00000102755.12",0,NA,"VVVVVVVVV",0,9,1,69,75,87,90,97,103,133,136,"ATGATCA","CTGT","GTGACCC","CAGA",2.28509471354106,12,7,30,58,2.1267246601037,4.34017235426102,8.34017235426102,101,"ENSG00000079974.19"
"21403","ENSG00000167378.10_6915",6907,6915,9,"ENSG00000167378.10",1,8,"VVVVVVVMV",0,8,0.884057971014493,116,122,133,136,143,149,157,160,"ATGAGGA","TTTA","GAGAACA","CTGA",2.41932091043096,11,7,8,35,3.08659389029706,4.8038499899592,8.34008187401717,101,"ENSG00000079974.19"
"43088","ENSG00000268361.1_3817",3809,3817,9,"ENSG00000268361.1",1,8,"VVVVVVVMV",0,8,0.884057971014493,116,122,133,136,143,149,157,160,"ATGAGGA","TTTA","GAGAACA","CTGA",2.41932091043096,11,7,8,35,3.08659389029706,4.8038499899592,8.34008187401717,101,"ENSG00000079974.19"
"35923","ENSG00000237484.7_118637",118629,118637,9,"ENSG00000237484.7",1,3,"VVMVVVVVV",0,8,0.882815734989648,91,97,103,106,112,118,133,136,"AGGATGC","ATGA","GTGAAGT","CTGA",2.52630022314462,6,6,15,36,2.39090942076842,4.8082277270998,8.33949066705839,101,"ENSG00000079974.19"
"30940","ENSG00000214814.7_89244",89236,89244,9,"ENSG00000214814.7",1,8,"VVVVVVVMV",0,8,0.884057971014493,114,120,133,136,181,187,214,217,"GTGATGA","CTGG","GTGGGGA","CTGA",2.70126535821578,13,45,27,94,1.20186061071896,4.80257408303936,8.33880596709734,101,"ENSG00000079974.19"
"46684","ENSG00000287044.1_34034",34026,34034,9,"ENSG00000287044.1",0,NA,"VVVVVVVVV",0,9,1,116,122,133,136,145,151,169,172,"GTGAAAA","AAGA","ATAAAGT","CTGA",2.21858431538536,11,9,18,47,2.5642180314518,4.33869503350522,8.33869503350522,101,"ENSG00000079974.19"
"16802","ENSG00000152315.5_118104",118096,118104,9,"ENSG00000152315.5",1,8,"VVVVVVVMV",0,8,0.884057971014493,87,93,133,136,147,153,162,165,"GTGATGA","CAGG","AAGATGA","CTGA",2.60565862429161,40,11,9,69,1.83513918258179,4.8015491694648,8.33778105352277,101,"ENSG00000079974.19"
"22012","ENSG00000169604.21_2123",2115,2123,9,"ENSG00000169604.21",1,1,"MVVVVVVVV",0,8,0.90600414078675,62,68,84,87,92,98,133,136,"TTGATGA","ATGA","AGGCTTA","CTGA",2.55475805421139,16,5,35,65,1.82237342561435,4.71352344675591,8.33754000990291,101,"ENSG00000079974.19"
"36432","ENSG00000240875.6_49128",49120,49128,9,"ENSG00000240875.6",0,NA,"VVVVVVVVV",0,9,1,114,120,133,136,184,190,210,213,"TTGATGT","TGGA","ATGACTT","CTGA",2.3752806924197,13,48,20,90,1.51340924412201,4.33715346506333,8.33715346506333,101,"ENSG00000079974.19"
"16061","ENSG00000150672.19_177654",177646,177654,9,"ENSG00000150672.19",1,2,"VMUVVVVVV",1,7,0.767701863354037,114,120,133,136,144,150,159,162,"ATGATGA","CAGA","TGGTTGA","CTGA",2.70591353634611,13,8,9,39,3.02568388418325,5.26627686495599,8.33708431837214,101,"ENSG00000079974.19"
"12383","ENSG00000138031.15_93727",93719,93727,9,"ENSG00000138031.15",0,NA,"VVVVVVVVV",0,9,1,114,120,133,136,160,166,177,180,"ATGAACA","ATGG","GCTATGA","CTGA",2.28293748908322,13,24,11,57,2.12807343632238,4.33691417421929,8.33691417421929,101,"ENSG00000079974.19"
"1371","ENSG00000054523.20_170457",170449,170457,9,"ENSG00000054523.20",0,NA,"VVVVVVVVV",0,9,1,93,99,133,136,148,154,165,168,"AGGAAGA","CATA","GTGCTCA","CTGA",2.3375220866071,34,12,11,66,1.76373737434265,4.33680448793082,8.33680448793082,101,"ENSG00000079974.19"
"30549","ENSG00000205683.12_187614",187606,187614,9,"ENSG00000205683.12",0,NA,"VVVVVVVVV",0,9,1,111,117,133,136,150,156,176,179,"GTGATGA","TTGC","TTGACAA","CTTA",2.30551057484757,16,14,20,59,1.97707433971605,4.33678620967496,8.33678620967496,101,"ENSG00000079974.19"
"11293","ENSG00000134504.14_64894",64886,64894,9,"ENSG00000134504.14",1,2,"VMVVVUVVV",1,7,0.806211180124223,75,81,96,99,106,112,133,136,"GTGATGG","CTGA","GTGAGTA","CTGA",2.71152326241202,15,7,21,52,2.37005965409512,5.11172035087715,8.33656507137405,101,"ENSG00000079974.19"
"1864","ENSG00000066827.16_148317",148309,148317,9,"ENSG00000066827.16",0,NA,"UVVVVVVVV",1,8,0.902691511387163,111,117,133,136,144,150,160,163,"GTAATGT","CTGC","TTGGGGA","CTGA",2.40970296409381,16,8,10,43,2.8368911233464,4.72539438765962,8.33616043320827,101,"ENSG00000079974.19"
"30032","ENSG00000198959.12_35916",35908,35916,9,"ENSG00000198959.12",0,NA,"VVVVVVVVV",0,9,1,104,110,133,136,143,149,179,182,"GTAATGT","CAGA","ATGTACA","CTGA",2.39173656606249,23,7,30,69,1.39960483835103,4.3361288196919,8.3361288196919,101,"ENSG00000079974.19"
"25742","ENSG00000182667.15_736353",736345,736353,9,"ENSG00000182667.15",0,NA,"VVVVVVUVV",1,8,0.886128364389234,103,109,133,136,156,162,171,174,"TTGATGA","CAGA","GCGATGT","CTGA",2.65060421326156,24,20,9,62,1.49463147192869,4.79133155675143,8.33584501430837,101,"ENSG00000079974.19"
"11732","ENSG00000135930.15_12237",12229,12237,9,"ENSG00000135930.15",1,6,"VVVVVMVVV",0,8,0.902691511387163,116,122,133,136,149,155,164,167,"TTGCTGA","CTGC","TAGATGG","CTGA",2.4322262813419,11,13,9,42,2.68499463647624,4.72495912802222,8.33572517357088,101,"ENSG00000079974.19"
"17910","ENSG00000155816.21_302045",302037,302045,9,"ENSG00000155816.21",1,2,"VMVVVVVVV",0,8,0.884057971014493,105,111,133,136,147,153,165,168,"ATGATCA","ATAA","GTGAGGA","CTGA",2.56005483955523,22,11,12,54,2.13026303862595,4.79932382558187,8.33555570963984,101,"ENSG00000079974.19"
"46589","ENSG00000286863.2_297550",297542,297550,9,"ENSG00000286863.2",1,7,"VVVVVVMVV",0,8,0.885300207039338,108,114,133,136,185,191,199,202,"CTGATCA","CTGA","ATTATGA","CTGA",2.6427683748498,19,49,8,85,1.55807018285676,4.79413150379718,8.33533233195453,101,"ENSG00000079974.19"
"15764","ENSG00000149403.13_421149",421141,421149,9,"ENSG00000149403.13",1,1,"MVVVVVVVV",0,8,0.90600414078675,108,114,133,136,154,160,178,181,"GTGAGGA","CAGA","CTGATCA","CTGA",2.58880456516604,19,18,18,64,1.58564914277892,4.71108656097146,8.33510312411845,101,"ENSG00000079974.19"
"1806","ENSG00000066032.19_802012",802004,802012,9,"ENSG00000066032.19",1,3,"VVMVVVVVV",0,8,0.882815734989648,115,121,133,136,155,161,216,219,"ATCATGG","CTGA","GTGAGGA","CTGA",2.68368591333041,12,19,55,95,1.32364944842187,4.80372221765615,8.33498515761474,101,"ENSG00000079974.19"
"3813","ENSG00000089169.15_227067",227059,227067,9,"ENSG00000089169.15",0,NA,"VVVVVVVVV",0,9,1,113,119,133,136,151,157,169,172,"CTGTTGG","CTTG","CTGATTT","CTGA",2.22950464957425,14,15,12,50,2.47654932043076,4.33497841273143,8.33497841273143,101,"ENSG00000079974.19"
"19494","ENSG00000163116.10_571147",571139,571147,9,"ENSG00000163116.10",1,5,"VVVVMVVVV",0,8,0.886542443064182,107,113,133,136,146,152,170,173,"ATGATGA","GTGG","GAGAAAA","CTGA",2.56941637350742,20,10,18,57,2.02462308565636,4.78851639392646,8.33468616618319,101,"ENSG00000079974.19"
"39660","ENSG00000254044.5_61494",61486,61494,9,"ENSG00000254044.5",1,5,"VVVVMVVVV",0,8,0.886542443064182,107,113,133,136,146,152,170,173,"ATGATGA","GTGG","GAGAAAA","CTGA",2.56941637350742,20,10,18,57,2.02462308565636,4.78851639392646,8.33468616618319,101,"ENSG00000079974.19"
"11450","ENSG00000134986.14_33900",33892,33900,9,"ENSG00000134986.14",0,NA,"VVVVVUVVV",1,8,0.922153209109731,72,78,88,91,105,111,133,136,"TTGATCA","CTGC","ATGAAAA","CTGA",2.49515424105885,10,14,22,55,1.94973563388306,4.64602431023551,8.33463714667443,101,"ENSG00000079974.19"
"11040","ENSG00000133687.16_42777",42769,42777,9,"ENSG00000133687.16",1,8,"VVVVVVVMV",0,8,0.884057971014493,96,102,109,112,114,120,133,136,"ATGATGA","CTGC","ATTATGA","TTGA",2.52380150773651,7,2,13,31,2.36780311336175,4.79828662456794,8.33451850862592,101,"ENSG00000079974.19"
"17294","ENSG00000153823.19_19486",19478,19486,9,"ENSG00000153823.19",1,3,"VVMVVVVVV",0,8,0.882815734989648,56,62,74,77,110,116,133,136,"ATGAAGA","CTTA","TTGTTGA","CTGA",2.62270305425687,12,33,17,71,1.72694015751755,4.80290679647417,8.33416973643276,101,"ENSG00000079974.19"
"35069","ENSG00000234828.9_334984",334976,334984,9,"ENSG00000234828.9",1,1,"MVVVVVUVV",1,7,0.792132505175983,114,120,133,136,142,148,157,160,"AAGATGA","GTGA","TTGATAA","CTGA",2.64026127392714,13,6,9,37,3.05690452077254,5.16466158673837,8.3331916074423,101,"ENSG00000079974.19"
"38430","ENSG00000250149.2_51658",51650,51658,9,"ENSG00000250149.2",1,5,"VVVVMVVVV",0,8,0.886542443064182,108,114,133,136,147,153,165,168,"ATGATCA","TGGA","AGGATGA","CTGA",2.51660842850087,19,11,12,51,2.3704658835757,4.78696385172872,8.33313362398544,101,"ENSG00000079974.19"
"47337","ENSG00000288016.3_150763",150755,150763,9,"ENSG00000288016.3",0,NA,"UVVVVVVVV",1,8,0.902691511387163,114,120,133,136,140,146,164,167,"CTGATGG","ATGA","AGGAACA","CTGA",2.46169141885691,13,4,18,44,2.47814042209791,4.72235413695267,8.33312018250132,101,"ENSG00000079974.19"
"36920","ENSG00000243620.2_400094",400086,400094,9,"ENSG00000243620.2",1,8,"VVVVVVVMV",0,8,0.884057971014493,115,121,133,136,141,147,157,160,"ATGATGC","CTCA","ATGATGG","CTTA",2.42297787040355,12,5,10,36,3.03415759690402,4.79683584989859,8.33306773395656,101,"ENSG00000079974.19"
"3476","ENSG00000084754.12_31745",31737,31745,9,"ENSG00000084754.12",1,1,"MVVVVVUVV",1,7,0.792132505175983,81,87,102,105,114,120,133,136,"GTGATAA","CTGA","GTGTAGA","CTGA",2.68116047416506,15,9,13,46,2.78330205243867,5.16442630338477,8.3329563240887,101,"ENSG00000079974.19"
"34809","ENSG00000234177.5_478",470,478,9,"ENSG00000234177.5",1,8,"VVVVVVVMV",0,8,0.884057971014493,111,117,133,136,143,149,157,160,"ATGATCA","GTTA","GGGGTGA","CTGA",2.45028819713058,16,7,8,40,2.85115871942076,4.79660334173949,8.33283522579746,101,"ENSG00000079974.19"
"27175","ENSG00000185722.18_61037",61029,61037,9,"ENSG00000185722.18",1,1,"MVVVVVVVV",0,8,0.90600414078675,113,119,133,136,147,153,165,168,"ATGATTA","CTTT","CTTATTA","CTGA",2.41089006626006,14,11,12,46,2.76117004326452,4.70844262124956,8.33245918439656,101,"ENSG00000079974.19"
"45418","ENSG00000285557.1_91932",91924,91932,9,"ENSG00000285557.1",0,NA,"VVVVVVVVV",0,9,1,115,121,133,136,149,155,164,167,"GTCATGA","TTGG","GTGACAA","CTTA",2.19340324419889,12,13,9,43,2.70531919494812,4.33200187240185,8.33200187240185,101,"ENSG00000079974.19"
"40366","ENSG00000255750.6_47779",47771,47779,9,"ENSG00000255750.6",0,NA,"VVVVVVVVV",0,9,1,114,120,133,136,141,147,161,164,"AGAAGGA","CAGT","TTGTTGT","CTGA",2.17564427891826,13,5,14,41,2.82260799461697,4.33172579685134,8.33172579685134,101,"ENSG00000079974.19"
"40444","ENSG00000256234.1_63915",63907,63915,9,"ENSG00000256234.1",0,NA,"VVVVVVVVV",0,9,1,114,120,133,136,141,147,161,164,"AGAAGGA","CAGT","TTGTTGT","CTGA",2.17564427891826,13,5,14,41,2.82260799461697,4.33172579685134,8.33172579685134,101,"ENSG00000079974.19"
"22606","ENSG00000170946.15_38523",38515,38523,9,"ENSG00000170946.15",1,5,"VVVVMVVVV",0,8,0.886542443064182,114,120,133,136,144,150,158,161,"TTGATAT","CTCA","CTGATGC","CTGA",2.41743321204926,13,8,8,38,3.0222337442241,4.78461378947146,8.33078356172819,101,"ENSG00000079974.19"
"24874","ENSG00000178425.14_84505",84497,84505,9,"ENSG00000178425.14",0,NA,"UVVVVUVVV",2,7,0.824844720496894,89,95,110,113,116,122,133,136,"CTGATGA","CTGC","TTGTTGG","CTGA",2.62030116594775,15,3,11,38,2.65595836413498,5.03115820094666,8.33053708293423,101,"ENSG00000079974.19"
"22482","ENSG00000170624.14_445728",445720,445728,9,"ENSG00000170624.14",0,NA,"VVVVVUVVV",1,8,0.922153209109731,76,82,90,93,100,106,133,136,"AGGAAGA","CTGT","TTGAGGA","CTGA",2.49475357106402,8,7,27,51,1.93515952714684,4.64171250022674,8.33032533666566,101,"ENSG00000079974.19"
"3363","ENSG00000083067.25_257303",257295,257303,9,"ENSG00000083067.25",1,1,"MVVVVVVVV",0,8,0.90600414078675,113,119,133,136,180,186,203,206,"TTGGTGA","ATGA","GTGATGG","CTGA",2.57404246741782,14,44,17,84,1.66476676512877,4.7062624703119,8.3302790334589,101,"ENSG00000079974.19"
"20230","ENSG00000164484.12_52335",52327,52335,9,"ENSG00000164484.12",0,NA,"VVVVVVVVV",0,9,1,114,120,133,136,144,150,181,184,"ATAATGA","TTTA","GAGATGA","CTCA",2.28474633355421,13,8,31,61,2.08939579386473,4.33025950438986,8.33025950438986,101,"ENSG00000079974.19"
"19580","ENSG00000163362.11_15560",15552,15560,9,"ENSG00000163362.11",0,NA,"UVVVVVVVV",1,8,0.902691511387163,111,117,133,136,143,149,159,162,"CTGATTT","CTGC","ATGAAGT","CTGA",2.40296617481688,16,7,10,42,2.85527675341961,4.71876281304971,8.32952885859836,101,"ENSG00000079974.19"
"41697","ENSG00000259560.2_50998",50990,50998,9,"ENSG00000259560.2",0,NA,"VVVVVUVVV",1,8,0.922153209109731,25,31,65,68,79,85,133,136,"AGGATGA","CTGT","CTGAAGA","CTGA",2.65675658943172,34,11,48,102,0.851142159257167,4.64071318886715,8.32932602530607,101,"ENSG00000079974.19"
"14635","ENSG00000145526.12_906051",906043,906051,9,"ENSG00000145526.12",0,NA,"VVVVVVVVV",0,9,1,112,118,133,136,148,154,171,174,"TTGATAT","TTGC","ACGATGC","CTGA",2.241513354457,15,12,17,53,2.37310739038926,4.32913243835898,8.32913243835898,101,"ENSG00000079974.19"
"45535","ENSG00000285693.2_839",831,839,9,"ENSG00000285693.2",0,NA,"VVVVVUVVV",1,8,0.922153209109731,80,86,100,103,115,121,133,136,"GTGACGA","CTGA","CAGAGGA","GTGA",2.38044207489448,14,12,12,47,2.69058290894004,4.64004918539248,8.3286620218314,101,"ENSG00000079974.19"
"9112","ENSG00000122729.19_32326",32318,32326,9,"ENSG00000122729.19",1,6,"VVVVVMUVV",1,7,0.788819875776397,75,81,95,98,105,111,133,136,"AGGATGA","ATGA","GTGATGA","CTGA",2.74777354897574,14,7,22,52,2.37177151875751,5.17256546131561,8.3278449644212,101,"ENSG00000079974.19"
"17764","ENSG00000155052.15_38783",38775,38783,9,"ENSG00000155052.15",1,1,"MVVVVVVVV",0,8,0.90600414078675,105,111,133,136,140,146,159,162,"AGGATGA","GAGA","ATGGAGA","CTGA",2.50778712168487,22,4,13,48,2.09575265771992,4.70358336723809,8.32759993038509,101,"ENSG00000079974.19"
"21888","ENSG00000169282.18_305716",305708,305716,9,"ENSG00000169282.18",0,NA,"VVVVVVVVV",0,9,1,115,121,133,136,145,151,175,178,"ATAAGCA","ATGT","GTGATGG","CTGA",2.25685125362995,12,9,24,54,2.26463739812766,4.32757810558183,8.32757810558182,101,"ENSG00000079974.19"
"47264","ENSG00000287916.1_199847",199839,199847,9,"ENSG00000287916.1",0,NA,"VVVVVVVVV",0,9,1,115,121,133,136,145,151,175,178,"ATAAGCA","ATGT","GTGATGG","CTGA",2.25685125362995,12,9,24,54,2.26463739812766,4.32757810558183,8.32757810558182,101,"ENSG00000079974.19"
"13686","ENSG00000143171.13_37387",37379,37387,9,"ENSG00000143171.13",0,NA,"VVVVVVVVV",0,9,1,86,92,133,136,154,160,176,179,"AAGATGA","ATCA","TAGATAA","CTGA",2.42643772337408,41,18,16,84,1.13232912800361,4.32714515429104,8.32714515429104,101,"ENSG00000079974.19"
"40730","ENSG00000257501.8_23187",23179,23187,9,"ENSG00000257501.8",1,2,"VMVVVVVVV",0,8,0.884057971014493,40,46,61,64,108,114,133,136,"GTGATGG","CTAA","GTGAAGA","CTGA",2.65122777058102,15,44,19,87,1.48802482979055,4.790719158416,8.32695104247397,101,"ENSG00000079974.19"
"11057","ENSG00000133794.20_58430",58422,58430,9,"ENSG00000133794.20",0,NA,"VVVVVVVVV",0,9,1,113,119,133,136,167,173,187,190,"TTGAAGC","CTGG","ATGAGAG","CTGA",2.31443626553806,14,31,14,68,1.87770454520838,4.32681991219886,8.32681991219886,101,"ENSG00000079974.19"
"26543","ENSG00000184384.14_27629",27621,27629,9,"ENSG00000184384.14",0,NA,"VVVVVVVVV",0,9,1,20,26,39,42,71,77,133,136,"ATGATGA","CTGA","ATGAAGA","CTAT",2.43722852316602,13,29,56,107,1.057514486164,4.32642616015104,8.32642616015104,101,"ENSG00000079974.19"
"13310","ENSG00000140945.17_384323",384315,384323,9,"ENSG00000140945.17",0,NA,"VVVVVVVVV",0,9,1,91,97,133,136,139,145,193,196,"GTGGAGA","CTTA","ATGATGA","CTGA",2.48910183880359,36,3,48,96,0.710862494890574,4.32621868839529,8.32621868839529,101,"ENSG00000079974.19"
"14174","ENSG00000144476.6_12115",12107,12115,9,"ENSG00000144476.6",0,NA,"UVVVVVVVV",1,8,0.902691511387163,63,69,87,90,106,112,133,136,"TTTATGA","CTGA","GTGAATT","CTGA",2.58688625331401,18,16,21,64,1.61528059546554,4.71529723772306,8.32606328327171,101,"ENSG00000079974.19"
"17566","ENSG00000154479.13_10041",10033,10041,9,"ENSG00000154479.13",1,2,"VMVVVVVVV",0,8,0.884057971014493,66,72,80,83,95,101,133,136,"ATGATGA","CTGA","GTGATAG","TTGA",2.63564792471042,8,12,32,61,1.58731606366612,4.78957555710057,8.32580744115854,101,"ENSG00000079974.19"
"411","ENSG00000011052.21_17931",17923,17931,9,"ENSG00000011052.21",0,NA,"UVVVVVVVV",1,8,0.902691511387163,115,121,133,136,141,147,163,166,"GTGATTC","CTGA","GAAATCA","CTGA",2.42280840517652,12,5,16,42,2.70755614894998,4.71490304586503,8.32566909141369,101,"ENSG00000079974.19"
"9166","ENSG00000123009.4_330",322,330,9,"ENSG00000123009.4",0,NA,"UVVVVVVVV",1,8,0.902691511387163,115,121,133,136,141,147,163,166,"GTGATTC","CTGA","GAAATCA","CTGA",2.42280840517652,12,5,16,42,2.70755614894998,4.71490304586503,8.32566909141369,101,"ENSG00000079974.19"
"36930","ENSG00000243678.12_6086",6078,6086,9,"ENSG00000243678.12",0,NA,"UVVVVVVVV",1,8,0.902691511387163,115,121,133,136,141,147,163,166,"GTGATTC","CTGA","GAAATCA","CTGA",2.42280840517652,12,5,16,42,2.70755614894998,4.71490304586503,8.32566909141369,101,"ENSG00000079974.19"
"7411","ENSG00000114062.22_27054",27046,27054,9,"ENSG00000114062.22",1,1,"MVVVVVVVV",0,8,0.90600414078675,74,80,99,102,115,121,133,136,"ATGATGA","TTGA","TTGTTTA","TTGA",2.48659759152367,19,13,12,53,2.22921042219788,4.70163192475559,8.32564848790259,101,"ENSG00000079974.19"
"43192","ENSG00000269891.2_72251",72243,72251,9,"ENSG00000269891.2",1,1,"MVVVVUVVV",1,7,0.82815734989648,79,85,94,97,105,111,133,136,"ATGCTGA","CTGA","ATCATTA","CTGA",2.6728617511301,9,8,22,48,2.2323320856397,5.01285260662676,8.32548200621268,101,"ENSG00000079974.19"
"37671","ENSG00000248656.3_179725",179717,179725,9,"ENSG00000248656.3",0,NA,"VVVVVVVVV",0,9,1,114,120,133,136,141,147,203,206,"GTGCTGG","TTAA","CTGAAGT","CTGA",2.30552905338923,13,5,56,83,1.9276046341185,4.32444958084501,8.32444958084501,101,"ENSG00000079974.19"
"22282","ENSG00000170153.11_341944",341936,341944,9,"ENSG00000170153.11",1,1,"MVVVVVVVV",0,8,0.90600414078675,100,106,133,136,145,151,167,170,"ATGATGT","TGGA","ATGAAGC","CTGA",2.5479886641529,27,9,16,61,1.81173821815859,4.69958232812781,8.32359889127481,101,"ENSG00000079974.19"
"4878","ENSG00000102218.6_6388",6380,6388,9,"ENSG00000102218.6",0,NA,"VVVVVVVVV",0,9,1,114,120,133,136,139,145,156,159,"TTGATAA","TAGA","GTGAAAA","CTGG",2.17639390181849,13,3,11,36,2.78483965074055,4.32353308238263,8.32353308238263,101,"ENSG00000079974.19"
"39378","ENSG00000253535.5_432338",432330,432338,9,"ENSG00000253535.5",1,1,"MVVVVUVVV",1,7,0.82815734989648,85,91,104,107,116,122,133,136,"ATAATGA","TTGA","TTAATGG","CTGA",2.56395797328486,13,9,11,42,2.94939053734931,5.01061092314542,8.32324032273134,101,"ENSG00000079974.19"
"5245","ENSG00000104067.17_132114",132106,132114,9,"ENSG00000104067.17",1,1,"MVVVVVVVV",0,8,0.90600414078675,112,118,133,136,180,186,212,215,"ATGATGG","GTGA","ATGAGGG","CTGA",2.64639725067665,15,44,26,94,1.14911910453922,4.69794186059588,8.32195842374288,101,"ENSG00000079974.19"
"24769","ENSG00000177879.17_17867",17859,17867,9,"ENSG00000177879.17",1,8,"VVVVVVVMV",0,8,0.884057971014493,109,115,133,136,147,153,196,199,"CTGATCA","CTGA","TTGCTGA","CTGA",2.64445756403899,18,11,43,81,1.51263789669245,4.78558874757142,8.32182063162939,101,"ENSG00000079974.19"
"42209","ENSG00000261115.7_404876",404868,404876,9,"ENSG00000261115.7",0,NA,"VVVVVUVVV",1,8,0.922153209109731,83,89,98,101,110,116,133,136,"CTGATGA","GTGA","ATGTTGG","CAGA",2.40587701395515,9,9,17,44,2.49315300576152,4.63308327469896,8.32169611113788,101,"ENSG00000079974.19"
"46288","ENSG00000286438.1_7069",7061,7069,9,"ENSG00000286438.1",0,NA,"VVVVVUVVV",1,8,0.922153209109731,72,78,90,93,102,108,133,136,"ATGCTCA","TTGA","GGGAGGA","CTGA",2.4462565341958,12,9,25,55,2.22382057100596,4.63304936641116,8.32166220285008,101,"ENSG00000079974.19"
"36384","ENSG00000240405.7_351369",351361,351369,9,"ENSG00000240405.7",0,NA,"VVVVVVVVV",0,9,1,89,95,133,136,151,157,170,173,"ATGATGA","CTTC","GTCAAGA","ATGA",2.37085675989775,38,15,13,75,1.47594900078514,4.3204151833592,8.3204151833592,101,"ENSG00000079974.19"
"11844","ENSG00000136193.17_65299",65291,65299,9,"ENSG00000136193.17",1,1,"MVVVVUVVV",1,7,0.82815734989648,115,121,133,136,140,146,155,158,"ATGAAGA","CTGT","TTCAAGA","CTGA",2.55383793992476,12,4,9,34,3.00325370030578,5.00720999161772,8.31983939120364,101,"ENSG00000079974.19"
"23413","ENSG00000172927.9_22755",22747,22755,9,"ENSG00000172927.9",1,5,"VVVVMVVVV",0,8,0.886542443064182,111,117,133,136,176,182,197,200,"ATGATGA","CAGC","CTGTTAA","CTGA",2.61433738964246,16,40,15,80,1.66239665689338,4.77282814696078,8.31899791921751,101,"ENSG00000079974.19"
"42135","ENSG00000260877.3_17632",17624,17632,9,"ENSG00000260877.3",1,5,"VVVVMVVVV",0,8,0.886542443064182,111,117,133,136,176,182,197,200,"ATGATGA","CAGC","CTGTTAA","CTGA",2.61433738964246,16,40,15,80,1.66239665689338,4.77282814696078,8.31899791921751,101,"ENSG00000079974.19"
"4308","ENSG00000100150.20_79538",79530,79538,9,"ENSG00000100150.20",0,NA,"VVVVVUVVV",1,8,0.922153209109731,103,109,133,136,141,147,170,173,"TTGATGT","ATGA","GGGAAGA","CTGA",2.5516577304402,24,5,23,61,1.50814270003253,4.62979855907513,8.31841139551405,101,"ENSG00000079974.19"
"45315","ENSG00000285404.1_78506",78498,78506,9,"ENSG00000285404.1",0,NA,"VVVVVUVVV",1,8,0.922153209109731,103,109,133,136,141,147,170,173,"TTGATGT","ATGA","GGGAAGA","CTGA",2.5516577304402,24,5,23,61,1.50814270003253,4.62979855907513,8.31841139551405,101,"ENSG00000079974.19"
"3086","ENSG00000080854.16_50311",50303,50311,9,"ENSG00000080854.16",0,NA,"VVUVVUVVV",2,7,0.805797101449275,115,121,133,136,143,149,159,162,"ATGATGA","TTGC","CGGATGT","CTGA",2.59805595254203,12,7,10,38,3.05995008775671,5.09508077617589,8.31826918197299,101,"ENSG00000079974.19"
"14947","ENSG00000146282.19_44206",44198,44206,9,"ENSG00000146282.19",1,2,"VMVVVVVVV",0,8,0.884057971014493,108,114,133,136,150,156,167,170,"ATGATGA","TTGA","GTGAAAA","CTTA",2.54110410696769,19,14,11,53,2.18557171655287,4.78156644075103,8.317798324809,101,"ENSG00000079974.19"
"33654","ENSG00000230590.13_74278",74270,74278,9,"ENSG00000230590.13",0,NA,"UVVVVVVVV",1,8,0.902691511387163,114,120,133,136,149,155,209,212,"ATGATGG","CTTA","ATGTAAA","CTGA",2.570567666399,13,13,54,89,1.69071762602468,4.70695885050451,8.31772489605316,101,"ENSG00000079974.19"
"37938","ENSG00000249240.2_59349",59341,59349,9,"ENSG00000249240.2",0,NA,"VVVVVVVVV",0,9,1,110,116,133,136,141,147,196,199,"ATGTTCA","CAAA","GTGGGGA","CTGA",2.33706981738889,17,5,49,80,1.68952074958269,4.3174965497105,8.3174965497105,101,"ENSG00000079974.19"
"2599","ENSG00000076356.7_86914",86906,86914,9,"ENSG00000076356.7",1,1,"MVVVVVVVV",0,8,0.90600414078675,107,113,133,136,144,150,193,196,"ATGATAT","CTGA","TTGAGGC","CTGA",2.5927701033779,20,8,43,80,1.48818463624306,4.6933296646906,8.3173462278376,101,"ENSG00000079974.19"
"22257","ENSG00000170044.9_366616",366608,366616,9,"ENSG00000170044.9",0,NA,"VVVVVVVVV",0,9,1,107,113,133,136,144,150,176,179,"ATCAAGA","GTGT","GTGGTAA","CTGA",2.33331278124781,20,8,26,63,1.71332502786638,4.31718589237961,8.31718589237961,101,"ENSG00000079974.19"
"829","ENSG00000036054.13_55056",55048,55056,9,"ENSG00000036054.13",1,2,"VMVVVVVVV",0,8,0.884057971014493,113,119,133,136,148,154,163,166,"ATGATGC","TTGA","GTGATTA","CTAA",2.4578728178161,14,12,9,44,2.73707024608165,4.78072225788058,8.31695414193855,101,"ENSG00000079974.19"
"8199","ENSG00000117154.12_98124",98116,98124,9,"ENSG00000117154.12",0,NA,"VVVVVUVVV",1,8,0.922153209109731,59,65,86,89,99,105,133,136,"ATGATGA","CAGA","TTGATGT","CTTA",2.55442946298703,21,10,28,68,1.48253588000345,4.62801640831259,8.31662924475151,101,"ENSG00000079974.19"
"44403","ENSG00000281641.3_227784",227776,227784,9,"ENSG00000281641.3",1,1,"MVVVVVVVV",0,8,0.90600414078675,98,104,133,136,152,158,167,170,"ATGATGT","TTCA","CTGAAGA","CTGA",2.58339609912229,29,16,9,63,1.54583175136282,4.69211810304452,8.31613466619151,101,"ENSG00000079974.19"
"18218","ENSG00000156564.10_177085",177077,177085,9,"ENSG00000156564.10",1,7,"VVVVVVMVV",0,8,0.885300207039338,97,103,133,136,145,151,160,163,"GTGATGT","CAGA","GTGAATT","CTGA",2.5659748812125,30,9,9,57,1.99275396849073,4.77481329414351,8.31601412230086,101,"ENSG00000079974.19"
"20141","ENSG00000164327.13_99685",99677,99685,9,"ENSG00000164327.13",0,NA,"VVVVVVVVV",0,9,1,104,110,133,136,147,153,172,175,"CTGATCT","CTGC","CTCATAA","CTGA",2.3369432557263,23,11,19,62,1.6833627868259,4.31574612291698,8.31574612291698,101,"ENSG00000079974.19"
"32404","ENSG00000226965.2_313359",313351,313359,9,"ENSG00000226965.2",1,2,"VMVVVVVVV",0,8,0.884057971014493,112,118,133,136,141,147,188,191,"ATGATAA","CTGG","CTGAGGT","CTGA",2.58895722483539,15,5,41,70,1.85769712216441,4.77935298860009,8.31558487265806,101,"ENSG00000079974.19"
"46517","ENSG00000286753.3_23248",23240,23248,9,"ENSG00000286753.3",1,6,"VVVVVMVVV",0,8,0.902691511387163,32,38,58,61,110,116,133,136,"ATGATGC","CAGA","GTGATTC","CTGA",2.64449088619066,20,49,17,95,1.18910230073697,4.70476038550201,8.31552643105066,101,"ENSG00000079974.19"
"37491","ENSG00000248309.9_407054",407046,407054,9,"ENSG00000248309.9",1,3,"VVMVVVVVV",0,8,0.882815734989648,91,97,108,111,116,122,133,136,"GTGTTGC","CTGC","GTGAGCA","CTGA",2.42131479867009,11,5,11,36,2.9946049370839,4.78417589872113,8.31543883867972,101,"ENSG00000079974.19"
"35829","ENSG00000237324.3_34370",34362,34370,9,"ENSG00000237324.3",0,NA,"VVVVVVVVV",0,9,1,113,119,133,136,178,184,209,212,"ATGAAGA","CAGG","ATAAGAA","CTGA",2.40270677512417,14,42,25,90,1.24190974438779,4.31498872797056,8.31498872797056,101,"ENSG00000079974.19"
"46472","ENSG00000286730.1_3376",3368,3376,9,"ENSG00000286730.1",1,1,"MVVVVVVVV",0,8,0.90600414078675,116,122,133,136,142,148,163,166,"GTGAGGA","TTGG","ATTTTGA","CTGA",2.3945795203465,11,6,15,41,2.79987486950126,4.69093458461948,8.31495114776648,101,"ENSG00000079974.19"
"46699","ENSG00000287069.1_160748",160740,160748,9,"ENSG00000287069.1",1,6,"VVVVVMVVV",0,8,0.902691511387163,87,93,107,110,115,121,133,136,"CTTATGG","CTGG","GTGTTGC","CTGA",2.38935573997015,14,5,12,40,2.88653824664236,4.7038941282775,8.31466017382616,101,"ENSG00000079974.19"
"45868","ENSG00000286003.1_15425",15417,15425,9,"ENSG00000286003.1",1,2,"VMVVVVVVV",0,8,0.884057971014493,111,117,133,136,171,177,196,199,"ATGATAA","GTGA","ATGATTA","CTGA",2.65192973269995,16,35,19,79,1.43308697452202,4.77815463146376,8.31438651552173,101,"ENSG00000079974.19"
"32324","ENSG00000226742.4_791",783,791,9,"ENSG00000226742.4",0,NA,"VVVVVUVVV",1,8,0.922153209109731,49,55,69,72,79,85,133,136,"ATGAGGA","CTGA","GTGTTGG","CTGG",2.4800334142364,14,7,48,78,1.96772129403731,4.62531934723665,8.31393218367558,101,"ENSG00000079974.19"
"28363","ENSG00000188859.7_99206",99198,99206,9,"ENSG00000188859.7",1,7,"VVVVVVMVV",0,8,0.885300207039338,114,120,133,136,144,150,196,199,"CTTATGA","CTGT","GTGATTA","CTGA",2.56526857707214,13,8,46,76,1.98818609070155,4.77249415112896,8.31369497928631,101,"ENSG00000079974.19"
"43209","ENSG00000270025.2_2560",2552,2560,9,"ENSG00000270025.2",0,NA,"VVVVVVVVV",0,9,1,101,107,133,136,170,176,186,189,"ATTTTCA","CAGA","ATGATGA","CTGA",2.41456088561846,26,34,10,79,1.15770555453909,4.3136945313322,8.3136945313322,101,"ENSG00000079974.19"
"47737","ENSG00000289143.1_83012",83004,83012,9,"ENSG00000289143.1",0,NA,"VVVVVVVVV",0,9,1,101,107,133,136,170,176,186,189,"ATTTTCA","CAGA","ATGATGA","CTGA",2.41456088561846,26,34,10,79,1.15770555453909,4.3136945313322,8.3136945313322,101,"ENSG00000079974.19"
"47829","ENSG00000289444.1_82993",82985,82993,9,"ENSG00000289444.1",0,NA,"VVVVVVVVV",0,9,1,101,107,133,136,170,176,186,189,"ATTTTCA","CAGA","ATGATGA","CTGA",2.41456088561846,26,34,10,79,1.15770555453909,4.3136945313322,8.3136945313322,101,"ENSG00000079974.19"
"25647","ENSG00000182348.7_247948",247940,247948,9,"ENSG00000182348.7",0,NA,"VVVVVVVVV",0,9,1,89,95,133,136,141,147,155,158,"ATGATTA","TTGA","TTTATAA","CTGT",2.30086799173157,38,5,8,60,1.91455311008119,4.31341826373958,8.31341826373958,101,"ENSG00000079974.19"
"47190","ENSG00000287795.1_58282",58274,58282,9,"ENSG00000287795.1",1,2,"VMVVVVVVV",0,8,0.884057971014493,103,109,133,136,147,153,168,171,"GTGATGA","ATGT","ATGAGGG","CTGA",2.58560716638815,24,11,15,59,1.87017893974065,4.77689001224875,8.31312189630672,101,"ENSG00000079974.19"
"17345","ENSG00000153936.18_19122",19114,19122,9,"ENSG00000153936.18",1,1,"MVVVVVVVV",0,8,0.90600414078675,97,103,111,114,116,122,133,136,"TTGATAA","GTGA","ATAAGGG","CTGA",2.42094473393973,8,2,11,30,2.6154655359637,4.68877427389047,8.31279083703747,101,"ENSG00000079974.19"
"12872","ENSG00000139287.13_42191",42183,42191,9,"ENSG00000139287.13",0,NA,"UVVVVVVVV",1,8,0.902691511387163,110,116,133,136,143,149,160,163,"ATAATTA","CTGG","CAGAGGA","CTGA",2.40866786923067,17,7,11,44,2.74945851448307,4.70181107733855,8.31257712288721,101,"ENSG00000079974.19"
"20410","ENSG00000164796.18_588167",588159,588167,9,"ENSG00000164796.18",1,7,"VVVVVVMVV",0,8,0.885300207039338,116,122,133,136,143,149,163,166,"AACCTGA","CTGA","GTGCAGA","CTGA",2.43191506608938,11,7,14,41,2.87032262606336,4.77077243333147,8.31197326148882,101,"ENSG00000079974.19"
"2173","ENSG00000070950.10_124070",124062,124070,9,"ENSG00000070950.10",0,NA,"VVVVVVVVV",0,9,1,77,83,96,99,106,112,133,136,"ATGATGG","CTGA","TTAAAGA","TTCA",2.21865599531884,13,7,21,50,2.45668090810329,4.31193021922389,8.31193021922389,101,"ENSG00000079974.19"
"2411","ENSG00000074416.16_142285",142277,142285,9,"ENSG00000074416.16",0,NA,"VVVVVVVVV",0,9,1,82,88,133,136,140,146,181,184,"AGGAGGA","CTAG","GTGATGA","CTGA",2.45298021609581,45,4,35,93,0.891102657012584,4.31107602441283,8.31107602441283,101,"ENSG00000079974.19"
"30526","ENSG00000205581.11_6151",6143,6151,9,"ENSG00000205581.11",0,NA,"VVVVVVVVV",0,9,1,116,122,133,136,176,182,194,197,"ATCATCA","CAAA","TTGTTTA","CTGA",2.29527937221542,11,40,12,72,1.94023592629172,4.31052460193197,8.31052460193197,101,"ENSG00000079974.19"
"21389","ENSG00000167346.9_203639",203631,203639,9,"ENSG00000167346.9",0,NA,"VVVVVVUVV",1,8,0.886128364389234,114,120,133,136,149,155,170,173,"ATGATGG","ATGT","ATAATAA","CTGA",2.48339155098446,13,13,15,50,2.50763308041529,4.76589418841126,8.3104076459682,101,"ENSG00000079974.19"
"24555","ENSG00000176895.9_4640",4632,4640,9,"ENSG00000176895.9",0,NA,"VVVVVVUVV",1,8,0.886128364389234,114,120,133,136,149,155,170,173,"ATGATGG","ATGT","ATAATAA","CTGA",2.48339155098446,13,13,15,50,2.50763308041529,4.76589418841126,8.3104076459682,101,"ENSG00000079974.19"
"35840","ENSG00000237352.6_301125",301117,301125,9,"ENSG00000237352.6",0,NA,"UVVVVVVVV",1,8,0.902691511387163,72,78,90,93,115,121,133,136,"ATGTTCA","CTGA","TTCATCA","CTGA",2.49550582692784,12,22,12,55,2.16177493874004,4.69962011289808,8.31038615844674,101,"ENSG00000079974.19"
"10437","ENSG00000131023.13_56416",56408,56416,9,"ENSG00000131023.13",1,1,"MVUVVVVVV",1,7,0.789648033126294,113,119,133,136,142,148,158,161,"ATGAGGA","CTGA","GAGGTGT","CTGA",2.64219557639856,14,6,10,39,2.9924830300038,5.15178005149855,8.31037218400372,101,"ENSG00000079974.19"
"7439","ENSG00000114268.12_2409",2401,2409,9,"ENSG00000114268.12",1,8,"VVVVVVVMV",0,8,0.884057971014493,116,122,133,136,143,149,163,166,"CTGAGGA","ATGA","GAGATTC","CTGA",2.43373486094049,11,7,14,41,2.87032262606336,4.77380542474999,8.31003730880797,101,"ENSG00000079974.19"
"13690","ENSG00000143183.18_54818",54810,54818,9,"ENSG00000143183.18",1,1,"MVVVVVVVV",0,8,0.90600414078675,79,85,112,115,116,122,133,136,"ATGATGA","CTGA","AAGATGT","ATGA",2.59917953667954,27,1,11,48,1.41597389401283,4.6859593679691,8.3099759311161,101,"ENSG00000079974.19"
"11842","ENSG00000136167.15_82506",82498,82506,9,"ENSG00000136167.15",0,NA,"VVVVVVVVV",0,9,1,106,112,133,136,143,149,158,161,"ATGAAGA","TTCA","ATGTTCA","GTGA",2.22399268058756,21,7,9,46,2.41253869010613,4.30978914017247,8.30978914017247,101,"ENSG00000079974.19"
"923","ENSG00000040731.10_30386",30378,30386,9,"ENSG00000040731.10",0,NA,"VVUVVVVVV",1,8,0.883643892339545,113,119,133,136,148,154,164,167,"ATGAGAA","GTGA","ATGGAGA","CTGA",2.45459828207149,14,12,10,45,2.73574944135421,4.77493449712436,8.30951006648254,101,"ENSG00000079974.19"
"14568","ENSG00000145375.9_385982",385974,385982,9,"ENSG00000145375.9",0,NA,"VVVVVVVVV",0,9,1,108,114,133,136,142,148,162,165,"ATGGGGA","ATGC","AGCAAGA","CTGA",2.22051176073782,19,6,14,48,2.43383939366063,4.3093127829782,8.3093127829782,101,"ENSG00000079974.19"
"14743","ENSG00000145808.10_244313",244305,244313,9,"ENSG00000145808.10",1,6,"VVVVVMVVV",0,8,0.902691511387163,81,87,99,102,110,116,133,136,"ATCATGA","CTGT","ATGAAGA","CTTA",2.41572850178665,12,8,17,46,2.68852378018518,4.69834511469072,8.30911116023938,101,"ENSG00000079974.19"
"44200","ENSG00000279472.1_2817",2809,2817,9,"ENSG00000279472.1",1,3,"VVMVVVVVV",0,8,0.882815734989648,111,117,133,136,143,149,161,164,"AAAATGT","CAGA","GTGAAGA","CTGA",2.44596943336875,16,7,12,44,2.80464300286273,4.77777647299693,8.30903941295552,101,"ENSG00000079974.19"
"32058","ENSG00000225742.6_8430",8422,8430,9,"ENSG00000225742.6",1,8,"VVVVVVVMV",0,8,0.884057971014493,80,86,99,102,110,116,133,136,"ATGGTGA","TTGC","CTGATCT","CTGA",2.46109036574846,13,8,17,47,2.68264508947955,4.77247854861732,8.30871043267529,101,"ENSG00000079974.19"
"38514","ENSG00000250349.3_1198001",1197993,1198001,9,"ENSG00000250349.3",0,NA,"VVVVVVVVV",0,9,1,93,99,133,136,179,185,199,202,"ATGATGG","GTGG","GGGAAGC","CTGA",2.45198404836294,34,43,14,100,0.887552794892776,4.3085282793281,8.3085282793281,101,"ENSG00000079974.19"
"6582","ENSG00000110841.14_25870",25862,25870,9,"ENSG00000110841.14",1,1,"MVVVVUVVV",1,7,0.82815734989648,109,115,133,136,150,156,164,167,"GTGATGA","CAGA","GTGCACA","CTGA",2.65691304282153,18,14,8,49,2.27050048107152,4.99581352497043,8.30844292455635,101,"ENSG00000079974.19"
"13736","ENSG00000143341.12_131896",131888,131896,9,"ENSG00000143341.12",1,2,"VMVVVVVVV",0,8,0.884057971014493,94,100,133,136,150,156,167,170,"CTGATGA","ATGA","ATGTAGT","CTGA",2.61924198724464,33,14,11,67,1.62547757780939,4.77177270652674,8.30800459058471,101,"ENSG00000079974.19"
"29254","ENSG00000197563.11_79153",79145,79153,9,"ENSG00000197563.11",0,NA,"UVVVVVVVV",1,8,0.902691511387163,113,119,133,136,153,159,172,175,"GTGATGA","CTCA","TTGATGG","TTGA",2.47126513321203,14,17,13,53,2.31130807312388,4.69660224030102,8.30736828584967,101,"ENSG00000079974.19"
"38031","ENSG00000249378.8_254690",254682,254690,9,"ENSG00000249378.8",1,1,"MVVVVVVVV",0,8,0.90600414078675,69,75,84,87,93,99,133,136,"AGGATTA","CTGA","TTTAGGA","CTGA",2.52735663945526,9,6,34,58,1.88360555952573,4.6831624556402,8.3071790187872,101,"ENSG00000079974.19"
"48123","ENSG00000290474.1_28820",28812,28820,9,"ENSG00000290474.1",1,6,"VVVVVMVVV",0,8,0.902691511387163,115,121,133,136,141,147,161,164,"GAGATGA","CGGC","TTGACGC","CTGA",2.39207546006971,12,5,14,40,2.83609251362198,4.69581556185502,8.30658160740367,101,"ENSG00000079974.19"
"18713","ENSG00000158258.16_85618",85610,85618,9,"ENSG00000158258.16",1,2,"VMVVVVVVV",0,8,0.884057971014493,111,117,133,136,144,150,162,165,"GTAATGG","CTGT","GTGAATA","CTGA",2.44358198663555,16,8,12,45,2.7886146674117,4.76979031124551,8.30602219530348,101,"ENSG00000079974.19"
"9208","ENSG00000123106.11_329621",329613,329621,9,"ENSG00000123106.11",0,NA,"VVVVVUVVV",1,8,0.922153209109731,115,121,133,136,161,167,176,179,"ATTGTGA","TGGA","ATGATGA","CTGA",2.45201154509665,12,25,9,55,2.12271442538346,4.61736451484029,8.30597735127921,101,"ENSG00000079974.19"
"30044","ENSG00000198963.11_36068",36060,36068,9,"ENSG00000198963.11",1,3,"UVMVVVVVV",1,7,0.785507246376811,93,99,111,114,116,122,133,136,"ATGATGA","TTGA","ATGTTCT","CTGA",2.69638885600244,12,2,11,34,2.67787429758514,5.16345000106701,8.30547898657426,101,"ENSG00000079974.19"
"30474","ENSG00000205133.12_119111",119103,119111,9,"ENSG00000205133.12",1,2,"VMVVVVVVV",0,8,0.884057971014493,71,77,112,115,116,122,133,136,"GTGATGA","TTGA","GTGGAAA","CTGA",2.66343565977516,35,1,11,56,1.32010061212256,4.76908458598923,8.3053164700472,101,"ENSG00000079974.19"
"17215","ENSG00000153707.19_13165",13157,13165,9,"ENSG00000153707.19",1,2,"VMUVVVVVV",1,7,0.767701863354037,72,78,88,91,96,102,133,136,"ATGATGA","CTGA","TTGGGGA","CTGA",2.84670608108108,10,5,31,55,1.9579643174124,5.23400121448823,8.30480866790438,101,"ENSG00000079974.19"
"34811","ENSG00000234184.8_38037",38029,38037,9,"ENSG00000234184.8",1,8,"VVVVVVVMV",0,8,0.884057971014493,69,75,91,94,107,113,133,136,"ATGATGA","TTGA","CTGATAA","CTGG",2.55365236951595,16,13,20,58,2.04843236704443,4.76819537428769,8.30442725834566,101,"ENSG00000079974.19"
"39966","ENSG00000254532.2_54934",54926,54934,9,"ENSG00000254532.2",0,NA,"VVVVVVVVV",0,9,1,94,100,133,136,172,178,195,198,"AGGAGGA","TTGA","ATGCAGA","CTGA",2.47291222570241,33,36,17,95,0.730985262692525,4.30426669184382,8.30426669184381,101,"ENSG00000079974.19"
"42113","ENSG00000260776.7_93",85,93,9,"ENSG00000260776.7",0,NA,"VVVVVVVVV",0,9,1,73,79,95,98,104,110,137,140,"GTCAAGA","AAGA","GTCATGG","CTGA",2.27856185644089,16,6,27,58,2.02524931712103,4.3039154233484,8.3039154233484,101,"ENSG00000079974.19"
"48221","ENSG00000290665.1_114",106,114,9,"ENSG00000290665.1",0,NA,"VVVVVVVVV",0,9,1,94,100,116,119,125,131,158,161,"GTCAAGA","AAGA","GTCATGG","CTGA",2.27856185644089,16,6,27,58,2.02524931712103,4.3039154233484,8.3039154233484,101,"ENSG00000079974.19"
"38875","ENSG00000251201.8_22294",22286,22294,9,"ENSG00000251201.8",0,NA,"VVVVVVUVV",1,8,0.886128364389234,61,67,93,96,113,119,133,136,"GTGATGA","CTGT","GTGGGAA","CTGA",2.64065803233545,26,17,14,66,1.43306795974382,4.75936371049504,8.30387716805198,101,"ENSG00000079974.19"
"30133","ENSG00000203739.6_36288",36280,36288,9,"ENSG00000203739.6",1,6,"VVVVVMVVV",0,8,0.902691511387163,114,120,133,136,149,155,164,167,"AAGGTGC","TTGA","GTGATGT","CTGA",2.41117218202429,13,13,9,44,2.69709426529491,4.69289386969755,8.3036599152462,101,"ENSG00000079974.19"
"15642","ENSG00000148948.8_782799",782791,782799,9,"ENSG00000148948.8",0,NA,"VVVVVVVVV",0,9,1,97,103,133,136,137,143,155,158,"ATGATCA","CTTT","GTCTTGC","CTGA",2.38287390392624,30,1,12,52,1.32760887487052,4.30335872526136,8.30335872526136,101,"ENSG00000079974.19"
"9001","ENSG00000121989.15_18758",18750,18758,9,"ENSG00000121989.15",1,2,"UMVVVVVVV",1,7,0.786749482401656,115,121,133,136,155,161,181,184,"ATGATGT","CTGA","ATGATGG","CTGA",2.81784562217475,12,19,20,60,1.83927936949645,5.15622921266536,8.30322714227199,101,"ENSG00000079974.19"
"9986","ENSG00000128655.19_333701",333693,333701,9,"ENSG00000128655.19",1,6,"VVVVVMVVV",0,8,0.902691511387163,115,121,133,136,145,151,164,167,"ACGATGG","ATGA","GGCATCA","CTGA",2.38286368277574,12,9,13,43,2.88224643401867,4.69200107979756,8.30276712534621,101,"ENSG00000079974.19"
"47712","ENSG00000289084.1_687052",687044,687052,9,"ENSG00000289084.1",0,NA,"VVVVVVVVV",0,9,1,92,98,133,136,148,154,183,186,"ATTATGA","CCTA","TTGATTC","CTGA",2.44312283344284,35,12,29,85,0.923493133538284,4.30274467245596,8.30274467245597,101,"ENSG00000079974.19"
"31312","ENSG00000222042.2_58018",58010,58018,9,"ENSG00000222042.2",0,NA,"VVVVVVVVV",0,9,1,106,112,133,136,138,144,153,156,"GTGATAA","CTTA","GTGTTAA","CCGA",2.28765708733017,21,2,9,41,1.95783211577235,4.30221984116003,8.30221984116003,101,"ENSG00000079974.19"
"17035","ENSG00000153002.12_37475",37467,37475,9,"ENSG00000153002.12",0,NA,"VVVVVVVVV",0,9,1,100,106,133,136,140,146,171,174,"ATGACGT","ATGA","ATTTTCA","CTGA",2.39907250804419,27,4,25,65,1.21345746181161,4.30181854552656,8.30181854552656,101,"ENSG00000079974.19"
"5499","ENSG00000105329.11_40743",40735,40743,9,"ENSG00000105329.11",1,8,"VVVVVVVMV",0,8,0.884057971014493,104,110,133,136,146,152,160,163,"GGGATGA","CTGC","GGGAGGA","CTGA",2.53640318010022,23,10,8,50,2.15213591951001,4.76537261337787,8.30160449743584,101,"ENSG00000079974.19"
"2240","ENSG00000072133.12_72187",72179,72187,9,"ENSG00000072133.12",1,1,"MVVVVVVVV",0,8,0.90600414078675,102,108,133,136,159,165,183,186,"ATGATGA","AAGA","TGGATGA","CTGA",2.65930861634476,25,23,18,75,0.980945499587904,4.67741740213823,8.30143396528523,101,"ENSG00000079974.19"
"24659","ENSG00000177338.14_52216",52208,52216,9,"ENSG00000177338.14",1,6,"VVVVVMVVV",0,8,0.902691511387163,106,112,133,136,142,148,160,163,"TTGATGA","CACA","GTCACGT","CTGA",2.46131988826071,21,6,12,48,2.35350933762834,4.69057714817493,8.30134319372359,101,"ENSG00000079974.19"
"11053","ENSG00000133789.15_25211",25203,25211,9,"ENSG00000133789.15",1,3,"VVMVVVVVV",0,8,0.882815734989648,111,117,133,136,145,151,160,163,"ATGATGG","CAAA","ATGGCAA","CTGA",2.44203707072197,16,9,9,43,2.79948611067674,4.76993331220581,8.3011962521644,101,"ENSG00000079974.19"
"34193","ENSG00000232077.2_49371",49363,49371,9,"ENSG00000232077.2",0,NA,"VVVUVVVVV",1,8,0.880745341614907,114,120,133,136,146,152,160,163,"CTATTGA","CTGA","TAGAAGA","CTGA",2.43080105952812,13,10,8,40,2.90710278039866,4.7781107943132,8.30109216077283,101,"ENSG00000079974.19"
"9827","ENSG00000127603.32_254011",254003,254011,9,"ENSG00000127603.32",1,8,"VVVVVVVMV",0,8,0.884057971014493,113,119,133,136,174,180,188,191,"ATGAAGA","GTGA","CTCATGT","CTGA",2.56550898988586,14,38,8,69,1.95506602006239,4.76461482149204,8.30084670555001,101,"ENSG00000079974.19"
"40233","ENSG00000255300.6_140404",140396,140404,9,"ENSG00000255300.6",1,1,"MVVVVVVVV",0,8,0.90600414078675,111,117,133,136,169,175,191,194,"AGGATGT","CTGC","GTGTTGA","CTGA",2.56203307958333,16,33,16,74,1.62560297358941,4.67645587603623,8.30047243918323,101,"ENSG00000079974.19"
"9860","ENSG00000127928.13_41553",41545,41553,9,"ENSG00000127928.13",1,8,"VVVVVVVMV",0,8,0.884057971014493,106,112,133,136,158,164,181,184,"ATGATGA","TTAA","ATAATGA","CTGA",2.66185349930657,21,22,17,69,1.31095032400772,4.76416007984621,8.30039196390418,101,"ENSG00000079974.19"
"21004","ENSG00000166220.14_3291",3283,3291,9,"ENSG00000166220.14",1,5,"VVVVMVVVV",0,8,0.886542443064182,73,79,92,95,107,113,133,136,"GTGGTGA","CAGA","CTCAGGA","CTGA",2.51065691548742,13,12,20,54,2.27795983930753,4.75391815230592,8.30008792456265,101,"ENSG00000079974.19"
"32308","ENSG00000226688.9_266512",266504,266512,9,"ENSG00000226688.9",1,1,"MVVVVVVVV",0,8,0.90600414078675,115,121,133,136,147,153,161,164,"ATAATGA","CAGA","GTGATTC","ATGA",2.37789867679455,12,11,8,40,2.84852128879153,4.67529478352213,8.29931134666913,101,"ENSG00000079974.19"
"39460","ENSG00000253627.1_24214",24206,24214,9,"ENSG00000253627.1",1,3,"VVMVVVVVV",0,8,0.882815734989648,33,39,53,56,73,79,133,136,"GTGATGA","CTGG","GTGTAGG","CTGA",2.65185657443199,14,17,54,94,1.39298717736796,4.76800775172864,8.29927069168723,101,"ENSG00000079974.19"
"47384","ENSG00000288067.1_94254",94246,94254,9,"ENSG00000288067.1",1,3,"VVMVVVVVV",0,8,0.882815734989648,33,39,53,56,73,79,133,136,"GTGATGA","CTGG","GTGTAGG","CTGA",2.65185657443199,14,17,54,94,1.39298717736796,4.76800775172864,8.29927069168723,101,"ENSG00000079974.19"
"13764","ENSG00000143374.18_6451",6443,6451,9,"ENSG00000143374.18",1,8,"VVVVVVVMV",0,8,0.884057971014493,80,86,103,106,116,122,133,136,"GGGATGA","GGGA","GTGTAGA","CTGA",2.46145835887098,17,10,11,47,2.64175466940634,4.76286926546988,8.29910114952785,101,"ENSG00000079974.19"
"2944","ENSG00000079691.19_110587",110579,110587,9,"ENSG00000079691.19",1,8,"VVVVVVVMV",0,8,0.884057971014493,88,94,104,107,116,122,133,136,"ATGATGC","TTGA","GTGAAAA","ATGA",2.42206803982382,10,9,11,39,2.90046542025052,4.76189642143567,8.29812830549364,101,"ENSG00000079974.19"
"1716","ENSG00000065559.15_4326",4318,4326,9,"ENSG00000065559.15",0,NA,"VVVUVVVVV",1,8,0.880745341614907,113,119,133,136,173,179,189,192,"ATGTTGA","CTGG","CTGCTGT","CTGA",2.56825899484817,14,37,10,70,1.97731387071046,4.7747601257579,8.29774149221753,101,"ENSG00000079974.19"
"10734","ENSG00000132561.14_132072",132064,132072,9,"ENSG00000132561.14",1,1,"MVVVVUVVV",1,7,0.82815734989648,95,101,133,136,157,163,179,182,"GTGATGA","CTGA","AAGATGA","CTGA",2.83782383079975,32,21,16,78,1.02033446860515,4.98479000181753,8.29741940140346,101,"ENSG00000079974.19"
"24194","ENSG00000175497.17_1015684",1015676,1015684,9,"ENSG00000175497.17",1,1,"MVVVVVVVV",0,8,0.90600414078675,113,119,133,136,153,159,167,170,"ATGATTA","CAAA","AAGATGG","CTGA",2.44785297175003,14,17,8,48,2.37401264494624,4.67325811415328,8.29727467730028,101,"ENSG00000079974.19"
"24084","ENSG00000175110.14_128755",128747,128755,9,"ENSG00000175110.14",0,NA,"VVUVVVVVV",1,8,0.883643892339545,87,93,101,104,109,115,133,136,"CTGTTGA","CTCA","GTGAGAA","CTGA",2.5078158604881,8,5,18,40,2.33176512924332,4.76263438312433,8.29720995248251,101,"ENSG00000079974.19"
"24736","ENSG00000177694.16_543157",543149,543157,9,"ENSG00000177694.16",0,NA,"UVVVVVVVV",1,8,0.902691511387163,70,76,89,92,95,101,133,136,"ATGATAA","ATGA","ATGACTT","CTGA",2.54335334498558,13,3,32,57,1.78685041889095,4.68563484636537,8.29640089191403,101,"ENSG00000079974.19"
"39417","ENSG00000253554.7_80273",80265,80273,9,"ENSG00000253554.7",1,1,"MVVVVVVVV",0,8,0.90600414078675,110,116,133,136,141,147,161,164,"ATGCTAC","ATGA","TTGATGA","CTGA",2.41872825677104,17,5,14,45,2.56383636382487,4.67217285224129,8.29618941538829,101,"ENSG00000079974.19"
"21101","ENSG00000166439.6_14956",14948,14956,9,"ENSG00000166439.6",0,NA,"UVVVVVVVV",1,8,0.902691511387163,87,93,103,106,116,122,133,136,"TTGAAGA","TTGA","AGAATTA","CTGA",2.38574881184748,10,10,11,40,2.83641310309011,4.68535129551833,8.29611734106699,101,"ENSG00000079974.19"
"9966","ENSG00000128585.18_349029",349021,349029,9,"ENSG00000128585.18",0,NA,"VVUVVVVVV",1,8,0.883643892339545,115,121,133,136,138,144,152,155,"ATGATTG","ATGA","TTAATGC","CTGA",2.4342280874945,12,2,8,31,2.81723734531405,4.76135614881934,8.29593171817752,101,"ENSG00000079974.19"
"37087","ENSG00000245248.9_282774",282766,282774,9,"ENSG00000245248.9",1,2,"VMVVVVVVV",0,8,0.884057971014493,108,114,133,136,181,187,197,200,"AAGATGA","GTGA","GTGGTGT","CTGA",2.61830181446768,19,45,10,83,1.57943766436715,4.75869577353792,8.29492765759589,101,"ENSG00000079974.19"
"19605","ENSG00000163453.11_9108",9100,9108,9,"ENSG00000163453.11",0,NA,"VVVUVVVVV",1,8,0.880745341614907,82,88,104,107,109,115,133,136,"GTGTTGA","ATGA","ATGAAGT","CTGA",2.56233705390622,16,2,18,45,2.00521388732689,4.77186522834208,8.29484659480171,101,"ENSG00000079974.19"
"40649","ENSG00000257261.7_258554",258546,258554,9,"ENSG00000257261.7",1,7,"VVVVVVMVV",0,8,0.885300207039338,84,90,133,136,146,152,163,166,"ATGAAGA","CTCA","GTATTGA","CTGA",2.56932076473956,43,10,11,73,1.88445812988569,4.75331580703736,8.29451663519471,101,"ENSG00000079974.19"
"43563","ENSG00000272369.1_104485",104477,104485,9,"ENSG00000272369.1",1,7,"VVVVVVMVV",0,8,0.885300207039338,84,90,133,136,146,152,163,166,"ATGAAGA","CTCA","GTATTGA","CTGA",2.56932076473956,43,10,11,73,1.88445812988569,4.75331580703736,8.29451663519471,101,"ENSG00000079974.19"
"5920","ENSG00000107249.24_312296",312288,312296,9,"ENSG00000107249.24",0,NA,"VVVVVVUVV",1,8,0.886128364389234,110,116,133,136,144,150,187,190,"ATGGTAA","CTGA","AAGATGA","CTGA",2.58306024576093,17,8,37,71,1.77820119257838,4.74965070774615,8.29416416530309,101,"ENSG00000079974.19"
"47741","ENSG00000289156.2_22484",22476,22484,9,"ENSG00000289156.2",1,8,"VVVVVVVMV",0,8,0.884057971014493,61,67,81,84,90,96,133,136,"TTGATGG","CTAA","TTGATGG","CTGA",2.55665880588591,14,6,37,66,1.98425544025076,4.75716186987254,8.29339375393051,101,"ENSG00000079974.19"
"10758","ENSG00000132694.19_36918",36910,36918,9,"ENSG00000132694.19",0,NA,"VVVVUVVVV",1,8,0.889855072463768,94,100,133,136,145,151,166,169,"AAGGTGA","CTGA","ATGAAGG","CTGA",2.57265867888001,33,9,15,66,1.78457505968507,4.73390822972128,8.29332851957635,101,"ENSG00000079974.19"
"13582","ENSG00000142230.13_52528",52520,52528,9,"ENSG00000142230.13",0,NA,"VVVVUVVVV",1,8,0.889855072463768,82,88,95,98,109,115,133,136,"GTTATGA","TTGA","TTGTTAA","CTGA",2.5269150199575,7,11,18,45,2.08892824479416,4.73375709446104,8.29317738431611,101,"ENSG00000079974.19"
"33023","ENSG00000228560.1_48572",48564,48572,9,"ENSG00000228560.1",1,2,"VMVVVVVVV",0,8,0.884057971014493,93,99,106,109,115,121,133,136,"AAGATTA","CTAA","ATGAAAA","CTGA",2.44607383621263,7,6,12,34,2.7203245076012,4.75687085392136,8.29310273797933,101,"ENSG00000079974.19"
"24354","ENSG00000175967.4_3217",3209,3217,9,"ENSG00000175967.4",1,1,"MVVVVVVVV",0,8,0.90600414078675,112,118,133,136,141,147,158,161,"GTGAGAA","CTGC","ATGTTAA","CTGA",2.37240490385997,15,5,11,40,2.85983504323997,4.66896693390994,8.29298349705694,101,"ENSG00000079974.19"
"40945","ENSG00000258162.4_150292",150284,150292,9,"ENSG00000258162.4",1,3,"VVMVVVVVV",0,8,0.882815734989648,115,121,133,136,162,168,181,184,"ATGATTA","CAGA","GTAAAGT","CTGA",2.55333427439185,12,26,13,60,2.02358452965431,4.76145325639999,8.29271619635858,101,"ENSG00000079974.19"
"14118","ENSG00000144451.20_607925",607917,607925,9,"ENSG00000144451.20",1,2,"VMVVVVVVV",0,8,0.884057971014493,109,115,133,136,150,156,181,184,"GTGATGA","GTGA","ATAAAAA","CTGA",2.61938989310736,18,14,25,66,1.56219494209807,4.75619855737012,8.29243044142809,101,"ENSG00000079974.19"
"2749","ENSG00000078053.17_9588",9580,9588,9,"ENSG00000078053.17",1,6,"VVVVVMVVV",0,8,0.902691511387163,115,121,133,136,167,173,196,199,"ATGATGT","ATGG","GTGATAA","CTGA",2.59878695931915,12,31,23,75,1.40132670308882,4.68164327463746,8.29240932018612,101,"ENSG00000079974.19"
"39264","ENSG00000253390.1_3636",3628,3636,9,"ENSG00000253390.1",0,NA,"UVVVVVVVV",1,8,0.902691511387163,110,116,133,136,140,146,154,157,"AGGATGA","CCAA","GGGAGGC","CTGA",2.41373321561986,17,4,8,38,2.63273535038935,4.6810725302971,8.29183857584575,101,"ENSG00000079974.19"
"40846","ENSG00000257943.2_120216",120208,120216,9,"ENSG00000257943.2",1,2,"VMVVVVVVV",0,8,0.884057971014493,65,71,80,83,114,120,133,136,"GGGATGA","TTGA","GTGAATA","CTGA",2.58365872334684,9,31,13,62,1.79781273540792,4.75555105609672,8.29178294015469,101,"ENSG00000079974.19"
"13735","ENSG00000143340.7_9500",9492,9500,9,"ENSG00000143340.7",1,6,"VVVVVMVVV",0,8,0.902691511387163,114,120,133,136,143,149,160,163,"GTTATCA","ATAA","GTGAAGA","CTGA",2.35595262513192,13,7,11,40,3.01450882069823,4.68021491372775,8.29098095927641,101,"ENSG00000079974.19"
"2829","ENSG00000078328.23_2297808",2297800,2297808,9,"ENSG00000078328.23",1,1,"MVVVVVVVV",0,8,0.90600414078675,112,118,133,136,147,153,161,164,"GTGAAGA","CTAC","GAGATGC","CTGA",2.38923633605956,15,11,8,43,2.73711088358685,4.66633828099598,8.29035484414297,101,"ENSG00000079974.19"
"24430","ENSG00000176261.16_34890",34882,34890,9,"ENSG00000176261.16",0,NA,"VVVVUVVVV",1,8,0.889855072463768,49,55,83,86,99,105,133,136,"ATCATGA","CTGA","TTGGGGA","CTGA",2.69638850874516,28,13,28,78,0.946692279406897,4.73065391776032,8.2900742076154,101,"ENSG00000079974.19"
"25319","ENSG00000180801.14_11779",11771,11779,9,"ENSG00000180801.14",0,NA,"VVVVVVUVV",1,8,0.886128364389234,110,116,133,136,158,164,176,179,"ATAATTA","CTGA","ATGTTAA","CTGA",2.55958444992275,17,22,12,60,1.91655515621592,4.74511287225857,8.2896263298155,101,"ENSG00000079974.19"
"2674","ENSG00000077254.14_36883",36875,36883,9,"ENSG00000077254.14",1,6,"VVVVVMVVV",0,8,0.902691511387163,82,88,99,102,107,113,133,136,"CTGATGA","CTGG","CTGTTGA","GTGA",2.44280798099406,11,5,20,45,2.42869259692044,4.67851978422022,8.28928582976887,101,"ENSG00000079974.19"
"33075","ENSG00000228624.8_418298",418290,418298,9,"ENSG00000228624.8",0,NA,"VVVVUVVVV",1,8,0.889855072463768,115,121,133,136,141,147,158,161,"TTGATGA","ATGA","TTGAGTA","CTGT",2.3882522627056,12,5,11,37,2.99624312688554,4.72948121956405,8.28890150941912,101,"ENSG00000079974.19"
"33838","ENSG00000231298.8_30797",30789,30797,9,"ENSG00000231298.8",1,1,"MVVVVVVVV",0,8,0.90600414078675,113,119,133,136,144,150,181,184,"ATGATCA","CACA","CAGATGA","CTGA",2.49017230057069,14,8,31,62,2.05767587086548,4.66470613533419,8.28872269848119,101,"ENSG00000079974.19"
"22784","ENSG00000171435.14_191473",191465,191473,9,"ENSG00000171435.14",1,2,"VMVVVVVVV",0,8,0.884057971014493,113,119,133,136,142,148,158,161,"TTGCAGA","TTGA","CTGATGT","CTGA",2.40236056297758,14,6,10,39,2.9924830300038,4.75205502913025,8.28828691318822,101,"ENSG00000079974.19"
"34064","ENSG00000231871.5_34367",34359,34367,9,"ENSG00000231871.5",1,8,"VVVVVVVMV",0,8,0.884057971014493,112,118,133,136,153,159,174,177,"ATGAGGA","ATGA","GTAGTGG","CTGA",2.52802308882964,15,17,15,56,2.15470348981367,4.75204768716948,8.28827957122745,101,"ENSG00000079974.19"
"22079","ENSG00000169764.16_3604",3596,3604,9,"ENSG00000169764.16",1,6,"VVVVVMVVV",0,8,0.902691511387163,53,59,72,75,84,90,133,136,"GAGATGT","CTGC","GTGAGGA","CTGA",2.5127378422147,13,9,43,74,1.95736283036165,4.67723711128157,8.28800315683023,101,"ENSG00000079974.19"
"35897","ENSG00000237442.3_2871",2863,2871,9,"ENSG00000237442.3",0,NA,"UVUVVVVVV",2,7,0.786335403726708,59,65,101,104,116,122,133,136,"CTGATGA","CTGA","TTGAAGA","CTGA",2.82167460994869,36,12,11,68,1.75770862185804,5.14221817204566,8.28755978695249,101,"ENSG00000079974.19"
"22907","ENSG00000171723.16_257687",257679,257687,9,"ENSG00000171723.16",1,1,"MVVVVVVVV",0,8,0.90600414078675,109,115,133,136,147,153,171,174,"TTGATTA","CAGA","TTGATTG","CTGA",2.47733238373973,18,11,18,56,2.13751328424883,4.66326562729509,8.28728219044208,101,"ENSG00000079974.19"
"47561","ENSG00000288694.2_11148",11140,11148,9,"ENSG00000288694.2",1,3,"VVMVVVVVV",0,8,0.882815734989648,111,117,133,136,147,153,193,196,"GTTATGA","CTGA","ACAATGA","CTGA",2.59952954233344,16,11,40,76,1.69347201565225,4.75591724113546,8.28718018109406,101,"ENSG00000079974.19"
"2348","ENSG00000073711.11_107575",107567,107575,9,"ENSG00000073711.11",0,NA,"VVVVVVUVV",1,8,0.886128364389234,112,118,133,136,144,150,168,171,"ATGATTT","ATGA","TTGTTCA","CTGA",2.46536752130022,15,8,18,50,2.5329405623046,4.74218100940984,8.28669446696678,101,"ENSG00000079974.19"
"43258","ENSG00000270589.1_250",242,250,9,"ENSG00000270589.1",1,1,"MVVVVVVVV",0,8,0.90600414078675,75,81,98,101,114,120,133,136,"ACCATGA","CAGA","AAGAGGA","CTGA",2.44202391895878,17,13,13,52,2.36855676691428,4.66217905665988,8.28619561980688,101,"ENSG00000079974.19"
"18444","ENSG00000157423.18_230574",230566,230574,9,"ENSG00000157423.18",1,1,"MVVVVVVVV",0,8,0.90600414078675,114,120,133,136,151,157,195,198,"GTGATGT","CTCA","ATGTTCA","CTGA",2.56013512797365,13,15,38,75,1.57968934472229,4.66181421613666,8.28583077928366,101,"ENSG00000079974.19"
"44025","ENSG00000276975.4_163735",163727,163735,9,"ENSG00000276975.4",1,1,"MVVVVVVVV",0,8,0.90600414078675,114,120,133,136,151,157,195,198,"GTGATGT","CTCA","ATGTTCA","CTGA",2.56013512797365,13,15,38,75,1.57968934472229,4.66181421613666,8.28583077928366,101,"ENSG00000079974.19"
"22279","ENSG00000170153.11_257204",257196,257204,9,"ENSG00000170153.11",1,6,"VVVVVMVVV",0,8,0.902691511387163,83,89,102,105,114,120,133,136,"GTGAGGA","CTGA","TAGAAGA","CTCA",2.37387196511336,13,9,13,44,2.87402150436547,4.67495865128031,8.28572469682896,101,"ENSG00000079974.19"
"35226","ENSG00000235437.10_110041",110033,110041,9,"ENSG00000235437.10",1,1,"MVVVVVVVV",0,8,0.90600414078675,70,76,90,93,97,103,133,136,"TTGAAGA","ATGA","GAGAAGA","CTGA",2.50761990070856,14,4,30,57,1.92824628418445,4.66142807222705,8.28544463537404,101,"ENSG00000079974.19"
"9471","ENSG00000124788.19_263443",263435,263443,9,"ENSG00000124788.19",1,2,"VMUVVVVVV",1,7,0.767701863354037,66,72,80,83,93,99,133,136,"ATGATGA","CTGG","GTGATGA","CTGA",2.87484355444305,8,10,34,61,1.69286910557905,5.21462320046652,8.28543065388267,101,"ENSG00000079974.19"
"17180","ENSG00000153317.15_286272",286264,286272,9,"ENSG00000153317.15",0,NA,"UVVVVVVVV",1,8,0.902691511387163,91,97,133,136,144,150,172,175,"ATGATGA","GTCA","ATAATGG","CTGA",2.59439322379326,36,8,22,75,1.40034255324015,4.67407434463213,8.28484039018078,101,"ENSG00000079974.19"
"23885","ENSG00000174469.23_628431",628423,628431,9,"ENSG00000174469.23",1,1,"MVVVVUVVV",1,7,0.82815734989648,65,71,95,98,106,112,133,136,"GGGATGA","CTGA","GTGATTA","CTGA",2.73355365112819,24,8,21,62,1.66493088165658,4.97215547229447,8.28478487188039,101,"ENSG00000079974.19"
"22598","ENSG00000170927.15_301343",301335,301343,9,"ENSG00000170927.15",1,2,"VMVVVVVVV",0,8,0.884057971014493,115,121,133,136,143,149,157,160,"TTGAGGA","CTAG","GTGAGAA","CTGA",2.38665391052065,12,7,8,36,3.08286607336289,4.74847303587514,8.28470491993311,101,"ENSG00000079974.19"
"30682","ENSG00000206552.4_1071",1063,1071,9,"ENSG00000206552.4",1,7,"VVVVVUMVV",1,7,0.807453416149068,109,115,133,136,147,153,170,173,"ATGATGA","CTTA","GTGTGGC","CTGA",2.70278039694889,18,11,17,55,2.19909675386277,5.05440818338051,8.28422184797678,101,"ENSG00000079974.19"
"21983","ENSG00000169439.12_112268",112260,112268,9,"ENSG00000169439.12",0,NA,"VVVVUUVVV",2,7,0.812008281573499,114,120,133,136,144,150,160,163,"ATGAAGA","CTCA","AGGAAGA","CTGA",2.56932076473956,13,8,10,40,3.01535129197326,5.03603909755926,8.28407222385325,101,"ENSG00000079974.19"
"12810","ENSG00000139154.16_278918",278910,278918,9,"ENSG00000139154.16",0,NA,"UVVVVVVVV",1,8,0.902691511387163,114,120,133,136,160,166,174,177,"ATGGTGC","CAGA","ATGAATA","CTGA",2.48514354264033,13,24,8,54,2.12254368467378,4.672541825569,8.28330787111766,101,"ENSG00000079974.19"
"33309","ENSG00000229309.2_38766",38758,38766,9,"ENSG00000229309.2",1,8,"VVVVVVVMV",0,8,0.884057971014493,49,55,70,73,82,88,133,136,"GTGAGGA","CAGA","CTAATGA","CTGA",2.56768970030117,15,9,45,78,1.86741518847577,4.74633663095423,8.2825685150122,101,"ENSG00000079974.19"
"2756","ENSG00000078114.19_156519",156511,156519,9,"ENSG00000078114.19",1,1,"MVVVVVVVV",0,8,0.90600414078675,94,100,133,136,139,145,177,180,"GTGATGA","CTGG","ATGGTGG","CTGA",2.67381603389145,33,3,32,77,0.808186638530216,4.65840671611831,8.2824232792653,101,"ENSG00000079974.19"
"39755","ENSG00000254186.3_184992",184984,184992,9,"ENSG00000254186.3",1,8,"VVVVVVVMV",0,8,0.884057971014493,115,121,133,136,144,150,198,201,"GTTATGA","CTGG","ATGAGGT","CTGA",2.54911971839812,12,8,48,77,1.99061702741228,4.74618712084993,8.2824190049079,101,"ENSG00000079974.19"
"9245","ENSG00000123352.18_125023",125015,125023,9,"ENSG00000123352.18",0,NA,"VVVVVUVVV",1,8,0.922153209109731,51,57,94,97,103,109,133,136,"ATGATGA","CAGA","CTGATGT","CTCA",2.56091474290981,37,6,24,76,1.30192122463358,4.59367154434142,8.28228438078034,101,"ENSG00000079974.19"
"9215","ENSG00000123119.12_40171",40163,40171,9,"ENSG00000123119.12",1,6,"VVVVVMVVV",0,8,0.902691511387163,111,117,133,136,145,151,191,194,"ATGAAGA","AAGA","TTGATTA","CTGA",2.53151167905814,16,9,40,74,1.80894959203931,4.67142352977339,8.28218957532204,101,"ENSG00000079974.19"
"15558","ENSG00000148660.22_55314",55306,55314,9,"ENSG00000148660.22",0,NA,"VVVVVUVVV",1,8,0.922153209109731,111,117,133,136,141,147,164,167,"GGGATGA","CCCA","GTGCAGT","CTGA",2.38565942946598,16,5,17,47,2.46974404046818,4.59353505922701,8.28214789566594,101,"ENSG00000079974.19"
"27806","ENSG00000187391.22_52588",52580,52588,9,"ENSG00000187391.22",1,2,"VMVVVVVVV",0,8,0.884057971014493,110,116,133,136,153,159,169,172,"GTGAAGA","TTGA","ATAATAA","CTGA",2.52001372248854,17,17,10,53,2.18325510707939,4.74583664758408,8.28206853164205,101,"ENSG00000079974.19"
"31058","ENSG00000215386.15_670267",670259,670267,9,"ENSG00000215386.15",0,NA,"UVVVVVVVV",1,8,0.902691511387163,116,122,133,136,144,150,171,174,"ATGATGA","CTTA","TAGATGG","CCGA",2.43926688343538,11,8,21,49,2.42293942001396,4.67117966072912,8.28194570627777,101,"ENSG00000079974.19"
"15071","ENSG00000147003.7_36665",36657,36665,9,"ENSG00000147003.7",1,3,"VVMVVVVVV",0,8,0.882815734989648,116,122,133,136,183,189,202,205,"ATGATAA","ATGA","AGGATCA","CTGA",2.56573510174234,11,47,13,80,1.89561162410058,4.75012807559571,8.2813910155543,101,"ENSG00000079974.19"
"45457","ENSG00000285602.1_37261",37253,37261,9,"ENSG00000285602.1",1,3,"VVMVVVVVV",0,8,0.882815734989648,116,122,133,136,183,189,202,205,"ATGATAA","ATGA","AGGATCA","CTGA",2.56573510174234,11,47,13,80,1.89561162410058,4.75012807559571,8.2813910155543,101,"ENSG00000079974.19"
"5098","ENSG00000103056.12_71618",71610,71618,9,"ENSG00000103056.12",0,NA,"UVVVVUVVV",2,7,0.824844720496894,107,113,133,136,145,151,164,167,"ATGATCA","CTGA","GGGTTGC","CTGA",2.634860656793,20,9,13,51,2.36054269323156,4.98157010129622,8.28094898328379,101,"ENSG00000079974.19"
"344","ENSG00000009335.18_104789",104781,104789,9,"ENSG00000009335.18",0,NA,"VVVVVUVVV",1,8,0.922153209109731,115,121,133,136,172,178,191,194,"TTGATGG","CTCT","GTGTTGA","CTGA",2.46487917425177,12,36,13,70,1.9356397542498,4.59204189564873,8.28065473208765,101,"ENSG00000079974.19"
"38237","ENSG00000249816.8_134742",134734,134742,9,"ENSG00000249816.8",1,3,"VVMVVVVVV",0,8,0.882815734989648,113,119,133,136,144,150,187,190,"GAGATGA","CAGA","ATGATTT","CTGA",2.55150352471133,14,8,37,68,1.98709224361307,4.74927893542214,8.28054187538073,101,"ENSG00000079974.19"
"2790","ENSG00000078295.17_313577",313569,313577,9,"ENSG00000078295.17",0,NA,"VVVVVUVVV",1,8,0.922153209109731,115,121,133,136,142,148,161,164,"ATCATGA","TTGA","TTAATAA","ATGA",2.31459203656227,12,6,13,40,2.93620699704671,4.59170514353212,8.28031797997105,101,"ENSG00000079974.19"
"23356","ENSG00000172752.16_138740",138732,138740,9,"ENSG00000172752.16",1,1,"MVVVUVVVV",1,7,0.795859213250517,111,117,133,136,147,153,162,165,"GTGAAGA","CTGA","ATGATTT","CTGA",2.65639513675638,16,11,9,45,2.67763915973854,5.09673501786193,8.280171870864,101,"ENSG00000079974.19"
"2994","ENSG00000080224.18_247063",247055,247063,9,"ENSG00000080224.18",1,1,"MVVVVVVVV",0,8,0.90600414078675,112,118,133,136,147,153,161,164,"GGGATGA","ATAA","TGGATGT","CTGA",2.38298769875529,15,11,8,43,2.73711088358685,4.65592388548887,8.27994044863587,101,"ENSG00000079974.19"
"17310","ENSG00000153904.21_105056",105048,105056,9,"ENSG00000153904.21",1,8,"VVVVVVVMV",0,8,0.884057971014493,89,95,107,110,115,121,133,136,"ATGGTCA","CTGG","ATAATGT","CTGA",2.40356632714518,12,5,12,38,2.94950207693477,4.743319397809,8.27955128186697,101,"ENSG00000079974.19"
"46648","ENSG00000286979.1_17574",17566,17574,9,"ENSG00000286979.1",1,6,"VVVVVMVVV",0,8,0.902691511387163,112,118,133,136,147,153,170,173,"ATGCTGA","AAGA","GAGAAGC","CTGA",2.4347886107181,15,11,17,52,2.44247399365069,4.66859951627617,8.27936556182482,101,"ENSG00000079974.19"
"21748","ENSG00000168843.14_57153",57145,57153,9,"ENSG00000168843.14",1,3,"UVMVVVVVV",1,7,0.785507246376811,116,122,133,136,143,149,164,167,"ATGATGA","CTAA","GAGATTG","CTGA",2.66098829195278,11,7,15,42,2.80930442936659,5.13730659392961,8.27933557943686,101,"ENSG00000079974.19"
"24624","ENSG00000177182.11_442838",442830,442838,9,"ENSG00000177182.11",1,6,"VVVVVMVVV",0,8,0.902691511387163,115,121,133,136,153,159,169,172,"TTCATGT","CTGA","GTAATTT","CTGA",2.4365430510786,12,17,10,48,2.4300940229878,4.66842859087795,8.27919463642661,101,"ENSG00000079974.19"
"31271","ENSG00000221866.10_39545",39537,39545,9,"ENSG00000221866.10",1,3,"VVMVVVVVV",0,8,0.882815734989648,108,114,133,136,144,150,203,206,"ATTATGA","ATAA","GTGATGA","CTGA",2.6138424618635,19,8,53,89,1.56468689160565,4.74757582600724,8.27883876596584,101,"ENSG00000079974.19"
"35536","ENSG00000236256.9_197872",197864,197872,9,"ENSG00000236256.9",1,6,"VVVVVMVVV",0,8,0.902691511387163,84,90,133,136,142,148,170,173,"TTGATGA","CTGT","CTCATTA","CTGA",2.59169717574845,43,6,22,80,1.39190382702744,4.66747124967094,8.27823729521959,101,"ENSG00000079974.19"
"35336","ENSG00000235746.1_305",297,305,9,"ENSG00000235746.1",1,7,"VVVVVVMVV",0,8,0.885300207039338,79,85,100,103,115,121,133,136,"ATGAGGC","CTCA","TTGGAGA","CTGA",2.44680954718821,15,12,12,48,2.6352298265801,4.73682336862537,8.27802419678273,101,"ENSG00000079974.19"
"32236","ENSG00000226453.4_145297",145289,145297,9,"ENSG00000226453.4",0,NA,"UVVVVVVVV",1,8,0.902691511387163,73,79,94,97,104,110,133,136,"ATGATGA","ATGG","GTGATGG","CTTA",2.46011604756911,15,7,23,54,2.26824756138742,4.66725530296204,8.2780213485107,101,"ENSG00000079974.19"
"18455","ENSG00000157429.16_6274",6266,6274,9,"ENSG00000157429.16",1,2,"VMVVVVVVV",0,8,0.884057971014493,68,74,88,91,97,103,133,136,"GTGATGA","TTGA","GTGATGG","TTGA",2.53388088178288,14,6,30,59,2.07427767307273,4.74170422123965,8.27793610529762,101,"ENSG00000079974.19"
"2434","ENSG00000074621.14_44834",44826,44834,9,"ENSG00000074621.14",1,3,"VVMVVVVVV",0,8,0.882815734989648,113,119,133,136,146,152,161,164,"GTGATGG","GTGT","AGGCTGA","CTGA",2.41627825598507,14,10,9,42,2.87814824916497,4.74666748893303,8.27793042889162,101,"ENSG00000079974.19"
"35766","ENSG00000237031.7_15374",15366,15374,9,"ENSG00000237031.7",1,6,"VVVVVMVVV",0,8,0.902691511387163,82,88,106,109,113,119,133,136,"TTGTTGG","CTGA","ATGAAAG","CTGA",2.44297108947338,18,4,14,45,2.3814967845591,4.66699267859541,8.27775872414407,101,"ENSG00000079974.19"
"3595","ENSG00000086475.15_24035",24027,24035,9,"ENSG00000086475.15",1,1,"MVVVVVVVV",0,8,0.90600414078675,102,108,133,136,148,154,202,205,"ATGATGG","ATGA","ATGAAAA","CTGA",2.65099653863795,25,12,48,94,0.941506029173933,4.65370407169007,8.27772063483707,101,"ENSG00000079974.19"
"2559","ENSG00000075785.14_94799",94791,94799,9,"ENSG00000075785.14",1,8,"VVVVVVVMV",0,8,0.884057971014493,101,107,133,136,154,160,174,177,"ATGATGA","TTAA","ATGAACA","CTGA",2.63820485065792,26,18,14,67,1.37771359208363,4.74143648245077,8.27766836650874,101,"ENSG00000079974.19"
"28336","ENSG00000188730.5_32978",32970,32978,9,"ENSG00000188730.5",0,NA,"VVVVUVVVV",1,8,0.889855072463768,57,63,81,84,93,99,133,136,"TTTATGA","CTGA","ATTATTA","CTGA",2.57886260466536,18,9,34,70,1.68050094581467,4.7182295775626,8.27764986741767,101,"ENSG00000079974.19"
"5054","ENSG00000102893.18_238263",238255,238263,9,"ENSG00000102893.18",0,NA,"VVVVUUVVV",2,7,0.812008281573499,87,93,101,104,112,118,133,136,"ATGATGA","CTGA","GTGGGGA","CTGT",2.6320583976834,8,8,15,40,2.5679741365733,5.02875753028232,8.27679065657632,101,"ENSG00000079974.19"
"24407","ENSG00000176204.14_218329",218321,218329,9,"ENSG00000176204.14",0,NA,"VVVVVUVVV",1,8,0.922153209109731,113,119,133,136,141,147,159,162,"AATATGA","TAGA","TAGAAGA","CTGA",2.31957831550176,14,5,12,40,2.88653824664236,4.58759842083019,8.27621125726911,101,"ENSG00000079974.19"
"41509","ENSG00000259126.1_327",319,327,9,"ENSG00000259126.1",1,8,"VVVVVVVMV",0,8,0.884057971014493,92,98,109,112,116,122,133,136,"ATGTTGA","TTCA","GTTAGCA","CTGA",2.40406726870401,11,4,11,35,2.92998831380578,4.73927585962479,8.27550774368276,101,"ENSG00000079974.19"
"6919","ENSG00000112249.14_310606",310598,310606,9,"ENSG00000112249.14",0,NA,"VVVVVVUVV",1,8,0.886128364389234,67,73,86,89,95,101,133,136,"ATGATGC","CTGA","TTGGTGA","ATGA",2.52804404868625,13,6,32,60,2.06976717121014,4.73084854061295,8.27536199816989,101,"ENSG00000079974.19"
"43778","ENSG00000273540.5_507147",507139,507147,9,"ENSG00000273540.5",1,1,"MVVVVVVVV",0,8,0.90600414078675,115,121,133,136,155,161,191,194,"ATGAGGA","CAGA","TTAAAGA","CTGA",2.57319357220413,12,19,30,70,1.44950599377421,4.65103245211709,8.27504901526409,101,"ENSG00000079974.19"
"6367","ENSG00000109618.13_2306",2298,2306,9,"ENSG00000109618.13",1,2,"VMVVVVVVV",0,8,0.884057971014493,83,89,133,136,145,151,191,194,"ATAATGA","CTGC","CTGATGA","CTGA",2.69744567328147,44,9,40,102,0.971475733764506,4.73861172224358,8.27484360630155,101,"ENSG00000079974.19"
"43941","ENSG00000275740.1_123681",123673,123681,9,"ENSG00000275740.1",1,6,"VVVVVMVVV",0,8,0.902691511387163,114,120,133,136,185,191,206,209,"ATGTTGA","CTGT","AGAATGA","CTGA",2.52623275004893,13,49,15,86,1.81380234695979,4.66383850348817,8.27460454903682,101,"ENSG00000079974.19"
"729","ENSG00000028528.15_36208",36200,36208,9,"ENSG00000028528.15",1,5,"VVVVMVVVV",0,8,0.886542443064182,60,66,77,80,87,93,133,136,"GTGAGGA","CGGA","ATGCTGT","CTGA",2.53742224182267,11,7,40,67,1.99524059437922,4.72784721829925,8.27401699055598,101,"ENSG00000079974.19"
"14718","ENSG00000145779.8_106306",106298,106306,9,"ENSG00000145779.8",1,2,"VMVVVVVVV",0,8,0.884057971014493,65,71,79,82,114,120,133,136,"GTGATGG","CTGG","GTGAATA","CTGA",2.58974519523346,8,32,13,62,1.68544273826049,4.73760267662088,8.27383456067885,101,"ENSG00000079974.19"
"22877","ENSG00000171634.19_49370",49362,49370,9,"ENSG00000171634.19",1,7,"VVVVVVMVV",0,8,0.885300207039338,115,121,133,136,145,151,163,166,"TTGATAA","CAGA","AAAAAGA","CTGA",2.40061315392417,12,9,12,42,2.92620981779387,4.73257437765541,8.27377520581276,101,"ENSG00000079974.19"
"46300","ENSG00000286472.1_2319",2311,2319,9,"ENSG00000286472.1",1,1,"MVVVVVVVV",0,8,0.90600414078675,70,76,85,88,97,103,133,136,"TTGATGA","ATGA","GTGAAGA","ATGA",2.5027551584585,9,9,30,57,1.9134270066895,4.6496153491032,8.2736319122502,101,"ENSG00000079974.19"
"14631","ENSG00000145526.12_781438",781430,781438,9,"ENSG00000145526.12",1,1,"MVVVVVVVV",0,8,0.90600414078675,104,110,133,136,146,152,168,171,"GCGATGT","CTGA","GTGCCAA","CTGA",2.50028997549066,23,10,16,58,1.92972637433992,4.64958155273609,8.27359811588308,101,"ENSG00000079974.19"
"3753","ENSG00000088832.18_4033",4025,4033,9,"ENSG00000088832.18",0,NA,"VVVVUVVVV",1,8,0.889855072463768,80,86,92,95,106,112,133,136,"ATGATGA","CTGA","ATGGAGC","CTGG",2.56038851351351,6,11,21,47,1.78561214942057,4.71371722654433,8.2731375163994,101,"ENSG00000079974.19"
"43842","ENSG00000274322.1_3965",3957,3965,9,"ENSG00000274322.1",0,NA,"VVVVUVVVV",1,8,0.889855072463768,80,86,92,95,106,112,133,136,"ATGATGA","CTGA","ATGGAGC","CTGG",2.56038851351351,6,11,21,47,1.78561214942057,4.71371722654433,8.2731375163994,101,"ENSG00000079974.19"
"12669","ENSG00000138767.14_94601",94593,94601,9,"ENSG00000138767.14",1,8,"VVVVVVVMV",0,8,0.884057971014493,108,114,133,136,140,146,157,160,"ATAATGA","CTGA","GTGGTGT","CTGT",2.48020183929014,19,4,11,43,2.41276054848068,4.73685986927041,8.27309175332838,101,"ENSG00000079974.19"
"17732","ENSG00000154975.14_431536",431528,431536,9,"ENSG00000154975.14",0,NA,"VVVVVVUVV",1,8,0.886128364389234,114,120,133,136,141,147,169,172,"GTGAAGA","AGGA","CTGAGGA","CTGA",2.48644980813614,13,5,22,49,2.3358752221412,4.72805181909553,8.27256527665247,101,"ENSG00000079974.19"
"25792","ENSG00000182752.10_78835",78827,78835,9,"ENSG00000182752.10",1,1,"MVVVVVVVV",0,8,0.90600414078675,80,86,99,102,115,121,133,136,"AAAATGA","CTGC","GTGCCAA","CTGA",2.39144493895505,13,13,12,47,2.65060692815329,4.64839329696341,8.27240986011041,101,"ENSG00000079974.19"
"41302","ENSG00000258785.7_75676",75668,75676,9,"ENSG00000258785.7",1,1,"MVVVVUVVV",1,7,0.82815734989648,113,119,133,136,180,186,194,197,"AAGATGA","CAGA","GTGATGC","CTGA",2.68369658580347,14,44,8,75,1.94726482681005,4.9596438497083,8.27227324929422,101,"ENSG00000079974.19"
"5176","ENSG00000103599.20_115330",115322,115330,9,"ENSG00000103599.20",1,2,"VMVVVVVVV",0,8,0.884057971014493,114,120,133,136,145,151,160,163,"CTGATGT","TAGA","ATGGAAA","CTGA",2.39486316501253,13,9,9,40,2.9779462793036,4.73592517818011,8.27215706223808,101,"ENSG00000079974.19"
"12237","ENSG00000137710.17_125996",125988,125996,9,"ENSG00000137710.17",1,6,"VVVVVMVVV",0,8,0.902691511387163,64,70,95,98,108,114,133,136,"ATGATGA","ATGA","CTGATGC","CTGT",2.54913591011448,25,10,19,63,1.64523065175638,4.65986751312989,8.27063355867854,101,"ENSG00000079974.19"
"25646","ENSG00000182348.7_214280",214272,214280,9,"ENSG00000182348.7",1,6,"VVVVVMVVV",0,8,0.902691511387163,83,89,133,136,143,149,168,171,"ATAGTGA","CTGA","TTGAAGT","CTGA",2.55957312508345,44,7,19,79,1.57562430689795,4.6598612851969,8.27062733074555,101,"ENSG00000079974.19"
"1884","ENSG00000067141.17_126727",126719,126727,9,"ENSG00000067141.17",1,1,"MVVVUVVVV",1,7,0.795859213250517,72,78,104,107,114,120,133,136,"ATGATGT","CTGA","TTGAACA","CTGA",2.74436589244502,26,7,13,55,2.05274520835517,5.08712945616383,8.2705663091659,101,"ENSG00000079974.19"
"36685","ENSG00000242593.8_322005",321997,322005,9,"ENSG00000242593.8",1,6,"VVVVVMVVV",0,8,0.902691511387163,113,119,133,136,151,157,172,175,"CTGATTG","GTGA","CTGAAGA","CTGA",2.44556016623865,14,15,15,53,2.33498119868037,4.65967891006784,8.27044495561649,101,"ENSG00000079974.19"
"25600","ENSG00000182197.13_187175",187167,187175,9,"ENSG00000182197.13",0,NA,"VVVVVUVVV",1,8,0.922153209109731,113,119,133,136,173,179,190,193,"CTGCTGT","CTGT","GTGATAA","CTGA",2.45432091451898,14,37,11,71,1.96311819908652,4.58131440730326,8.26992724374218,101,"ENSG00000079974.19"
"38264","ENSG00000249856.1_76786",76778,76786,9,"ENSG00000249856.1",0,NA,"VVVVVVUVV",1,8,0.886128364389234,111,117,133,136,172,178,187,190,"AAGAAGA","CTGA","ATGTTTA","CTGA",2.55691178784642,16,36,9,70,1.85287943090787,4.72473950413767,8.2692529616946,101,"ENSG00000079974.19"
"7816","ENSG00000115816.15_25853",25845,25853,9,"ENSG00000115816.15",0,NA,"VVVVVUVVV",1,8,0.922153209109731,112,118,133,136,168,174,185,188,"TTGATAA","CTGT","CTGCTTA","CTGA",2.45868246776241,15,32,11,67,1.93046787423654,4.58042108149648,8.26903391793541,101,"ENSG00000079974.19"
"444","ENSG00000011677.13_197655",197647,197655,9,"ENSG00000011677.13",1,1,"MVVVVVVVV",0,8,0.90600414078675,108,114,133,136,147,153,162,165,"ATAATGC","TGGA","ATGATTA","CTGA",2.42480302261863,19,11,9,48,2.41239551204182,4.64443724904151,8.26845381218851,101,"ENSG00000079974.19"
"26137","ENSG00000183495.15_41311",41303,41311,9,"ENSG00000183495.15",1,2,"VMVVVVVVV",0,8,0.884057971014493,63,69,81,84,95,101,133,136,"TTGATGA","CTGA","CTGCTGA","CTGC",2.55014434486912,12,11,32,64,1.92560045462626,4.73164068843842,8.26787257249639,101,"ENSG00000079974.19"
"25368","ENSG00000181143.15_7257",7249,7257,9,"ENSG00000181143.15",1,2,"VMVVVVVVV",0,8,0.884057971014493,109,115,133,136,142,148,190,193,"ATAATGA","CAGA","TTGACGC","CTGA",2.58910765362853,18,6,42,75,1.66386644883208,4.73114603492223,8.26737791898021,101,"ENSG00000079974.19"
"23446","ENSG00000172986.13_63190",63182,63190,9,"ENSG00000172986.13",0,NA,"UVVVVVVVV",1,8,0.902691511387163,116,122,133,136,144,150,160,163,"ATAAAGA","CTTA","ATTTTCA","CTGA",2.34077892829604,11,8,10,38,3.02123989921163,4.65660818862965,8.2673742341783,101,"ENSG00000079974.19"
"21068","ENSG00000166377.21_232228",232220,232228,9,"ENSG00000166377.21",1,6,"VVVVVMVVV",0,8,0.902691511387163,110,116,133,136,146,152,163,166,"ATGAAGC","CTTG","ATGATGG","CTGA",2.39769490449042,17,10,11,47,2.64175466940634,4.65659684150228,8.26736288705094,101,"ENSG00000079974.19"
"35348","ENSG00000235774.2_15419",15411,15419,9,"ENSG00000235774.2",0,NA,"VVVVVVUVV",1,8,0.886128364389234,110,116,133,136,141,147,169,172,"ATAATGC","ATGA","TTGATTA","CTGA",2.51925438496346,17,5,22,53,2.09421213667742,4.72231034244178,8.26682379999872,101,"ENSG00000079974.19"
"32309","ENSG00000226688.9_272524",272516,272524,9,"ENSG00000226688.9",1,1,"MVVVVVVVV",0,8,0.90600414078675,94,100,133,136,141,147,156,159,"GTGCTGA","AGGA","GTGATTA","CTGA",2.49361187493124,33,5,9,56,1.94699612860027,4.64276882370213,8.26678538684912,101,"ENSG00000079974.19"
"13413","ENSG00000141376.23_469264",469256,469264,9,"ENSG00000141376.23",1,1,"MVVVVVVVV",0,8,0.90600414078675,83,89,133,136,143,149,178,181,"ATGATGT","GAGA","GTGATAA","CTGA",2.6131799505582,44,7,29,89,1.14933974499794,4.64263485384649,8.26665141699349,101,"ENSG00000079974.19"
"16437","ENSG00000151532.15_110452",110444,110452,9,"ENSG00000151532.15",1,6,"VVVVVMVVV",0,8,0.902691511387163,100,106,133,136,141,147,155,158,"GTGATAA","ATTA","ATGAAGA","CTGA",2.49062987003152,27,5,8,49,2.01546424997234,4.65491584587895,8.2656818914276,101,"ENSG00000079974.19"
"12054","ENSG00000136940.14_24945",24937,24945,9,"ENSG00000136940.14",0,NA,"VVUVVUVVV",2,7,0.805797101449275,112,118,133,136,142,148,166,169,"GTGGTGA","CTGA","CTGAGGC","CTGA",2.64553729806023,15,6,18,48,2.53118672654907,5.04202551173766,8.26521391753476,101,"ENSG00000079974.19"
"33659","ENSG00000230612.3_10806",10798,10806,9,"ENSG00000230612.3",0,NA,"VVVVUVVVV",1,8,0.889855072463768,66,72,105,108,116,122,133,136,"CTAATGA","CTTA","TTGGTGA","CTGA",2.52504777282865,33,8,11,61,1.98929319701238,4.70573625396751,8.26515654382258,101,"ENSG00000079974.19"
"33634","ENSG00000230537.2_70679",70671,70679,9,"ENSG00000230537.2",0,NA,"VVVVUVVVV",1,8,0.889855072463768,57,63,72,75,83,89,133,136,"GTGAATA","CTGA","CTGATGG","CTGA",2.54857938831563,9,8,44,70,1.8319444928288,4.70561843706658,8.26503872692165,101,"ENSG00000079974.19"
"35886","ENSG00000237422.3_20961",20953,20961,9,"ENSG00000237422.3",0,NA,"VVVVUVVVV",1,8,0.889855072463768,57,63,72,75,83,89,133,136,"GTGAATA","CTGA","CTGATGG","CTGA",2.54857938831563,9,8,44,70,1.8319444928288,4.70561843706658,8.26503872692165,101,"ENSG00000079974.19"
"16536","ENSG00000151779.14_377276",377268,377276,9,"ENSG00000151779.14",0,NA,"VVVVUVVVV",1,8,0.889855072463768,112,118,133,136,165,171,183,186,"CTGATGA","GTGC","GTGGTTA","CTGA",2.53404628230941,15,29,12,65,1.92879872175262,4.70561015095385,8.26503044080892,101,"ENSG00000079974.19"
"40116","ENSG00000255029.2_15526",15518,15526,9,"ENSG00000255029.2",0,NA,"UVVVVUVVV",2,7,0.824844720496894,114,120,133,136,143,149,199,202,"AAGATGA","CTGA","AGGATCA","CTGA",2.67964115756547,13,7,50,79,1.99804630292495,4.96558017167369,8.26495905366126,101,"ENSG00000079974.19"
"4705","ENSG00000101745.17_52756",52748,52756,9,"ENSG00000101745.17",1,7,"VVVVVVMVV",0,8,0.885300207039338,95,101,133,136,150,156,171,174,"GTGAAGA","CTAA","GTGAGGA","CTGA",2.61468072600645,32,14,15,70,1.46329227455251,4.72362427864888,8.26482510680623,101,"ENSG00000079974.19"
"42625","ENSG00000265257.5_86248",86240,86248,9,"ENSG00000265257.5",1,7,"VVVVVVMVV",0,8,0.885300207039338,95,101,133,136,150,156,171,174,"GTGAAGA","CTAA","GTGAGGA","CTGA",2.61468072600645,32,14,15,70,1.46329227455251,4.72362427864888,8.26482510680623,101,"ENSG00000079974.19"
"37900","ENSG00000249069.8_74511",74503,74511,9,"ENSG00000249069.8",1,3,"VVMVVVVVV",0,8,0.882815734989648,109,115,133,136,140,146,161,164,"ATGATGT","TAGA","GTGCCTA","CTGA",2.49084058209086,18,4,15,46,2.32532772751302,4.73273290202969,8.26399584198828,101,"ENSG00000079974.19"
"5056","ENSG00000102893.18_39647",39639,39647,9,"ENSG00000102893.18",0,NA,"VVVVVUVVV",1,8,0.922153209109731,113,119,133,136,143,149,202,205,"TTCATTA","CTGA","ATGCTAA","CTGA",2.45007086965229,14,7,53,83,1.9650809010164,4.57472167467459,8.26333451111351,101,"ENSG00000079974.19"
"2755","ENSG00000078098.15_42466",42458,42466,9,"ENSG00000078098.15",1,8,"VVVVVVVMV",0,8,0.884057971014493,109,115,133,136,141,147,156,159,"ATGATTT","TTCA","GTGATAA","CTGA",2.44306345878965,18,5,9,41,2.62060803478981,4.72692444001353,8.2631563240715,101,"ENSG00000079974.19"
"9296","ENSG00000123836.15_33957",33949,33957,9,"ENSG00000123836.15",0,NA,"VVVVUUVVV",2,7,0.812008281573499,84,90,101,104,111,117,133,136,"ATGAGCA","CTGA","TTGATGC","CTGA",2.59715758454291,11,7,16,43,2.74570764219225,5.01502288478624,8.26305601108023,101,"ENSG00000079974.19"
"3630","ENSG00000087095.13_16130",16122,16130,9,"ENSG00000087095.13",1,6,"VVVVVMVVV",0,8,0.902691511387163,101,107,133,136,166,172,183,186,"ATGATTA","TTGA","TTAATGA","CTGA",2.61560013458871,26,30,11,76,1.17045936788218,4.6519483996184,8.26271444516706,101,"ENSG00000079974.19"
"28703","ENSG00000196357.12_60594",60586,60594,9,"ENSG00000196357.12",1,8,"VVVVVVVMV",0,8,0.884057971014493,108,114,133,136,146,152,163,166,"AGGATGA","CAGG","TTGATAG","CTGA",2.46635177598247,19,10,11,49,2.4620212489147,4.72609160553279,8.26232348959076,101,"ENSG00000079974.19"
"2702","ENSG00000077514.9_160654",160646,160654,9,"ENSG00000077514.9",0,NA,"VVVVUVVVV",1,8,0.889855072463768,94,100,110,113,115,121,133,136,"ATGATGA","CTGG","ATGACAG","CAGA",2.43001367992568,10,2,12,33,2.61084928422341,4.70273512093199,8.26215541078706,101,"ENSG00000079974.19"
"10727","ENSG00000132549.20_830036",830028,830036,9,"ENSG00000132549.20",1,1,"MVVVVVVVV",0,8,0.90600414078675,114,120,133,136,172,178,186,189,"GTGAAGA","CCAA","GTGATAA","CTGA",2.48394245096671,13,36,8,66,1.99211484239026,4.63793279554208,8.26194935868907,101,"ENSG00000079974.19"
"18951","ENSG00000159461.15_52035",52027,52035,9,"ENSG00000159461.15",1,1,"MVVVVVVVV",0,8,0.90600414078675,111,117,133,136,138,144,153,156,"ATGATGT","CTGT","GTGAACA","GTGA",2.41300004571818,16,2,9,36,2.46431972997215,4.63774667535666,8.26176323850366,101,"ENSG00000079974.19"
"38736","ENSG00000250958.1_20314",20306,20314,9,"ENSG00000250958.1",1,8,"VVVVVVVMV",0,8,0.884057971014493,105,111,133,136,152,158,209,212,"ATGATGA","CGGA","CAGATGT","CTGA",2.71111905084058,22,16,51,98,0.827666753373319,4.72544843974429,8.26168032380226,101,"ENSG00000079974.19"
"16703","ENSG00000152104.12_76817",76809,76817,9,"ENSG00000152104.12",1,5,"VVVVMVVVV",0,8,0.886542443064182,84,90,133,136,156,162,171,174,"GTGCTGA","CTGA","TTGTGGA","CTGA",2.63737477111904,43,20,9,81,1.27714414347497,4.71491065440047,8.2610804266572,101,"ENSG00000079974.19"
"21067","ENSG00000166377.21_190259",190251,190259,9,"ENSG00000166377.21",1,7,"VVVVVUMVV",1,7,0.807453416149068,65,71,83,86,92,98,133,136,"GTGATAA","CTGA","CTGAAGA","CTGA",2.71283277146236,12,6,35,62,2.03697011016876,5.03063047997945,8.26044414457573,101,"ENSG00000079974.19"
"43827","ENSG00000274149.1_103",95,103,9,"ENSG00000274149.1",1,8,"VVVVVVVMV",0,8,0.884057971014493,87,93,105,108,114,120,134,137,"ATGATGT","TTGA","ATGATCT","CTCA",2.40259717122738,12,6,14,41,2.87948946421436,4.72420098476589,8.26043286882386,101,"ENSG00000079974.19"
"43491","ENSG00000271955.2_557",549,557,9,"ENSG00000271955.2",1,6,"VVVVVMVVV",0,8,0.902691511387163,81,87,102,105,112,118,133,136,"ATGATGA","CCAA","ATGAGAA","CTTA",2.38003283544585,15,7,15,46,2.73068460625846,4.64939254397437,8.26015858952302,101,"ENSG00000079974.19"
"22885","ENSG00000171681.13_30873",30865,30873,9,"ENSG00000171681.13",1,1,"MVVVVUVVV",1,7,0.82815734989648,114,120,133,136,144,150,206,209,"ATGATGA","ATCA","TTGATGT","CTGA",2.6707830522951,13,8,56,86,1.98279237407987,4.94700318067846,8.25963258026438,101,"ENSG00000079974.19"
"18707","ENSG00000158258.16_378556",378548,378556,9,"ENSG00000158258.16",0,NA,"UVVVVVVVV",1,8,0.902691511387163,116,122,133,136,141,147,172,175,"GTCATGG","CAGA","ATAATGA","CTGA",2.46222057777356,11,5,25,50,2.18007764261726,4.64872037361025,8.25948641915891,101,"ENSG00000079974.19"
"46872","ENSG00000287292.1_427660",427652,427660,9,"ENSG00000287292.1",1,8,"VVVVVVVMV",0,8,0.884057971014493,114,120,133,136,141,147,160,163,"GTCATGA","GTAA","AGGAAGA","CTGA",2.40202007218368,13,5,13,40,2.87932552744932,4.72319816883513,8.2594300528931,101,"ENSG00000079974.19"
"39876","ENSG00000254394.2_168628",168620,168628,9,"ENSG00000254394.2",1,7,"VVVVVVMVV",0,8,0.885300207039338,112,118,133,136,151,157,209,212,"ATGATGA","TTGC","TTGACAA","CTGA",2.61114716875824,15,15,52,91,1.46486462928857,4.71812810525255,8.2593289334099,101,"ENSG00000079974.19"
"9217","ENSG00000123119.12_42964",42956,42964,9,"ENSG00000123119.12",1,1,"MVVVVVVVV",0,8,0.90600414078675,114,120,133,136,150,156,172,175,"ATAATTA","TTGA","TAGAAGA","CTGA",2.42446992754681,13,14,16,52,2.37723020157233,4.6350907629711,8.2591073261181,101,"ENSG00000079974.19"
"3943","ENSG00000091157.15_177086",177078,177086,9,"ENSG00000091157.15",1,1,"MVVVVVVVV",0,8,0.90600414078675,108,114,133,136,139,145,163,166,"ATGGTGA","GAGA","ATGGAGA","CTGA",2.49367279564394,19,3,18,49,1.9149730414855,4.6348645864446,8.2588811495916,101,"ENSG00000079974.19"
"18023","ENSG00000156011.18_416101",416093,416101,9,"ENSG00000156011.18",1,7,"VVVVVVMVV",0,8,0.885300207039338,111,117,133,136,143,149,159,162,"GTGATTA","GAGA","CTTAGGA","CTGA",2.40203159993164,16,7,10,42,2.85527675341961,4.71720518824097,8.25840601639832,101,"ENSG00000079974.19"
"11408","ENSG00000134852.15_47782",47774,47782,9,"ENSG00000134852.15",1,8,"VVVVVVVMV",0,8,0.884057971014493,108,114,133,136,150,156,171,174,"ATGATGG","TTAA","ATGAGGT","CTGA",2.53048536335127,19,14,15,57,2.01671851161793,4.72165523348994,8.25788711754791,101,"ENSG00000079974.19"
"32866","ENSG00000228195.2_397",389,397,9,"ENSG00000228195.2",0,NA,"VVVVVUVVV",1,8,0.922153209109731,85,91,102,105,109,115,133,136,"ATGAAGG","GTGA","GTGATGA","CTTA",2.37133921300393,11,4,18,42,2.46604079327924,4.56874221999303,8.25735505643195,101,"ENSG00000079974.19"
"28284","ENSG00000188626.7_5764",5756,5764,9,"ENSG00000188626.7",1,8,"VVVVVVVMV",0,8,0.884057971014493,116,122,133,136,165,171,179,182,"ATGAAGA","TCGA","TTGATGG","CTGA",2.52991445448688,11,29,8,57,2.01621196836424,4.72057708290253,8.25680896696051,101,"ENSG00000079974.19"
"42280","ENSG00000261480.1_5811",5803,5811,9,"ENSG00000261480.1",1,8,"VVVVVVVMV",0,8,0.884057971014493,116,122,133,136,165,171,179,182,"ATGAAGA","TCGA","TTGATGG","CTGA",2.52991445448688,11,29,8,57,2.01621196836424,4.72057708290253,8.25680896696051,101,"ENSG00000079974.19"
"21792","ENSG00000168959.15_362272",362264,362272,9,"ENSG00000168959.15",1,8,"VVVVVVVMV",0,8,0.884057971014493,114,120,133,136,153,159,177,180,"CTGATGA","AGGA","ATTAGGA","CTGA",2.52335090295008,13,17,18,57,2.05979418861683,4.72053338540434,8.25676526946231,101,"ENSG00000079974.19"
"28956","ENSG00000196821.10_41303",41295,41303,9,"ENSG00000196821.10",1,2,"VMVVVVVVV",0,8,0.884057971014493,92,98,104,107,111,117,133,136,"ATGATGA","CTGT","GTGGTTA","ATGA",2.49998671118821,6,4,16,35,2.21537767892269,4.7204889383777,8.25672082243567,101,"ENSG00000079974.19"
"20512","ENSG00000164989.17_418270",418262,418270,9,"ENSG00000164989.17",1,2,"VMVVVVVVV",0,8,0.884057971014493,63,69,94,97,112,118,133,136,"ATAATGA","CTGT","CTGAAGT","CTGA",2.60072426476407,25,15,15,64,1.54266524117297,4.72020675156669,8.25643863562466,101,"ENSG00000079974.19"
"13950","ENSG00000144036.16_283912",283904,283912,9,"ENSG00000144036.16",0,NA,"VVUVVVVVV",1,8,0.883643892339545,111,117,133,136,145,151,166,169,"ATTAAGA","ATGA","AAGAAGA","CTGA",2.44203358397545,16,9,15,49,2.60676869659968,4.72174814744234,8.25632371680052,101,"ENSG00000079974.19"
"17747","ENSG00000155011.9_334943",334935,334943,9,"ENSG00000155011.9",1,6,"VVVVVMVVV",0,8,0.902691511387163,112,118,133,136,139,145,160,163,"GTGATTA","CTAT","ATGAAGT","CTGA",2.42060422449613,15,3,15,42,2.44486536556497,4.64555671555146,8.25632276110012,101,"ENSG00000079974.19"
"6462","ENSG00000109956.13_19085",19077,19085,9,"ENSG00000109956.13",1,1,"MVVVVVVVV",0,8,0.90600414078675,86,92,133,136,148,154,171,174,"TTGATGA","CTTT","GGGATGA","CTGA",2.55968027540004,41,12,17,79,1.46448298540741,4.63225453868525,8.25627110183225,101,"ENSG00000079974.19"
"29223","ENSG00000197475.11_6645",6637,6645,9,"ENSG00000197475.11",1,2,"VMVVVVVVV",0,8,0.884057971014493,79,85,98,101,116,122,133,136,"CTCATGA","CTCA","ATTCTGA","CTGA",2.45082271261193,13,15,11,48,2.53706209726462,4.71897004533603,8.255201929394,101,"ENSG00000079974.19"
"18236","ENSG00000156639.12_85388",85380,85388,9,"ENSG00000156639.12",1,1,"MVVVVVVVV",0,8,0.90600414078675,42,48,58,61,71,77,133,136,"ATGTTGA","ATGA","AAGATTC","CTGA",2.50576322310647,10,10,56,85,1.81804984710431,4.63078450028686,8.25480106343386,101,"ENSG00000079974.19"
"29955","ENSG00000198929.13_217231",217223,217231,9,"ENSG00000198929.13",1,2,"VMVVVVVVV",0,8,0.884057971014493,105,111,133,136,138,144,168,171,"ATAATTA","CTGA","GTGAAGA","CTGA",2.65460134181464,22,2,24,57,1.17606578887895,4.71835201691081,8.25458390096878,101,"ENSG00000079974.19"
"6554","ENSG00000110693.19_554355",554347,554355,9,"ENSG00000110693.19",1,6,"VVVVVMVVV",0,8,0.902691511387163,40,46,58,61,97,103,133,136,"AGAATGA","CTGA","CTGATTA","CTGA",2.61465028896222,12,36,30,87,1.143182835925,4.64354619058494,8.2543122361336,101,"ENSG00000079974.19"
"33622","ENSG00000230490.4_82197",82189,82197,9,"ENSG00000230490.4",0,NA,"UVVVVVVVV",1,8,0.902691511387163,80,86,103,106,115,121,133,136,"ATGAGGA","TTGA","GTGAGAA","CTGG",2.38588172969829,17,9,12,47,2.66640863594683,4.64307170848386,8.25383775403251,101,"ENSG00000079974.19"
"16184","ENSG00000151067.23_599492",599484,599492,9,"ENSG00000151067.23",1,1,"MVVVVVVVV",0,8,0.90600414078675,116,122,133,136,145,151,167,170,"GTGATGG","ATGG","GTCTTCA","CTGA",2.37422135631318,11,9,16,45,2.68993440327286,4.62951919467352,8.25353575782052,101,"ENSG00000079974.19"
"13273","ENSG00000140836.17_669797",669789,669797,9,"ENSG00000140836.17",0,NA,"VVVVUVVVV",1,8,0.889855072463768,110,116,133,136,152,158,172,175,"ATGAAGA","CTGA","GTGAAAA","TTGA",2.49856044688327,17,16,14,56,2.11499591383825,4.69301638993167,8.25243667978675,101,"ENSG00000079974.19"
"46877","ENSG00000287292.1_481245",481237,481245,9,"ENSG00000287292.1",0,NA,"VVUVVVVVV",1,8,0.883643892339545,99,105,133,136,140,146,158,161,"ATGTTGA","TTGA","ATGCAGC","CTGA",2.54943267478593,28,4,12,53,1.87396013669669,4.71754449215073,8.25212006150891,101,"ENSG00000079974.19"
"11856","ENSG00000136237.19_135979",135971,135979,9,"ENSG00000136237.19",1,2,"VMVVVVVVV",0,8,0.884057971014493,54,60,97,100,111,117,133,136,"AAGATAA","CTGA","GTGAGGG","CTGA",2.58970077390376,37,11,16,73,1.59790454509585,4.71564409278022,8.25187597683819,101,"ENSG00000079974.19"
"4147","ENSG00000095777.17_32898",32890,32898,9,"ENSG00000095777.17",1,8,"VVVVVVVMV",0,8,0.884057971014493,66,72,88,91,99,105,133,136,"CTGAAGA","GTGA","GTGCAGA","CTGA",2.52949778902374,16,8,28,61,1.99902634374007,4.71558623430792,8.25181811836589,101,"ENSG00000079974.19"
"12809","ENSG00000139154.16_247466",247458,247466,9,"ENSG00000139154.16",0,NA,"VVVVVVUVV",1,8,0.886128364389234,113,119,133,136,154,160,208,211,"GTGATGT","CTCA","TTGAAGA","CTGA",2.62305742527095,14,18,48,89,1.34054002242553,4.70689738105797,8.2514108386149,101,"ENSG00000079974.19"
"8506","ENSG00000119326.15_33223",33215,33223,9,"ENSG00000119326.15",0,NA,"VVVVVUVVV",1,8,0.922153209109731,113,119,133,136,153,159,199,202,"ATGATGC","GAGA","ATGAGCA","CTGA",2.52571911066044,14,17,40,80,1.41252152735013,4.56266223293826,8.25127506937718,101,"ENSG00000079974.19"
"16524","ENSG00000151746.15_32571",32563,32571,9,"ENSG00000151746.15",1,7,"VVVVVVMVV",0,8,0.885300207039338,112,118,133,136,170,176,228,231,"ATGATGA","CTAA","TAGATAA","CTGA",2.68548153519602,15,34,52,110,0.935206289148888,4.70960413094726,8.25080495910461,101,"ENSG00000079974.19"
"41114","ENSG00000258553.5_101068",101060,101068,9,"ENSG00000258553.5",1,1,"MVVVVVVVV",0,8,0.90600414078675,100,106,133,136,182,188,200,203,"CAGATGA","CTGA","CTGAGGC","CTGA",2.61660292967632,27,46,12,94,1.06287549451225,4.62672375642194,8.25074031956894,101,"ENSG00000079974.19"
"21910","ENSG00000169306.10_1233562",1233554,1233562,9,"ENSG00000169306.10",1,6,"VVVVVMVVV",0,8,0.902691511387163,111,117,133,136,147,153,205,208,"TAGATGA","TTGA","GTGGAGA","CTGA",2.5327139337266,16,11,52,88,1.67453530398151,4.6398237155397,8.25058976108836,101,"ENSG00000079974.19"
"15954","ENSG00000150394.14_344783",344775,344783,9,"ENSG00000150394.14",1,2,"VMVVVVVVV",0,8,0.884057971014493,52,58,71,74,79,85,133,136,"ATAATGA","GTGA","AAGAAGT","CTGA",2.53891558499544,13,5,48,75,1.93089858928242,4.714250622313,8.25048250637098,101,"ENSG00000079974.19"
"42067","ENSG00000260600.1_1498",1490,1498,9,"ENSG00000260600.1",1,2,"VMVVVVVVV",0,8,0.884057971014493,52,58,71,74,79,85,133,136,"ATAATGA","GTGA","AAGAAGT","CTGA",2.53891558499544,13,5,48,75,1.93089858928242,4.714250622313,8.25048250637098,101,"ENSG00000079974.19"
"23601","ENSG00000173406.16_1418424",1418416,1418424,9,"ENSG00000173406.16",0,NA,"VVVVVVUVV",1,8,0.886128364389234,112,118,133,136,148,154,169,172,"ATGAAGA","ATGG","TTGTTCA","CTGA",2.44959710256049,15,12,15,51,2.49290068452352,4.7058870087317,8.25040046628863,101,"ENSG00000079974.19"
"22311","ENSG00000170289.13_126294",126286,126294,9,"ENSG00000170289.13",1,8,"VVVVVVVMV",0,8,0.884057971014493,113,119,133,136,175,181,190,193,"AGGCTGA","CTGA","GTGAGTT","CTGA",2.53269630118827,14,39,9,71,1.97154630018358,4.71404707702635,8.25027896108432,101,"ENSG00000079974.19"
"4717","ENSG00000101752.13_113080",113072,113080,9,"ENSG00000101752.13",0,NA,"UVVVVVVVV",1,8,0.902691511387163,114,120,133,136,139,145,155,158,"TTGATTA","GTCA","TTGAAAA","CTGA",2.35947761172741,13,3,10,35,2.82812012749484,4.63949271808607,8.25025876363472,101,"ENSG00000079974.19"
"17346","ENSG00000153936.18_32385",32377,32385,9,"ENSG00000153936.18",1,1,"MVVVVVVVV",0,8,0.90600414078675,106,112,133,136,145,151,163,166,"ATTATGG","ATGA","ATGTTTT","CTGA",2.42790495287435,21,9,12,51,2.31891874584804,4.62623794125259,8.25025450439958,101,"ENSG00000079974.19"
"44690","ENSG00000283380.1_439966",439958,439966,9,"ENSG00000283380.1",1,8,"VVVVVVVMV",0,8,0.884057971014493,113,119,133,136,144,150,182,185,"AGGAAGA","CTGA","ATGAGTT","CTGA",2.5221558560148,14,8,32,63,2.04088035654689,4.71381318249473,8.2500450665527,101,"ENSG00000079974.19"
"46321","ENSG00000286481.2_34008",34000,34008,9,"ENSG00000286481.2",1,7,"VVVVVVMVV",0,8,0.885300207039338,111,117,133,136,144,150,175,178,"GTGAACA","CTGA","ATGAGGC","CTGA",2.51042809084667,16,8,25,58,2.09756005506019,4.70843683184283,8.24963766000018,101,"ENSG00000079974.19"
"48168","ENSG00000290551.1_533464",533456,533464,9,"ENSG00000290551.1",1,2,"VMVVVUVVV",1,7,0.806211180124223,113,119,133,136,144,150,161,164,"ATGATGA","CTGA","GTGCACA","CTGG",2.57179054054054,14,8,11,42,2.95372298478643,5.02474831376418,8.24959303426107,101,"ENSG00000079974.19"
"29662","ENSG00000198586.14_203763",203755,203763,9,"ENSG00000198586.14",1,8,"VVVVVVVMV",0,8,0.884057971014493,111,117,133,136,145,151,159,162,"AAGATGT","CTTA","ATAAAGG","CTGA",2.40930433885127,16,9,8,42,2.78604043607184,4.71201734043674,8.24824922449471,101,"ENSG00000079974.19"
"40563","ENSG00000257022.1_34427",34419,34427,9,"ENSG00000257022.1",1,6,"VVVVVMVVV",0,8,0.902691511387163,82,88,133,136,147,153,168,171,"ACGATGA","CTCC","ATGAAGA","CTGA",2.53419924000086,45,11,15,80,1.65244631549865,4.63677697887609,8.24754302442475,101,"ENSG00000079974.19"
"7543","ENSG00000114757.19_235606",235598,235606,9,"ENSG00000114757.19",1,8,"VVVVVVVMV",0,8,0.884057971014493,85,91,133,136,142,148,163,166,"CTGATGA","CTGC","ATTGGGA","CTGA",2.55653427405585,42,6,15,72,1.8015810603772,4.71128572185406,8.24751760591203,101,"ENSG00000079974.19"
"28617","ENSG00000196236.13_45992",45984,45992,9,"ENSG00000196236.13",1,6,"VVVVVMVVV",0,8,0.902691511387163,112,118,133,136,140,146,158,161,"ATGGAGA","TTGA","GTTACCA","CTGA",2.37081552111144,15,4,12,40,2.73842218679623,4.63596474855146,8.24673079410011,101,"ENSG00000079974.19"
"46995","ENSG00000287469.1_94310",94302,94310,9,"ENSG00000287469.1",0,NA,"UVVVVVVVV",1,8,0.902691511387163,64,70,81,84,113,119,133,136,"AAGATGT","ATGA","GTAATGT","CTGA",2.49522307595508,11,29,14,63,1.9074115226911,4.63555800726458,8.24632405281324,101,"ENSG00000079974.19"
"24167","ENSG00000175390.15_24538",24530,24538,9,"ENSG00000175390.15",1,1,"MVUVVVVVV",1,7,0.789648033126294,107,113,133,136,142,148,159,162,"GTGATGA","TTGA","ATTAGGA","CTGA",2.68286133545083,20,6,11,46,2.4640621002461,5.08745108414624,8.24604321665142,101,"ENSG00000079974.19"
"14966","ENSG00000146416.19_256497",256489,256497,9,"ENSG00000146416.19",1,5,"VVVVMVVVV",0,8,0.886542443064182,108,114,133,136,144,150,201,204,"ATGCTGA","GTGA","ATGGTAA","CTGA",2.58491767830258,19,8,51,87,1.56542761647043,4.69955303462191,8.24572280687864,101,"ENSG00000079974.19"
"40654","ENSG00000257261.7_355008",355000,355008,9,"ENSG00000257261.7",1,1,"MVVVVVVVV",0,8,0.90600414078675,97,103,133,136,165,171,186,189,"ATGAAGA","ATGA","GTGAAAA","CTGA",2.63471976433365,30,29,15,83,0.921989260334717,4.62169692230643,8.24571348545343,101,"ENSG00000079974.19"
"9024","ENSG00000122257.20_21994",21986,21994,9,"ENSG00000122257.20",0,NA,"UVVVUVVVV",2,7,0.792546583850932,68,74,86,89,114,120,133,136,"ATTATGA","GTGA","GTGATGA","CTGA",2.73837312519266,12,25,13,59,2.04315565683653,5.07474412286357,8.24493045826729,101,"ENSG00000079974.19"
"8079","ENSG00000116729.14_34785",34777,34785,9,"ENSG00000116729.14",1,1,"MVVVVVVVV",0,8,0.90600414078675,115,121,133,136,141,147,160,163,"TTGATAA","CTGA","ATAATGG","ATGA",2.33779807317651,12,5,13,39,2.89554315851381,4.62021591158931,8.24423247473631,101,"ENSG00000079974.19"
"9165","ENSG00000122986.14_58625",58617,58625,9,"ENSG00000122986.14",1,8,"VVVVVVVMV",0,8,0.884057971014493,86,92,103,106,112,118,133,136,"ATGAAAA","CTGC","TTGGTGG","CTGA",2.40479126207775,11,6,15,41,2.79987486950126,4.70795415417157,8.24418603822954,101,"ENSG00000079974.19"
"24852","ENSG00000178226.11_3967",3959,3967,9,"ENSG00000178226.11",1,1,"MVVVVUVVV",1,7,0.82815734989648,112,118,133,136,154,160,171,174,"GAGATGA","CAGA","GTGGTGA","CTGA",2.6186487949816,15,18,11,53,2.26818155281187,4.93146004650563,8.24408944609155,101,"ENSG00000079974.19"
"31260","ENSG00000221823.11_42998",42990,42998,9,"ENSG00000221823.11",1,7,"VVVVVVMVV",0,8,0.885300207039338,97,103,110,113,116,122,133,136,"ATGATGA","TTGA","AAGGTGT","CAGA",2.42090019770128,7,3,11,30,2.67173332818336,4.7027669948813,8.24396782303865,101,"ENSG00000079974.19"
"43747","ENSG00000273398.6_47991",47983,47991,9,"ENSG00000273398.6",1,7,"VVVVVVMVV",0,8,0.885300207039338,97,103,110,113,116,122,133,136,"ATGATGA","TTGA","AAGGTGT","CAGA",2.42090019770128,7,3,11,30,2.67173332818336,4.7027669948813,8.24396782303865,101,"ENSG00000079974.19"
"10167","ENSG00000129636.13_130365",130357,130365,9,"ENSG00000129636.13",1,1,"MVVVVVVVV",0,8,0.90600414078675,89,95,133,136,179,185,194,197,"ATGATGA","CAGT","TTGTGGA","CTGA",2.62107881896289,38,43,9,99,1.00566641195441,4.61988130126009,8.24389786440709,101,"ENSG00000079974.19"
"28912","ENSG00000196678.14_51118",51110,51118,9,"ENSG00000196678.14",1,8,"VVVVVVVMV",0,8,0.884057971014493,89,95,107,110,113,119,133,136,"TTTATGG","CTGA","ATGGTTT","CTGA",2.42933568492628,12,3,14,38,2.63221583451699,4.70694676683972,8.24317865089769,101,"ENSG00000079974.19"
"7016","ENSG00000112530.12_174697",174689,174697,9,"ENSG00000112530.12",1,7,"VVVVVVMVV",0,8,0.885300207039338,92,98,106,109,115,121,133,136,"AAGATGT","CTAA","AAGAACA","CTGA",2.40045142304435,8,6,12,35,2.80463758214713,4.70191176727737,8.24311259543472,101,"ENSG00000079974.19"
"22095","ENSG00000169851.16_125587",125579,125587,9,"ENSG00000169851.16",0,NA,"UVVVVVVVV",1,8,0.902691511387163,104,110,133,136,141,147,158,161,"TTGATTA","CTTA","ATTTTGA","CTGA",2.45055059569386,23,5,11,48,2.19208416258757,4.63227203346999,8.24303807901864,101,"ENSG00000079974.19"
"20924","ENSG00000165995.24_26253",26245,26253,9,"ENSG00000165995.24",1,2,"VMVVVVVVV",0,8,0.884057971014493,91,97,109,112,114,120,133,136,"GTGAAGT","CAGA","GAGAGGA","CTGA",2.44197861960156,12,2,13,36,2.54708005331408,4.70673437933112,8.24296626338909,101,"ENSG00000079974.19"
"16852","ENSG00000152454.4_69",61,69,9,"ENSG00000152454.4",0,NA,"VVVVVUVVV",1,8,0.922153209109731,50,56,71,74,83,89,100,103,"CTGATTA","CCGG","GTCAGCA","CTGA",2.30424792469504,15,9,11,44,2.85453102015611,4.55404596286409,8.24265879930301,101,"ENSG00000079974.19"
"10960","ENSG00000133216.17_75470",75462,75470,9,"ENSG00000133216.17",1,6,"VVVVVMVVV",0,8,0.902691511387163,116,122,133,136,147,153,166,169,"ATGATGT","CAGA","GTGAGCT","CTGG",2.36835375311545,11,11,13,44,2.73771762998642,4.63168566268903,8.24245170823768,101,"ENSG00000079974.19"
"9569","ENSG00000125629.16_6251",6243,6251,9,"ENSG00000125629.16",1,1,"MVVVVVVVV",0,8,0.90600414078675,87,93,133,136,144,150,161,164,"ATGTTGA","CCGT","GTGTTTA","CTGA",2.47488636690108,40,8,11,68,1.97382614135459,4.61826714684044,8.24228370998744,101,"ENSG00000079974.19"
"15769","ENSG00000149452.16_5643",5635,5643,9,"ENSG00000149452.16",1,1,"MVVVVVVVV",0,8,0.90600414078675,89,95,133,136,147,153,180,183,"ATCATGA","CTAA","GTGAGGG","CTGA",2.61455585475199,38,11,27,85,1.04170206385902,4.61801860721808,8.24203517036508,101,"ENSG00000079974.19"
"9091","ENSG00000122584.13_208722",208714,208722,9,"ENSG00000122584.13",1,1,"MVVVVVVVV",0,8,0.90600414078675,75,81,95,98,115,121,133,136,"GTGATTT","CTGT","ATGTTGC","CTGA",2.41825547363702,14,17,12,52,2.35036647833753,4.61801740897942,8.24203397212642,101,"ENSG00000079974.19"
"25898","ENSG00000183060.16_15209",15201,15209,9,"ENSG00000183060.16",1,2,"VMVVVVVVV",0,8,0.884057971014493,110,116,133,136,142,148,162,165,"TTGAAGA","CTGA","GTGATCA","CTGG",2.4313363071964,17,6,14,46,2.61427567441327,4.70579609726398,8.24202798132195,101,"ENSG00000079974.19"
"25430","ENSG00000181381.15_50599",50591,50599,9,"ENSG00000181381.15",1,1,"MVVVVVVVV",0,8,0.90600414078675,116,122,133,136,153,159,172,175,"GTTATGA","GTGG","GTCAAGA","CTGA",2.42232429421924,11,17,13,50,2.32281586714079,4.61791112381727,8.24192768696427,101,"ENSG00000079974.19"
"5921","ENSG00000107249.24_334426",334418,334426,9,"ENSG00000107249.24",0,NA,"VVUVVVVVV",1,8,0.883643892339545,115,121,133,136,151,157,166,169,"ATGAAGA","CTCC","TTGAGCA","CTGA",2.44058245587375,12,15,9,45,2.55863203067095,4.70729543412399,8.24187100348217,101,"ENSG00000079974.19"
"42449","ENSG00000263317.1_119802",119794,119802,9,"ENSG00000263317.1",1,8,"VVVVVUVMV",1,7,0.806211180124224,82,88,100,103,115,121,133,136,"GTGATTA","GTGA","ATGATGG","CTGA",2.60067887439634,12,12,12,45,2.73009128503269,5.01698761191874,8.24183233241564,101,"ENSG00000079974.19"
"19588","ENSG00000163378.14_24384",24376,24384,9,"ENSG00000163378.14",1,8,"VVVVVVVMV",0,8,0.884057971014493,31,37,48,51,85,91,133,136,"CTGATGG","CTGA","GTGTTGT","CTGA",2.67130309561502,11,34,42,96,1.01268675007009,4.70534351354256,8.24157539760053,101,"ENSG00000079974.19"
"15575","ENSG00000148737.18_184003",183995,184003,9,"ENSG00000148737.18",1,3,"VVMVVVVVV",0,8,0.882815734989648,73,79,95,98,104,110,133,136,"GTGATGC","CTGC","GAGAGGG","CTGA",2.49859192583254,16,6,23,54,2.18047693944023,4.70943911124763,8.24070205120622,101,"ENSG00000079974.19"
"16716","ENSG00000152207.8_38574",38566,38574,9,"ENSG00000152207.8",1,7,"VVVVVVMVV",0,8,0.885300207039338,110,116,133,136,139,145,156,159,"ATGATGT","CTGA","GTTAACA","TTGA",2.44842597931761,17,3,11,40,2.47476708886333,4.69940173774518,8.24060256590253,101,"ENSG00000079974.19"
"21197","ENSG00000166813.17_47449",47441,47449,9,"ENSG00000166813.17",1,1,"MVVUVVVVV",1,7,0.786749482401656,116,122,133,136,148,154,166,169,"ATGATTA","GTGA","ATGGTGA","CTGA",2.64967936792092,11,12,12,44,2.70740943193863,5.09298463785286,8.23998256745948,101,"ENSG00000079974.19"
"9923","ENSG00000128512.24_222227",222219,222227,9,"ENSG00000128512.24",1,1,"MVVVVVVVV",0,8,0.90600414078675,95,101,133,136,145,151,168,171,"AGGATGT","TTGA","GTGACCA","CTGA",2.51849470391104,32,9,17,67,1.67158225105343,4.61538673594842,8.23940329909541,101,"ENSG00000079974.19"
"35461","ENSG00000236107.10_227973",227965,227973,9,"ENSG00000236107.10",0,NA,"VVVVUVVVV",1,8,0.889855072463768,111,117,133,136,142,148,156,159,"GTTCTGA","CTGG","ATGGAGA","CTGA",2.380765253312,16,6,8,39,2.84665549196025,4.6796059618434,8.23902625169847,101,"ENSG00000079974.19"
"29209","ENSG00000197442.11_153557",153549,153557,9,"ENSG00000197442.11",0,NA,"UVVVVVVVV",1,8,0.902691511387163,84,90,133,136,150,156,170,173,"CTGATGA","CGTA","GTGAAAA","CTGA",2.55271932800843,43,14,14,80,1.49465638899656,4.62819631059652,8.23896235614518,101,"ENSG00000079974.19"
"14935","ENSG00000146243.14_54839",54831,54839,9,"ENSG00000146243.14",1,1,"MVVVVVVVV",0,8,0.90600414078675,90,96,133,136,164,170,185,188,"ATGAAGA","ATGA","GTGAAAA","CTGA",2.63471976433365,37,28,15,89,0.894798364167929,4.61489919826474,8.23891576141173,101,"ENSG00000079974.19"
"39307","ENSG00000253438.5_72751",72743,72751,9,"ENSG00000253438.5",1,7,"UVVVVVMVV",1,7,0.787991718426501,116,122,133,136,149,155,164,167,"ATGATGA","TTGG","GTGTTGG","CTGA",2.64935741044549,11,13,9,42,2.68499463647624,5.08684434319487,8.23881121690088,101,"ENSG00000079974.19"
"41597","ENSG00000259345.7_248626",248618,248626,9,"ENSG00000259345.7",1,2,"VMVVVVVVV",0,8,0.884057971014493,108,114,133,136,146,152,162,165,"ATGAGGT","TTTA","ATGAAGA","CTGA",2.45000437044355,19,10,10,48,2.47686204250345,4.70255612803178,8.23878801208975,101,"ENSG00000079974.19"
"8701","ENSG00000120306.11_103787",103779,103787,9,"ENSG00000120306.11",1,7,"VVVVVVMVV",0,8,0.885300207039338,115,121,133,136,148,154,167,170,"GTGATAC","CAGA","CTGGAGA","CTGA",2.41475609008545,12,12,13,46,2.68924888045263,4.69690570358891,8.23810653174626,101,"ENSG00000079974.19"
"31167","ENSG00000217539.2_60",52,60,9,"ENSG00000217539.2",1,8,"VVVVVVVMV",0,8,0.884057971014493,14,20,30,33,41,47,62,65,"GTGCAGA","CTTA","CTGCTGA","CTGA",2.40999336591644,10,8,15,42,2.74045106834555,4.70176837694713,8.2380002610051,101,"ENSG00000079974.19"
"3359","ENSG00000082996.20_103735",103727,103735,9,"ENSG00000082996.20",1,2,"VMVVVVVVV",0,8,0.884057971014493,69,75,99,102,110,116,133,136,"ATGGTGA","CAGA","GTAAACA","CTGA",2.53558646306605,24,8,17,58,1.90224390984672,4.7015384159051,8.23777029996307,101,"ENSG00000079974.19"
"32833","ENSG00000228043.5_79428",79420,79428,9,"ENSG00000228043.5",1,1,"MVVVVUVVV",1,7,0.82815734989648,115,121,133,136,145,151,163,166,"ATGATCT","CTGT","GTGAAGT","CTGA",2.51567561563859,12,9,12,42,2.92620981779387,4.92434514717944,8.23697454676536,101,"ENSG00000079974.19"
"8443","ENSG00000118946.12_46591",46583,46591,9,"ENSG00000118946.12",1,8,"VVVVVVVMV",0,8,0.884057971014493,114,120,133,136,150,156,165,168,"GTTATGG","TTGA","CTGAGTA","CTGA",2.42679688400221,13,14,9,45,2.62306899651252,4.70042872246514,8.23666060652311,101,"ENSG00000079974.19"
"28931","ENSG00000196739.15_31850",31842,31850,9,"ENSG00000196739.15",1,5,"VVVVMVVVV",0,8,0.886542443064182,79,85,96,99,110,116,133,136,"AAGATGT","GTGA","GTGGTCC","CTGA",2.43783662583162,11,11,17,48,2.50935208188324,4.69039906352351,8.23656883578024,101,"ENSG00000079974.19"
"27590","ENSG00000186615.12_14869",14861,14869,9,"ENSG00000186615.12",1,2,"VMVVVUVVV",1,7,0.806211180124223,71,77,84,87,92,98,133,136,"ATGATGA","CAGA","GTGCTGG","CTGA",2.76756894175151,7,5,35,56,1.59624172539898,5.01167533426893,8.23652005476583,101,"ENSG00000079974.19"
"44208","ENSG00000279633.1_1092",1084,1092,9,"ENSG00000279633.1",1,2,"VMVVVVVVV",0,8,0.884057971014493,83,89,101,104,112,118,133,136,"CTAATGG","TTGA","CTGAAAA","CTGA",2.39826782565663,12,8,15,44,2.81258156631618,4.7002584343401,8.23649031839807,101,"ENSG00000079974.19"
"46672","ENSG00000287042.3_139488",139480,139488,9,"ENSG00000287042.3",1,5,"VVVVMVVVV",0,8,0.886542443064182,57,63,81,84,116,122,133,136,"ATGATGA","CAGA","CTGATGG","ATGA",2.56100523518781,18,32,11,70,1.68735325414792,4.69018037218332,8.23635014444005,101,"ENSG00000079974.19"
"2687","ENSG00000077279.20_90289",90281,90289,9,"ENSG00000077279.20",1,3,"VVMVVVVVV",0,8,0.882815734989648,113,119,133,136,143,149,157,160,"TTCATGT","CTAA","CTGCAGA","CTGA",2.37244688357192,14,7,8,38,3.00386870971515,4.70504531671532,8.23630825667392,101,"ENSG00000079974.19"
"9030","ENSG00000122367.21_29174",29166,29174,9,"ENSG00000122367.21",0,NA,"VVVUVVVVV",1,8,0.880745341614907,108,114,133,136,179,185,199,202,"CTGATGC","CTGC","GTGAAGA","CTGA",2.60997648876527,19,43,14,85,1.45220967235526,4.7130132326976,8.23599459915722,101,"ENSG00000079974.19"
"47773","ENSG00000289258.1_41441",41433,41441,9,"ENSG00000289258.1",0,NA,"VVVUVVVVV",1,8,0.880745341614907,108,114,133,136,179,185,199,202,"CTGATGC","CTGC","GTGAAGA","CTGA",2.60997648876527,19,43,14,85,1.45220967235526,4.7130132326976,8.23599459915722,101,"ENSG00000079974.19"
"27810","ENSG00000187391.22_593731",593723,593731,9,"ENSG00000187391.22",1,1,"MVVVVVVVV",0,8,0.90600414078675,90,96,133,136,165,171,186,189,"ATGAAGA","ATGA","GTGAAAA","CTGA",2.63471976433365,37,29,15,90,0.88271924969423,4.61187941964631,8.23589598279331,101,"ENSG00000079974.19"
"13055","ENSG00000139973.18_177927",177919,177927,9,"ENSG00000139973.18",1,1,"MVVVVVVVV",0,8,0.90600414078675,49,55,65,68,111,117,133,136,"ATGATGA","TTGA","CTGAAGT","CTGT",2.51468036179394,10,43,16,78,1.6818203023021,4.61158901189876,8.23560557504576,101,"ENSG00000079974.19"
"4423","ENSG00000100505.14_80253",80245,80253,9,"ENSG00000100505.14",1,8,"VVVVVVVMV",0,8,0.884057971014493,102,108,133,136,143,149,157,160,"ATGATGA","CTGG","GTGGTGG","CTGT",2.49634451969402,25,7,8,49,2.15309983959121,4.69884915938784,8.23508104344581,101,"ENSG00000079974.19"
"43424","ENSG00000271860.9_710192",710184,710192,9,"ENSG00000271860.9",1,2,"VMVVVVVVV",0,8,0.884057971014493,69,75,84,87,108,114,133,136,"TTGAAGA","CTAA","GTGAGGA","CTGA",2.57163203158161,9,21,19,58,1.64989669841545,4.69852756057321,8.23475944463118,101,"ENSG00000079974.19"
"26550","ENSG00000184408.10_148198",148190,148198,9,"ENSG00000184408.10",1,8,"VVVVVVVMV",0,8,0.884057971014493,115,121,133,136,142,148,165,168,"ATGATGC","GTGT","GCCAGGA","CTGA",2.41529180287706,12,6,17,44,2.69027341612019,4.69805469215848,8.23428657621645,101,"ENSG00000079974.19"
"35465","ENSG00000236107.10_259296",259288,259296,9,"ENSG00000236107.10",1,2,"VMVVVUVVV",1,7,0.806211180124223,110,116,133,136,145,151,161,164,"ATGATCT","CTGA","CTGAGAA","CTGA",2.59882114383261,17,9,10,45,2.711575168361,5.0092623651446,8.2341070856415,101,"ENSG00000079974.19"
"19647","ENSG00000163558.13_14763",14755,14763,9,"ENSG00000163558.13",0,NA,"VVVVVVUVV",1,8,0.886128364389234,116,122,133,136,147,153,162,165,"ATGATGA","GTAA","CTGAAGT","GTGA",2.38732390059244,11,11,9,40,2.84164240492455,4.6892837688852,8.23379722644214,101,"ENSG00000079974.19"
"16257","ENSG00000151240.17_29787",29779,29787,9,"ENSG00000151240.17",1,1,"MVVVVVVVV",0,8,0.90600414078675,109,115,133,136,149,155,167,170,"ATGATGA","CTGG","AGGAAGG","CTCA",2.41776705830406,18,13,12,52,2.31884957010788,4.60932415636707,8.23334071951407,101,"ENSG00000079974.19"
"40321","ENSG00000255532.2_14659",14651,14659,9,"ENSG00000255532.2",1,8,"VVVVVVVMV",0,8,0.884057971014493,114,120,133,136,142,148,195,198,"AAGATGA","CTAA","GAGAGCA","CTGA",2.5205280981669,13,6,47,75,1.98419309534189,4.69692843744697,8.23316032150494,101,"ENSG00000079974.19"
"20302","ENSG00000164619.10_39670",39662,39670,9,"ENSG00000164619.10",0,NA,"VVVVVUVVV",1,8,0.922153209109731,42,48,82,85,96,102,133,136,"TTGGTGA","CTGA","TTGCTGT","CTGA",2.58348522525701,34,11,31,85,0.954447594759784,4.54442060745164,8.23303344389056,101,"ENSG00000079974.19"
"30425","ENSG00000204956.6_4947",4939,4947,9,"ENSG00000204956.6",1,1,"MVVVVVVVV",0,8,0.90600414078675,111,117,133,136,150,156,172,175,"CTGATTA","CAGA","ATAAAAA","CTGA",2.43244131677297,16,14,16,55,2.21925416276112,4.60888240197856,8.23289896512556,101,"ENSG00000079974.19"
"23561","ENSG00000173226.17_6179",6171,6179,9,"ENSG00000173226.17",1,8,"VVVVVVVMV",0,8,0.884057971014493,72,78,88,91,112,118,133,136,"ATGAAGC","CAGA","CTGCTGA","CTGA",2.52176151647161,10,21,15,55,1.97481191241962,4.69663883889092,8.2328707229489,101,"ENSG00000079974.19"
"41814","ENSG00000259783.6_510",502,510,9,"ENSG00000259783.6",1,1,"MVVVVVVVV",0,8,0.90600414078675,100,106,133,136,147,153,208,211,"TTGATGA","CTGT","ATGCTCA","CTGA",2.62421406764034,27,11,55,102,0.938528847922671,4.60832232471457,8.23233888786157,101,"ENSG00000079974.19"
"21336","ENSG00000167178.17_492",484,492,9,"ENSG00000167178.17",1,1,"MVVVVVVVV",0,8,0.90600414078675,100,106,133,136,147,153,209,212,"TTGATGA","CTGT","ATGCTCA","CTGA",2.62421406764034,27,11,56,103,0.938356558169168,4.60827925227619,8.23229581542319,101,"ENSG00000079974.19"
"30073","ENSG00000203506.5_89347",89339,89347,9,"ENSG00000203506.5",1,1,"MVVVVVVVV",0,8,0.90600414078675,89,95,105,108,114,120,133,136,"ATCTTGC","CTCA","GTGAGGG","CTGA",2.33250913615615,10,6,13,38,2.88206473513312,4.60803141071019,8.23204797385719,101,"ENSG00000079974.19"
"15605","ENSG00000148935.12_75004",74996,75004,9,"ENSG00000148935.12",1,7,"VVVVVVMVV",0,8,0.885300207039338,34,40,77,80,115,121,133,136,"ATGAGGA","TTGA","CTGAGGA","CTGA",2.66713172969829,37,35,12,93,0.982291392881917,4.69079239771763,8.23199322587498,101,"ENSG00000079974.19"
"13712","ENSG00000143228.13_73386",73378,73386,9,"ENSG00000143228.13",1,2,"VMVVVVVVV",0,8,0.884057971014493,103,109,133,136,147,153,168,171,"GTGATAA","CTGT","ATGAGAA","CTGA",2.53678183786293,24,11,15,59,1.87017893974065,4.69551446470671,8.23174634876468,101,"ENSG00000079974.19"
"35228","ENSG00000235437.10_174101",174093,174101,9,"ENSG00000235437.10",1,2,"VMVVVVVVV",0,8,0.884057971014493,57,63,96,99,105,111,133,136,"ATGAGGA","CTGA","GTGATGA","TTGA",2.60596850110898,33,6,22,70,1.40831883053255,4.69536054281478,8.23159242687275,101,"ENSG00000079974.19"
"3914","ENSG00000090905.19_116600",116592,116600,9,"ENSG00000090905.19",1,1,"MVVVVVVVV",0,8,0.90600414078675,112,118,133,136,171,177,185,188,"ATGATTA","AAGA","ATAAGGA","CTGA",2.47801313817428,15,35,8,67,1.90949294194974,4.60739513244456,8.23141169559156,101,"ENSG00000079974.19"
"6253","ENSG00000109016.18_11436",11428,11436,9,"ENSG00000109016.18",1,7,"VVVVVVMVV",0,8,0.885300207039338,113,119,133,136,146,152,164,167,"ATGCTGA","GTCA","AAGAAAA","CTGA",2.39014348843687,14,10,12,45,2.82619369388064,4.69012090419827,8.23132173235562,101,"ENSG00000079974.19"
"11738","ENSG00000135951.16_133394",133386,133394,9,"ENSG00000135951.16",0,NA,"VVVVUVVVV",1,8,0.889855072463768,88,94,108,111,115,121,133,136,"ATAATTA","ATCA","ATGTTGA","CTGA",2.38239452924488,14,4,12,39,2.80452374081856,4.6717884839461,8.23120877380117,101,"ENSG00000079974.19"
"6878","ENSG00000112182.16_334488",334480,334488,9,"ENSG00000112182.16",1,8,"VVVVVVVMV",0,8,0.884057971014493,114,120,133,136,146,152,169,172,"CTGAGGA","CAGA","ATATTGT","CTGA",2.42780737134201,13,10,17,49,2.59264543972174,4.69450697883378,8.23073886289175,101,"ENSG00000079974.19"
"37520","ENSG00000248360.7_381226",381218,381226,9,"ENSG00000248360.7",1,1,"MVVVVVVVV",0,8,0.90600414078675,115,121,133,136,140,146,157,160,"AGGATTA","CAAA","ATGATTC","CTGA",2.32500171099739,12,4,11,36,2.92626049687161,4.60656797588023,8.23058453902722,101,"ENSG00000079974.19"
"21707","ENSG00000168710.18_37891",37883,37891,9,"ENSG00000168710.18",1,6,"VVVVVMVVV",0,8,0.902691511387163,90,96,108,111,112,118,133,136,"GTGCTGA","TTGA","GCCATTA","CTGA",2.4384933568512,12,1,15,37,2.22180717497103,4.61960738849476,8.23037343404341,101,"ENSG00000079974.19"
"47958","ENSG00000289809.2_22367",22359,22367,9,"ENSG00000289809.2",0,NA,"VVVVVUVVV",1,8,0.922153209109731,106,112,133,136,141,147,165,168,"ATTATAA","GTGA","CTGCTGG","CTGA",2.42841584963905,21,5,18,53,1.97748604430352,4.5417312604743,8.23034409691322,101,"ENSG00000079974.19"
"3443","ENSG00000084070.12_21318",21310,21318,9,"ENSG00000084070.12",1,1,"MVVVVVVVV",0,8,0.90600414078675,116,122,133,136,165,171,186,189,"AAGAAGA","ATGA","GTGAAAA","CTGA",2.48581362460182,11,29,15,64,1.85315334787354,4.60631104463809,8.23032760778509,101,"ENSG00000079974.19"
"25649","ENSG00000182348.7_270439",270431,270439,9,"ENSG00000182348.7",1,8,"VVVVVVVMV",0,8,0.884057971014493,111,117,133,136,139,145,162,165,"GTGATCA","CAGG","CTGAAGA","CTGA",2.47996184865218,16,3,17,45,2.24241190716345,4.69387272454449,8.23010460860246,101,"ENSG00000079974.19"
"39213","ENSG00000253311.3_5705",5697,5705,9,"ENSG00000253311.3",1,8,"VVVVVVVMV",0,8,0.884057971014493,86,92,106,109,114,120,133,136,"ATGATAA","ATGA","CTGATCA","CTGG",2.39048172336396,14,5,13,41,2.83865348206628,4.69379957612317,8.23003146018114,101,"ENSG00000079974.19"
"1396","ENSG00000054983.17_10800",10792,10800,9,"ENSG00000054983.17",1,1,"MVVVVVVVV",0,8,0.90600414078675,79,85,95,98,114,120,133,136,"ATGATGA","TTGA","ATCATTG","CTGC",2.41417360503718,10,16,13,48,2.32891002623397,4.60585018162047,8.22986674476747,101,"ENSG00000079974.19"
"17879","ENSG00000155657.29_238041",238033,238041,9,"ENSG00000155657.29",1,3,"VVMVVVVVV",0,8,0.882815734989648,116,122,133,136,146,152,163,166,"TTGGTGA","CTCA","GCAAGGA","CTGA",2.38659954890482,11,10,11,41,2.88295945323706,4.69840577815063,8.22966871810922,101,"ENSG00000079974.19"
"46669","ENSG00000287021.1_61500",61492,61500,9,"ENSG00000287021.1",1,6,"VVVVVMVVV",0,8,0.902691511387163,71,77,88,91,100,106,133,136,"ATGATGA","CTTA","GTGACAT","CTTA",2.45163416142765,11,9,27,56,2.12895642096938,4.6182960409551,8.22906208650375,101,"ENSG00000079974.19"
"22009","ENSG00000169604.21_19049",19041,19049,9,"ENSG00000169604.21",1,8,"VVVVVVVMV",0,8,0.884057971014493,108,114,133,136,159,165,181,184,"ATAATGA","GAGA","GTGAAGA","CTGA",2.58942371593614,19,23,16,67,1.50845641437831,4.69282029682148,8.22905218087945,101,"ENSG00000079974.19"
"15637","ENSG00000148948.8_519635",519627,519635,9,"ENSG00000148948.8",1,1,"MVVVVVVVV",0,8,0.90600414078675,91,97,103,106,113,119,133,136,"TGGATGA","CTGA","ATGAGGT","ATGA",2.39356962851802,6,7,14,36,2.46135717733052,4.60462200852934,8.22863857167633,101,"ENSG00000079974.19"
"18788","ENSG00000158486.15_154380",154372,154380,9,"ENSG00000158486.15",1,7,"VVVVVVMVV",0,8,0.885300207039338,86,92,102,105,114,120,133,136,"GAGATGA","AAGA","GTGGTCT","CTGA",2.39045603714241,10,9,13,41,2.81318230505451,4.68738897150097,8.22858979965832,101,"ENSG00000079974.19"
"37639","ENSG00000248587.8_81451",81443,81451,9,"ENSG00000248587.8",1,5,"VVVVMVVVV",0,8,0.886542443064182,112,118,133,136,141,147,160,163,"ATCAGGA","CTGT","ATGAGTT","CTGA",2.39268517857131,15,5,13,42,2.77747826044877,4.68217819606438,8.22834796832111,101,"ENSG00000079974.19"
"2542","ENSG00000075643.6_63426",63418,63426,9,"ENSG00000075643.6",1,1,"MVVVVVVVV",0,8,0.90600414078675,113,119,133,136,146,152,168,171,"ATAATTA","CTTT","ATGTTGA","CTGA",2.3692531024614,14,10,16,49,2.62183404791356,4.60421368274739,8.22823024589439,101,"ENSG00000079974.19"
"37925","ENSG00000249209.2_252132",252124,252132,9,"ENSG00000249209.2",0,NA,"VVVVVUVVV",1,8,0.922153209109731,112,118,133,136,151,157,170,173,"CTGATTA","ATAA","GAGATGC","CTGA",2.36582669291883,15,15,13,52,2.38271534722955,4.53872332500544,8.22733616144436,101,"ENSG00000079974.19"
"1441","ENSG00000056097.16_10397",10389,10397,9,"ENSG00000056097.16",1,8,"VVVVVVVMV",0,8,0.884057971014493,114,120,133,136,146,152,198,201,"AAGATGA","CCGC","ATGATAA","CTGA",2.52953957365991,13,10,46,78,1.8997700329589,4.69084179767291,8.22707368173088,101,"ENSG00000079974.19"
"5732","ENSG00000106536.21_171103",171095,171103,9,"ENSG00000106536.21",1,8,"VVVVVUVMV",1,7,0.806211180124224,116,122,133,136,177,183,193,196,"TTGCTGA","CTGA","TTGATGA","CTGA",2.70412337399149,11,41,10,71,1.98078321785632,5.0020680944499,8.2269128149468,101,"ENSG00000079974.19"
"40650","ENSG00000257261.7_259414",259406,259414,9,"ENSG00000257261.7",0,NA,"VVVVVUVVV",1,8,0.922153209109731,114,120,133,136,141,147,162,165,"GGGAAGA","CAGA","AGGCTGC","CTGA",2.30829187180931,13,5,15,42,2.7615897979202,4.53755056916223,8.22616340560115,101,"ENSG00000079974.19"
"43564","ENSG00000272369.1_105345",105337,105345,9,"ENSG00000272369.1",0,NA,"VVVVVUVVV",1,8,0.922153209109731,114,120,133,136,141,147,162,165,"GGGAAGA","CAGA","AGGCTGC","CTGA",2.30829187180931,13,5,15,42,2.7615897979202,4.53755056916223,8.22616340560115,101,"ENSG00000079974.19"
"31741","ENSG00000224609.8_145673",145665,145673,9,"ENSG00000224609.8",1,8,"VVVVVVVMV",0,8,0.884057971014493,113,119,133,136,157,163,176,179,"AGGATGT","CTGT","ATGGAGA","CTGA",2.49571707647133,14,21,13,57,2.12138720220059,4.6898752613357,8.22610714539367,101,"ENSG00000079974.19"
"28158","ENSG00000188283.12_28928",28920,28928,9,"ENSG00000188283.12",0,NA,"VVVVVUVVV",1,8,0.922153209109731,113,119,133,136,149,155,172,175,"ATGATGA","CAGC","AGGAAGA","CTAA",2.36883183944941,14,13,17,53,2.35582780618232,4.53701001729459,8.22562285373352,101,"ENSG00000079974.19"
"20940","ENSG00000166006.14_59911",59903,59911,9,"ENSG00000166006.14",1,7,"VVVVVVMVV",0,8,0.885300207039338,106,112,133,136,150,156,168,171,"ATGTTCA","CTGA","ATGAAAT","CTGA",2.51197542152244,21,14,12,56,1.99066693307879,4.6842924358071,8.22549326396445,101,"ENSG00000079974.19"
"27209","ENSG00000185737.13_808742",808734,808742,9,"ENSG00000185737.13",1,8,"VVVVVVVMV",0,8,0.884057971014493,110,116,133,136,138,144,159,162,"GTGCTGT","CTGA","GTGCTAT","CTGA",2.49702782572622,17,2,15,43,2.10970862370361,4.68914019880294,8.22537208286091,101,"ENSG00000079974.19"
"30352","ENSG00000204740.11_197682",197674,197682,9,"ENSG00000204740.11",1,8,"VVVVVVVMV",0,8,0.884057971014493,116,122,133,136,143,149,157,160,"ATGAAGG","TGGA","TTGATCT","CTGA",2.35020094170921,11,7,8,35,3.08659389029706,4.68865004208962,8.22488192614759,101,"ENSG00000079974.19"
"22480","ENSG00000170624.14_413553",413545,413553,9,"ENSG00000170624.14",0,NA,"UVVVVVUVV",2,7,0.788819875776397,81,87,102,105,116,122,133,136,"ATGCTGA","CTGA","AGGTAGA","CTGA",2.63147661599496,15,11,11,46,2.73446683986213,5.06941106995714,8.22469057306273,101,"ENSG00000079974.19"
"7056","ENSG00000112584.14_74878",74870,74878,9,"ENSG00000112584.14",1,8,"VVVVVVVMV",0,8,0.884057971014493,84,90,133,136,149,155,168,171,"ATGCTGA","CAGA","GTGAACT","CTGA",2.57092055774648,43,13,13,78,1.61377022562834,4.68831015265121,8.22454203670918,101,"ENSG00000079974.19"
"38675","ENSG00000250842.1_14025",14017,14025,9,"ENSG00000250842.1",1,1,"MVVVVVVVV",0,8,0.90600414078675,114,120,133,136,145,151,173,176,"GTGAAGA","CAGT","GGGATTA","CTGA",2.40711922598954,13,9,22,53,2.35395841980873,4.60035498160141,8.22437154474841,101,"ENSG00000079974.19"
"41440","ENSG00000259040.5_85356",85348,85356,9,"ENSG00000259040.5",1,7,"VVVVVVMVV",0,8,0.885300207039338,72,78,88,91,97,103,133,136,"CTCATGA","GTGA","GTCAGGA","CTGA",2.50528796478525,10,6,30,55,2.02974451275361,4.68291606949715,8.2241168976545,101,"ENSG00000079974.19"
"31692","ENSG00000224445.3_41467",41459,41467,9,"ENSG00000224445.3",1,7,"VVVVVVMVV",0,8,0.885300207039338,115,121,133,136,169,175,187,190,"ACGAGGA","GTGA","ATGTTGA","CTGA",2.51162540446558,12,33,12,66,1.98736381850633,4.68288329540255,8.2240841235599,101,"ENSG00000079974.19"
"15613","ENSG00000148948.8_1104027",1104019,1104027,9,"ENSG00000148948.8",0,NA,"VVUVUVVVV",2,7,0.773498964803312,88,94,101,104,112,118,133,136,"GTGATCA","CTGA","ATGATAA","CTGA",2.70874867678193,7,8,15,39,2.46028092755748,5.12965135985926,8.22364721907251,101,"ENSG00000079974.19"
"14008","ENSG00000144229.13_573905",573897,573905,9,"ENSG00000144229.13",0,NA,"VVVVVUVVV",1,8,0.922153209109731,113,119,133,136,145,151,170,173,"ATGAAGC","CAGT","GGGATGG","CTGA",2.34739977206137,14,9,19,51,2.49023352917344,4.53489133572897,8.2235041721679,101,"ENSG00000079974.19"
"41258","ENSG00000258751.2_93036",93028,93036,9,"ENSG00000258751.2",1,8,"VVVVVVVMV",0,8,0.884057971014493,111,117,133,136,174,180,220,223,"ATTATGA","CAGA","GTGTTGA","CTGA",2.68172397760953,16,38,40,103,0.869500813122804,4.68691516596325,8.22314705002122,101,"ENSG00000079974.19"
"36181","ENSG00000238169.2_6624",6616,6624,9,"ENSG00000238169.2",1,8,"VVVVVVVMV",0,8,0.884057971014493,113,119,133,136,157,163,181,184,"GAGATGA","CAGA","CTGCTGT","CTGA",2.53630082200862,14,21,18,62,1.83831445854273,4.68674665131672,8.22297853537469,101,"ENSG00000079974.19"
"9584","ENSG00000125676.20_121661",121653,121661,9,"ENSG00000125676.20",0,NA,"VVVVVUVVV",1,8,0.922153209109731,102,108,133,136,142,148,192,195,"TTGATGT","TTGA","GTCATGT","CTGA",2.54591839833588,25,6,44,84,1.16467060203448,4.53436498106842,8.22297781750734,101,"ENSG00000079974.19"
"27775","ENSG00000187323.12_86000",85992,86000,9,"ENSG00000187323.12",0,NA,"VVVVVVUVV",1,8,0.886128364389234,114,120,133,136,162,168,183,186,"ATGATGG","GTGT","ATGAGAA","CTGA",2.5193328035637,13,26,15,63,1.91702696284873,4.67814474665169,8.22265820420862,101,"ENSG00000079974.19"
"41844","ENSG00000259846.1_209786",209778,209786,9,"ENSG00000259846.1",0,NA,"UVVVVVVVV",1,8,0.902691511387163,102,108,133,136,140,146,156,159,"ATGATTA","CACA","TTGAAAA","CTGA",2.46540130074235,25,4,10,48,2.01133505668868,4.61183593207609,8.22260197762474,101,"ENSG00000079974.19"
"30668","ENSG00000206384.11_20945",20937,20945,9,"ENSG00000206384.11",1,8,"VVVVVVVMV",0,8,0.884057971014493,113,119,133,136,143,149,164,167,"ATGATAT","CTGG","ATCAGCA","CTGA",2.39371163079393,14,7,15,45,2.78701068822528,4.68627205671287,8.22250394077084,101,"ENSG00000079974.19"
"23835","ENSG00000174437.18_60094",60086,60094,9,"ENSG00000174437.18",1,7,"VVVVVVMVV",0,8,0.885300207039338,110,116,133,136,149,155,187,190,"ATGAGGA","TTCA","TTGATGA","CTGA",2.57750956685961,17,13,32,71,1.5395264445387,4.68073088923402,8.22193171739137,101,"ENSG00000079974.19"
"4321","ENSG00000100170.10_66838",66830,66838,9,"ENSG00000100170.10",1,8,"VVVVVUVMV",1,7,0.806211180124224,106,112,133,136,142,148,158,161,"AAGATGA","ATGA","AAGATGA","CTGA",2.63852610242898,21,6,10,46,2.39770287043562,4.99696922165721,8.2218139421541,101,"ENSG00000079974.19"
"19455","ENSG00000163053.11_20845",20837,20845,9,"ENSG00000163053.11",1,6,"VVVVVMVVV",0,8,0.902691511387163,103,109,133,136,142,148,199,202,"ATGATTA","CTTA","GTGCTCA","CTGA",2.5856741079676,24,6,51,90,1.203788423261,4.61040395242792,8.22116999797657,101,"ENSG00000079974.19"
"18255","ENSG00000156687.11_385958",385950,385958,9,"ENSG00000156687.11",1,8,"VVVVVVVMV",0,8,0.884057971014493,91,97,133,136,141,147,159,162,"ATGTTGA","CAAA","ATGATTA","CTGA",2.52653348492022,36,5,12,62,1.89557911437996,4.68478392012869,8.22101580418666,101,"ENSG00000079974.19"
"37622","ENSG00000248550.4_252435",252427,252435,9,"ENSG00000248550.4",1,6,"VVVVVMVVV",0,8,0.902691511387163,103,109,133,136,170,176,185,188,"AGGATGA","CTTA","AAGAAGA","CTGA",2.57992913619625,24,34,9,76,1.24076277809914,4.61007258818521,8.22083863373386,101,"ENSG00000079974.19"
"1006","ENSG00000044115.21_201284",201276,201284,9,"ENSG00000044115.21",1,6,"VVVVVMVVV",0,8,0.902691511387163,85,91,133,136,140,146,154,157,"TTGAGGA","CTAA","CTGAAGT","CTGA",2.49322927499651,42,4,8,63,1.81855706173302,4.61002139042745,8.2207874359761,101,"ENSG00000079974.19"
"27516","ENSG00000186432.10_57888",57880,57888,9,"ENSG00000186432.10",1,1,"MVVVVVVVV",0,8,0.90600414078675,111,117,133,136,152,158,174,177,"AGGATTA","ATGA","GAGATAA","CTGA",2.44527874648094,16,16,16,57,2.08504899530997,4.59672682629572,8.22074338944272,101,"ENSG00000079974.19"
"26441","ENSG00000184226.15_75442",75434,75442,9,"ENSG00000184226.15",1,1,"MVVVVVVVV",0,8,0.90600414078675,110,116,133,136,149,155,187,190,"GTGATGA","ATAA","CTCATGC","CTGA",2.5269538243728,17,13,32,71,1.5395264445387,4.59647131842267,8.22048788156967,101,"ENSG00000079974.19"
"10928","ENSG00000133119.13_140634",140626,140634,9,"ENSG00000133119.13",0,NA,"VVVVVUUVV",2,7,0.808281573498965,74,80,100,103,114,120,133,136,"ATGATGT","TTGA","GGGAAGA","CTGA",2.65570407277178,20,11,13,53,2.24474300493431,4.98735920585321,8.22048549984907,101,"ENSG00000079974.19"
"2591","ENSG00000076356.7_129218",129210,129218,9,"ENSG00000076356.7",1,6,"VVVVVMVVV",0,8,0.902691511387163,51,57,69,72,108,114,133,136,"GTGATAA","CAGA","CTGACTA","CTGA",2.52685441591657,12,36,19,76,1.59181992985177,4.60937900899057,8.22014505453922,101,"ENSG00000079974.19"
"33713","ENSG00000230873.9_21891",21883,21891,9,"ENSG00000230873.9",1,1,"MVVVVVVVV",0,8,0.90600414078675,109,115,133,136,137,143,152,155,"GTTATGA","GAGA","ATGAATA","CTGA",2.44722873558176,18,1,9,37,2.06953411318097,4.59609808759817,8.22011465074517,101,"ENSG00000079974.19"
"18131","ENSG00000156218.13_344082",344074,344082,9,"ENSG00000156218.13",1,1,"MVVVVVVVV",0,8,0.90600414078675,97,103,133,136,144,150,196,199,"ATGATGA","AGGA","AGGCTGA","CTGA",2.60201413083922,30,8,46,93,1.0361964618872,4.59573933353717,8.21975589668417,101,"ENSG00000079974.19"
"29202","ENSG00000197416.5_54284",54276,54284,9,"ENSG00000197416.5",0,NA,"UVVVVUVVV",2,7,0.824844720496894,108,114,133,136,141,147,158,161,"AGGATGA","ATGA","TTGCTCA","CTGA",2.57674314357033,19,5,11,44,2.50276775571577,4.9202638448795,8.21964272686708,101,"ENSG00000079974.19"
"9835","ENSG00000127616.21_25210",25202,25210,9,"ENSG00000127616.21",1,2,"VMVVVVVVV",0,8,0.884057971014493,112,118,133,136,143,149,162,165,"GGGAAGA","CAGA","CTGCCGA","CTGA",2.38430538532282,15,7,13,44,2.83729252071384,4.68316543904982,8.2193973231078,101,"ENSG00000079974.19"
"13470","ENSG00000141526.18_4580",4572,4580,9,"ENSG00000141526.18",1,1,"MVVVVVVVV",0,8,0.90600414078675,102,108,133,136,148,154,204,207,"ATGAGGA","ATGA","GTGGTGG","CTGA",2.61586092666748,25,12,50,96,0.940112812972218,4.59479641435551,8.21881297750251,101,"ENSG00000079974.19"
"11639","ENSG00000135597.19_72239",72231,72239,9,"ENSG00000135597.19",1,8,"VVVVVVVMV",0,8,0.884057971014493,112,118,133,136,147,153,198,201,"ATGTTTA","CTGA","ATGACCA","CTGA",2.54674834061302,15,11,45,80,1.75193761316873,4.68256497098055,8.21879685503852,101,"ENSG00000079974.19"
"33196","ENSG00000228999.4_210472",210464,210472,9,"ENSG00000228999.4",1,7,"VVVVVVMVV",0,8,0.885300207039338,83,89,97,100,115,121,133,136,"CTGAAGA","ATGA","CAGATGG","CTGA",2.46864099590397,8,15,12,44,2.25170591514295,4.67732813862568,8.21852896678303,101,"ENSG00000079974.19"
"21328","ENSG00000167139.9_4382",4374,4382,9,"ENSG00000167139.9",0,NA,"VVVVVUVVV",1,8,0.922153209109731,107,113,133,136,146,152,164,167,"CTGATAA","TAGA","ATACTGA","CTGA",2.36587783485174,20,10,12,51,2.34710825270671,4.52990678792957,8.2185196243685,101,"ENSG00000079974.19"
"15","ENSG00000001460.18_54984",54976,54984,9,"ENSG00000001460.18",1,5,"VVVVMVVVV",0,8,0.886542443064182,114,120,133,136,142,148,173,176,"ATGATTC","CAGA","CTGACAA","CTGA",2.46530689450667,13,6,25,53,2.25263884457577,4.67200453532172,8.21817430757845,101,"ENSG00000079974.19"
"36687","ENSG00000242593.8_92249",92241,92249,9,"ENSG00000242593.8",1,2,"VMVVVVVVV",0,8,0.884057971014493,81,87,100,103,115,121,133,136,"ATGCTTA","CTGG","GTGTGGT","CTGA",2.40061590848376,13,12,12,46,2.7236491260237,4.68193879564552,8.21817067970349,101,"ENSG00000079974.19"
"34977","ENSG00000234556.1_5612",5604,5612,9,"ENSG00000234556.1",1,1,"MVVVVVVVV",0,8,0.90600414078675,79,85,100,103,112,118,133,136,"ACTATGC","TTGA","CTTATGA","CTGA",2.35446811557252,15,9,15,48,2.67899429046649,4.59386209857082,8.21787866171782,101,"ENSG00000079974.19"
"13913","ENSG00000143924.19_51360",51352,51360,9,"ENSG00000143924.19",1,7,"VVVVVVMVV",0,8,0.885300207039338,96,102,133,136,180,186,197,200,"ATGATGA","GAGA","ATGCAGA","CTGA",2.65259784189697,31,44,11,95,1.02114359772873,4.67628230259379,8.21748313075114,101,"ENSG00000079974.19"
"41016","ENSG00000258394.1_18067",18059,18067,9,"ENSG00000258394.1",1,2,"VMVVVVVVV",0,8,0.884057971014493,84,90,133,136,142,148,160,163,"CTGATGA","CAAA","CTGATAC","CTGA",2.51712373554488,43,6,12,70,1.94232581758066,4.68078768030329,8.21701956436126,101,"ENSG00000079974.19"
"14269","ENSG00000144642.22_867766",867758,867766,9,"ENSG00000144642.22",1,1,"MVVVVVVVV",0,8,0.90600414078675,112,118,133,136,153,159,207,210,"AAGATGG","GTGA","GTGCTGA","CTGA",2.55450124607995,15,17,48,89,1.34147966194838,4.59287199228702,8.21688855543402,101,"ENSG00000079974.19"
"44774","ENSG00000283563.1_1093379",1093371,1093379,9,"ENSG00000283563.1",1,1,"MVVVVVVVV",0,8,0.90600414078675,112,118,133,136,153,159,207,210,"AAGATGG","GTGA","GTGCTGA","CTGA",2.55450124607995,15,17,48,89,1.34147966194838,4.59287199228702,8.21688855543402,101,"ENSG00000079974.19"
"2596","ENSG00000076356.7_42707",42699,42707,9,"ENSG00000076356.7",0,NA,"UVVVVVVVV",1,8,0.902691511387163,116,122,133,136,157,163,173,176,"ATCATGT","CTTA","GTGCTTT","CTGA",2.43154155489583,11,21,10,51,2.21362879871143,4.60597645783757,8.21674250338622,101,"ENSG00000079974.19"
"31225","ENSG00000219545.12_124685",124677,124685,9,"ENSG00000219545.12",0,NA,"UVVVVVVVV",1,8,0.902691511387163,113,119,133,136,147,153,166,169,"TTGATGA","CTAA","ATTTTGA","CTTA",2.35537732794159,14,11,13,47,2.72089110698782,4.6058516566496,8.21661770219825,101,"ENSG00000079974.19"
"44757","ENSG00000283549.1_124644",124636,124644,9,"ENSG00000283549.1",0,NA,"UVVVVVVVV",1,8,0.902691511387163,113,119,133,136,147,153,166,169,"TTGATGA","CTAA","ATTTTGA","CTTA",2.35537732794159,14,11,13,47,2.72089110698782,4.6058516566496,8.21661770219825,101,"ENSG00000079974.19"
"42199","ENSG00000261083.3_18211",18203,18211,9,"ENSG00000261083.3",1,8,"VVVVVVVMV",0,8,0.884057971014493,115,121,133,136,146,152,161,164,"GTGATGA","ATGG","CTGCTGA","ATGA",2.36870483975882,12,10,9,40,2.93011159320768,4.68036929789996,8.21660118195793,101,"ENSG00000079974.19"
"5095","ENSG00000103047.8_83216",83208,83216,9,"ENSG00000103047.8",1,1,"MVVVVVVVV",0,8,0.90600414078675,113,119,133,136,148,154,170,173,"ATGTTGG","CTTA","GTATTCA","CTGA",2.38222635004737,14,12,16,51,2.48875095851114,4.59256498970673,8.21658155285373,101,"ENSG00000079974.19"
"8571","ENSG00000119650.13_77979",77971,77979,9,"ENSG00000119650.13",0,NA,"VVVVVVUVV",1,8,0.886128364389234,113,119,133,136,141,147,155,158,"ACAATGA","GGGA","ATGAGGT","CTGA",2.35647948267651,14,5,8,36,2.97807621886246,4.67198485917646,8.21649831673339,101,"ENSG00000079974.19"
"21567","ENSG00000168385.18_15762",15754,15762,9,"ENSG00000168385.18",1,2,"VMVVVVVVV",0,8,0.884057971014493,98,104,133,136,144,150,160,163,"ATGATGT","AGGA","AAGATAA","CTGA",2.50136313139235,29,8,10,56,2.0452007583321,4.68023874190362,8.21647062596159,101,"ENSG00000079974.19"
"44228","ENSG00000279894.1_545",537,545,9,"ENSG00000279894.1",1,8,"VVVVVVVMV",0,8,0.884057971014493,34,40,70,73,83,89,133,136,"GTGATGG","CTGA","CTGGTAA","CTGA",2.66549285700662,30,10,44,93,0.950914794399045,4.68021679361079,8.21644867766876,101,"ENSG00000079974.19"
"17418","ENSG00000154153.15_19353",19345,19353,9,"ENSG00000154153.15",0,NA,"VVVVVUVVV",1,8,0.922153209109731,104,110,133,136,144,150,177,180,"CTGATGT","CTTG","GTGAGGA","CTGA",2.49712729162349,23,8,27,67,1.46321056444065,4.52768146048265,8.21629429692157,101,"ENSG00000079974.19"
"40493","ENSG00000256597.3_15161",15153,15161,9,"ENSG00000256597.3",0,NA,"VVVVVUVVV",1,8,0.922153209109731,83,89,104,107,114,120,133,136,"GTAATGT","CTGA","CTGATTT","CTGG",2.29097505674341,15,7,13,44,2.83729252071384,4.52761489141747,8.21622772785639,101,"ENSG00000079974.19"
"16917","ENSG00000152689.18_115893",115885,115893,9,"ENSG00000152689.18",0,NA,"VVVVVUVVV",1,8,0.922153209109731,87,93,104,107,115,121,133,136,"CTGCTGG","TTGA","GTGATGA","CTGG",2.27366181085567,11,8,12,40,2.95261791259771,4.52759082957554,8.21620366601446,101,"ENSG00000079974.19"
"10222","ENSG00000130021.15_198817",198809,198817,9,"ENSG00000130021.15",0,NA,"VVVVVVUVV",1,8,0.886128364389234,114,120,133,136,139,145,158,161,"AAGAAGA","CACA","GTGATAA","CTGA",2.40166599919168,13,3,13,38,2.67544884834434,4.67163887740556,8.21615233496249,101,"ENSG00000079974.19"
"20217","ENSG00000164440.15_22057",22049,22057,9,"ENSG00000164440.15",1,8,"VVVVVVVMV",0,8,0.884057971014493,86,92,103,106,112,118,133,136,"AAAATGT","CTGA","AGGAAGC","CTGA",2.38785995107669,11,6,15,41,2.79987486950126,4.67973530250314,8.21596718656111,101,"ENSG00000079974.19"
"43577","ENSG00000272446.5_7240",7232,7240,9,"ENSG00000272446.5",1,8,"VVVVVVVMV",0,8,0.884057971014493,86,92,103,106,112,118,133,136,"AAAATGT","CTGA","AGGAAGC","CTGA",2.38785995107669,11,6,15,41,2.79987486950126,4.67973530250314,8.21596718656111,101,"ENSG00000079974.19"
"19037","ENSG00000160293.17_49611",49603,49611,9,"ENSG00000160293.17",0,NA,"VVVVVUVVV",1,8,0.922153209109731,113,119,133,136,146,152,190,193,"GGGATGA","CAGG","CTGAAGG","CTGA",2.4325539851606,14,10,38,71,1.89233445704308,4.5273402561951,8.21595309263402,101,"ENSG00000079974.19"
"33219","ENSG00000229066.2_13613",13605,13613,9,"ENSG00000229066.2",1,7,"VVVVVVMVV",0,8,0.885300207039338,98,104,133,136,146,152,164,167,"ATGAGGA","AAGA","GTGATTT","CTGA",2.51729811166223,29,10,12,60,1.91483113596785,4.67420463676235,8.2154054649197,101,"ENSG00000079974.19"
"12698","ENSG00000138785.16_188996",188988,188996,9,"ENSG00000138785.16",0,NA,"VVVVVUVVV",1,8,0.922153209109731,42,48,71,74,85,91,133,136,"ATGATGA","CTGA","ATGCTAG","CTAA",2.54756877413127,23,11,42,85,1.12185294683931,4.52641119359529,8.21502403003421,101,"ENSG00000079974.19"
"20763","ENSG00000165583.16_3654",3646,3654,9,"ENSG00000165583.16",1,5,"VVVVMVVVV",0,8,0.886542443064182,107,113,133,136,150,156,189,192,"GTGATGA","CTGC","TTTATCA","CTGA",2.62293687328529,20,14,33,76,1.18911538701212,4.66884030222851,8.21501007448524,101,"ENSG00000079974.19"
"45690","ENSG00000285784.1_401545",401537,401545,9,"ENSG00000285784.1",1,6,"VVVVVMVVV",0,8,0.902691511387163,95,101,133,136,144,150,169,172,"GTGATGA","AAGA","ATGGTTT","CTGA",2.52458177146883,32,8,19,68,1.58530555066471,4.60396267344756,8.21472871899621,101,"ENSG00000079974.19"
"42019","ENSG00000260364.1_130213",130205,130213,9,"ENSG00000260364.1",1,1,"MVVVVVVVV",0,8,0.90600414078675,114,120,133,136,182,188,199,202,"ATGCTGA","CTTC","GCGAAGA","CTGA",2.45678559596993,13,46,11,79,1.98349448098447,4.59051628019601,8.214532843343,101,"ENSG00000079974.19"
"12443","ENSG00000138190.17_57404",57396,57404,9,"ENSG00000138190.17",0,NA,"VVVVVUVVV",1,8,0.922153209109731,110,116,133,136,165,171,185,188,"CTGATAA","TTGA","GTGTCAA","CTGA",2.46232916337049,17,29,14,69,1.68762730845809,4.52578876606535,8.21440160250427,101,"ENSG00000079974.19"
"7052","ENSG00000112576.13_58965",58957,58965,9,"ENSG00000112576.13",1,1,"MVVVVVVVV",0,8,0.90600414078675,115,121,133,136,142,148,158,161,"ATTTTGT","ATGA","CAGCTGA","CTGA",2.29477401627437,12,6,10,37,3.06278955962705,4.59032075036405,8.21433731351105,101,"ENSG00000079974.19"
"42875","ENSG00000267225.1_5369",5361,5369,9,"ENSG00000267225.1",0,NA,"VVVUVVVVV",1,8,0.880745341614907,104,110,133,136,143,149,158,161,"GTGCTGA","ATGA","AGGAAGT","CTGA",2.47379349976633,23,7,9,48,2.27346641499958,4.69135577002712,8.21433713648674,101,"ENSG00000079974.19"
"28611","ENSG00000196227.11_14152",14144,14152,9,"ENSG00000196227.11",1,7,"VVVVVVMVV",0,8,0.885300207039338,91,97,106,109,115,121,133,136,"AAGTTGA","CTCA","TTCATCA","CTGA",2.37169457026704,9,6,12,36,2.88069458060241,4.672997928929,8.21419875708635,101,"ENSG00000079974.19"
"39785","ENSG00000254186.3_993330",993322,993330,9,"ENSG00000254186.3",1,8,"VVVVVVVMV",0,8,0.884057971014493,87,93,133,136,144,150,160,163,"ATGATGA","ATGA","CTGAAGG","CTGG",2.5082937286473,40,8,10,67,1.98802186261282,4.6774950133987,8.21372689745667,101,"ENSG00000079974.19"
"6614","ENSG00000111058.8_61837",61829,61837,9,"ENSG00000111058.8",1,8,"VVVVVVVMV",0,8,0.884057971014493,80,86,97,100,111,117,133,136,"TTTAGGA","CTGA","TTCATGT","CTGA",2.42080480268554,11,11,16,47,2.57119737585519,4.67747401510636,8.21370589916433,101,"ENSG00000079974.19"
"26598","ENSG00000184588.18_365371",365363,365371,9,"ENSG00000184588.18",0,NA,"UVVVVVVVV",1,8,0.902691511387163,108,114,133,136,151,157,170,173,"ATGATCA","ATCA","TTGATAT","CTGA",2.45429235773674,19,15,13,56,2.04979303709686,4.60293552216879,8.21370156771744,101,"ENSG00000079974.19"
"8990","ENSG00000121964.15_291748",291740,291748,9,"ENSG00000121964.15",0,NA,"VVVVUVVVV",1,8,0.889855072463768,116,122,133,136,176,182,191,194,"GTGTTGA","TTGA","CTCATCA","CTGA",2.49536461369379,11,40,9,69,1.98078869929088,4.6541381976457,8.21355848750077,101,"ENSG00000079974.19"
"20446","ENSG00000164830.19_22335",22327,22335,9,"ENSG00000164830.19",1,8,"VVVVVVVMV",0,8,0.884057971014493,101,107,133,136,154,160,171,174,"GTGATGA","TTAA","ATGAATA","CTGA",2.58244760037658,26,18,11,64,1.49212029481457,4.67710940766462,8.21334129172259,101,"ENSG00000079974.19"
"16700","ENSG00000152104.12_145658",145650,145658,9,"ENSG00000152104.12",1,3,"VVMVVVVVV",0,8,0.882815734989648,87,93,99,102,108,114,133,136,"GTGATTA","ATGA","ATGAGTT","CTGA",2.49717005424954,6,6,19,40,2.07964757995453,4.68186198540453,8.21312492536312,101,"ENSG00000079974.19"
"33192","ENSG00000228980.4_84006",83998,84006,9,"ENSG00000228980.4",1,6,"VVVVUMVVV",1,7,0.792546583850932,63,69,82,85,109,115,133,136,"ATGATGA","CTTA","GTGATAT","CTGA",2.75852364019213,13,24,18,64,1.77835675623561,5.04212858937912,8.21231492478285,101,"ENSG00000079974.19"
"3584","ENSG00000086200.17_102810",102802,102810,9,"ENSG00000086200.17",1,6,"VVVVVMVVV",0,8,0.902691511387163,115,121,133,136,145,151,168,171,"AAAATGA","CTTA","GTTATTC","CTGA",2.36316634747245,12,9,17,47,2.6511251156644,4.60139185803686,8.21215790358551,101,"ENSG00000079974.19"
"47535","ENSG00000288643.1_200576",200568,200576,9,"ENSG00000288643.1",1,6,"VVVVVMVVV",0,8,0.902691511387163,115,121,133,136,145,151,168,171,"AAAATGA","CTTA","GTTATTC","CTGA",2.36316634747245,12,9,17,47,2.6511251156644,4.60139185803686,8.21215790358551,101,"ENSG00000079974.19"
"39942","ENSG00000254530.2_225957",225949,225957,9,"ENSG00000254530.2",1,8,"VVVVVUVMV",1,7,0.806211180124224,116,122,133,136,141,147,199,202,"GTGATGA","GAGA","ATGATGA","CTGA",2.70621559161563,11,5,52,77,1.90776282192853,4.98730002484152,8.21214474533842,101,"ENSG00000079974.19"
"44218","ENSG00000279696.1_2220",2212,2220,9,"ENSG00000279696.1",1,8,"VVVVVVVMV",0,8,0.884057971014493,109,115,133,136,162,168,187,190,"ATGATCC","CTGA","GTGATTT","CTGA",2.60342111474566,18,26,19,72,1.34597978077832,4.67553013643734,8.21176202049531,101,"ENSG00000079974.19"
"707","ENSG00000027075.17_210302",210294,210302,9,"ENSG00000027075.17",1,1,"MVVVVVVVV",0,8,0.90600414078675,78,84,98,101,112,118,133,136,"TTGATGA","GTGA","CTAATGC","CAGA",2.35997416200298,14,11,15,49,2.61728620527664,4.58761182132414,8.21162838447113,101,"ENSG00000079974.19"
"20471","ENSG00000164924.18_4019",4011,4019,9,"ENSG00000164924.18",1,1,"MVVVVVVVV",0,8,0.90600414078675,114,120,133,136,148,154,166,169,"ATTATGA","GTGA","CTGATAT","CTGG",2.34394744951698,13,12,12,46,2.7236491260237,4.58749136403423,8.21150792718123,101,"ENSG00000079974.19"
"3935","ENSG00000091136.15_37989",37981,37989,9,"ENSG00000091136.15",1,2,"VMVVVVVVV",0,8,0.884057971014493,112,118,133,136,146,152,194,197,"AAGATGC","CAGA","CTGATGG","CTGA",2.5319023140264,15,10,42,76,1.82140187015379,4.67518765758245,8.21141954164042,101,"ENSG00000079974.19"
"10596","ENSG00000131773.15_191068",191060,191068,9,"ENSG00000131773.15",1,1,"MVVVVVVVV",0,8,0.90600414078675,116,122,133,136,143,149,192,195,"ATGTTGA","CTTT","GTTAGGA","CTGA",2.45451990375458,11,7,43,70,1.98594041358965,4.58735160965504,8.21136817280204,101,"ENSG00000079974.19"
"20120","ENSG00000164318.18_101843",101835,101843,9,"ENSG00000164318.18",1,7,"VVVVVVMVV",0,8,0.885300207039338,97,103,133,136,163,169,177,180,"ATGATGT","GTGA","TTGAGGC","CTGA",2.63530695475264,30,27,8,74,1.11133611898245,4.67001228766667,8.21121311582402,101,"ENSG00000079974.19"
"34882","ENSG00000234350.7_43640",43632,43640,9,"ENSG00000234350.7",1,6,"VVVVVMVVV",0,8,0.902691511387163,71,77,90,93,99,105,133,136,"CTGAGGA","TAGA","GTGAAGC","CTGA",2.43711852464174,13,6,28,56,2.15395203339379,4.60035221608468,8.21111826163333,101,"ENSG00000079974.19"
"9094","ENSG00000122591.13_31205",31197,31205,9,"ENSG00000122591.13",1,1,"MVVVVVVVV",0,8,0.90600414078675,113,119,133,136,150,156,202,205,"AGGATGA","ATGG","GTGAATA","CTGA",2.51324210341879,14,14,46,83,1.59265614507408,4.58690087529984,8.21091743844684,101,"ENSG00000079974.19"
"14730","ENSG00000145781.9_45331",45323,45331,9,"ENSG00000145781.9",1,8,"VVVVVVVMV",0,8,0.884057971014493,110,116,133,136,146,152,197,200,"GTTATGA","CTAA","GTGAGGC","CTGA",2.55570364509703,17,10,45,81,1.66057343464262,4.67464943382237,8.21088131788034,101,"ENSG00000079974.19"
"30632","ENSG00000206120.11_335050",335042,335050,9,"ENSG00000206120.11",1,3,"VVMVVVVVV",0,8,0.882815734989648,114,120,133,136,146,152,162,165,"ATCATCA","CTAA","GTTAAAA","CTGA",2.37103813316661,13,10,10,42,2.9112208143975,4.67953542554373,8.21079836550232,101,"ENSG00000079974.19"
"10667","ENSG00000132274.17_15650",15642,15650,9,"ENSG00000132274.17",1,1,"MVVVVVVVV",0,8,0.90600414078675,116,122,133,136,145,151,193,196,"GTCATGA","CCGT","CTGATGG","CTGA",2.46095353631114,11,9,42,71,1.93907381333352,4.58635768051861,8.21037424366561,101,"ENSG00000079974.19"
"39509","ENSG00000253693.1_239697",239689,239697,9,"ENSG00000253693.1",1,1,"MVVVVVVVV",0,8,0.90600414078675,109,115,133,136,145,151,167,170,"CTGAAGG","TTGA","ATGATTT","CTGA",2.39530041973625,18,9,16,52,2.37574389218883,4.58610333927429,8.21011990242128,101,"ENSG00000079974.19"
"8316","ENSG00000118217.7_12456",12448,12456,9,"ENSG00000118217.7",0,NA,"VVVVVUVVV",1,8,0.922153209109731,108,114,133,136,178,184,196,199,"AAGTTGT","CTGA","GTGAAAA","CTGA",2.48186505798318,19,42,12,82,1.53982417414485,4.52139780684151,8.21001064328043,101,"ENSG00000079974.19"
"33536","ENSG00000230155.8_7284",7276,7284,9,"ENSG00000230155.8",1,1,"MVVVVVVVV",0,8,0.90600414078675,79,85,101,104,111,117,133,136,"AACATGT","GTGA","ATGAAGG","CTGA",2.36184337782002,16,7,16,48,2.59825334375833,4.58596896563962,8.20998552878662,101,"ENSG00000079974.19"
"5472","ENSG00000104967.8_8060",8052,8060,9,"ENSG00000104967.8",1,5,"VVVVMVUVV",1,7,0.772670807453416,115,121,133,136,147,153,162,165,"CTGATGC","CTGA","ATGGTGT","CTGA",2.6428533111446,12,11,9,41,2.85804558259554,5.11926691422321,8.20995014403688,101,"ENSG00000079974.19"
"32329","ENSG00000226762.5_14275",14267,14275,9,"ENSG00000226762.5",1,2,"VMVVVVVVV",0,8,0.884057971014493,53,59,89,92,97,103,133,136,"ATGAAGA","CTGC","ATGGTGA","CTGA",2.63873502411784,30,5,30,74,1.10164382164796,4.67330266227506,8.20953454633303,101,"ENSG00000079974.19"
"40398","ENSG00000255910.2_97935",97927,97935,9,"ENSG00000255910.2",1,2,"UMVVVVVVV",1,7,0.786749482401656,76,82,95,98,109,115,133,136,"GTGATGA","GTGA","TTGCTGG","CTGA",2.66710948770196,13,11,18,51,2.46725140640158,5.06199533110366,8.20899326071028,101,"ENSG00000079974.19"
"11719","ENSG00000135905.21_269372",269364,269372,9,"ENSG00000135905.21",1,3,"VVMVVVVVV",0,8,0.882815734989648,69,75,93,96,111,117,133,136,"AAGGTGA","CTGA","ATGAAAC","CTGA",2.50973638158271,18,15,16,58,1.97868526960411,4.67756528670555,8.20882822666414,101,"ENSG00000079974.19"
"10268","ENSG00000130338.13_128517",128509,128517,9,"ENSG00000130338.13",0,NA,"VVVVUVVVV",1,8,0.889855072463768,68,74,95,98,110,116,133,136,"AAGATGG","CTGA","AGGCTGT","CTGA",2.50857707566423,21,12,17,59,1.87324612741497,4.64927332462746,8.20869361448253,101,"ENSG00000079974.19"
"43821","ENSG00000274023.1_77912",77904,77912,9,"ENSG00000274023.1",0,NA,"VVVVUVVVV",1,8,0.889855072463768,68,74,95,98,110,116,133,136,"AAGATGG","CTGA","AGGCTGT","CTGA",2.50857707566423,21,12,17,59,1.87324612741497,4.64927332462746,8.20869361448253,101,"ENSG00000079974.19"
"43534","ENSG00000272180.1_127759",127751,127759,9,"ENSG00000272180.1",1,7,"VVVVVVMVV",0,8,0.885300207039338,67,73,86,89,98,104,133,136,"ATGATGA","CAGA","TTGACAA","CTCA",2.48616812128819,13,9,29,60,2.09512994249798,4.66739602110482,8.20859684926217,101,"ENSG00000079974.19"
"40987","ENSG00000258231.5_97398",97390,97398,9,"ENSG00000258231.5",0,NA,"VVVVVVUVV",1,8,0.886128364389234,6,12,25,28,73,79,133,136,"ATGAGGA","CTGA","ATGTTTG","CTGA",2.64853003585802,13,45,54,121,0.999259819818816,4.66403168138473,8.20854513894167,101,"ENSG00000079974.19"
"45695","ENSG00000285788.1_10141",10133,10141,9,"ENSG00000285788.1",0,NA,"UVVVVVVVV",1,8,0.902691511387163,82,88,133,136,147,153,166,169,"AAGATGT","TTGA","ATGATCC","CTGA",2.49539590601293,45,11,13,78,1.75446762496708,4.59761008292998,8.20837612847863,101,"ENSG00000079974.19"
"47618","ENSG00000288720.2_56436",56428,56436,9,"ENSG00000288720.2",0,NA,"UVVVVVVVV",1,8,0.902691511387163,82,88,133,136,147,153,166,169,"AAGATGT","TTGA","ATGATCC","CTGA",2.49539590601293,45,11,13,78,1.75446762496708,4.59761008292998,8.20837612847863,101,"ENSG00000079974.19"
"41778","ENSG00000259711.1_14687",14679,14687,9,"ENSG00000259711.1",1,8,"VVVVVVVMV",0,8,0.884057971014493,66,72,86,89,116,122,133,136,"CTGATGG","CCGA","GTGGAGG","CTGA",2.49749049625095,14,27,11,61,2.03724834283111,4.67179624612603,8.208028130184,101,"ENSG00000079974.19"
"21233","ENSG00000166862.7_40853",40845,40853,9,"ENSG00000166862.7",1,1,"MVVVVVVVV",0,8,0.90600414078675,116,122,133,136,152,158,175,178,"GAGATGA","GTGC","ATGGAGA","CTGA",2.42620490396918,11,16,17,53,2.16121870476617,4.58397951614018,8.20799607928718,101,"ENSG00000079974.19"
"32003","ENSG00000225546.6_84896",84888,84896,9,"ENSG00000225546.6",1,2,"VMVVVVVVV",0,8,0.884057971014493,112,118,133,136,139,145,154,157,"ATGAGGC","CTTA","GTTATAT","CTGA",2.39630670157038,15,3,9,36,2.71154812569429,4.67173153404087,8.20796341809884,101,"ENSG00000079974.19"
"38615","ENSG00000250634.6_109196",109188,109196,9,"ENSG00000250634.6",0,NA,"VVVVUUVVV",2,7,0.812008281573499,83,89,100,103,110,116,133,136,"ATGATGA","CCTA","ATGAACT","CTGA",2.57373131109833,11,7,17,44,2.6811065779692,4.95982882965619,8.20786195595018,101,"ENSG00000079974.19"
"43745","ENSG00000273360.1_3839",3831,3839,9,"ENSG00000273360.1",1,1,"MVVVVVVVV",0,8,0.90600414078675,116,122,133,136,167,173,220,223,"GTGAGGA","GTGA","ATGATCA","CTGA",2.59688952355997,11,31,47,98,1.0221120899682,4.58367722842534,8.20769379157234,101,"ENSG00000079974.19"
"2011","ENSG00000069020.19_244575",244567,244575,9,"ENSG00000069020.19",1,7,"VVVUVVMVV",1,7,0.766045548654244,79,85,95,98,115,121,133,136,"ATGATGA","CTAA","ATGTTGT","CTGA",2.73995788654737,10,17,12,48,2.30732977446029,5.14342892119403,8.20761111581101,101,"ENSG00000079974.19"
"8972","ENSG00000121904.19_589169",589161,589169,9,"ENSG00000121904.19",1,6,"VVVVVMVVV",0,8,0.902691511387163,111,117,133,136,155,161,169,172,"AGGATCA","CTTA","ATGCTGT","CTGA",2.43691817136763,16,19,8,52,2.14107392597854,4.59679876710735,8.207564812656,101,"ENSG00000079974.19"
"24227","ENSG00000175497.17_654600",654592,654600,9,"ENSG00000175497.17",0,NA,"UVVVVVVVV",1,8,0.902691511387163,111,117,133,136,147,153,170,173,"ATTATGA","TTAA","ATCAATA","CTGA",2.40244434597539,16,11,17,53,2.37076607058593,4.59676542760547,8.20753147315413,101,"ENSG00000079974.19"
"47169","ENSG00000287737.3_3998",3990,3998,9,"ENSG00000287737.3",1,5,"VVVVMVVVV",0,8,0.886542443064182,115,121,133,136,141,147,159,162,"AGGATGC","GTCA","GGGAGGA","CTGA",2.35437606964193,12,5,12,38,2.94950207693477,4.66133563530357,8.2075054075603,101,"ENSG00000079974.19"
"7239","ENSG00000113391.19_214694",214686,214694,9,"ENSG00000113391.19",1,8,"VVVVVVVMV",0,8,0.884057971014493,111,117,133,136,146,152,165,168,"TTGATGT","TTAA","GCGCTGA","CTGA",2.40411952812649,16,10,13,48,2.65706975281283,4.67113331841403,8.207365202472,101,"ENSG00000079974.19"
"24756","ENSG00000177822.10_13218",13210,13218,9,"ENSG00000177822.10",1,2,"VMVVVVVVV",0,8,0.884057971014493,115,121,133,136,162,168,181,184,"AGGATAA","CTGT","ATGATAA","CTGA",2.49882634090514,12,26,13,60,2.02358452965431,4.6706067005888,8.20683858464677,101,"ENSG00000079974.19"
"32325","ENSG00000226747.6_12803",12795,12803,9,"ENSG00000226747.6",1,1,"MVVVVVVVV",0,8,0.90600414078675,116,122,133,136,141,147,163,166,"GTGATGA","CAAA","GTGAGTA","CTTA",2.34631591006389,11,5,16,41,2.68895975093365,4.58276645450656,8.20678301765355,101,"ENSG00000079974.19"
"33956","ENSG00000231646.6_72475",72467,72475,9,"ENSG00000231646.6",1,1,"MVVVVVVVV",0,8,0.90600414078675,116,122,133,136,141,147,163,166,"GTGATGA","CAAA","GTGAGTA","CTTA",2.34631591006389,11,5,16,41,2.68895975093365,4.58276645450656,8.20678301765355,101,"ENSG00000079974.19"
"7521","ENSG00000114573.11_3685",3677,3685,9,"ENSG00000114573.11",1,3,"VVMVVVVVV",0,8,0.882815734989648,114,120,133,136,146,152,172,175,"ATCATGA","TAGA","GTAAAAA","CTGA",2.4437077929856,13,10,20,52,2.41052112524927,4.67547660295498,8.20673954291357,101,"ENSG00000079974.19"
"14024","ENSG00000144278.15_348435",348427,348435,9,"ENSG00000144278.15",1,2,"VMVVVVVVV",0,8,0.884057971014493,116,122,133,136,147,153,167,170,"AAGATTA","TGGA","CTGAAGA","CTGA",2.39909682948125,11,11,14,45,2.68727877257712,4.67031440894636,8.20654629300433,101,"ENSG00000079974.19"
"16339","ENSG00000151348.16_108352",108344,108352,9,"ENSG00000151348.16",0,NA,"VVVVVUVVV",1,8,0.922153209109731,53,59,72,75,87,93,133,136,"ATGATGA","CTGA","GTGATAA","TGGA",2.44323117760618,13,12,40,74,1.78194618347545,4.51753850854583,8.20615134498475,101,"ENSG00000079974.19"
"18851","ENSG00000158865.13_48525",48517,48525,9,"ENSG00000158865.13",1,8,"VVVVVVVMV",0,8,0.884057971014493,112,118,133,136,150,156,176,179,"ATGATTA","AGGA","TAGATGA","CTGA",2.49462067969577,15,14,20,58,2.04866270526617,4.66986680914283,8.2060986932008,101,"ENSG00000079974.19"
"25876","ENSG00000183032.12_180714",180706,180714,9,"ENSG00000183032.12",0,NA,"VVUVVVVVV",1,8,0.883643892339545,54,60,72,75,86,92,133,136,"GTGATTA","CTCA","GTCAAGA","CTGA",2.52509875735815,12,11,41,73,1.85202014224014,4.67150296449029,8.20607853384847,101,"ENSG00000079974.19"
"48167","ENSG00000290551.1_52277",52269,52277,9,"ENSG00000290551.1",0,NA,"VVVUVVVVV",1,8,0.880745341614907,111,117,133,136,144,150,158,161,"ATGATGA","CTAA","ATTCTTA","CTCA",2.38549963365162,16,8,8,41,2.82885170854667,4.68304564988937,8.206027016349,101,"ENSG00000079974.19"
"37134","ENSG00000245552.9_54707",54699,54707,9,"ENSG00000245552.9",0,NA,"VVVUVVVVV",1,8,0.880745341614907,108,114,133,136,181,187,196,199,"ATCATGA","TTGA","TTTAAGA","CTGA",2.57309831069354,19,45,9,82,1.57808332427885,4.68301801555895,8.20599938201858,101,"ENSG00000079974.19"
"28327","ENSG00000188687.18_39855",39847,39855,9,"ENSG00000188687.18",1,1,"MVVVVVVVV",0,8,0.90600414078675,104,110,133,136,155,161,177,180,"ATGATCA","CTGG","GTGACAT","CTGA",2.54602177880362,23,19,16,67,1.35427706614444,4.58193889787547,8.20595546102247,101,"ENSG00000079974.19"
"42556","ENSG00000264324.1_59816",59808,59816,9,"ENSG00000264324.1",1,1,"MVVVVVVVV",0,8,0.90600414078675,104,110,133,136,155,161,177,180,"ATGATCA","CTGG","GTGACAT","CTGA",2.54602177880362,23,19,16,67,1.35427706614444,4.58193889787547,8.20595546102247,101,"ENSG00000079974.19"
"25263","ENSG00000180287.17_176907",176899,176907,9,"ENSG00000180287.17",1,1,"MVVVVVVVV",0,8,0.90600414078675,112,118,133,136,141,147,155,158,"ATGATGA","GTGC","ATGGACA","CTGT",2.31402466463871,15,5,8,37,2.89994278903026,4.58169347165542,8.20571003480242,101,"ENSG00000079974.19"
"41782","ENSG00000259713.1_12354",12346,12354,9,"ENSG00000259713.1",1,8,"VVVVVVVMV",0,8,0.884057971014493,52,58,88,91,99,105,133,136,"ATTATGA","CTGG","AAGATGA","CTGA",2.62092426597675,30,8,28,75,1.20474599526473,4.66939360877743,8.2056254928354,101,"ENSG00000079974.19"
"8951","ENSG00000121895.8_50369",50361,50369,9,"ENSG00000121895.8",1,1,"MVVVVVVVV",0,8,0.90600414078675,112,118,133,136,139,145,153,156,"ATGAGTA","CGGA","AGCAAGA","CTGA",2.34051577069028,15,3,8,35,2.72215482649544,4.58139832444099,8.20541488758799,101,"ENSG00000079974.19"
"28941","ENSG00000196782.13_397022",397014,397022,9,"ENSG00000196782.13",1,3,"VVMVVVVVV",0,8,0.882815734989648,73,79,92,95,109,115,133,136,"AAGTTGA","ATGA","GTGCTGT","CTGA",2.46623208337464,13,14,18,54,2.25456332875014,4.67402763781194,8.20529057777053,101,"ENSG00000079974.19"
"27585","ENSG00000186575.19_78265",78257,78265,9,"ENSG00000186575.19",1,7,"VVVVVVMVV",0,8,0.885300207039338,83,89,102,105,110,116,133,136,"ATGACTA","CTGG","AAGTTGA","CTGA",2.40330555781905,13,5,17,44,2.6333919465228,4.66385724966245,8.2050580778198,101,"ENSG00000079974.19"
"2492","ENSG00000075275.18_175883",175875,175883,9,"ENSG00000075275.18",1,3,"VVMVVVVVV",0,8,0.882815734989648,109,115,133,136,147,153,162,165,"AGGATGA","AAGA","GTTTTAA","CTGA",2.42877154478131,18,11,9,47,2.50284565971135,4.67366398956335,8.20492692952194,101,"ENSG00000079974.19"
"25562","ENSG00000182168.15_133932",133924,133932,9,"ENSG00000182168.15",0,NA,"VVVVVUVVV",1,8,0.922153209109731,60,66,76,79,85,91,133,136,"TTAATGA","CTGA","TTGAGGA","GTGA",2.42214758377316,10,6,42,67,1.91678746617448,4.51610950616555,8.20472234260447,101,"ENSG00000079974.19"
"42842","ENSG00000267134.3_108594",108586,108594,9,"ENSG00000267134.3",1,3,"VVMVVVVVV",0,8,0.882815734989648,115,121,133,136,139,145,156,159,"TTGATGG","TGGA","GTGTGCA","CTGA",2.38130342077614,12,3,11,35,2.81845516435072,4.67345282571458,8.20471576567318,101,"ENSG00000079974.19"
"6642","ENSG00000111218.12_138241",138233,138241,9,"ENSG00000111218.12",0,NA,"VVVVVUVVV",1,8,0.922153209109731,112,118,133,136,159,165,188,191,"GTGAGGT","TTGA","GAGATGA","CTGA",2.4934092907809,15,23,23,70,1.44127775052199,4.51600158893199,8.20461442537092,101,"ENSG00000079974.19"
"14842","ENSG00000145949.12_20939",20931,20939,9,"ENSG00000145949.12",1,8,"VVVVUVVMV",1,7,0.773913043478261,82,88,133,136,140,146,154,157,"GTGATGA","CTGA","GTCATAA","CTGA",2.79263801998894,45,4,8,66,1.81811250221949,5.10892482553644,8.20457699944948,101,"ENSG00000079974.19"
"18393","ENSG00000157184.7_2173",2165,2173,9,"ENSG00000157184.7",0,NA,"VVVVVVUVV",1,8,0.886128364389234,41,47,64,67,108,114,133,136,"GAGATGA","CAGA","TTGATGT","CTGA",2.59542244363024,17,41,19,86,1.33634246161122,4.65978968811988,8.20430314567682,101,"ENSG00000079974.19"
"21991","ENSG00000169504.15_8802",8794,8802,9,"ENSG00000169504.15",1,2,"VMVVVVVVV",0,8,0.884057971014493,104,110,133,136,151,157,186,189,"TTGATGA","GTGA","ATGGGGA","CTGA",2.65446619868252,23,15,29,76,0.975824756445391,4.66806652024888,8.20429840430685,101,"ENSG00000079974.19"
"203","ENSG00000006530.18_82574",82566,82574,9,"ENSG00000006530.18",0,NA,"UVVUVVVVV",2,7,0.78343685300207,81,87,98,101,106,112,133,136,"TTGATGA","ATGA","TTGCTGA","CTGA",2.68651481096815,11,5,21,46,2.37068326431302,5.07019550102517,8.20394291303345,101,"ENSG00000079974.19"
"18760","ENSG00000158352.18_133222",133214,133222,9,"ENSG00000158352.18",0,NA,"UVVVVVVVV",1,8,0.902691511387163,111,117,133,136,149,155,164,167,"GTGATGG","GTTA","GTTTTGG","CTGA",2.37576837031718,16,13,9,47,2.53344635924029,4.5929755403387,8.20374158588735,101,"ENSG00000079974.19"
"25402","ENSG00000181355.21_131382",131374,131382,9,"ENSG00000181355.21",1,2,"VMVVUVVVV",1,7,0.773913043478261,115,121,133,136,142,148,158,161,"GTGAAGA","CTGA","CTTCTGA","CTGA",2.6052971637834,12,6,10,37,3.06278955962705,5.10785932954577,8.20351150345881,101,"ENSG00000079974.19"
"29387","ENSG00000197912.16_32621",32613,32621,9,"ENSG00000197912.16",0,NA,"UVVVVVVVV",1,8,0.902691511387163,79,85,97,100,116,122,133,136,"GTGATAA","CTGT","CTGATGA","CAGA",2.38418169307528,12,16,11,48,2.47640955718845,4.59273854442258,8.20350458997124,101,"ENSG00000079974.19"
"28341","ENSG00000188730.5_71852",71844,71852,9,"ENSG00000188730.5",1,2,"VMVVVVVVV",0,8,0.884057971014493,83,89,133,136,145,151,162,165,"TTAGTGA","CTGA","ATGGTGA","CTGA",2.50975366686376,44,9,11,73,1.93668261338955,4.66709343145365,8.20332531551162,101,"ENSG00000079974.19"
"39757","ENSG00000254186.3_203366",203358,203366,9,"ENSG00000254186.3",1,1,"MVVVVVVVV",0,8,0.90600414078675,94,100,107,110,115,121,133,136,"TTGATGT","CTGT","CTGAAGA","CTGT",2.34100997939038,7,5,12,33,2.70951731002549,4.57906262649034,8.20307918963734,101,"ENSG00000079974.19"
"11039","ENSG00000133687.16_252685",252677,252685,9,"ENSG00000133687.16",1,8,"VVVVVVVMV",0,8,0.884057971014493,64,70,85,88,108,114,133,136,"AAAATGA","CAGA","ATGAAGA","CTGA",2.53564070308589,15,20,19,63,1.7627554087625,4.66675669066711,8.20298857472508,101,"ENSG00000079974.19"
"21781","ENSG00000168952.16_199770",199762,199770,9,"ENSG00000168952.16",1,6,"VVVVVMVVV",0,8,0.902691511387163,114,120,133,136,149,155,176,179,"CAGATGA","CAGA","ATTAGAA","CTGA",2.43273606061703,13,13,21,56,2.15008160112957,4.59208050131077,8.20284654685942,101,"ENSG00000079974.19"
"26041","ENSG00000183230.18_1305634",1305626,1305634,9,"ENSG00000183230.18",1,3,"VVMVVVVVV",0,8,0.882815734989648,48,54,97,100,108,114,133,136,"ATGATAA","CTTA","CTGATCT","CTGA",2.56849879707096,43,8,19,79,1.56241201762094,4.67143433285683,8.20269727281542,101,"ENSG00000079974.19"
"35493","ENSG00000236202.1_16386",16378,16386,9,"ENSG00000236202.1",0,NA,"VVVVVVUVV",1,8,0.886128364389234,59,65,84,87,93,99,133,136,"ATCAAGA","CTGA","TTGTGGA","CTGA",2.55127738226935,19,6,34,68,1.62420301294622,4.65817972368548,8.20269318124241,101,"ENSG00000079974.19"
"10887","ENSG00000133056.14_37667",37659,37667,9,"ENSG00000133056.14",0,NA,"VVVVVVUVV",1,8,0.886128364389234,108,114,133,136,145,151,166,169,"CAGATGA","CTTC","GTGACGA","CTGA",2.44317880154318,19,9,15,52,2.34479655289162,4.65816380746155,8.20267726501848,101,"ENSG00000079974.19"
"908","ENSG00000040341.18_234663",234655,234663,9,"ENSG00000040341.18",1,8,"VVVVVVVMV",0,8,0.884057971014493,106,112,133,136,141,147,160,163,"GTGATTA","GTGA","AAGCAGA","CTGA",2.46047617169364,21,5,13,48,2.26222762245988,4.66635052510437,8.20258240916234,101,"ENSG00000079974.19"
"28487","ENSG00000189337.17_144626",144618,144626,9,"ENSG00000189337.17",1,6,"VVVVVMVVV",0,8,0.902691511387163,112,118,133,136,144,150,158,161,"CTGATGC","GAGA","GCACTGA","CTGA",2.31867750439291,15,8,8,40,2.90938599097387,4.59180900506499,8.20257505061364,101,"ENSG00000079974.19"
"3208","ENSG00000082293.13_316798",316790,316798,9,"ENSG00000082293.13",1,2,"VMVVVVVVV",0,8,0.884057971014493,84,90,104,107,113,119,133,136,"GAGATGA","CAAA","ATGAGTT","CTGA",2.37507627612356,14,6,14,43,2.83144750097253,4.66632233544907,8.20255421950704,101,"ENSG00000079974.19"
"23056","ENSG00000172159.16_189089",189081,189089,9,"ENSG00000172159.16",1,8,"VVVVVVVMV",0,8,0.884057971014493,110,116,133,136,139,145,158,161,"GTAATTA","CTGG","ATGATGG","CTGA",2.44074845678718,17,3,13,42,2.39241030607213,4.66601667116333,8.2022485552213,101,"ENSG00000079974.19"
"6931","ENSG00000112304.11_18848",18840,18848,9,"ENSG00000112304.11",0,NA,"VVVVVVUVV",1,8,0.886128364389234,115,121,133,136,146,152,162,165,"GTGCTAA","TTGA","AAGATTA","CTGA",2.35615432454084,12,10,10,41,2.92251211305717,4.65755190249903,8.20206536005596,101,"ENSG00000079974.19"
"13758","ENSG00000143344.16_33532",33524,33532,9,"ENSG00000143344.16",1,1,"MVVVVVVVV",0,8,0.90600414078675,111,117,133,136,173,179,225,228,"ATGATGT","CTGC","AGGAAGA","CTGA",2.61816136736299,16,37,46,108,0.857388745760208,4.57794946537837,8.20196602852537,101,"ENSG00000079974.19"
"32965","ENSG00000228352.2_5283",5275,5283,9,"ENSG00000228352.2",0,NA,"VVUVVVVVV",1,8,0.883643892339545,71,77,96,99,105,111,133,136,"GTGATGA","CTGA","TTCCTGA","GTGA",2.50514405280747,19,6,22,56,1.96824442714197,4.66730119479794,8.20187676415612,101,"ENSG00000079974.19"
"11685","ENSG00000135824.13_1272",1264,1272,9,"ENSG00000135824.13",1,7,"VVVVVVMVV",0,8,0.885300207039338,93,99,133,136,143,149,157,160,"TTCATGA","CTGA","AACATGG","CTGA",2.49749810457953,34,7,8,58,1.99224050797665,4.66055696796004,8.20175779611739,101,"ENSG00000079974.19"
"25448","ENSG00000181626.12_17536",17528,17536,9,"ENSG00000181626.12",1,7,"VVVVVVMVV",0,8,0.885300207039338,102,108,133,136,145,151,207,210,"TTGATGA","CTCA","TTGAAGG","CTGA",2.62787256813082,25,9,56,99,1.12292879242127,4.66051981165668,8.20172063981403,101,"ENSG00000079974.19"
"40842","ENSG00000257923.12_278535",278527,278535,9,"ENSG00000257923.12",1,6,"VVUVVMVVV",1,7,0.786335403726708,83,89,106,109,110,116,133,136,"ATGATGA","CTGA","ATTTTCA","CTGA",2.765625,17,1,17,44,1.78701045090609,5.05612761272652,8.20146922763335,101,"ENSG00000079974.19"
"3766","ENSG00000088881.22_61972",61964,61972,9,"ENSG00000088881.22",1,1,"MVVVVUVVV",1,7,0.82815734989648,115,121,133,136,141,147,155,158,"ATGAGGA","GGGA","GCGATGC","CTGA",2.4714516354927,12,5,8,34,3.07847702438505,4.88870531525076,8.20133471483668,101,"ENSG00000079974.19"
"34329","ENSG00000232729.8_27171",27163,27171,9,"ENSG00000232729.8",1,2,"VMVVVVVVV",0,8,0.884057971014493,85,91,104,107,113,119,133,136,"ACGATGA","ATTA","GTGATGA","CTTA",2.3687376017803,13,6,14,42,2.86819816555468,4.66494554435584,8.20117742841381,101,"ENSG00000079974.19"
"23325","ENSG00000172572.7_88270",88262,88270,9,"ENSG00000172572.7",1,1,"MVVVVVVVV",0,8,0.90600414078675,113,119,133,136,182,188,210,213,"TTGATGA","TTAA","TGGATGA","CTGA",2.54024350054634,14,46,22,91,1.37364286762853,4.57714988448436,8.20116644763136,101,"ENSG00000079974.19"
"42472","ENSG00000263551.6_116209",116201,116209,9,"ENSG00000263551.6",1,7,"VVVVVVMVV",0,8,0.885300207039338,114,120,133,136,148,154,176,179,"ATCATGA","CAGG","TTGAATA","CTGA",2.47055776169648,13,12,22,56,2.16907304999889,4.65986453199386,8.20106536015121,101,"ENSG00000079974.19"
"46498","ENSG00000286749.1_11274",11266,11274,9,"ENSG00000286749.1",1,8,"VVVVVVVMV",0,8,0.884057971014493,95,101,133,136,140,146,183,186,"GTGCTGA","CTGA","GTGGTGT","CTGA",2.66397950084877,32,4,37,82,0.897768416471651,4.66440793886586,8.20063982292383,101,"ENSG00000079974.19"
"29679","ENSG00000198590.12_14492",14484,14492,9,"ENSG00000198590.12",0,NA,"VVUVVVVVV",1,8,0.883643892339545,116,122,133,136,140,146,154,157,"ATGGTGA","GTCA","AGCATTA","CTGA",2.34214047483752,11,4,8,32,3.04928404403719,4.66588846907184,8.20046403843001,101,"ENSG00000079974.19"
"27792","ENSG00000187391.22_171724",171716,171724,9,"ENSG00000187391.22",1,2,"VMVVVVVVV",0,8,0.884057971014493,112,118,133,136,140,146,188,191,"ATCATGA","CACA","ATGATAA","CTGA",2.53438596333367,15,4,42,70,1.76092876982702,4.66420879801287,8.20044068207084,101,"ENSG00000079974.19"
"24250","ENSG00000175600.16_172641",172633,172641,9,"ENSG00000175600.16",1,3,"VVMVVVVVV",0,8,0.882815734989648,88,94,133,136,160,166,184,187,"ATGATGA","TAGA","TTGATCA","CTGA",2.68355239234854,39,24,18,90,0.784897152917926,4.66881160881039,8.20007454876898,101,"ENSG00000079974.19"
"38915","ENSG00000251293.1_43490",43482,43490,9,"ENSG00000251293.1",1,6,"VVVVVMVVV",0,8,0.902691511387163,114,120,133,136,142,148,160,163,"CTGATAA","CTAA","ATGATGT","ATGA",2.30778043329767,13,6,12,40,2.97060724261778,4.58895253281723,8.19971857836589,101,"ENSG00000079974.19"
"48506","ENSG00000291200.1_15751",15743,15751,9,"ENSG00000291200.1",1,1,"MVVVVUVVV",1,7,0.82815734989648,95,101,111,114,116,122,133,136,"TTGTTGA","CTGA","GTACTGG","CTGA",2.52915341461786,10,2,11,32,2.68688258497362,4.88697633727318,8.1996057368591,101,"ENSG00000079974.19"
"23519","ENSG00000173145.11_13813",13805,13813,9,"ENSG00000173145.11",0,NA,"UVVVVVVVV",1,8,0.902691511387163,92,98,133,136,147,153,166,169,"ATGAGGA","TTCA","GTGTTTA","CTGA",2.48882713442717,35,11,13,68,1.7628367132883,4.58875440236736,8.19952044791602,101,"ENSG00000079974.19"
"13984","ENSG00000144218.21_382303",382295,382303,9,"ENSG00000144218.21",1,2,"VMVVVVVVV",0,8,0.884057971014493,116,122,133,136,148,154,169,172,"ATCCTGA","CTGG","ATCAGGA","CTGA",2.41385732783183,11,12,15,47,2.56052258120655,4.66322619168802,8.19945807574599,101,"ENSG00000079974.19"
"5357","ENSG00000104375.17_207247",207239,207247,9,"ENSG00000104375.17",1,2,"VMVVVVVVV",0,8,0.884057971014493,84,90,99,102,116,122,133,136,"GTGATAA","CTGA","ATTATGA","CTGT",2.42935062860522,9,14,11,43,2.45722104225862,4.66322297490668,8.19945485896465,101,"ENSG00000079974.19"
"32429","ENSG00000226994.9_106380",106372,106380,9,"ENSG00000226994.9",1,8,"VVVVVVVMV",0,8,0.884057971014493,116,122,133,136,146,152,174,177,"GGAATGA","ATGA","GAGATGA","CTGA",2.45570028084169,11,10,22,52,2.28089419667938,4.66305735057266,8.19928923463064,101,"ENSG00000079974.19"
"7603","ENSG00000115129.14_6674",6666,6674,9,"ENSG00000115129.14",1,8,"VVVVVUVMV",1,7,0.806211180124224,66,72,85,88,104,110,133,136,"ATCATGA","CTGA","CTGAACA","CTGA",2.70821283306948,13,16,23,61,1.84292908446783,4.97442032623277,8.19926504672966,101,"ENSG00000079974.19"
"10491","ENSG00000131374.15_1227893",1227885,1227893,9,"ENSG00000131374.15",1,2,"VMVVVVVVV",0,8,0.884057971014493,64,70,78,81,93,99,133,136,"GTGATTA","CTAA","TTGATGG","CTGA",2.56371596890637,8,12,34,63,1.5605150792099,4.66298871797976,8.19922060203773,101,"ENSG00000079974.19"
"2883","ENSG00000079101.18_1307",1299,1307,9,"ENSG00000079101.18",1,2,"VMVVVVVVV",0,8,0.884057971014493,65,71,85,88,97,103,133,136,"ATGATGA","ATGA","AAGAGGA","CTTA",2.49152249312606,14,9,30,62,2.04105462279415,4.66280114424197,8.19903302829994,101,"ENSG00000079974.19"
"29558","ENSG00000198216.14_44923",44915,44923,9,"ENSG00000198216.14",1,3,"VVMVVVVVV",0,8,0.882815734989648,94,100,133,136,140,146,158,161,"ATGATGA","GTAA","ATTATTC","CTGA",2.52870300290904,33,4,12,58,1.8127081529414,4.66768204308375,8.19894498304235,101,"ENSG00000079974.19"
"39802","ENSG00000254226.6_257119",257111,257119,9,"ENSG00000254226.6",1,1,"MVVVVVVVV",0,8,0.90600414078675,114,120,133,136,153,159,172,175,"ATAATGT","GAGA","GTGGTCA","CTGA",2.39333352730008,13,17,13,52,2.34315375914449,4.57467765195293,8.19869421509992,101,"ENSG00000079974.19"
"7127","ENSG00000112902.12_322237",322229,322237,9,"ENSG00000112902.12",1,6,"VVVVVMVVV",0,8,0.902691511387163,90,96,104,107,109,115,133,136,"ATGGTGA","CCAA","TTGAGGT","CTGA",2.45705132201136,8,2,18,37,1.97127014823372,4.58790307374402,8.19866911929268,101,"ENSG00000079974.19"
"47344","ENSG00000288016.3_95093",95085,95093,9,"ENSG00000288016.3",1,1,"MVVVVVVVV",0,8,0.90600414078675,111,117,133,136,145,151,183,186,"ATAATGT","CTAA","TTGATTT","CTGA",2.462957085464,16,9,32,66,1.87883350097368,4.57463685101676,8.19865341416376,101,"ENSG00000079974.19"
"13077","ENSG00000140015.20_318434",318426,318434,9,"ENSG00000140015.20",1,7,"VVVVVVMVV",0,8,0.885300207039338,116,122,133,136,158,164,173,176,"ATACTGA","TTGA","ATGAAAA","CTGA",2.46781634603658,11,22,9,51,2.17742806291387,4.65738425912276,8.19858508728011,101,"ENSG00000079974.19"
"22865","ENSG00000171587.15_67107",67099,67107,9,"ENSG00000171587.15",0,NA,"VVVVVUVVV",1,8,0.922153209109731,114,120,133,136,181,187,195,198,"AAGATGC","CTAG","ATGAGGA","CTGA",2.40911792137342,13,45,8,75,1.97836425494673,4.50978759935905,8.19840043579797,101,"ENSG00000079974.19"
"3506","ENSG00000085276.19_369379",369371,369379,9,"ENSG00000085276.19",1,7,"VVVVVVMVV",0,8,0.885300207039338,108,114,133,136,145,151,164,167,"ATGATCA","ATGT","GTGTTTG","CTGA",2.42698520859762,19,9,13,50,2.44730626942836,4.65680191501979,8.19800274317713,101,"ENSG00000079974.19"
"4566","ENSG00000101096.20_2973",2965,2973,9,"ENSG00000101096.20",1,3,"VVMVVVVVV",0,8,0.882815734989648,114,120,133,136,140,146,179,182,"ATGATGC","CAGT","GTGCTTA","CTGA",2.51362576340204,13,4,33,59,1.90927847264344,4.66669589049759,8.19795883045618,101,"ENSG00000079974.19"
"19729","ENSG00000163630.11_253345",253337,253345,9,"ENSG00000163630.11",0,NA,"VVVVVUVVV",1,8,0.922153209109731,112,118,133,136,140,146,156,159,"CTAATAA","CAGA","ATTAAGC","CTGA",2.28452431234794,15,4,10,38,2.80704417341016,4.50930156393244,8.19791440037136,101,"ENSG00000079974.19"
"4615","ENSG00000101333.19_365002",364994,365002,9,"ENSG00000101333.19",1,1,"MVVVVUVVV",1,7,0.82815734989648,116,122,133,136,140,146,157,160,"ATGCTGA","ATGA","GGCATCA","CTGA",2.49154399329091,11,4,11,35,2.92998831380578,4.88507040060296,8.19769980018888,101,"ENSG00000079974.19"
"15176","ENSG00000147246.10_96417",96409,96417,9,"ENSG00000147246.10",1,5,"VVVVMVVVV",0,8,0.886542443064182,66,72,92,95,104,110,133,136,"ATGAAGA","CTGA","ATGCTGA","GTGA",2.52094220364002,20,9,23,61,1.79961217025853,4.65147338196467,8.1976431542214,101,"ENSG00000079974.19"
"7900","ENSG00000115977.21_79871",79863,79871,9,"ENSG00000115977.21",1,6,"VVVVVMVVV",0,8,0.902691511387163,89,95,108,111,115,121,133,136,"ATGGTAT","CTGT","GTGGTTA","CTGA",2.32409479920112,13,4,12,38,2.85126994004647,4.58630881701348,8.19707486256213,101,"ENSG00000079974.19"
"34249","ENSG00000232287.2_12360",12352,12360,9,"ENSG00000232287.2",0,NA,"VVVUVVVVV",1,8,0.880745341614907,84,90,133,136,174,180,193,196,"GTGATTT","CTGA","ATGATGA","CTGA",2.6648300558851,43,38,13,103,0.930732371714094,4.67406651940369,8.19704788586332,101,"ENSG00000079974.19"
"28214","ENSG00000188517.17_119738",119730,119738,9,"ENSG00000188517.17",1,1,"MVVVVVVVV",0,8,0.90600414078675,112,118,133,136,173,179,187,190,"CTGATGC","TGGA","TTGATAA","CTGA",2.4583004071768,15,37,8,69,1.90306681278464,4.57293404849082,8.19695061163782,101,"ENSG00000079974.19"
"39678","ENSG00000254092.4_186729",186721,186729,9,"ENSG00000254092.4",1,6,"VVVVVMVVV",0,8,0.902691511387163,115,121,133,136,144,150,192,195,"CTGAGAA","CTGA","GTAATGC","CTGA",2.45163250538824,12,8,42,71,2.00048148382468,4.58617454660324,8.19694059215189,101,"ENSG00000079974.19"
"41505","ENSG00000259122.2_2360",2352,2360,9,"ENSG00000259122.2",0,NA,"UVVVVVVVV",1,8,0.902691511387163,110,116,133,136,144,150,182,185,"ATCATGC","ATGA","GTAATGT","CTGA",2.47687445210187,17,8,32,66,1.83198826685374,4.58612115354989,8.19688719909854,101,"ENSG00000079974.19"
"20651","ENSG00000165246.15_218886",218878,218886,9,"ENSG00000165246.15",1,6,"VVVVVMVVV",0,8,0.902691511387163,106,112,133,136,143,149,158,161,"GAGATGA","GAGA","GTGCTTT","CTGA",2.38965742485678,21,7,9,46,2.41253869010613,4.58589704728783,8.19666309283648,101,"ENSG00000079974.19"
"25714","ENSG00000182621.18_673674",673666,673674,9,"ENSG00000182621.18",1,1,"MVVVVVVVV",0,8,0.90600414078675,24,30,65,68,115,121,133,136,"ATGATGA","CTGA","GTCATAA","CTGC",2.59827461389961,35,47,12,103,0.968455671164543,4.57257160762383,8.19658817077082,101,"ENSG00000079974.19"
"9865","ENSG00000127947.16_40447",40439,40447,9,"ENSG00000127947.16",0,NA,"VVVVVUVVV",1,8,0.922153209109731,86,92,102,105,112,118,133,136,"ATGTTGA","CTAA","GTGGGTA","GTGA",2.2903050354467,10,7,15,41,2.7605648588743,4.50731627379641,8.19592911023534,101,"ENSG00000079974.19"
"6356","ENSG00000109466.14_92395",92387,92395,9,"ENSG00000109466.14",0,NA,"VVVVVUVVV",1,8,0.922153209109731,52,58,98,101,114,120,133,136,"ATGATGT","CTGA","CTAATTA","CTAA",2.46212047738711,40,13,13,75,1.61472211194062,4.50721465696366,8.19582749340259,101,"ENSG00000079974.19"
"37268","ENSG00000246379.8_5815",5807,5815,9,"ENSG00000246379.8",1,1,"MVVVVVVVV",0,8,0.90600414078675,115,121,133,136,143,149,166,169,"TAGTTGA","ATGA","CTGATTT","CTGA",2.33744303056036,12,7,17,45,2.70378843106325,4.57168549203308,8.19570205518008,101,"ENSG00000079974.19"
"21724","ENSG00000168785.8_22582",22574,22582,9,"ENSG00000168785.8",1,6,"VVVVVMVVV",0,8,0.902691511387163,116,122,133,136,146,152,160,163,"GTAATGA","CTTA","TTGATTA","CTGC",2.3138803913631,11,10,8,38,2.91299138763703,4.58471516584776,8.19548121139642,101,"ENSG00000079974.19"
"23128","ENSG00000172264.19_1482587",1482579,1482587,9,"ENSG00000172264.19",1,8,"VVVVVVVMV",0,8,0.884057971014493,114,120,133,136,142,148,158,161,"GTGACGT","ATGA","GGAATGC","CTGA",2.33951458208719,13,6,10,38,3.03922922923171,4.65899827745324,8.19523016151121,101,"ENSG00000079974.19"
"38869","ENSG00000251199.6_193511",193503,193511,9,"ENSG00000251199.6",0,NA,"UVVVVVVVV",1,8,0.902691511387163,116,122,133,136,143,149,163,166,"TTGTTTA","CTTA","CTGAACA","CTGA",2.32006400907195,11,7,14,41,2.87032262606336,4.58435400496909,8.19512005051775,101,"ENSG00000079974.19"
"1","ENSG00000000457.14_30274",30266,30274,9,"ENSG00000000457.14",0,NA,"VVVVVVUVV",1,8,0.886128364389234,57,63,75,78,116,122,133,136,"ATCATGA","CTGT","ATTTTCA","CTGA",2.49077676433492,12,38,11,70,1.99695171826429,4.65053253679094,8.19504599434787,101,"ENSG00000079974.19"
"18111","ENSG00000156140.10_46507",46499,46507,9,"ENSG00000156140.10",1,6,"VVVVVMVVV",0,8,0.902691511387163,111,117,133,136,148,154,182,185,"ATGATTA","GTTA","GTGATTG","CTGA",2.48379422432927,16,12,28,65,1.77825534978281,4.58422087799448,8.19498692354314,101,"ENSG00000079974.19"
"23485","ENSG00000173068.19_114204",114196,114204,9,"ENSG00000173068.19",1,8,"VVVVVVVMV",0,8,0.884057971014493,114,120,133,136,151,157,169,172,"ATGAGGA","TTAA","GTCTGGA","CTGA",2.41891394056999,13,15,12,49,2.50870554726455,4.65869962109945,8.19493150515742,101,"ENSG00000079974.19"
"355","ENSG00000009694.14_42013",42005,42013,9,"ENSG00000009694.14",1,1,"MVVVVVVVV",0,8,0.90600414078675,115,121,133,136,152,158,168,171,"GTGATAA","ATGG","TTTATGG","CTGA",2.36877410860676,12,16,10,47,2.49154367973466,4.5708427676116,8.1948593307586,101,"ENSG00000079974.19"
"394","ENSG00000010818.11_100573",100565,100573,9,"ENSG00000010818.11",0,NA,"UVVVVVVVV",1,8,0.902691511387163,115,121,133,136,147,153,165,168,"AGGATGT","ACGA","GTCAAGC","CTGA",2.33015116638102,12,11,12,44,2.80200557223349,4.58408667036006,8.19485271590872,101,"ENSG00000079974.19"
"11291","ENSG00000134504.14_122176",122168,122176,9,"ENSG00000134504.14",1,1,"MVVVVVVVV",0,8,0.90600414078675,105,111,133,136,142,148,157,160,"CTGATGC","CCAA","ATGACTA","CTGA",2.39396481454412,22,6,9,46,2.32357500372946,4.57083510850589,8.19485167165289,101,"ENSG00000079974.19"
"31356","ENSG00000223536.7_8824",8816,8824,9,"ENSG00000223536.7",0,NA,"VVVVVVUVV",1,8,0.886128364389234,116,122,133,136,139,145,155,158,"AAGAAGA","TTGA","ATTCTTA","CTGA",2.35760807628129,11,3,10,33,2.88390446837489,4.65032291089587,8.1948363684528,101,"ENSG00000079974.19"
"16842","ENSG00000152404.16_104869",104861,104869,9,"ENSG00000152404.16",0,NA,"VVVVVVUVV",1,8,0.886128364389234,53,59,83,86,95,101,133,136,"AAGATGC","CTGA","ATGAATA","CTGA",2.60132661551813,24,9,32,74,1.25898530637659,4.65029068579103,8.19480414334796,101,"ENSG00000079974.19"
"4239","ENSG00000099715.15_710197",710189,710197,9,"ENSG00000099715.15",1,2,"VMVVVVVVV",0,8,0.884057971014493,116,122,133,136,143,149,170,173,"GTGATCT","CTGT","ATGAGAA","CTGA",2.42951295995185,11,7,21,48,2.43693774232768,4.65842270216833,8.1946545862263,101,"ENSG00000079974.19"
"4905","ENSG00000102290.23_812103",812095,812103,9,"ENSG00000102290.23",1,2,"VMVVVVVVV",0,8,0.884057971014493,116,122,133,136,143,149,170,173,"GTGATCT","CTGT","ATGAGAA","CTGA",2.42951295995185,11,7,21,48,2.43693774232768,4.65842270216833,8.1946545862263,101,"ENSG00000079974.19"
"26290","ENSG00000183780.13_31460",31452,31460,9,"ENSG00000183780.13",1,1,"MVVVVVVVV",0,8,0.90600414078675,114,120,133,136,146,152,164,167,"TTGGTGC","CAGA","GTAAATA","CTGA",2.31328016550173,13,10,12,44,2.86058706384062,4.57061370846303,8.19463027161003,101,"ENSG00000079974.19"
"8911","ENSG00000121440.15_60330",60322,60330,9,"ENSG00000121440.15",0,NA,"VVVVVVUVV",1,8,0.886128364389234,72,78,94,97,107,113,133,136,"ATGATGC","CTGA","GGAATGA","CTAA",2.45194004289474,16,10,20,55,2.25254508643806,4.64970300976742,8.19421646732436,101,"ENSG00000079974.19"
"47437","ENSG00000288102.1_79517",79509,79517,9,"ENSG00000288102.1",1,2,"VMVVVVVVV",0,8,0.884057971014493,68,74,83,86,92,98,133,136,"TTGATGT","ATGA","TTCAAGA","CTGA",2.51365097368344,9,6,35,59,1.87307275008868,4.65768647699457,8.19391836105254,101,"ENSG00000079974.19"
"20760","ENSG00000165555.10_24521",24513,24521,9,"ENSG00000165555.10",1,1,"MVVVVVVVV",0,8,0.90600414078675,111,117,133,136,182,188,239,242,"ATGATGT","CTGC","CTGTTGC","CTGA",2.61562758357921,16,46,51,122,0.842047383575955,4.56989115185934,8.19390771500633,101,"ENSG00000079974.19"
"28990","ENSG00000196876.19_52671",52663,52671,9,"ENSG00000196876.19",1,8,"VVVVVVVMV",0,8,0.884057971014493,116,122,133,136,154,160,185,188,"ATGAAGA","CACA","GTGATGC","CTGA",2.55141673351811,11,18,25,63,1.62060073812754,4.65751140706206,8.19374329112003,101,"ENSG00000079974.19"
"33486","ENSG00000229989.6_101332",101324,101332,9,"ENSG00000229989.6",1,1,"MVVVVVVVV",0,8,0.90600414078675,116,122,133,136,145,151,171,174,"GGGATGG","CTCA","TTTAGGA","CTGA",2.3753167307126,11,9,20,49,2.44298661979725,4.56960787280364,8.19362443595064,101,"ENSG00000079974.19"
"35148","ENSG00000235122.4_34115",34107,34115,9,"ENSG00000235122.4",1,2,"VMVVVVVVV",0,8,0.884057971014493,115,121,133,136,148,154,169,172,"AAGATGA","GTGA","ATGATCA","CTCA",2.40658004805841,12,12,15,48,2.58494111848045,4.65720202638413,8.1934339104421,101,"ENSG00000079974.19"
"9726","ENSG00000126777.18_22488",22480,22488,9,"ENSG00000126777.18",0,NA,"VVVVVUUVV",2,7,0.808281573498965,112,118,133,136,140,146,198,201,"GTGATGA","TTGA","ATGTAGA","CTGA",2.71368903815354,15,4,52,80,1.74875483591036,4.96000377256681,8.19313006656267,101,"ENSG00000079974.19"
"34987","ENSG00000234640.1_1926",1918,1926,9,"ENSG00000234640.1",0,NA,"UVVVVVVVV",1,8,0.902691511387163,107,113,133,136,150,156,170,173,"AAGATTC","CTGA","ATGAAGC","CTGA",2.45170343464495,20,14,14,57,1.98450628717891,4.58229896286964,8.19306500841829,101,"ENSG00000079974.19"
"47162","ENSG00000287722.1_482625",482617,482625,9,"ENSG00000287722.1",0,NA,"UVVVVVVVV",1,8,0.902691511387163,108,114,133,136,145,151,203,206,"ATGTTGT","GTGA","ATAATGA","CTGA",2.52002307083343,19,9,52,89,1.52896714434138,4.5822802374744,8.19304628302305,101,"ENSG00000079974.19"
"32166","ENSG00000226197.4_437951",437943,437951,9,"ENSG00000226197.4",1,2,"VMVVVVVVV",0,8,0.884057971014493,116,122,133,136,139,145,158,161,"AGGAAGA","GTGA","ATGTTTC","CTGA",2.38944826967377,11,3,13,36,2.69737098893804,4.65675653002412,8.19298841408209,101,"ENSG00000079974.19"
"29657","ENSG00000198561.16_46307",46299,46307,9,"ENSG00000198561.16",1,8,"VVVVVVVMV",0,8,0.884057971014493,89,95,106,109,114,120,133,136,"AAGGTCA","GTGA","GTGATTA","CTGA",2.36112931689954,11,5,13,38,2.88521413468769,4.65651906183782,8.19275094589579,101,"ENSG00000079974.19"
"40026","ENSG00000254732.2_57771",57763,57771,9,"ENSG00000254732.2",1,8,"VVVVVVVMV",0,8,0.884057971014493,89,95,106,109,114,120,133,136,"AAGGTCA","GTGA","GTGATTA","CTGA",2.36112931689954,11,5,13,38,2.88521413468769,4.65651906183782,8.19275094589579,101,"ENSG00000079974.19"
"47472","ENSG00000288534.1_86968",86960,86968,9,"ENSG00000288534.1",1,8,"VVVVVVVMV",0,8,0.884057971014493,89,95,106,109,114,120,133,136,"AAGGTCA","GTGA","GTGATTA","CTGA",2.36112931689954,11,5,13,38,2.88521413468769,4.65651906183782,8.19275094589579,101,"ENSG00000079974.19"
"19322","ENSG00000162739.14_2373",2365,2373,9,"ENSG00000162739.14",0,NA,"VVVVVVUVV",1,8,0.886128364389234,90,96,108,111,116,122,133,136,"ATGAAGA","CAGA","ATCATGT","GTGA",2.33918682106721,12,5,11,37,2.99624312688554,4.64770548350008,8.19221894105701,101,"ENSG00000079974.19"
"48383","ENSG00000291054.1_137608",137600,137608,9,"ENSG00000291054.1",1,8,"VVVVVVVMV",0,8,0.884057971014493,83,89,97,100,111,117,133,136,"GGGATGT","CAGA","TTGAAGG","CTGA",2.44354591775716,8,11,16,44,2.33344045056286,4.65593664223598,8.19216852629395,101,"ENSG00000079974.19"
"45936","ENSG00000286062.2_14163",14155,14163,9,"ENSG00000286062.2",0,NA,"VVUVVVVVV",1,8,0.883643892339545,115,121,133,136,148,154,168,171,"GTGTTGC","CTGT","TTGAGGT","CTGA",2.39849541717972,12,12,14,47,2.64013717591965,4.65752665594611,8.19210222530429,101,"ENSG00000079974.19"
"8174","ENSG00000117114.21_474187",474179,474187,9,"ENSG00000117114.21",0,NA,"VVVVVUVVV",1,8,0.922153209109731,112,118,133,136,143,149,158,161,"AGCATGA","TTGG","AGGTGGA","CTGA",2.26090141519477,15,7,9,40,2.94121729565198,4.50347334923761,8.19208618567653,101,"ENSG00000079974.19"
"26807","ENSG00000185046.20_246712",246704,246712,9,"ENSG00000185046.20",0,NA,"UVVVVVVVV",1,8,0.902691511387163,93,99,133,136,145,151,166,169,"CTGAAGA","GTGA","GTGAAAT","CTGA",2.48177819442915,34,9,15,67,1.7797903134941,4.58124456908878,8.19201061463743,101,"ENSG00000079974.19"
"37877","ENSG00000249012.2_2276",2268,2276,9,"ENSG00000249012.2",1,1,"MVVVVVVVV",0,8,0.90600414078675,106,112,133,136,149,155,172,175,"GTGCTGA","CAGA","GAGATAG","CTGA",2.47039979395163,21,13,17,60,1.80154713755003,4.56771977430689,8.19173633745389,101,"ENSG00000079974.19"
"36383","ENSG00000240405.7_343428",343420,343428,9,"ENSG00000240405.7",1,3,"VVMVVVVVV",0,8,0.882815734989648,87,93,104,107,114,120,133,136,"AACATGA","CTAA","GTTGTGG","CTGA",2.35711930961476,11,7,13,40,2.92704015889572,4.6602922224152,8.19155516237379,101,"ENSG00000079974.19"
"2459","ENSG00000075035.10_19365",19357,19365,9,"ENSG00000075035.10",1,2,"VMVVVVVVV",0,8,0.884057971014493,80,86,95,98,114,120,133,136,"ATGATGG","CAGA","ATGATGT","CTCA",2.45615133668425,9,16,13,47,2.2467989482646,4.65528529820657,8.19151718226454,101,"ENSG00000079974.19"
"41230","ENSG00000258710.8_3974",3966,3974,9,"ENSG00000258710.8",0,NA,"VVVVVUVVV",1,8,0.922153209109731,108,114,133,136,142,148,156,159,"ATGATGT","ATGA","ATTGAGA","CTAA",2.31796488171008,19,6,8,42,2.55820840465107,4.5028269040129,8.19143974045182,101,"ENSG00000079974.19"
"46899","ENSG00000287345.1_3917",3909,3917,9,"ENSG00000287345.1",0,NA,"VVVVVUVVV",1,8,0.922153209109731,108,114,133,136,142,148,156,159,"ATGATGT","ATGA","ATTGAGA","CTAA",2.31796488171008,19,6,8,42,2.55820840465107,4.5028269040129,8.19143974045182,101,"ENSG00000079974.19"
"34431","ENSG00000233006.8_52400",52392,52400,9,"ENSG00000233006.8",0,NA,"UVVVVVVVV",1,8,0.902691511387163,113,119,133,136,141,147,164,167,"ATAAAGA","GTGC","GTGAAAA","CTGA",2.35839385235652,14,5,17,45,2.59899857656282,4.58040606473491,8.19117211028357,101,"ENSG00000079974.19"
"14037","ENSG00000144285.23_101686",101678,101686,9,"ENSG00000144285.23",1,1,"MVVVVUVVV",1,7,0.82815734989648,112,118,133,136,169,175,185,188,"ATGATAA","CAGA","TTGATTA","CTGA",2.63624342295466,15,33,10,67,1.9386072466905,4.8783908499304,8.19102024951632,101,"ENSG00000079974.19"
"46994","ENSG00000287469.1_90049",90041,90049,9,"ENSG00000287469.1",1,3,"VVMVVVVVV",0,8,0.882815734989648,112,118,133,136,143,149,173,176,"TTGATGG","ATAA","TTGAAGA","CTGA",2.46233429128996,15,7,24,55,2.22332493913863,4.65972172026792,8.19098466022652,101,"ENSG00000079974.19"
"46599","ENSG00000286871.1_6971",6963,6971,9,"ENSG00000286871.1",1,2,"VMVVVVVVV",0,8,0.884057971014493,93,99,133,136,142,148,163,166,"GTGTTGA","CCGA","TTGAATA","CTGA",2.52085572589485,34,6,15,64,1.81300464443042,4.65467737093236,8.19090925499033,101,"ENSG00000079974.19"
"12178","ENSG00000137563.13_2271",2263,2271,9,"ENSG00000137563.13",0,NA,"VVVVUVVVV",1,8,0.889855072463768,107,113,133,136,145,151,194,197,"CTGATGA","GGGA","GTGAGTA","CTGA",2.56098134471851,20,9,43,81,1.45213396365195,4.6313357321105,8.19075602196557,101,"ENSG00000079974.19"
"12132","ENSG00000137414.7_8023",8015,8023,9,"ENSG00000137414.7",1,1,"MVVVVVVVV",0,8,0.90600414078675,94,100,133,136,143,149,161,164,"CTTATGA","ATGG","ATGATGC","CTGA",2.44371355051868,33,7,12,61,1.97493496932602,4.56658965986264,8.19060622300964,101,"ENSG00000079974.19"
"38001","ENSG00000249330.3_95950",95942,95950,9,"ENSG00000249330.3",1,8,"VVVVVUVMV",1,7,0.806211180124224,28,34,72,75,85,91,133,136,"ATGATGA","CTGA","CTGCTAA","CTGA",2.84206081081081,38,10,42,99,0.914985015231652,4.96551427182593,8.19035899232282,101,"ENSG00000079974.19"
"35390","ENSG00000235904.3_121252",121244,121252,9,"ENSG00000235904.3",0,NA,"VVVVVUVVV",1,8,0.922153209109731,111,117,133,136,159,165,182,185,"ATCTTGA","CTGT","GTGACTA","CTGA",2.44474963717247,16,23,17,65,1.70859561126899,4.50173163143803,8.19034446787695,101,"ENSG00000079974.19"
"22402","ENSG00000170485.17_27702",27694,27702,9,"ENSG00000170485.17",1,8,"VVVVVVVMV",0,8,0.884057971014493,110,116,133,136,140,146,174,177,"ATGAAGA","AAGA","GTGTAGA","CTGA",2.52728870608517,17,4,28,58,1.76725681128943,4.65396204629763,8.1901939303556,101,"ENSG00000079974.19"
"4093","ENSG00000094975.14_53711",53703,53711,9,"ENSG00000094975.14",0,NA,"VVVUVUVVV",2,7,0.802898550724638,113,119,133,136,156,162,173,176,"ATGATTA","CTGA","GTGGCCA","CTGA",2.65274168399168,14,20,11,54,2.22777040045062,4.9781787400988,8.18977294299735,101,"ENSG00000079974.19"
"18599","ENSG00000157827.20_164163",164155,164163,9,"ENSG00000157827.20",1,7,"UVVVVVMVV",1,7,0.787991718426501,114,120,133,136,148,154,204,207,"CTGATGA","CTGA","TTGAGGC","CTGA",2.7579077180568,13,12,50,84,1.76392572205356,5.03749429394139,8.1894611676474,101,"ENSG00000079974.19"
"21900","ENSG00000169302.16_134590",134582,134590,9,"ENSG00000169302.16",1,5,"VVVVMVVVV",0,8,0.886542443064182,115,121,133,136,183,189,210,213,"CAGATGA","CAGA","ATGATTA","CTGA",2.56660430386027,12,47,21,89,1.46218035353598,4.64321892815111,8.18938870040784,101,"ENSG00000079974.19"
"37688","ENSG00000248673.2_194286",194278,194286,9,"ENSG00000248673.2",0,NA,"UVVVVVVVV",1,8,0.902691511387163,66,72,89,92,102,108,133,136,"TTGATGA","TTCA","GTAATTT","CTGA",2.4581296673765,17,10,25,61,1.92623253858795,4.57844091360781,8.18920695915647,101,"ENSG00000079974.19"
"32510","ENSG00000227110.7_223895",223887,223895,9,"ENSG00000227110.7",1,1,"MVVVVVVVV",0,8,0.90600414078675,89,95,109,112,116,122,133,136,"AAGATTA","ATGT","GGGATTA","CTGA",2.31200739336177,14,4,11,38,2.84726313322388,4.56516143890893,8.18917800205593,101,"ENSG00000079974.19"
"3395","ENSG00000083099.11_9154",9146,9154,9,"ENSG00000083099.11",0,NA,"VVUVVVVVV",1,8,0.883643892339545,115,121,133,136,143,149,159,162,"AGGAAGA","CAAA","GGGAGGA","CTGA",2.33373673836774,12,7,10,38,3.05995008775671,4.65454875255208,8.18912432191026,101,"ENSG00000079974.19"
"14497","ENSG00000145147.20_45885",45877,45885,9,"ENSG00000145147.20",1,1,"MVVVVVVVV",0,8,0.90600414078675,102,108,133,136,141,147,155,158,"ATGAGGA","GAGA","CACATGA","CTGA",2.42570558045769,25,5,8,47,2.08614250131555,4.56437825942503,8.18839482257203,101,"ENSG00000079974.19"
"38385","ENSG00000250095.5_96710",96702,96710,9,"ENSG00000250095.5",0,NA,"VVVVUVVVV",1,8,0.889855072463768,109,115,133,136,148,154,167,170,"ATAATTA","CTTA","CTGATTT","CTGA",2.4245270090338,18,12,13,52,2.35161283170159,4.62878155631507,8.18820184617014,101,"ENSG00000079974.19"
"17117","ENSG00000153165.19_46952",46944,46952,9,"ENSG00000153165.19",1,2,"VMVVVVVVV",0,8,0.884057971014493,115,121,133,136,144,150,169,172,"ATGATAA","CTGA","TTAATTA","CTAA",2.40653041749659,12,8,19,48,2.56391001398769,4.6518615326579,8.18809341671587,101,"ENSG00000079974.19"
"5091","ENSG00000103047.8_106438",106430,106438,9,"ENSG00000103047.8",1,1,"MVVVVVVVV",0,8,0.90600414078675,67,73,89,92,96,102,133,136,"CTGATGA","CTGA","ATGTACA","ATGA",2.47068522770931,16,4,31,60,1.78279617176304,4.56350775578961,8.18752431893661,101,"ENSG00000079974.19"
"30463","ENSG00000205038.12_166453",166445,166453,9,"ENSG00000205038.12",0,NA,"VVVUVVVVV",1,8,0.880745341614907,94,100,133,136,167,173,184,187,"ATGTTGA","TTGA","TTGATGG","CTGA",2.64191578289404,33,31,11,84,1.04519749254367,4.66449234462598,8.18747371108561,101,"ENSG00000079974.19"
"28485","ENSG00000189337.17_1131037",1131029,1131037,9,"ENSG00000189337.17",1,1,"MVVVVVVVV",0,8,0.90600414078675,113,119,133,136,149,155,177,180,"CTGAGGA","CCCA","ATGTTGA","CTGA",2.42805366738774,14,13,22,58,2.06562682153056,4.56316281769554,8.18717938084254,101,"ENSG00000079974.19"
"26306","ENSG00000183826.18_138707",138699,138707,9,"ENSG00000183826.18",0,NA,"VVVVVUUVV",2,7,0.808281573498965,86,92,133,136,143,149,161,164,"ATGATCA","CTGA","AGGTTGA","CTGA",2.67835727841462,41,7,12,69,1.95902703963499,4.95368555726644,8.1868118512623,101,"ENSG00000079974.19"
"35300","ENSG00000235652.11_83022",83014,83022,9,"ENSG00000235652.11",0,NA,"VVVVVVUVV",1,8,0.886128364389234,98,104,133,136,148,154,167,170,"ATGATTA","CTGG","GTAAATA","CTGA",2.52378456275906,29,12,13,63,1.74354330022966,4.64219342965585,8.18670688721279,101,"ENSG00000079974.19"
"16469","ENSG00000151617.17_44789",44781,44789,9,"ENSG00000151617.17",1,1,"MVVVVVVVV",0,8,0.90600414078675,103,109,133,136,150,156,164,167,"ATGATGA","CTGG","TTGTTAA","CTGG",2.46437058147008,24,14,8,55,1.82099743135892,4.56253366028986,8.18655022343686,101,"ENSG00000079974.19"
"29564","ENSG00000198265.12_45713",45705,45713,9,"ENSG00000198265.12",0,NA,"VVUVVVVVV",1,8,0.883643892339545,43,49,56,59,76,82,133,136,"ATGAGGA","GTGA","GTGAAGG","CTGA",2.63491028735482,7,17,51,84,1.04181487798913,4.65197086508865,8.18654643444683,101,"ENSG00000079974.19"
"15038","ENSG00000146802.13_5278",5270,5278,9,"ENSG00000146802.13",0,NA,"VVVVVUVVV",1,8,0.922153209109731,116,122,133,136,147,153,171,174,"ATGATGA","CAGC","TGGATAA","CAGA",2.33166967728725,11,11,18,49,2.44715686390202,4.49790534478758,8.1865181812265,101,"ENSG00000079974.19"
"19946","ENSG00000164039.15_13813",13805,13813,9,"ENSG00000164039.15",1,6,"VVVVVMVVV",0,8,0.902691511387163,100,106,133,136,181,187,196,199,"GTGATGA","CTGT","ACAAAGA","CTGA",2.57984722152464,27,45,9,90,1.10393480008713,4.57572906922952,8.18649511477817,101,"ENSG00000079974.19"
"40832","ENSG00000257842.6_188096",188088,188096,9,"ENSG00000257842.6",1,7,"UVVVVVMVV",1,7,0.787991718426501,84,90,102,105,114,120,133,136,"AAGATGA","CAGA","GTTCTGA","CTGA",2.58825739661428,12,9,13,43,2.88224643401867,5.03432393619514,8.18629080990114,101,"ENSG00000079974.19"
"40906","ENSG00000258081.4_186710",186702,186710,9,"ENSG00000258081.4",1,7,"UVVVVVMVV",1,7,0.787991718426501,84,90,102,105,114,120,133,136,"AAGATGA","CAGA","GTTCTGA","CTGA",2.58825739661428,12,9,13,43,2.88224643401867,5.03432393619514,8.18629080990114,101,"ENSG00000079974.19"
"24663","ENSG00000177359.23_20119",20111,20119,9,"ENSG00000177359.23",0,NA,"VVVVVUVVV",1,8,0.922153209109731,111,117,133,136,145,151,194,197,"ATGATTA","CTTT","ATAATAA","CTGA",2.42862655274655,16,9,43,77,1.79964951995404,4.49762330123275,8.18623613767168,101,"ENSG00000079974.19"
"30923","ENSG00000214776.13_24632",24624,24632,9,"ENSG00000214776.13",0,NA,"VVVVVUVVV",1,8,0.922153209109731,111,117,133,136,145,151,194,197,"ATGATTA","CTTT","ATAATAA","CTGA",2.42862655274655,16,9,43,77,1.79964951995404,4.49762330123275,8.18623613767168,101,"ENSG00000079974.19"
"44967","ENSG00000284634.1_56945",56937,56945,9,"ENSG00000284634.1",0,NA,"VVVVVUVVV",1,8,0.922153209109731,111,117,133,136,145,151,194,197,"ATGATTA","CTTT","ATAATAA","CTGA",2.42862655274655,16,9,43,77,1.79964951995404,4.49762330123275,8.18623613767168,101,"ENSG00000079974.19"
"48538","ENSG00000291252.1_19362",19354,19362,9,"ENSG00000291252.1",0,NA,"VVVVVUVVV",1,8,0.922153209109731,111,117,133,136,145,151,194,197,"ATGATTA","CTTT","ATAATAA","CTGA",2.42862655274655,16,9,43,77,1.79964951995404,4.49762330123275,8.18623613767168,101,"ENSG00000079974.19"
"8826","ENSG00000120899.18_130316",130308,130316,9,"ENSG00000120899.18",1,7,"VVVVVVMVV",0,8,0.885300207039338,106,112,133,136,141,147,156,159,"AGGATGT","CTGG","ATGGAGC","CTGA",2.43470278073003,21,5,9,44,2.34858436457467,4.64498405902705,8.1861848871844,101,"ENSG00000079974.19"
"14897","ENSG00000146090.16_62662",62654,62662,9,"ENSG00000146090.16",1,8,"VVVVVVVMV",0,8,0.884057971014493,83,89,102,105,115,121,133,136,"ATGATGA","ATGA","TTGATGA","TTAA",2.36085164370521,13,10,12,44,2.86058706384062,4.64989950546884,8.18613138952681,101,"ENSG00000079974.19"
"16807","ENSG00000152348.16_179966",179958,179966,9,"ENSG00000152348.16",1,1,"MVVVVVVVV",0,8,0.90600414078675,23,29,47,50,71,77,133,136,"ATCATGA","GTGA","CTGTAGA","CTGA",2.60126538186359,18,21,56,104,0.90533985952829,4.56177726798805,8.18579383113505,101,"ENSG00000079974.19"
"11367","ENSG00000134769.23_236965",236957,236965,9,"ENSG00000134769.23",0,NA,"VVVVVVUVV",1,8,0.886128364389234,81,87,102,105,109,115,133,136,"CAGATAA","CTGC","GTGAGGA","CTGA",2.42664045336501,15,4,18,46,2.38742097017111,4.64125599815114,8.18576945570807,101,"ENSG00000079974.19"
"23970","ENSG00000174579.5_19257",19249,19257,9,"ENSG00000174579.5",1,6,"UVVVVMVVV",1,7,0.805383022774327,65,71,83,86,94,100,133,136,"ATGATGA","ATGG","CTGGTGA","CTGA",2.66903255336062,12,8,33,62,2.06268900266569,4.96405983960079,8.1855919306981,101,"ENSG00000079974.19"
"27698","ENSG00000187164.20_179486",179478,179486,9,"ENSG00000187164.20",1,6,"VVVVVMVVV",0,8,0.902691511387163,43,49,79,82,92,98,133,136,"ATGTTGA","TTGA","TTGAAGC","CTGA",2.59546308019134,30,10,35,84,0.994868362631759,4.57448889097684,8.18525493652549,101,"ENSG00000079974.19"
"20932","ENSG00000166002.7_16669",16661,16669,9,"ENSG00000166002.7",1,8,"UVVVVVVMV",1,7,0.786749482401656,114,120,133,136,167,173,212,215,"ATGATGT","CTGA","CTGATGA","CTGA",2.86345373028286,13,31,39,92,1.06306160086642,5.03818828402137,8.185186213628,101,"ENSG00000079974.19"
"12671","ENSG00000138768.15_44696",44688,44696,9,"ENSG00000138768.15",1,6,"VVVVVMVVV",0,8,0.902691511387163,114,120,133,136,158,164,187,190,"AAAATGA","GTGA","ATGATTA","CTGA",2.51078647229064,13,22,23,67,1.5578362555,4.5741031843594,8.18486922990805,101,"ENSG00000079974.19"
"7777","ENSG00000115677.18_48443",48435,48443,9,"ENSG00000115677.18",1,1,"MVVVVVVVV",0,8,0.90600414078675,115,121,133,136,145,151,166,169,"ATTTTGA","CTGA","ATGTAGA","CTGG",2.32040831410097,12,9,15,45,2.77385574891908,4.56081112739806,8.18482769054506,101,"ENSG00000079974.19"
"5216","ENSG00000103995.14_75768",75760,75768,9,"ENSG00000103995.14",1,6,"VVVVVMVVV",0,8,0.902691511387163,84,90,102,105,112,118,133,136,"TAGATTA","CTGT","TTGATAT","CTGA",2.31977258487317,12,7,15,43,2.82962898783847,4.5736948884149,8.18446093396355,101,"ENSG00000079974.19"
"38692","ENSG00000250891.3_476392",476384,476392,9,"ENSG00000250891.3",1,8,"VVVVVVVMV",0,8,0.884057971014493,55,61,77,80,87,93,133,136,"GTGAAGA","ATGA","ATTATCA","CTGA",2.51012805459286,16,7,40,72,1.85835345948475,4.64813512252595,8.18436700658392,101,"ENSG00000079974.19"
"23394","ENSG00000172915.20_269072",269064,269072,9,"ENSG00000172915.20",1,2,"VMVVVVVVV",0,8,0.884057971014493,80,86,99,102,115,121,133,136,"GTGATTA","CTGA","GTTATTA","ATGA",2.39126532174124,13,13,12,47,2.65060692815329,4.64809393494039,8.18432581899836,101,"ENSG00000079974.19"
"9516","ENSG00000125166.13_22350",22342,22350,9,"ENSG00000125166.13",0,NA,"VVVVVUVVV",1,8,0.922153209109731,110,116,133,136,146,152,191,194,"ATGCAGA","CCAA","GTGATGA","CTGA",2.44566956048625,17,10,39,75,1.67812800303694,4.49564793490298,8.1842607713419,101,"ENSG00000079974.19"
"36547","ENSG00000241743.4_291984",291976,291984,9,"ENSG00000241743.4",1,1,"MVVVVVVVV",0,8,0.90600414078675,91,97,133,136,148,154,206,209,"ATGATGA","AAGA","GTGCAGT","CTGA",2.62003496769611,36,12,52,109,0.773564962550883,4.5601161867979,8.1841327499449,101,"ENSG00000079974.19"
"15949","ENSG00000150394.14_295606",295598,295606,9,"ENSG00000150394.14",1,8,"VVVVVVVMV",0,8,0.884057971014493,114,120,133,136,155,161,172,175,"ATAATGA","CTAA","TTGATGA","TTGA",2.44292155016184,13,19,11,52,2.30442402725601,4.6476419237504,8.18387380780837,101,"ENSG00000079974.19"
"26862","ENSG00000185053.14_843289",843281,843289,9,"ENSG00000185053.14",1,8,"VVVVVVUMV",1,7,0.770186335403727,116,122,133,136,142,148,160,163,"ATGATGA","AAGA","ATAATTA","CTGA",2.61538969742584,11,6,12,38,2.97649584985615,5.1031067915071,8.18385213312201,101,"ENSG00000079974.19"
"5276","ENSG00000104237.11_214157",214149,214157,9,"ENSG00000104237.11",1,1,"MVVVVVUVV",1,7,0.792132505175983,113,119,133,136,151,157,167,170,"ATGAGAA","CTGA","GTGATTA","CTGA",2.63122478733144,14,15,10,48,2.5195395340307,5.01525952906007,8.18378954976401,101,"ENSG00000079974.19"
"27542","ENSG00000186471.13_13137",13129,13137,9,"ENSG00000186471.13",1,8,"VVVVVUVMV",1,7,0.806211180124224,86,92,104,107,116,122,133,136,"AAGAAGA","CTGA","GTGGGGT","CTGA",2.53115165271129,12,9,11,41,2.96068183600898,4.95875654685439,8.18360126735128,101,"ENSG00000079974.19"
"4532","ENSG00000100916.14_24981",24973,24981,9,"ENSG00000100916.14",1,1,"MVVVVVVVV",0,8,0.90600414078675,115,121,133,136,148,154,163,166,"ATGAGGA","ATGA","ATGAATT","GTGA",2.31823182435087,12,12,9,42,2.78204584031701,4.55923116733071,8.18324773047771,101,"ENSG00000079974.19"
"10411","ENSG00000130962.18_55182",55174,55182,9,"ENSG00000130962.18",1,1,"MVVVVVVVV",0,8,0.90600414078675,42,48,62,65,109,115,133,136,"ATAATGA","CTGA","GTGAGCA","ATGA",2.49504257288088,14,44,18,85,1.60321667882833,4.55920845784188,8.18322502098887,101,"ENSG00000079974.19"
"38527","ENSG00000250349.3_55161",55153,55161,9,"ENSG00000250349.3",1,1,"MVVVVVVVV",0,8,0.90600414078675,42,48,62,65,109,115,133,136,"ATAATGA","CTGA","GTGAGCA","ATGA",2.49504257288088,14,44,18,85,1.60321667882833,4.55920845784188,8.18322502098887,101,"ENSG00000079974.19"
"47670","ENSG00000288912.1_1688",1680,1688,9,"ENSG00000288912.1",1,8,"VVVVVVVMV",0,8,0.884057971014493,89,95,133,136,142,148,168,171,"TTTATGA","CTGG","ATGAAGA","CTGA",2.56265886181111,38,6,20,73,1.50320102247476,4.64689835863721,8.18313024269518,101,"ENSG00000079974.19"
"16161","ENSG00000151012.13_27757",27749,27757,9,"ENSG00000151012.13",1,2,"VMVVVUVVV",1,7,0.806211180124223,115,121,133,136,140,146,159,162,"CTGAAGA","CTGA","GTAAGTA","CTGA",2.55240807806748,12,4,13,38,2.8168696944754,4.95823088706465,8.18307560756155,101,"ENSG00000079974.19"
"26261","ENSG00000183735.11_49541",49533,49541,9,"ENSG00000183735.11",1,8,"VVVVVUVMV",1,7,0.806211180124224,113,119,133,136,146,152,170,173,"GTGATCA","ATGA","ATGTTGA","CTGA",2.60006605407788,14,10,18,51,2.49864537163068,4.9581047663708,8.1829494868677,101,"ENSG00000079974.19"
"47542","ENSG00000288665.1_3663",3655,3663,9,"ENSG00000288665.1",1,8,"VVVVVUVMV",1,7,0.806211180124224,113,119,133,136,146,152,170,173,"GTGATCA","ATGA","ATGTTGA","CTGA",2.60006605407788,14,10,18,51,2.49864537163068,4.9581047663708,8.1829494868677,101,"ENSG00000079974.19"
"12664","ENSG00000138764.15_19381",19373,19381,9,"ENSG00000138764.15",1,8,"VVVVVVVMV",0,8,0.884057971014493,114,120,133,136,148,154,170,173,"AGGATGG","CAGA","GGGCTCA","CTGA",2.40988670720575,13,12,16,50,2.52076293860985,4.64666857999537,8.18290046405334,101,"ENSG00000079974.19"
"28656","ENSG00000196284.17_380393",380385,380393,9,"ENSG00000196284.17",0,NA,"UVVVVVVVV",1,8,0.902691511387163,111,117,133,136,151,157,171,174,"TTGAGCA","CTGA","TTCATTA","CTGA",2.40375704524214,16,15,14,54,2.26316121926427,4.5720520468863,8.18281809243495,101,"ENSG00000079974.19"
"23362","ENSG00000172766.19_17566",17558,17566,9,"ENSG00000172766.19",1,8,"VVVVVVVMV",0,8,0.884057971014493,110,116,133,136,147,153,178,181,"ATTATGA","CTAC","GTAATGA","CTGA",2.50848272164769,17,11,25,62,1.8631186503596,4.64658419866938,8.18281608272735,101,"ENSG00000079974.19"
"10010","ENSG00000128805.15_193941",193933,193941,9,"ENSG00000128805.15",1,3,"VVMVVVVVV",0,8,0.882815734989648,49,55,67,70,114,120,133,136,"ATGATGT","GTGA","CTGATGA","CAGA",2.50255478293796,12,44,13,78,1.92250817959152,4.65155168312782,8.18281462308641,101,"ENSG00000079974.19"
"8096","ENSG00000116783.15_245598",245590,245598,9,"ENSG00000116783.15",1,8,"VVVVVVVMV",0,8,0.884057971014493,82,88,133,136,141,147,202,205,"GTGATGA","CAGA","ATGCAGG","CTGA",2.64804479957829,45,5,55,114,0.932494710496647,4.64653167692131,8.18276356097928,101,"ENSG00000079974.19"
"41419","ENSG00000259030.8_282750",282742,282750,9,"ENSG00000259030.8",1,8,"VVVVVVVMV",0,8,0.884057971014493,82,88,133,136,141,147,202,205,"GTGATGA","CAGA","ATGCAGG","CTGA",2.64804479957829,45,5,55,114,0.932494710496647,4.64653167692131,8.18276356097928,101,"ENSG00000079974.19"
"24152","ENSG00000175344.19_19072",19064,19072,9,"ENSG00000175344.19",1,1,"MVVVVVVVV",0,8,0.90600414078675,85,91,106,109,116,122,133,136,"ATAATTT","CAGA","GTGGTAG","CTGA",2.29829293276794,15,7,11,42,2.91266155369768,4.55865360970431,8.18267017285131,101,"ENSG00000079974.19"
"39764","ENSG00000254186.3_408586",408578,408586,9,"ENSG00000254186.3",1,1,"MVVVVVVVV",0,8,0.90600414078675,114,120,133,136,153,159,168,171,"ATGGAGA","CAGT","GGGATGA","CTGA",2.37151899758541,13,17,9,48,2.4242089841333,4.55858390867568,8.18260047182267,101,"ENSG00000079974.19"
"1759","ENSG00000065883.18_40409",40401,40409,9,"ENSG00000065883.18",1,1,"MVVVVVVVV",0,8,0.90600414078675,102,108,133,136,143,149,170,173,"GTGATTA","ATGG","GTGATTA","CTGA",2.49025685193584,25,7,21,62,1.63203243120538,4.55843619436107,8.18245275750807,101,"ENSG00000079974.19"
"29002","ENSG00000196914.9_55142",55134,55142,9,"ENSG00000196914.9",0,NA,"VVVVVVUVV",1,8,0.886128364389234,107,113,133,136,166,172,180,183,"ATGCTGT","CTGA","GTGTTAG","CTGA",2.55447426519674,20,30,8,67,1.52156667217624,4.6378487767053,8.18236223426223,101,"ENSG00000079974.19"
"31529","ENSG00000224018.2_15988",15980,15988,9,"ENSG00000224018.2",1,2,"VMVVVVVVV",0,8,0.884057971014493,109,115,133,136,185,191,203,206,"ATGATGA","CAAA","ATTAGCA","CTGA",2.54384439586645,18,49,12,88,1.62550724379817,4.64611747072697,8.18234935478494,101,"ENSG00000079974.19"
"34244","ENSG00000232284.9_367098",367090,367098,9,"ENSG00000232284.9",1,1,"MVVVVVVVV",0,8,0.90600414078675,76,82,96,99,109,115,133,136,"CTGATTG","CAGA","AGGATGC","CTGA",2.3601948024393,14,10,18,51,2.49864537163068,4.55831934697317,8.18233591012017,101,"ENSG00000079974.19"
"2948","ENSG00000079691.19_225530",225522,225530,9,"ENSG00000079691.19",1,5,"VVVVMVVVV",0,8,0.886542443064182,85,91,103,106,111,117,133,136,"ATGTTGG","TTGG","GTGATAG","CTGA",2.37525606624667,12,5,16,42,2.70755614894998,4.63564914764861,8.18181891990534,101,"ENSG00000079974.19"
"27927","ENSG00000187672.15_712332",712324,712332,9,"ENSG00000187672.15",1,1,"MVVVVVVVV",0,8,0.90600414078675,89,95,106,109,115,121,133,136,"GGGATGG","GAGA","TTAAGGA","CTGA",2.28772254625906,11,6,12,38,2.97649584985615,4.5569948728958,8.18101143604279,101,"ENSG00000079974.19"
"18174","ENSG00000156395.14_43912",43904,43912,9,"ENSG00000156395.14",1,8,"VVVVVVVMV",0,8,0.884057971014493,73,79,92,95,113,119,133,136,"TTGATGA","TAGA","GACATGC","CTGA",2.45087820439913,13,18,14,54,2.2398258321207,4.64475346536205,8.18098534942002,101,"ENSG00000079974.19"
"28731","ENSG00000196376.11_409698",409690,409698,9,"ENSG00000196376.11",1,2,"VMVVVVVVV",0,8,0.884057971014493,56,62,74,77,84,90,133,136,"AAGATCA","CTGA","AGGAAAA","CTGA",2.48510992246657,12,7,43,71,2.01129740178583,4.64467422122408,8.18090610528205,101,"ENSG00000079974.19"
"26881","ENSG00000185177.14_21511",21503,21511,9,"ENSG00000185177.14",1,1,"MVVVVVVVV",0,8,0.90600414078675,114,120,133,136,158,164,174,177,"GTGATTA","CTTT","GTAAAGA","CTGA",2.40411930246521,13,22,10,54,2.19920409677699,4.55666652830294,8.18068309144994,101,"ENSG00000079974.19"
"25644","ENSG00000182348.7_179028",179020,179028,9,"ENSG00000182348.7",0,NA,"UVVVVUVVV",2,7,0.824844720496894,73,79,99,102,113,119,133,136,"ATGATGG","CTCA","AGGAGGA","CTGA",2.59911105255738,20,11,14,54,2.19689680003379,4.88107595427074,8.18045483625832,101,"ENSG00000079974.19"
"5694","ENSG00000106304.16_34556",34548,34556,9,"ENSG00000106304.16",1,2,"VMUVVVVVV",1,7,0.767701863354037,115,121,133,136,142,148,157,160,"AAGCTGA","CTGA","TTGATGT","CTGA",2.60292520599287,12,6,9,36,3.08515402764691,5.1094971835665,8.18030463698265,101,"ENSG00000079974.19"
"30596","ENSG00000205930.11_63985",63977,63985,9,"ENSG00000205930.11",1,5,"VVVVMVVVV",0,8,0.886542443064182,84,90,101,104,115,121,133,136,"ATGATGA","CTCA","AGCATTA","CTCA",2.363352016698,11,11,12,43,2.78034280521069,4.63400572913267,8.1801755013894,101,"ENSG00000079974.19"
"47127","ENSG00000287700.3_7323",7315,7323,9,"ENSG00000287700.3",1,1,"MVVVUVVVV",1,7,0.795859213250517,107,113,133,136,144,150,163,166,"GTGATAA","CTGA","AAGAAGA","CTGA",2.63850844713803,20,8,13,50,2.39688712076739,4.99673585875524,8.18017271175731,101,"ENSG00000079974.19"
"38293","ENSG00000249894.1_45156",45148,45156,9,"ENSG00000249894.1",1,6,"VVVVVMVVV",0,8,0.902691511387163,106,112,133,136,145,151,173,176,"TTAATGA","CAGA","AAGATTA","CTGA",2.47636589811154,21,9,22,61,1.76795666100043,4.56926566210268,8.18003170765133,101,"ENSG00000079974.19"
"38559","ENSG00000250421.5_57660",57652,57660,9,"ENSG00000250421.5",1,6,"VVVVVMVVV",0,8,0.902691511387163,106,112,133,136,145,151,173,176,"TTAATGA","CAGA","AAGATTA","CTGA",2.47636589811154,21,9,22,61,1.76795666100043,4.56926566210268,8.18003170765133,101,"ENSG00000079974.19"
"19479","ENSG00000163104.18_44081",44073,44081,9,"ENSG00000163104.18",1,2,"UMVVVVVVV",1,7,0.786749482401656,86,92,104,107,115,121,133,136,"ATGATAA","CTAA","CTGAGTA","CTGA",2.57442628666944,12,8,12,41,2.9690210902687,5.03296575034958,8.17996367995621,101,"ENSG00000079974.19"
"44719","ENSG00000283434.2_46040",46032,46040,9,"ENSG00000283434.2",0,NA,"VVUVVVVVV",1,8,0.883643892339545,80,86,97,100,111,117,133,136,"CTGAAGA","GAGA","ATGGGGA","CTGA",2.40137416320769,11,11,16,47,2.57119737585519,4.64508961597662,8.17966518533479,101,"ENSG00000079974.19"
"36875","ENSG00000243295.2_518815",518807,518815,9,"ENSG00000243295.2",1,1,"MVVVVVVVV",0,8,0.90600414078675,103,109,133,136,147,153,172,175,"ATGAGGA","ATCA","GTGTTAA","CTGA",2.48907660166663,24,11,19,63,1.62837010246952,4.5555535283951,8.17957009154209,101,"ENSG00000079974.19"
"30371","ENSG00000204764.14_105276",105268,105276,9,"ENSG00000204764.14",0,NA,"VVVUVVVVV",1,8,0.880745341614907,97,103,109,112,116,122,133,136,"ATGAGGA","CTTA","CTGATGT","CTAA",2.39127785558683,6,4,11,30,2.6843125240617,4.65654122366014,8.17952259011977,101,"ENSG00000079974.19"
"20068","ENSG00000164199.18_426260",426252,426260,9,"ENSG00000164199.18",1,3,"VVMVVVVVV",0,8,0.882815734989648,90,96,106,109,116,122,133,136,"ATGATTA","ATGA","CTGATTT","CTCA",2.34120553812161,10,7,11,37,2.98392688917998,4.64799095249767,8.17925389245626,101,"ENSG00000079974.19"
"37031","ENSG00000244464.2_25860",25852,25860,9,"ENSG00000244464.2",0,NA,"VVUVVVVVV",1,8,0.883643892339545,115,121,133,136,143,149,164,167,"ATATTGC","CTGA","AGGAAAA","CTGA",2.36231528591047,12,7,15,43,2.82962898783847,4.64459939014373,8.17917495950191,101,"ENSG00000079974.19"
"31659","ENSG00000224318.6_63583",63575,63583,9,"ENSG00000224318.6",1,2,"VMVVVVVVV",0,8,0.884057971014493,109,115,133,136,163,169,183,186,"GTAATGA","TGGA","CTGATGA","CTGA",2.54195490897924,18,27,14,68,1.62530917736985,4.64291880930785,8.17915069336583,101,"ENSG00000079974.19"
"23920","ENSG00000174482.11_1085323",1085315,1085323,9,"ENSG00000174482.11",1,8,"VVVUVVVMV",1,7,0.764803312629399,47,53,62,65,115,121,133,136,"ATGATGA","ATGA","GTTATGA","CTGA",2.80263494486351,9,50,12,80,1.79515366834702,5.11984665852594,8.17905990904354,101,"ENSG00000079974.19"
"22766","ENSG00000171385.11_175747",175739,175747,9,"ENSG00000171385.11",1,6,"VVVVVMVVV",0,8,0.902691511387163,116,122,133,136,146,152,200,203,"ATGTTGT","CTTA","CTGACAA","CTGA",2.45939618925849,11,10,48,78,1.87684397195919,4.56820464175394,8.1789706873026,101,"ENSG00000079974.19"
"3020","ENSG00000080298.16_189169",189161,189169,9,"ENSG00000080298.16",1,5,"VVVVMVVVV",0,8,0.886542443064182,77,83,101,104,113,119,133,136,"ACGATAA","ATGA","CTCATTA","CTGA",2.40613265128553,18,9,14,50,2.48905424386845,4.632484646443,8.17865441869973,101,"ENSG00000079974.19"
"33588","ENSG00000230426.5_601012",601004,601012,9,"ENSG00000230426.5",1,1,"MVVVVVVVV",0,8,0.90600414078675,112,118,133,136,146,152,162,165,"TTCATGA","GGGA","AGGAAGG","CTGA",2.31028456907907,15,10,10,44,2.8163612972043,4.55456460609953,8.17858116924652,101,"ENSG00000079974.19"
"9961","ENSG00000128585.18_122801",122793,122801,9,"ENSG00000128585.18",1,8,"VVVVVVUMV",1,7,0.770186335403727,115,121,133,136,139,145,156,159,"ATTAGGA","CTGA","ATGAGGA","CTGA",2.63574250414847,12,3,11,35,2.81845516435072,5.09751796466846,8.17826330628337,101,"ENSG00000079974.19"
"29398","ENSG00000197943.12_125055",125047,125055,9,"ENSG00000197943.12",1,5,"VVUVMVVVV",1,7,0.770186335403727,89,95,133,136,143,149,164,167,"ATGATGA","CTGA","ATCTGGA","CTGA",2.78505067567568,38,7,15,69,1.82006030457505,5.09676620226989,8.17751154388479,101,"ENSG00000079974.19"
"47939","ENSG00000289733.1_165301",165293,165301,9,"ENSG00000289733.1",1,5,"VVUVMVVVV",1,7,0.770186335403727,89,95,133,136,143,149,164,167,"ATGATGA","CTGA","ATCTGGA","CTGA",2.78505067567568,38,7,15,69,1.82006030457505,5.09676620226989,8.17751154388479,101,"ENSG00000079974.19"
"25134","ENSG00000179603.18_90724",90716,90724,9,"ENSG00000179603.18",1,8,"VVVVVVVMV",0,8,0.884057971014493,95,101,133,136,149,155,167,170,"AAGAGGA","CTGA","GTGAGAG","CTGA",2.53340767990997,32,13,12,66,1.67559486872184,4.64124485036375,8.17747673442172,101,"ENSG00000079974.19"
"27991","ENSG00000187823.4_263673",263665,263673,9,"ENSG00000187823.4",1,6,"VVVVVMUVV",1,7,0.788819875776397,89,95,106,109,116,122,133,136,"ATGAAGG","CTGA","CGGATGT","CTGA",2.56009168351485,11,7,11,38,3.0203974279366,5.0219188295089,8.17719833261449,101,"ENSG00000079974.19"
"6909","ENSG00000112234.9_72331",72323,72331,9,"ENSG00000112234.9",1,2,"VMVVVVVVV",0,8,0.884057971014493,90,96,133,136,148,154,168,171,"ATGATGT","CCGG","GTGGAGA","CTGA",2.53830225292941,37,12,14,72,1.641487350021,4.6408755923876,8.17710747644557,101,"ENSG00000079974.19"
"45534","ENSG00000285690.1_2884",2876,2884,9,"ENSG00000285690.1",0,NA,"VVVVVUVVV",1,8,0.922153209109731,84,90,133,136,157,163,176,179,"AGGATGA","CAGT","ACGATGA","CTGA",2.51934242307512,43,21,13,86,1.15802666397855,4.48841070445317,8.1770235408921,101,"ENSG00000079974.19"
"45844","ENSG00000285968.1_3214",3206,3214,9,"ENSG00000285968.1",0,NA,"VVVVVUVVV",1,8,0.922153209109731,84,90,133,136,157,163,176,179,"AGGATGA","CAGT","ACGATGA","CTGA",2.51934242307512,43,21,13,86,1.15802666397855,4.48841070445317,8.1770235408921,101,"ENSG00000079974.19"
"15087","ENSG00000147044.23_128727",128719,128727,9,"ENSG00000147044.23",1,6,"VVVVVMVVV",0,8,0.902691511387163,114,120,133,136,140,146,160,163,"ATTATGA","CAGG","GTGAAGA","TTGA",2.32903978108733,13,4,14,40,2.73786037673368,4.56619806266231,8.17696410821096,101,"ENSG00000079974.19"
"41520","ENSG00000259134.7_86224",86216,86224,9,"ENSG00000259134.7",1,6,"VVVVVMVVV",0,8,0.902691511387163,78,84,95,98,106,112,133,136,"ATGCTGG","CTGA","TTGCTGA","GTGA",2.37604356691226,11,8,21,49,2.42293942001396,4.56580746652392,8.17657351207258,101,"ENSG00000079974.19"
"35576","ENSG00000236356.1_18072",18064,18072,9,"ENSG00000236356.1",1,8,"VVVVVVVMV",0,8,0.884057971014493,113,119,133,136,147,153,167,170,"GTTAAGA","GTGA","GAGATGG","CTGA",2.38336623492201,14,11,14,48,2.67218893375837,4.64032429164294,8.17655617570091,101,"ENSG00000079974.19"
"38203","ENSG00000249781.7_40177",40169,40177,9,"ENSG00000249781.7",1,6,"VVVVVMVVV",0,8,0.902691511387163,97,103,112,115,116,122,133,136,"GTCATGT","CTGG","GTTTGGA","CTGA",2.36119205670325,9,1,11,30,2.52107458842492,4.56558874161165,8.1763547871603,101,"ENSG00000079974.19"
"3364","ENSG00000083067.25_344711",344703,344711,9,"ENSG00000083067.25",0,NA,"VVVVUVVVV",1,8,0.889855072463768,114,120,133,136,145,151,160,163,"ATCATGG","TGGA","GTGTTTG","CTGA",2.32345733368694,13,9,9,40,2.9779462793036,4.61691545930413,8.1763357491592,101,"ENSG00000079974.19"
"9028","ENSG00000122335.17_7828",7820,7828,9,"ENSG00000122335.17",1,8,"UVVVVVVMV",1,7,0.786749482401656,110,116,133,136,144,150,166,169,"GTGATGA","CTAA","ATAATCA","CTGA",2.64239320383361,17,8,16,50,2.50092111305376,5.02921895131945,8.17621688092608,101,"ENSG00000079974.19"
"40855","ENSG00000257986.3_152207",152199,152207,9,"ENSG00000257986.3",1,8,"VVVVVVVMV",0,8,0.884057971014493,101,107,133,136,182,188,198,201,"CTGATGT","ATGA","ATGATGG","CTGA",2.61360787968966,26,46,10,91,1.13571731154999,4.63994246070359,8.17617434476156,101,"ENSG00000079974.19"
"32731","ENSG00000227674.3_39962",39954,39962,9,"ENSG00000227674.3",0,NA,"VVVVUVVVV",1,8,0.889855072463768,86,92,108,111,116,122,133,136,"ATGGTTA","GTGA","ATCATTT","CTGA",2.35308540274897,16,5,11,41,2.77930076081277,4.61663419478481,8.17605448463989,101,"ENSG00000079974.19"
"44478","ENSG00000282440.1_6847",6839,6847,9,"ENSG00000282440.1",1,6,"VVVVVMVVV",0,8,0.902691511387163,106,112,133,136,152,158,167,170,"GTGATCA","TTGA","ATCTTGC","CTGA",2.45454631656815,21,16,9,55,1.89710215308345,4.56518606588445,8.1759521114331,101,"ENSG00000079974.19"
"45119","ENSG00000285051.2_280258",280250,280258,9,"ENSG00000285051.2",1,8,"VVVVVVVMV",0,8,0.884057971014493,95,101,133,136,142,148,159,162,"AGGATGA","TTCA","GGGAGGA","CTGA",2.48476002700571,32,6,11,58,1.99295025907046,4.6395042764438,8.17573616050177,101,"ENSG00000079974.19"
"45202","ENSG00000285218.1_310029",310021,310029,9,"ENSG00000285218.1",1,8,"VVVVVVVMV",0,8,0.884057971014493,95,101,133,136,142,148,159,162,"AGGATGA","TTCA","GGGAGGA","CTGA",2.48476002700571,32,6,11,58,1.99295025907046,4.6395042764438,8.17573616050177,101,"ENSG00000079974.19"
"46999","ENSG00000287474.1_180869",180861,180869,9,"ENSG00000287474.1",1,6,"VVVVVMVVV",0,8,0.902691511387163,115,121,133,136,142,148,190,193,"ATGATTA","TTAA","GTGACAT","CTGA",2.43917288600095,12,6,42,69,1.99764454234412,4.56469927892095,8.17546532446961,101,"ENSG00000079974.19"
"34583","ENSG00000233491.8_178309",178301,178309,9,"ENSG00000233491.8",1,1,"MVVVVVVVV",0,8,0.90600414078675,89,95,133,136,144,150,161,164,"ATGATGT","GAGA","GAAATTA","CTGA",2.43454819380145,38,8,11,66,1.97537098453474,4.5514230691361,8.17543963228309,101,"ENSG00000079974.19"
"1500","ENSG00000058091.17_440071",440063,440071,9,"ENSG00000058091.17",1,8,"VVVVVVVMV",0,8,0.884057971014493,87,93,104,107,113,119,133,136,"GTGATGA","TTTA","GTGAACA","GTGA",2.35405992738042,11,6,14,40,2.86308628654337,4.63920478393653,8.17543666799451,101,"ENSG00000079974.19"
"27879","ENSG00000187546.14_322315",322307,322315,9,"ENSG00000187546.14",1,3,"VVMVVVVVV",0,8,0.882815734989648,77,83,101,104,115,121,133,136,"ATAATAA","TTGA","ATGAAAT","CTGA",2.4174297517853,18,11,12,50,2.46027132556381,4.64411741769979,8.17538035765839,101,"ENSG00000079974.19"
"10678","ENSG00000132334.17_118093",118085,118093,9,"ENSG00000132334.17",1,8,"VVVVVVVMV",0,8,0.884057971014493,44,50,68,71,80,86,133,136,"ATGATCA","CTGG","ATGAGAT","CTGA",2.54010961664146,18,9,47,83,1.62173203420698,4.6389490362875,8.17518092034548,101,"ENSG00000079974.19"
"18862","ENSG00000158985.14_35843",35835,35843,9,"ENSG00000158985.14",0,NA,"VVVUVVVVV",1,8,0.880745341614907,116,122,133,136,139,145,157,160,"AAGAAGA","ATGT","TTGATGT","CTGA",2.37648566397537,11,3,12,35,2.76538674811928,4.65215612698876,8.17513749344839,101,"ENSG00000079974.19"
"39554","ENSG00000253796.4_186237",186229,186237,9,"ENSG00000253796.4",0,NA,"VVVVUVVVV",1,8,0.889855072463768,114,120,133,136,149,155,170,173,"GGGCTGA","ATGA","CTGAGAA","CTGA",2.39317196874343,13,13,15,50,2.50763308041529,4.61552821800953,8.1749485078646,101,"ENSG00000079974.19"
"34266","ENSG00000232342.7_5297",5289,5297,9,"ENSG00000232342.7",1,8,"VVVVVVVMV",0,8,0.884057971014493,82,88,102,105,108,114,133,136,"ATGGTGA","CTGA","CTGGGGA","CTGG",2.446226980774,14,3,19,45,2.24607967745371,4.63856488732009,8.17479677137806,101,"ENSG00000079974.19"
"7797","ENSG00000115761.17_9370",9362,9370,9,"ENSG00000115761.17",1,1,"MVVVVVVVV",0,8,0.90600414078675,109,115,133,136,145,151,165,168,"ATGTTCA","TTGA","AAGATAC","CTGA",2.35701292617352,18,9,14,50,2.48905424386845,4.55061843792299,8.17463500106998,101,"ENSG00000079974.19"
"20248","ENSG00000164506.15_90469",90461,90469,9,"ENSG00000164506.15",1,3,"VVMVVVVVV",0,8,0.882815734989648,115,121,133,136,149,155,172,175,"ATTATGA","CTTC","ATTATTA","CTGA",2.42696401583299,12,13,17,51,2.39239884315455,4.64303973717695,8.17430267713554,101,"ENSG00000079974.19"
"21265","ENSG00000166948.10_2915",2907,2915,9,"ENSG00000166948.10",1,2,"VMVVVVVVV",0,8,0.884057971014493,90,96,106,109,115,121,133,136,"GTGATGG","GGGA","GTGATGA","CTGT",2.34175663810848,10,6,12,37,2.94002531109953,4.63793405795568,8.17416594201365,101,"ENSG00000079974.19"
"36870","ENSG00000243295.2_363963",363955,363963,9,"ENSG00000243295.2",1,8,"VVVVVVVMV",0,8,0.884057971014493,84,90,105,108,113,119,133,136,"ATGCTGG","AAGA","GAGAGGA","CTGA",2.37394412341145,15,5,14,43,2.7246821084173,4.63774406612342,8.17397595018139,101,"ENSG00000079974.19"
"32753","ENSG00000227733.12_42705",42697,42705,9,"ENSG00000227733.12",0,NA,"UVVVVVVVV",1,8,0.902691511387163,103,109,133,136,183,189,203,206,"ATGTTGA","CTTG","ATGATGA","CTGA",2.57424885125652,24,47,14,94,1.09111294263825,4.56319298775376,8.17395903330242,101,"ENSG00000079974.19"
"48533","ENSG00000291242.1_48509",48501,48509,9,"ENSG00000291242.1",0,NA,"UVVVVVVVV",1,8,0.902691511387163,103,109,133,136,183,189,203,206,"ATGTTGA","CTTG","ATGATGA","CTGA",2.57424885125652,24,47,14,94,1.09111294263825,4.56319298775376,8.17395903330242,101,"ENSG00000079974.19"
"4542","ENSG00000100994.12_13861",13853,13861,9,"ENSG00000100994.12",1,1,"MVVVVVVVV",0,8,0.90600414078675,90,96,133,136,165,171,185,188,"ATGAAGT","ATGA","GTGAAGA","CTGA",2.58938971083273,37,29,14,89,0.936976846494487,4.54989372967817,8.17391029282517,101,"ENSG00000079974.19"
"17533","ENSG00000154310.17_96965",96957,96965,9,"ENSG00000154310.17",1,8,"VVVVVVVMV",0,8,0.884057971014493,108,114,133,136,150,156,165,168,"TTGTTGA","CTGT","ATAATGC","CTGA",2.45276464318059,19,14,9,51,2.19873515143668,4.63762485982683,8.1738567438848,101,"ENSG00000079974.19"
"6555","ENSG00000110693.19_623877",623869,623877,9,"ENSG00000110693.19",1,8,"VVVVVVVMV",0,8,0.884057971014493,113,119,133,136,142,148,162,165,"CTGATGT","CTGG","GTGATTA","CTGG",2.3576914892692,14,6,14,43,2.83144750097253,4.6373476906918,8.17357957474977,101,"ENSG00000079974.19"
"2849","ENSG00000078328.23_861527",861519,861527,9,"ENSG00000078328.23",1,2,"VMVVVVVVV",0,8,0.884057971014493,111,117,133,136,151,157,165,168,"ATGCAGA","CAGA","ACGATGT","CTGA",2.42623172856797,16,15,8,48,2.37371199598715,4.63714754661007,8.17337943066804,101,"ENSG00000079974.19"
"44371","ENSG00000281357.5_110262",110254,110262,9,"ENSG00000281357.5",0,NA,"VVUVVVVVV",1,8,0.883643892339545,114,120,133,136,143,149,168,171,"ACAATGA","TTGT","ATGATAA","CTGA",2.39722350814753,13,7,19,48,2.57273250585677,4.63855564004342,8.1731312094016,101,"ENSG00000079974.19"
"23266","ENSG00000172456.18_312741",312733,312741,9,"ENSG00000172456.18",1,2,"VMVVVVVVV",0,8,0.884057971014493,106,112,133,136,146,152,160,163,"ATGTTCA","CTGC","ATGAGGG","CTGA",2.43855805860257,21,10,8,48,2.29000487540921,4.63676464985659,8.17299653391456,101,"ENSG00000079974.19"
"13508","ENSG00000141627.14_320047",320039,320047,9,"ENSG00000141627.14",1,8,"VVVVVVVMV",0,8,0.884057971014493,110,116,133,136,160,166,192,195,"CTGATGT","CTGT","GTGTTGA","CTGA",2.61127335257807,17,24,26,76,1.13806383004539,4.63663821180812,8.17287009586609,101,"ENSG00000079974.19"
"30894","ENSG00000214548.18_38364",38356,38364,9,"ENSG00000214548.18",0,NA,"UVVVVUVVV",2,7,0.824844720496894,114,120,133,136,146,152,169,172,"ATGATGG","CACA","GTGTGGA","CTGA",2.53517661593051,13,10,17,49,2.59264543972174,4.87345571981462,8.1728346018022,101,"ENSG00000079974.19"
"41514","ENSG00000259133.5_81352",81344,81352,9,"ENSG00000259133.5",1,8,"VVUVVVVMV",1,7,0.767701863354037,86,92,101,104,112,118,133,136,"AAGATGA","CTAA","GTGATAA","CTGA",2.66157539546419,9,8,15,41,2.66416212963374,5.10199952484876,8.17280697826491,101,"ENSG00000079974.19"
"25901","ENSG00000183067.6_24737",24729,24737,9,"ENSG00000183067.6",0,NA,"UVUVVVVVV",2,7,0.786335403726708,114,120,133,136,144,150,158,161,"TTGAAGA","CTGA","GTGTTTG","CTGA",2.56309306395316,13,8,8,38,3.0222337442241,5.02738020931129,8.17272182421812,101,"ENSG00000079974.19"
"14751","ENSG00000145819.18_192295",192287,192295,9,"ENSG00000145819.18",1,6,"VVVVVMVVV",0,8,0.902691511387163,107,113,133,136,149,155,163,166,"TTGATAA","TTGC","GTGAGGT","CTGA",2.41226570525522,20,13,8,50,2.16543109507265,4.5618006158602,8.17256666140885,101,"ENSG00000079974.19"
"16152","ENSG00000150995.21_192579",192571,192579,9,"ENSG00000150995.21",0,NA,"VVVVVVUVV",1,8,0.886128364389234,91,97,133,136,149,155,175,178,"ATGAGGA","CAGA","GAGTTGA","CTGA",2.59430843706899,36,13,20,78,1.21668158584274,4.62801779157567,8.1725312491326,101,"ENSG00000079974.19"
"40317","ENSG00000255528.1_12974",12966,12974,9,"ENSG00000255528.1",1,1,"MVVVVVVVV",0,8,0.90600414078675,116,122,133,136,139,145,156,159,"ATTCTGA","CAAA","AGGAGGA","CTGA",2.30484766934106,11,3,11,34,2.8281652332091,4.54845409053737,8.17247065368437,101,"ENSG00000079974.19"
"17645","ENSG00000154655.16_5965",5957,5965,9,"ENSG00000154655.16",1,2,"VMVVVVVVV",0,8,0.884057971014493,105,111,133,136,170,176,187,190,"ATGATGA","AGGA","ATGGATA","CTGA",2.57963237408247,22,34,11,76,1.3469254407911,4.63611865033522,8.17235053439319,101,"ENSG00000079974.19"
"43568","ENSG00000272391.6_49121",49113,49121,9,"ENSG00000272391.6",0,NA,"VVVVVUVVV",1,8,0.922153209109731,96,102,133,136,139,145,162,165,"GTGATCA","CGGA","GTAAAGC","CTGA",2.47561097086575,31,3,17,60,1.43053691943479,4.48365251463495,8.17226535107388,101,"ENSG00000079974.19"
"32170","ENSG00000226239.2_15876",15868,15876,9,"ENSG00000226239.2",1,7,"VVVVVVMVV",0,8,0.885300207039338,109,115,133,136,146,152,170,173,"ATGGAGT","CTGA","GGGAGGA","CTGA",2.44835336836484,18,10,18,55,2.20065885793331,4.63075366175806,8.17195448991541,101,"ENSG00000079974.19"
"13430","ENSG00000141429.14_11012",11004,11012,9,"ENSG00000141429.14",1,1,"MVVVVUVVV",1,7,0.82815734989648,80,86,99,102,104,110,133,136,"CAGATGA","TTGA","ATGATGA","CTGA",2.63309313703011,13,2,23,47,1.88231991297212,4.85906853995988,8.1716979395458,101,"ENSG00000079974.19"
"11306","ENSG00000134516.20_421342",421334,421342,9,"ENSG00000134516.20",0,NA,"VVVVVVUVV",1,8,0.886128364389234,63,69,81,84,87,93,133,136,"ATGAGGA","CTGA","TTGAAGA","CTGG",2.51804017099315,12,3,40,64,1.72146570369056,4.62710004424456,8.1716135018015,101,"ENSG00000079974.19"
"35900","ENSG00000237461.3_156687",156679,156687,9,"ENSG00000237461.3",0,NA,"UVVVVVVVV",1,8,0.902691511387163,109,115,133,136,144,150,160,163,"ATGATTT","CCCA","ATTAGGA","CTGA",2.33764240882855,18,8,10,45,2.65898769979868,4.56081760633058,8.17158365187923,101,"ENSG00000079974.19"
"40160","ENSG00000255145.3_243371",243363,243371,9,"ENSG00000255145.3",0,NA,"UVVVVVVVV",1,8,0.902691511387163,109,115,133,136,144,150,160,163,"ATGATTT","CCCA","ATTAGGA","CTGA",2.33764240882855,18,8,10,45,2.65898769979868,4.56081760633058,8.17158365187923,101,"ENSG00000079974.19"
"4697","ENSG00000101680.16_61370",61362,61370,9,"ENSG00000101680.16",1,6,"VVVVVMVVV",0,8,0.902691511387163,111,117,133,136,145,151,179,182,"GTGATGA","CTTA","GTGGTAA","GTGA",2.44187715245906,16,9,28,62,1.96297397330369,4.56053874742436,8.17130479297301,101,"ENSG00000079974.19"
"6138","ENSG00000108100.18_258070",258062,258070,9,"ENSG00000108100.18",1,2,"VMVVVVVVV",0,8,0.884057971014493,100,106,133,136,171,177,185,188,"TTTATGA","CTGA","GTTAAGA","CTGA",2.61560246953022,27,35,8,79,1.10271808996267,4.6350169717077,8.17124885576568,101,"ENSG00000079974.19"
"22803","ENSG00000171444.19_77197",77189,77197,9,"ENSG00000171444.19",1,2,"VMVVVVVVV",0,8,0.884057971014493,100,106,133,136,171,177,185,188,"TTTATGA","CTGA","GTTAAGA","CTGA",2.61560246953022,27,35,8,79,1.10271808996267,4.6350169717077,8.17124885576568,101,"ENSG00000079974.19"
"6048","ENSG00000107862.7_4297",4289,4297,9,"ENSG00000107862.7",1,7,"VVVVVVMVV",0,8,0.885300207039338,93,99,133,136,144,150,174,177,"ATGATGT","CTGC","GTGTTTC","CTGA",2.58099920520083,34,8,24,75,1.31260191182326,4.6298158199572,8.17101664811455,101,"ENSG00000079974.19"
"1776","ENSG00000066032.19_1256449",1256441,1256449,9,"ENSG00000066032.19",1,1,"MVVVVUVVV",1,7,0.82815734989648,87,93,104,107,114,120,133,136,"ATTAGGT","CTGA","CTCATGA","CTGA",2.47596988307997,11,7,13,40,2.92704015889572,4.85837651152389,8.17100591110981,101,"ENSG00000079974.19"
"5252","ENSG00000104093.14_85397",85389,85397,9,"ENSG00000104093.14",1,1,"MVVVVVVVV",0,8,0.90600414078675,91,97,133,136,142,148,170,173,"TTGATGA","ATAA","TTGTAGA","CTGA",2.51853350832633,36,6,22,73,1.39750558633485,4.54693224379427,8.17094880694127,101,"ENSG00000079974.19"
"19758","ENSG00000163637.13_277555",277547,277555,9,"ENSG00000163637.13",0,NA,"VVVVVUVVV",1,8,0.922153209109731,107,113,133,136,149,155,174,177,"TTGTTGA","CTAA","GTGTTCC","CTGA",2.42536130116524,20,13,19,61,1.75977185061689,4.48221179792962,8.17082463436854,101,"ENSG00000079974.19"
"32453","ENSG00000227028.6_51836",51828,51836,9,"ENSG00000227028.6",1,3,"UVMVVVVVV",1,7,0.785507246376811,73,79,95,98,104,110,133,136,"GTGATGA","CTAA","GTGACTA","CTGA",2.6901127984282,16,6,23,54,2.18047693944023,5.02864056557373,8.17066955108097,101,"ENSG00000079974.19"
"12015","ENSG00000136861.19_91306",91298,91306,9,"ENSG00000136861.19",0,NA,"VVVVVUVVV",1,8,0.922153209109731,82,88,103,106,115,121,133,136,"GTGGTGA","ATGA","CTGCTTA","CAGA",2.26558899002799,15,9,12,45,2.82414445701873,4.48201776430134,8.17063060074026,101,"ENSG00000079974.19"
"14158","ENSG00000144455.14_697504",697496,697504,9,"ENSG00000144455.14",1,2,"VMVVVVVVV",0,8,0.884057971014493,116,122,133,136,143,149,175,178,"ATCAGGA","CTAA","GTGTTAA","CTGA",2.44889670142082,11,7,26,53,2.21130148005632,4.63431987238212,8.17055175644009,101,"ENSG00000079974.19"
"3918","ENSG00000090989.18_21655",21647,21655,9,"ENSG00000090989.18",1,7,"VVVVVVMVV",0,8,0.885300207039338,110,116,133,136,144,150,163,166,"TTGATGA","TAGA","GTGATTA","GTGA",2.37791126424469,17,8,13,47,2.66352836419091,4.62906753145554,8.17026835961289,101,"ENSG00000079974.19"
"40320","ENSG00000255529.9_61997",61989,61997,9,"ENSG00000255529.9",1,3,"VVMVVVVVV",0,8,0.882815734989648,90,96,109,112,116,122,133,136,"TTGATCA","CTTT","TTGAAAA","CTGA",2.34867944570655,13,4,11,37,2.89801098999725,4.63896849034356,8.17023143030215,101,"ENSG00000079974.19"
"17295","ENSG00000153823.19_283386",283378,283386,9,"ENSG00000153823.19",1,3,"VVMVVVVVV",0,8,0.882815734989648,70,76,95,98,103,109,133,136,"GTGATGG","CTGG","GTGGTAC","CTGA",2.50993100604427,19,5,24,57,1.82210354748064,4.63874423027727,8.17000717023586,101,"ENSG00000079974.19"
"29875","ENSG00000198836.11_59866",59858,59866,9,"ENSG00000198836.11",1,8,"VVVVVVVMV",0,8,0.884057971014493,116,122,133,136,187,193,209,212,"AGGATGA","CTGG","GAGATTG","CTGA",2.5201510774742,11,51,16,87,1.73400364682263,4.63375270749599,8.16998459155396,101,"ENSG00000079974.19"
"29127","ENSG00000197265.9_23581",23573,23581,9,"ENSG00000197265.9",0,NA,"UVVVVVVVV",1,8,0.902691511387163,111,117,133,136,147,153,196,199,"TTGATGT","CATA","ATGATGG","CTGA",2.4828856377906,16,11,43,79,1.68417194457,4.5591857157935,8.16995176134215,101,"ENSG00000079974.19"
"42535","ENSG00000264015.2_40219",40211,40219,9,"ENSG00000264015.2",1,6,"VVVVVMVVV",0,8,0.902691511387163,77,83,94,97,104,110,133,136,"AAGAAGA","CAGA","GGGCTGT","CTGA",2.38529154040875,11,7,23,50,2.33425246943534,4.55904901804008,8.16981506358873,101,"ENSG00000079974.19"
"27798","ENSG00000187391.22_307379",307371,307379,9,"ENSG00000187391.22",1,6,"VVVVVMVVV",0,8,0.902691511387163,113,119,133,136,150,156,186,189,"ATCATGA","CAAA","CTGAAAA","CTGA",2.47840858028729,14,14,30,67,1.71329137402753,4.55900381065237,8.16976985620102,101,"ENSG00000079974.19"
"21779","ENSG00000168952.16_12129",12121,12129,9,"ENSG00000168952.16",0,NA,"UVVVVVVVV",1,8,0.902691511387163,98,104,133,136,145,151,165,168,"ACAATGA","TTGA","GTCATGG","CTGA",2.45291971201724,29,9,14,61,1.88049899886738,4.55832426974557,8.16909031529423,101,"ENSG00000079974.19"
"11786","ENSG00000136051.15_8477",8469,8477,9,"ENSG00000136051.15",0,NA,"UVVVVVVVV",1,8,0.902691511387163,64,70,81,84,103,109,133,136,"CTGATTT","CTGA","TTGAGTA","CTGA",2.49327542962864,11,19,24,63,1.61134695537754,4.55829578822545,8.1690618337741,101,"ENSG00000079974.19"
"25659","ENSG00000182389.20_231643",231635,231643,9,"ENSG00000182389.20",1,7,"VVVVVVMVV",0,8,0.885300207039338,96,102,109,112,116,122,133,136,"ATAATGA","TTCA","AAAATAA","CTGA",2.36453851314887,7,4,11,31,2.74698355691928,4.62764341114461,8.16884423930196,101,"ENSG00000079974.19"
"44637","ENSG00000283228.1_106425",106417,106425,9,"ENSG00000283228.1",1,7,"VVVVVVMVV",0,8,0.885300207039338,96,102,109,112,116,122,133,136,"ATAATGA","TTCA","AAAATAA","CTGA",2.36453851314887,7,4,11,31,2.74698355691928,4.62764341114461,8.16884423930196,101,"ENSG00000079974.19"
"21648","ENSG00000168675.19_187462",187454,187462,9,"ENSG00000168675.19",1,8,"VVVVVVVMV",0,8,0.884057971014493,110,116,133,136,149,155,188,191,"ATGAAGA","GTGT","ATGAAGA","CTGA",2.550775623854,17,13,33,72,1.52508516577879,4.63256399786803,8.168795881926,101,"ENSG00000079974.19"
"15490","ENSG00000148498.17_288725",288717,288725,9,"ENSG00000148498.17",1,1,"MVVVVVVVV",0,8,0.90600414078675,115,121,133,136,155,161,170,173,"CTGAAGA","TAGA","CTAAAGA","CTGA",2.37827465960521,12,19,9,49,2.32272245667367,4.54447171351044,8.16848827665744,101,"ENSG00000079974.19"
"13384","ENSG00000141298.19_156058",156050,156058,9,"ENSG00000141298.19",0,NA,"VVUVVVVVV",1,8,0.883643892339545,112,118,133,136,147,153,170,173,"TGGATGA","ATTA","ATTATGA","CTGA",2.41382570392116,15,11,17,52,2.44247399365069,4.63366133828127,8.16823690763944,101,"ENSG00000079974.19"
"30158","ENSG00000203867.8_17874",17866,17874,9,"ENSG00000203867.8",1,8,"VVVVVVVMV",0,8,0.884057971014493,87,93,106,109,114,120,133,136,"GTGCTTT","GTGA","ATGAGGA","CTGA",2.34729840986336,13,5,13,40,2.87932552744932,4.63199539830126,8.16822728235923,101,"ENSG00000079974.19"
"14591","ENSG00000145416.14_533646",533638,533646,9,"ENSG00000145416.14",1,2,"VMVVVVVVV",0,8,0.884057971014493,115,121,133,136,154,160,179,182,"CTGAAGA","CTCA","GGGAGGA","CTGA",2.48685686117474,12,18,19,58,1.94818048211351,4.63180655581962,8.16803843987759,101,"ENSG00000079974.19"
"3010","ENSG00000080224.18_923134",923126,923134,9,"ENSG00000080224.18",1,1,"MVVVVVVVV",0,8,0.90600414078675,109,115,133,136,152,158,180,183,"AGGTTGA","CTGG","TTGAAGA","CTGA",2.49186043679824,18,16,22,65,1.56257750627352,4.54374510456544,8.16776166771244,101,"ENSG00000079974.19"
"4571","ENSG00000101109.13_30777",30769,30777,9,"ENSG00000101109.13",0,NA,"VVVUVVVVV",1,8,0.880745341614907,83,89,100,103,108,114,133,136,"ATGGTCA","CAGA","GTGAAAC","CTGA",2.413268065805,11,5,19,44,2.49023833375704,4.64467302644759,8.16765439290721,101,"ENSG00000079974.19"
"7707","ENSG00000115419.13_28179",28171,28179,9,"ENSG00000115419.13",1,7,"VVVVVVMVV",0,8,0.885300207039338,79,85,100,103,115,121,133,136,"TAGATTA","CTGT","CTGATAA","CTGA",2.38058339568398,15,12,12,48,2.6352298265801,4.62644644945166,8.16764727760901,101,"ENSG00000079974.19"
"36733","ENSG00000242808.12_371308",371300,371308,9,"ENSG00000242808.12",1,8,"VVVVVVVMV",0,8,0.884057971014493,110,116,133,136,140,146,196,199,"AAGATGT","ATGA","CTGCTGA","CTGA",2.5395642921713,17,4,50,80,1.59519471843208,4.63140583322685,8.16763771728482,101,"ENSG00000079974.19"
"46451","ENSG00000286685.3_60765",60757,60765,9,"ENSG00000286685.3",1,1,"MVVVVVVVV",0,8,0.90600414078675,72,78,98,101,111,117,133,136,"GTAATGA","TTTA","GTGAAAT","CTGA",2.40397098481728,20,10,16,55,2.1471342692962,4.54340187535284,8.16741843849984,101,"ENSG00000079974.19"
"31647","ENSG00000224271.8_170235",170227,170235,9,"ENSG00000224271.8",0,NA,"VVVVVUVVV",1,8,0.922153209109731,86,92,133,136,148,154,162,165,"CTGGTGA","CAGA","ATAAATA","CTGA",2.42482864058231,41,12,8,70,1.74698106696932,4.47812633437952,8.16673917081844,101,"ENSG00000079974.19"
"44368","ENSG00000281344.1_190227",190219,190227,9,"ENSG00000281344.1",1,2,"VMVVVVVVV",0,8,0.884057971014493,116,122,133,136,154,160,184,187,"ATGATGG","ATTA","CTAATGA","CTGA",2.52903031396522,11,18,24,62,1.66136578443378,4.63039196938381,8.16662385344178,101,"ENSG00000079974.19"
"44568","ENSG00000283052.2_130599",130591,130599,9,"ENSG00000283052.2",1,2,"VMVVVVVVV",0,8,0.884057971014493,116,122,133,136,154,160,184,187,"ATGATGG","ATTA","CTAATGA","CTGA",2.52903031396522,11,18,24,62,1.66136578443378,4.63039196938381,8.16662385344178,101,"ENSG00000079974.19"
"8257","ENSG00000117616.18_68754",68746,68754,9,"ENSG00000117616.18",1,8,"VVVVVVVMV",0,8,0.884057971014493,116,122,133,136,143,149,159,162,"ATGCTGG","CTCT","CTGCTGT","CTGA",2.32016173495291,11,7,10,37,3.05362272147605,4.63034190529053,8.1665737893485,101,"ENSG00000079974.19"
"27426","ENSG00000186141.10_7580",7572,7580,9,"ENSG00000186141.10",1,1,"MVVVVVVVV",0,8,0.90600414078675,116,122,133,136,140,146,154,157,"ATGTAGA","AGGA","GTATGGA","CTGA",2.26813939071448,11,4,8,32,3.04928404403719,4.54255332886677,8.16656989201377,101,"ENSG00000079974.19"
"22121","ENSG00000169855.21_615922",615914,615922,9,"ENSG00000169855.21",1,5,"VVVVMVVVV",0,8,0.886542443064182,115,121,133,136,141,147,158,161,"ATGATGA","TTGT","ACGAAGT","GTGA",2.32279327954586,12,5,11,37,2.99624312688554,4.62038291429782,8.16655268655455,101,"ENSG00000079974.19"
"18981","ENSG00000159882.13_9664",9656,9664,9,"ENSG00000159882.13",1,7,"UVVVVVMVV",1,7,0.787991718426501,112,118,133,136,177,183,192,195,"ATGATGA","GTGA","CTCAGGA","CTGA",2.7215998460914,15,41,9,74,1.91412232060201,5.01453032363617,8.16649719734217,101,"ENSG00000079974.19"
"44006","ENSG00000276644.5_28833",28825,28833,9,"ENSG00000276644.5",1,6,"VVVVVMVVV",0,8,0.902691511387163,108,114,133,136,149,155,173,176,"ATAATCA","ATGA","CTGGAGA","CTGA",2.44737890812812,19,13,18,59,1.90702654814432,4.55572148391627,8.16648752946493,101,"ENSG00000079974.19"
"7278","ENSG00000113448.20_22231",22223,22231,9,"ENSG00000113448.20",1,2,"VMVVVVVVV",0,8,0.884057971014493,115,121,133,136,145,151,160,163,"ATCAGCA","CTGA","GGGCTAA","CTGA",2.32901906626104,12,9,9,39,2.9941639103681,4.63023942136042,8.16647130541839,101,"ENSG00000079974.19"
"37350","ENSG00000247556.6_8795",8787,8795,9,"ENSG00000247556.6",1,1,"MVVVVVVVV",0,8,0.90600414078675,73,79,100,103,112,118,133,136,"ATTATAC","CTGA","TGGAGGA","CTGA",2.39877173177059,21,9,15,54,2.17756188674515,4.5423433579706,8.16635992111759,101,"ENSG00000079974.19"
"45797","ENSG00000285920.2_8778",8770,8778,9,"ENSG00000285920.2",1,1,"MVVVVVVVV",0,8,0.90600414078675,73,79,100,103,112,118,133,136,"ATTATAC","CTGA","TGGAGGA","CTGA",2.39877173177059,21,9,15,54,2.17756188674515,4.5423433579706,8.16635992111759,101,"ENSG00000079974.19"
"48455","ENSG00000291122.1_66258",66250,66258,9,"ENSG00000291122.1",1,2,"VMVVVVVVV",0,8,0.884057971014493,112,118,133,136,183,189,200,203,"GTGATCT","ATGA","ATGTTGA","CTGA",2.49350289246884,15,47,11,82,1.89694743902184,4.6300750138702,8.16630689792817,101,"ENSG00000079974.19"
"39400","ENSG00000253554.7_207621",207613,207621,9,"ENSG00000253554.7",1,1,"MVVVVVVVV",0,8,0.90600414078675,97,103,133,136,145,151,159,162,"TTTATGA","ATGA","GTTTTAA","CTGA",2.42921714412346,30,9,8,56,1.97429673513776,4.54226942399021,8.16628598713721,101,"ENSG00000079974.19"
"19311","ENSG00000162706.13_15503",15495,15503,9,"ENSG00000162706.13",1,8,"VVVVVVVMV",0,8,0.884057971014493,115,121,133,136,156,162,199,202,"AGGATGC","CAGA","GTGAAGA","CTGA",2.58076124705964,12,20,37,78,1.31476973352463,4.62996117848057,8.16619306253854,101,"ENSG00000079974.19"
"13157","ENSG00000140443.15_218794",218786,218794,9,"ENSG00000140443.15",1,8,"VVVVVVVMV",0,8,0.884057971014493,12,18,59,62,73,79,133,136,"TAGATGA","CTGA","GTGAAGT","CTGA",2.65220345610254,41,11,54,115,0.837115754293251,4.62961803207754,8.16584991613551,101,"ENSG00000079974.19"
"1094","ENSG00000047617.17_74220",74212,74220,9,"ENSG00000047617.17",1,1,"MVVVVVVVV",0,8,0.90600414078675,116,122,133,136,177,183,191,194,"AGGATGA","GTTA","TTCATGC","CTGA",2.43075195526062,11,41,8,69,1.96095079136816,4.54149095660974,8.16550751975674,101,"ENSG00000079974.19"
"36962","ENSG00000243944.5_113896",113888,113896,9,"ENSG00000243944.5",0,NA,"VVVVVUVVV",1,8,0.922153209109731,77,83,97,100,106,112,133,136,"AGGAAGA","CTGA","ATGATAT","CTAA",2.32479219771364,14,6,21,50,2.40877252320025,4.47684679365613,8.16545963009506,101,"ENSG00000079974.19"
"19324","ENSG00000162745.11_23398",23390,23398,9,"ENSG00000162745.11",1,6,"VVVVVMVVV",0,8,0.902691511387163,58,64,78,81,87,93,133,136,"ATGATAA","CTCA","CTGATGA","CTTA",2.43753446122161,14,6,40,69,1.96815841649386,4.55459703949282,8.16536308504147,101,"ENSG00000079974.19"
"12783","ENSG00000139132.16_12692",12684,12692,9,"ENSG00000139132.16",1,1,"MVVVVUVVV",1,7,0.82815734989648,46,52,64,67,75,81,133,136,"TGGATGA","CTGA","ATGATTC","CTGA",2.61322455129795,12,8,52,81,1.98830755961188,4.85245114206621,8.16508054165213,101,"ENSG00000079974.19"
"33845","ENSG00000231304.2_294157",294149,294157,9,"ENSG00000231304.2",1,1,"MVVVVVVVV",0,8,0.90600414078675,111,117,133,136,150,156,164,167,"ATGATGT","CTGC","TTGGTAA","ATGA",2.35796590404253,16,14,8,47,2.44361812123082,4.54084770371192,8.16486426685892,101,"ENSG00000079974.19"
"32719","ENSG00000227646.7_26479",26471,26479,9,"ENSG00000227646.7",1,8,"VVVVVVVMV",0,8,0.884057971014493,115,121,133,136,137,143,152,155,"ATAATCA","CTAA","ATGTGAA","CTGA",2.3817457687309,12,1,9,31,2.63618269851883,4.62862195584787,8.16485383990584,101,"ENSG00000079974.19"
"20528","ENSG00000165029.17_26817",26809,26817,9,"ENSG00000165029.17",1,6,"VVVVVMVVV",0,8,0.902691511387163,115,121,133,136,146,152,167,170,"AAGCTGA","GGGA","TTGAGGT","CTGA",2.32449545427619,12,10,15,46,2.71957890381417,4.55405381641387,8.16481986196252,101,"ENSG00000079974.19"
"41639","ENSG00000259408.2_3418",3410,3418,9,"ENSG00000259408.2",1,8,"VVVVVVVMV",0,8,0.884057971014493,98,104,133,136,147,153,166,169,"ATGCAGA","ATGA","ATGATAA","CTGA",2.50521665059889,29,11,13,62,1.81278343837046,4.62855694392409,8.16478882798206,101,"ENSG00000079974.19"
"15027","ENSG00000146729.10_9520",9512,9520,9,"ENSG00000146729.10",0,NA,"UVVVVVVVV",1,8,0.902691511387163,53,59,78,81,94,100,133,136,"ATGTTTA","CTGA","GTGAAAT","CTGA",2.53027874601842,19,13,33,74,1.34693533337269,4.55386507670721,8.16463112225587,101,"ENSG00000079974.19"
"41586","ENSG00000259306.2_176",168,176,9,"ENSG00000259306.2",1,8,"VVVVVVVMV",0,8,0.884057971014493,59,65,103,106,112,118,133,136,"GAGATGC","CTGA","CTGCTCA","CTGA",2.50629571658815,38,6,15,68,1.80387017759424,4.62812707204547,8.16435895610344,101,"ENSG00000079974.19"
"20457","ENSG00000164871.18_17178",17170,17178,9,"ENSG00000164871.18",1,8,"VVVVVVVMV",0,8,0.884057971014493,110,116,133,136,144,150,191,194,"CTCATGG","CTGA","ATGAAAA","CTGA",2.51296187463045,17,8,41,75,1.75840847331457,4.6278719093794,8.16410379343737,101,"ENSG00000079974.19"
"24857","ENSG00000178287.18_17178",17170,17178,9,"ENSG00000178287.18",1,8,"VVVVVVVMV",0,8,0.884057971014493,110,116,133,136,144,150,191,194,"CTCATGG","CTGA","ATGAAAA","CTGA",2.51296187463045,17,8,41,75,1.75840847331457,4.6278719093794,8.16410379343737,101,"ENSG00000079974.19"
"42921","ENSG00000267337.2_38228",38220,38228,9,"ENSG00000267337.2",0,NA,"VVVVVUVVV",1,8,0.922153209109731,99,105,133,136,156,162,172,175,"ATTATAA","CTGA","AGGAGAA","CTGA",2.4817315440882,28,20,10,67,1.35596313130624,4.47521002297355,8.16382285941248,101,"ENSG00000079974.19"
"26192","ENSG00000183654.9_33479",33471,33479,9,"ENSG00000183654.9",1,8,"VVVVVVVMV",0,8,0.884057971014493,97,103,110,113,114,120,133,136,"ATAATGC","CAGA","GTGACAC","CTGA",2.44195865212173,7,1,13,30,2.22991027115264,4.62740865465771,8.16364053871568,101,"ENSG00000079974.19"
"9244","ENSG00000123338.13_10319",10311,10319,9,"ENSG00000123338.13",0,NA,"UVVVVVVVV",1,8,0.902691511387163,75,81,100,103,112,118,133,136,"AGGATGG","CTCA","ATAATTG","CTGA",2.37997600802096,19,9,15,52,2.34479655289162,4.55282581825783,8.16359186380648,101,"ENSG00000079974.19"
"33946","ENSG00000231606.2_11066",11058,11066,9,"ENSG00000231606.2",1,8,"VVVVVUVMV",1,7,0.806211180124224,91,97,133,136,142,148,160,163,"ATGATGA","CAGA","AAGATTT","CTGA",2.67086286067043,36,6,12,63,1.9479288894554,4.93842032348124,8.16326504397813,101,"ENSG00000079974.19"
"6085","ENSG00000107957.17_115454",115446,115454,9,"ENSG00000107957.17",0,NA,"VVVVVVUVV",1,8,0.886128364389234,102,108,133,136,137,143,155,158,"AGGATGA","CTTA","GTGTGCA","CTGA",2.55247981187193,25,1,12,47,1.45829559535596,4.61870691862554,8.16322037618247,101,"ENSG00000079974.19"
"9735","ENSG00000126821.8_18562",18554,18562,9,"ENSG00000126821.8",0,NA,"VVVVUVVVV",1,8,0.889855072463768,107,113,133,136,162,168,179,182,"ATGATAA","ATGA","GTCACTA","CTGA",2.5251945612018,20,26,11,66,1.58046067064747,4.60377276966486,8.16319305951993,101,"ENSG00000079974.19"
"47886","ENSG00000289587.2_3458",3450,3458,9,"ENSG00000289587.2",1,1,"MVVVVVVVV",0,8,0.90600414078675,114,120,133,136,149,155,163,166,"AAAATAA","CAGA","GTGATAC","CTGA",2.32112261672147,13,13,8,43,2.68231038213909,4.53911529007056,8.16313185321756,101,"ENSG00000079974.19"
"3963","ENSG00000091428.18_88291",88283,88291,9,"ENSG00000091428.18",0,NA,"VVVVVUVVV",1,8,0.922153209109731,88,94,105,108,116,122,133,136,"GTGAGGA","CTGT","TTTATGT","CTGT",2.23585795236335,11,8,11,39,2.99201626321764,4.47443398641,8.16304682284892,101,"ENSG00000079974.19"
"45939","ENSG00000286062.2_66247",66239,66247,9,"ENSG00000286062.2",0,NA,"UVVVVVVVV",1,8,0.902691511387163,86,92,133,136,144,150,188,191,"TTGATGA","TTTA","GTCATGA","CTGA",2.57865722716407,41,8,38,96,1.0179335085641,4.55224542241447,8.16301146796313,101,"ENSG00000079974.19"
"23316","ENSG00000172572.7_149116",149108,149116,9,"ENSG00000172572.7",1,2,"VMVVVVVVV",0,8,0.884057971014493,70,76,87,90,99,105,133,136,"TGGATGA","CTGG","AAGATTA","CTGA",2.46104107871397,11,9,28,57,2.0998911501025,4.62670791871558,8.16293980277355,101,"ENSG00000079974.19"
"35349","ENSG00000235774.2_2095",2087,2095,9,"ENSG00000235774.2",0,NA,"VVVVVUVVV",1,8,0.922153209109731,108,114,133,136,144,150,204,207,"ACGATGT","ATGA","ATGTGGC","CTGA",2.44989838685172,19,8,54,90,1.5644201782253,4.47426902264253,8.16288185908146,101,"ENSG00000079974.19"
"27064","ENSG00000185532.20_1276648",1276640,1276648,9,"ENSG00000185532.20",1,1,"MVVVVVVVV",0,8,0.90600414078675,89,95,133,136,181,187,196,199,"ATGAGGA","GTAA","TTGATGA","CTGA",2.57250330903733,38,45,9,101,1.00429266681357,4.53857868176561,8.16259524491261,101,"ENSG00000079974.19"
"42079","ENSG00000260658.7_244510",244502,244510,9,"ENSG00000260658.7",1,2,"VMVVVVVVV",0,8,0.884057971014493,98,104,133,136,143,149,189,192,"ATGGTGA","TTGA","ATGAAAA","CTGA",2.61389962056022,29,7,40,85,1.07909803080467,4.62627387530153,8.1625057593595,101,"ENSG00000079974.19"
"20703","ENSG00000165379.14_224722",224714,224722,9,"ENSG00000165379.14",1,1,"MVVVVVVVV",0,8,0.90600414078675,111,117,133,136,143,149,163,166,"ATGCTAG","CTGT","ATGAGTA","CTGA",2.3160428384542,16,7,14,46,2.71336174087338,4.53841183264202,8.16242839578901,101,"ENSG00000079974.19"
"36531","ENSG00000241684.8_218501",218493,218501,9,"ENSG00000241684.8",0,NA,"UVVVVUVVV",2,7,0.824844720496894,115,121,133,136,148,154,169,172,"ATGAAGA","ATTA","ATGCTGA","CTGA",2.53006772885011,12,12,15,48,2.58494111848045,4.86301482770363,8.16239370969121,101,"ENSG00000079974.19"
"3831","ENSG00000089177.19_7206",7198,7206,9,"ENSG00000089177.19",1,1,"MVVUVVVVV",1,7,0.786749482401656,82,88,100,103,114,120,133,136,"AAGATGT","CTGA","AGGAAGA","CTGA",2.5950374554159,12,11,13,45,2.76039948308047,5.01516229646328,8.1621602260699,101,"ENSG00000079974.19"
"22573","ENSG00000170871.12_75870",75862,75870,9,"ENSG00000170871.12",1,7,"VVVVVVMVV",0,8,0.885300207039338,115,121,133,136,147,153,162,165,"AAGGTGA","CTGT","GCCAGGA","CTGA",2.34382058311842,12,11,9,41,2.85804558259554,4.62087903417958,8.16207986233693,101,"ENSG00000079974.19"
"6952","ENSG00000112335.15_11354",11346,11354,9,"ENSG00000112335.15",1,8,"VVVVVVVMV",0,8,0.884057971014493,110,116,133,136,140,146,160,163,"ATCATGA","TTCA","AGGAAGC","CTGA",2.40450655326026,17,4,14,44,2.47281007051852,4.62571343973007,8.16194532378804,101,"ENSG00000079974.19"
"43759","ENSG00000273471.1_45411",45403,45411,9,"ENSG00000273471.1",0,NA,"VVVUUVVVV",2,7,0.770600414078675,91,97,110,113,116,122,133,136,"GTGATGT","CTGA","GTAATTT","CTGA",2.62990931783936,13,3,11,36,2.78483965074055,5.07939210908408,8.16179376539878,101,"ENSG00000079974.19"
"44824","ENSG00000283684.1_45801",45793,45801,9,"ENSG00000283684.1",0,NA,"VVVUUVVVV",2,7,0.770600414078675,91,97,110,113,116,122,133,136,"GTGATGT","CTGA","GTAATTT","CTGA",2.62990931783936,13,3,11,36,2.78483965074055,5.07939210908408,8.16179376539878,101,"ENSG00000079974.19"
"13710","ENSG00000143228.13_54627",54619,54627,9,"ENSG00000143228.13",0,NA,"VVVVVVUVV",1,8,0.886128364389234,71,77,88,91,105,111,133,136,"CTGAAGA","CTCA","TTGGGGA","CTGA",2.46954267198555,11,14,22,56,2.00520242095767,4.61720505854868,8.16171851610561,101,"ENSG00000079974.19"
"2917","ENSG00000079263.19_100284",100276,100284,9,"ENSG00000079263.19",1,5,"VVVVMVVVV",0,8,0.886542443064182,111,117,133,136,144,150,203,206,"CTGAAGA","GTGA","ATGGTAA","CTGA",2.49529170794266,16,8,53,86,1.82573262647535,4.61525266985661,8.16142244211334,101,"ENSG00000079974.19"
"23618","ENSG00000173406.16_462411",462403,462411,9,"ENSG00000173406.16",1,8,"VVVVVVVMV",0,8,0.884057971014493,70,76,86,89,105,111,133,136,"GAGATGA","CTAA","CAGAAGA","CTGA",2.50277760464232,10,16,22,57,1.81553046643191,4.62517862434518,8.16141050840315,101,"ENSG00000079974.19"
"26526","ENSG00000184349.14_252219",252211,252219,9,"ENSG00000184349.14",1,6,"VVVVVMVVV",0,8,0.902691511387163,107,113,133,136,141,147,171,174,"TTGATGG","ATAA","CTGAAGA","CTGA",2.46993564264131,20,5,24,58,1.73562080953505,4.55046460678595,8.1612306523346,101,"ENSG00000079974.19"
"39992","ENSG00000254627.1_7177",7169,7177,9,"ENSG00000254627.1",1,8,"VVVVVVVMV",0,8,0.884057971014493,116,122,133,136,144,150,165,168,"AAGAGGA","CTGG","ATCAGCA","CTGA",2.35630866678546,11,8,15,43,2.79091879929339,4.62491081113245,8.16114269519042,101,"ENSG00000079974.19"
"45273","ENSG00000285283.1_259698",259690,259698,9,"ENSG00000285283.1",1,8,"VVVVVVVMV",0,8,0.884057971014493,116,122,133,136,144,150,165,168,"AAGAGGA","CTGG","ATCAGCA","CTGA",2.35630866678546,11,8,15,43,2.79091879929339,4.62491081113245,8.16114269519042,101,"ENSG00000079974.19"
"35023","ENSG00000234717.2_65511",65503,65511,9,"ENSG00000234717.2",1,8,"VVVVVVVMV",0,8,0.884057971014493,68,74,94,97,103,109,133,136,"AAGATGC","CTGA","GGCAAGA","CTGA",2.50673202092353,20,6,24,59,1.78796367700451,4.62487762079035,8.16110950484832,101,"ENSG00000079974.19"
"6697","ENSG00000111540.16_738",730,738,9,"ENSG00000111540.16",1,1,"MVVVVVVVV",0,8,0.90600414078675,114,120,133,136,139,145,155,158,"GTGCCTA","CTGA","GTGCTAT","CTGA",2.29801582854909,13,3,10,35,2.82812012749484,4.53705641278885,8.16107297593585,101,"ENSG00000079974.19"
"36770","ENSG00000242880.2_397276",397268,397276,9,"ENSG00000242880.2",0,NA,"UVVVVVVVV",1,8,0.902691511387163,112,118,133,136,141,147,158,161,"ATGTTGT","CTGT","GTGATAA","CTGG",2.30100404789936,15,5,11,40,2.85983504323997,4.54996550730892,8.16073155285757,101,"ENSG00000079974.19"
"42059","ENSG00000260573.4_105463",105455,105463,9,"ENSG00000260573.4",1,1,"MVVVVVVVV",0,8,0.90600414078675,82,88,102,105,110,116,133,136,"GTCATGA","CTGA","ATTAATA","TTGA",2.3320224264175,14,5,17,45,2.59899857656282,4.53645368816986,8.16047025131686,101,"ENSG00000079974.19"
"30098","ENSG00000203685.11_46834",46826,46834,9,"ENSG00000203685.11",1,3,"VVMVVVVVV",0,8,0.882815734989648,115,121,133,136,143,149,194,197,"TTGATGT","CTTT","GTGATTA","CTGA",2.47634346514236,12,7,45,73,2.00748260023596,4.62910975862959,8.16037269858818,101,"ENSG00000079974.19"
"26535","ENSG00000184374.3_64446",64438,64446,9,"ENSG00000184374.3",1,8,"VVVVVVVMV",0,8,0.884057971014493,105,111,133,136,147,153,192,195,"ATTTTGA","CTGA","TTGATAA","CTGA",2.59490155734422,22,11,39,81,1.19706774413311,4.62410286494031,8.16033474899828,101,"ENSG00000079974.19"
"6193","ENSG00000108587.16_8862",8854,8862,9,"ENSG00000108587.16",1,1,"MVVVVVVVV",0,8,0.90600414078675,104,110,133,136,142,148,189,192,"TTGATGG","ATGA","ATGCTGG","CTGA",2.53065343176961,23,6,41,79,1.27361113977978,4.53615850456097,8.16017506770797,101,"ENSG00000079974.19"
"6751","ENSG00000111785.21_22990",22982,22990,9,"ENSG00000111785.21",1,2,"VMVVVVVVV",0,8,0.884057971014493,67,73,81,84,114,120,133,136,"ATGATGA","CTAA","GTGAATA","ATGA",2.51903607187556,8,30,13,60,1.70127890961711,4.62371318053021,8.15994506458818,101,"ENSG00000079974.19"
"25002","ENSG00000179088.16_89813",89805,89813,9,"ENSG00000179088.16",0,NA,"VVVVUVVVV",1,8,0.889855072463768,106,112,133,136,153,159,172,175,"TTGATGT","CTGG","TTCAAGA","CTGA",2.49675485353325,21,17,13,60,1.7570274044916,4.60051494034499,8.15993523020006,101,"ENSG00000079974.19"
"34933","ENSG00000234423.2_20503",20495,20503,9,"ENSG00000234423.2",1,2,"VMVVVVVVV",0,8,0.884057971014493,112,118,133,136,142,148,162,165,"TTGAAGA","ATGT","CTGCTGC","CTGA",2.35817369683886,15,6,14,44,2.77333864836149,4.6236241568218,8.15985604087977,101,"ENSG00000079974.19"
"5704","ENSG00000106415.13_103207",103199,103207,9,"ENSG00000106415.13",1,3,"VVMVVVVVV",0,8,0.882815734989648,106,112,133,136,143,149,181,184,"TTGATGT","CAGA","GTGCTCA","CTGA",2.55206470030117,21,7,32,69,1.50016671780937,4.62848284662096,8.15974578657955,101,"ENSG00000079974.19"
"29726","ENSG00000198643.7_15445",15437,15445,9,"ENSG00000198643.7",1,2,"VMVVVVVVV",0,8,0.884057971014493,113,119,133,136,147,153,187,190,"AAGATGG","TTGA","CTGAAGG","CTGA",2.49466187761261,14,11,34,68,1.86255255304396,4.62340793428201,8.15963981833998,101,"ENSG00000079974.19"
"35009","ENSG00000234690.7_130006",129998,130006,9,"ENSG00000234690.7",0,NA,"VVVVVVUVV",1,8,0.886128364389234,105,111,133,136,138,144,157,160,"GGGATGA","TTGG","GTGCTGA","CTGA",2.50115430481693,22,2,13,46,1.78550102939663,4.61496576537737,8.1594792229343,101,"ENSG00000079974.19"
"25112","ENSG00000179454.14_72446",72438,72446,9,"ENSG00000179454.14",0,NA,"VVVUVVVVV",1,8,0.880745341614907,110,116,133,136,148,154,162,165,"CTAATGG","CAGA","ATGAATA","CTGA",2.40610331681112,17,12,8,46,2.50511453636657,4.63645082877684,8.15943219523647,101,"ENSG00000079974.19"
"39414","ENSG00000253554.7_609183",609175,609183,9,"ENSG00000253554.7",1,8,"VVVVVVVMV",0,8,0.884057971014493,107,113,133,136,140,146,160,163,"ATGTTGT","AAGA","ATGATAA","CTGA",2.44337373297868,20,4,14,47,2.20225582410093,4.6228535109897,8.15908539504767,101,"ENSG00000079974.19"
"15210","ENSG00000147316.15_91554",91546,91554,9,"ENSG00000147316.15",1,2,"VMVVVVVVV",0,8,0.884057971014493,107,113,133,136,146,152,168,171,"ATGATAA","CTAT","GTAATGT","CTGA",2.45158481252947,20,10,16,55,2.1471342692962,4.62275825487317,8.15899013893114,101,"ENSG00000079974.19"
"13755","ENSG00000143344.16_237005",236997,237005,9,"ENSG00000143344.16",0,NA,"VVVVVUVVV",1,8,0.922153209109731,81,87,104,107,116,122,133,136,"GTCATTA","CTGC","GACATGG","CTGA",2.27781030926537,17,9,11,46,2.6954680462079,4.47021752699427,8.15883036343319,101,"ENSG00000079974.19"
"37258","ENSG00000246363.4_26241",26233,26241,9,"ENSG00000246363.4",1,2,"VMVVVUVVV",1,7,0.806211180124223,46,52,67,70,116,122,133,136,"ATGATGC","CTGG","ATGATGG","CTGA",2.67575198536869,15,46,11,81,1.89736163408362,4.93392705080205,8.15877177129894,101,"ENSG00000079974.19"
"15945","ENSG00000150394.14_200272",200264,200272,9,"ENSG00000150394.14",0,NA,"VVVVVUVVV",1,8,0.922153209109731,111,117,133,136,164,170,179,182,"AGCATGA","CTGG","CTCCTGA","CTGA",2.39559364027342,16,28,9,62,1.909852020085,4.47011907214361,8.15873190858253,101,"ENSG00000079974.19"
"39767","ENSG00000254186.3_46621",46613,46621,9,"ENSG00000254186.3",1,1,"MVVVVVVVV",0,8,0.90600414078675,116,122,133,136,138,144,156,159,"ATACTGA","CAAA","CTGAAGG","CTGA",2.32709621022492,11,2,12,34,2.6248058813537,4.53469515404663,8.15871171719362,101,"ENSG00000079974.19"
"30011","ENSG00000198947.18_660878",660870,660878,9,"ENSG00000198947.18",0,NA,"VVVVVVUVV",1,8,0.886128364389234,83,89,133,136,147,153,176,179,"ATGTTGA","CAGA","GTCATGG","CTGA",2.58936276053501,44,11,23,87,1.19417226450975,4.61414766701912,8.15866112457606,101,"ENSG00000079974.19"
"8967","ENSG00000121904.19_394350",394342,394350,9,"ENSG00000121904.19",0,NA,"UVVVVVVVV",1,8,0.902691511387163,46,52,63,66,99,105,133,136,"GTGATGA","ATGA","TTGATGA","TTGA",2.55186683550882,11,33,28,81,1.17853317588154,4.54774468648508,8.15851073203374,101,"ENSG00000079974.19"
"21118","ENSG00000166451.14_6651",6643,6651,9,"ENSG00000166451.14",1,1,"MVVVVVVVV",0,8,0.90600414078675,91,97,133,136,148,154,183,186,"GTGATGT","ATGA","ATGCTAA","CTGA",2.58245980324342,36,12,29,86,0.920961821836892,4.53434012753158,8.15835669067858,101,"ENSG00000079974.19"
"16656","ENSG00000152034.11_50247",50239,50247,9,"ENSG00000152034.11",1,6,"VVVVVMVVV",0,8,0.902691511387163,111,117,133,136,144,150,161,164,"CTGGTGA","ATCA","ATGTTTG","CTGA",2.30566099436914,16,8,11,44,2.81900123054908,4.54751863158584,8.15828467713449,101,"ENSG00000079974.19"
"14355","ENSG00000144724.20_584383",584375,584383,9,"ENSG00000144724.20",1,7,"VVVVVVMVV",0,8,0.885300207039338,114,120,133,136,163,169,180,183,"CTGATAA","CTTA","GTGAATT","CTGA",2.45985246107371,13,27,11,60,2.06896943300712,4.61699646004129,8.15819728819864,101,"ENSG00000079974.19"
"19126","ENSG00000161807.3_899",891,899,9,"ENSG00000161807.3",1,8,"VVVVVUVMV",1,7,0.806211180124224,82,88,106,109,113,119,133,136,"ATGATGA","CTGA","ATAAGGA","TTGA",2.60270873552124,18,4,14,45,2.3814967845591,4.93322208867517,8.15806680917206,101,"ENSG00000079974.19"
"6020","ENSG00000107736.22_372961",372953,372961,9,"ENSG00000107736.22",1,1,"MVVVVVVVV",0,8,0.90600414078675,55,61,77,80,92,98,133,136,"CTGATGA","CTGT","GTGATGG","CAGA",2.47190866669675,16,12,35,72,1.65679335503766,4.53404611658733,8.15806267973433,101,"ENSG00000079974.19"
"4989","ENSG00000102580.15_109964",109956,109964,9,"ENSG00000102580.15",1,8,"VVVVVVVMV",0,8,0.884057971014493,110,116,133,136,146,152,176,179,"ATGAAGA","GAGA","TTGATAT","CTGA",2.47792590461035,17,10,24,60,1.96699945417022,4.62162637122647,8.15785825528444,101,"ENSG00000079974.19"
"14678","ENSG00000145703.17_294536",294528,294536,9,"ENSG00000145703.17",1,1,"MVVVVVVVV",0,8,0.90600414078675,115,121,133,136,147,153,170,173,"GTTCTGA","ATGG","GTGTTGA","CTGA",2.34007249547281,12,11,17,49,2.53406394811461,4.53363681281667,8.15765337596367,101,"ENSG00000079974.19"
"25563","ENSG00000182168.15_167094",167086,167094,9,"ENSG00000182168.15",1,1,"MVVVVVVVV",0,8,0.90600414078675,111,117,133,136,140,146,164,167,"GTAATGA","CAAA","TTATTGA","CTGA",2.37297045205673,16,4,18,47,2.3144925160433,4.53357388243871,8.15759044558571,101,"ENSG00000079974.19"
"9246","ENSG00000123360.12_15608",15600,15608,9,"ENSG00000123360.12",1,1,"MVVVVVVVV",0,8,0.90600414078675,89,95,102,105,109,115,133,136,"TTGATGA","TTGA","CTGGGGA","CCGA",2.39825858697194,7,4,18,38,2.14539845618909,4.5334472590005,8.1574638221475,101,"ENSG00000079974.19"
"28499","ENSG00000189337.17_77484",77476,77484,9,"ENSG00000189337.17",1,8,"UVVVVVVMV",1,7,0.786749482401656,71,77,91,94,101,107,133,136,"ATGATGG","CTGT","ATGATTA","CTGA",2.67611133585068,14,7,26,56,2.20024090186636,5.01024578521773,8.15724371482435,101,"ENSG00000079974.19"
"20264","ENSG00000164574.16_182528",182520,182528,9,"ENSG00000164574.16",1,8,"VVVVVVVMV",0,8,0.884057971014493,95,101,109,112,115,121,133,136,"CTTATGA","GTAA","CTGAGGC","CTGA",2.37559683790494,8,3,12,32,2.6466277482812,4.6209850002452,8.15721688430317,101,"ENSG00000079974.19"
"45651","ENSG00000285778.2_27673",27665,27673,9,"ENSG00000285778.2",1,2,"VMVVVUVVV",1,7,0.806211180124223,48,54,67,70,79,85,133,136,"GTGATGT","CAGA","ATGAAGA","CTGA",2.66690393526655,13,9,48,79,1.95003565591614,4.93234880608996,8.15719352658685,101,"ENSG00000079974.19"
"8922","ENSG00000121621.7_36164",36156,36164,9,"ENSG00000121621.7",0,NA,"UVVVVVVVV",1,8,0.902691511387163,107,113,133,136,146,152,168,171,"TTGATGG","ATAA","TTGAGGT","CTGA",2.40574645345212,20,10,16,55,2.1471342692962,4.54636098974425,8.15712703529291,101,"ENSG00000079974.19"
"21055","ENSG00000166342.19_42894",42886,42894,9,"ENSG00000166342.19",1,2,"VMVVVUVVV",1,7,0.806211180124223,115,121,133,136,145,151,173,176,"TTGATGA","GTAA","GTGATGT","CTGA",2.60557273387854,12,9,22,52,2.3586165794513,4.93227536799373,8.15712008849062,101,"ENSG00000079974.19"
"12935","ENSG00000139641.13_21257",21249,21257,9,"ENSG00000139641.13",0,NA,"VVUVVVVVV",1,8,0.883643892339545,111,117,133,136,146,152,202,205,"ATGATAA","CTGT","AGGAAGG","CTGA",2.51272489895507,16,10,50,85,1.73856374575765,4.6225157680312,8.15709133738937,101,"ENSG00000079974.19"
"14496","ENSG00000145147.20_28119",28111,28119,9,"ENSG00000145147.20",1,8,"VVVVVVVMV",0,8,0.884057971014493,45,51,70,73,111,117,133,136,"TTGATGA","CTGA","ATGTTGA","CTGG",2.57053527151004,19,38,16,82,1.34643393508035,4.62083393628682,8.15706582034479,101,"ENSG00000079974.19"
"16439","ENSG00000151532.15_196505",196497,196505,9,"ENSG00000151532.15",1,6,"VVVVVMVVV",0,8,0.902691511387163,70,76,88,91,99,105,133,136,"ACTATGA","CATA","GTGATTA","CTGA",2.40353368085837,12,8,28,57,2.16129882059366,4.5462141732457,8.15698021879435,101,"ENSG00000079974.19"
"30377","ENSG00000204764.14_269795",269787,269795,9,"ENSG00000204764.14",1,1,"MVVVVUVVV",1,7,0.82815734989648,108,114,133,136,137,143,153,156,"ATAATGA","GTGA","TTTATGA","CTGA",2.61450680121166,19,1,10,39,1.94731916052282,4.84434112548346,8.15697052506939,101,"ENSG00000079974.19"
"26745","ENSG00000185008.19_1398802",1398794,1398802,9,"ENSG00000185008.19",1,1,"MVVVVVVVV",0,8,0.90600414078675,103,109,133,136,152,158,182,185,"ATGGTGT","CAGA","GTGTTGA","CTGA",2.56669222037594,24,16,24,73,1.02049394390461,4.53294385326939,8.15696041641638,101,"ENSG00000079974.19"
"3724","ENSG00000088538.13_315237",315229,315237,9,"ENSG00000088538.13",1,1,"MVVVVVVVV",0,8,0.90600414078675,83,89,133,136,140,146,157,160,"AAGATGA","CAAA","GTGAATC","CTGA",2.4460362291076,44,4,11,68,1.82384417629809,4.53268809258719,8.15670465573419,101,"ENSG00000079974.19"
"6730","ENSG00000111716.14_25425",25417,25425,9,"ENSG00000111716.14",0,NA,"UVVVVVVVV",1,8,0.902691511387163,100,106,133,136,145,151,166,169,"ATGATGA","GTGA","TTACTGA","CAGA",2.44695578238483,27,9,15,60,1.87030543092678,4.54583599503975,8.15660204058841,101,"ENSG00000079974.19"
"37317","ENSG00000247121.8_44092",44084,44092,9,"ENSG00000247121.8",1,8,"VVVVVVVMV",0,8,0.884057971014493,90,96,133,136,143,149,170,173,"ATTATGA","CTGG","ATTCTGA","CTGA",2.55251210381459,37,7,21,74,1.46458337074593,4.62033268237746,8.15656456643543,101,"ENSG00000079974.19"
"1791","ENSG00000066032.19_556662",556654,556662,9,"ENSG00000066032.19",0,NA,"VVVVVVUVV",1,8,0.886128364389234,113,119,133,136,140,146,154,157,"CTGAATA","TTGA","TTGTTTA","CTGA",2.33017037481836,14,4,8,35,2.91345959558434,4.61198219026002,8.15649564781695,101,"ENSG00000079974.19"
"19970","ENSG00000164093.18_7659",7651,7659,9,"ENSG00000164093.18",0,NA,"VVVVVUVVV",1,8,0.922153209109731,29,35,50,53,73,79,133,136,"ATGATGA","CCGA","TTGAAGT","GTGA",2.5023758658869,15,20,54,98,1.18847501263096,4.46774519630256,8.15635803274149,101,"ENSG00000079974.19"
"21713","ENSG00000168743.13_44249",44241,44249,9,"ENSG00000168743.13",1,5,"VVVVMVVVV",0,8,0.886542443064182,86,92,133,136,154,160,171,174,"ATCATGG","TTGA","GTGATTA","CTGA",2.56208490446798,41,18,11,79,1.35955714783002,4.61003079440414,8.15620056666087,101,"ENSG00000079974.19"
"33997","ENSG00000231689.3_549032",549024,549032,9,"ENSG00000231689.3",1,8,"VVVVVVVMV",0,8,0.884057971014493,110,116,133,136,152,158,168,171,"ATGATGG","ATGT","ATAAATA","CTGA",2.43524965909257,17,16,10,52,2.24389376406672,4.61972287283763,8.1559547568956,101,"ENSG00000079974.19"
"14800","ENSG00000145934.17_1031661",1031653,1031661,9,"ENSG00000145934.17",1,8,"VVVVVVUMV",1,7,0.770186335403727,91,97,107,110,114,120,133,136,"ATGATGA","AGGA","ATGTTCA","CTGA",2.62819656327166,10,4,13,36,2.77876096591714,5.07501784693205,8.15576318854695,101,"ENSG00000079974.19"
"10478","ENSG00000131242.18_74764",74756,74764,9,"ENSG00000131242.18",0,NA,"UVVVVVVVV",1,8,0.902691511387163,104,110,133,136,142,148,198,201,"ATGAGGA","CTTA","GTGTCTA","CTGA",2.53796583821231,23,6,50,88,1.25928656371327,4.5447647046155,8.15553075016416,101,"ENSG00000079974.19"
"20843","ENSG00000165837.12_35204",35196,35204,9,"ENSG00000165837.12",0,NA,"VVVVUVVVV",1,8,0.889855072463768,74,80,92,95,104,110,133,136,"ATGATGA","CTGT","GTCATCC","CAGA",2.41121378647779,12,9,23,53,2.30958973611223,4.59608707815771,8.15550736801278,101,"ENSG00000079974.19"
"21185","ENSG00000166780.11_22695",22687,22695,9,"ENSG00000166780.11",1,7,"VVVVVVMVV",0,8,0.885300207039338,116,122,133,136,149,155,168,171,"TTGCTGA","TTCA","ATGTGGA","CTGA",2.3797245266147,11,13,13,46,2.59219767661185,4.6142569635108,8.15545779166815,101,"ENSG00000079974.19"
"42214","ENSG00000261130.5_61416",61408,61416,9,"ENSG00000261130.5",1,7,"VVVVVVMVV",0,8,0.885300207039338,116,122,133,136,149,155,168,171,"TTGCTGA","TTCA","ATGTGGA","CTGA",2.3797245266147,11,13,13,46,2.59219767661185,4.6142569635108,8.15545779166815,101,"ENSG00000079974.19"
"43836","ENSG00000274265.5_79873",79865,79873,9,"ENSG00000274265.5",1,2,"VMVVVVVVV",0,8,0.884057971014493,110,116,133,136,155,161,171,174,"ATGTTGA","CAAA","GTAATGC","CTGA",2.45981051194725,17,19,10,55,2.07774774365381,4.6191211224922,8.15535300655017,101,"ENSG00000079974.19"
"45384","ENSG00000285534.1_96257",96249,96257,9,"ENSG00000285534.1",1,1,"MVVVVVVVV",0,8,0.90600414078675,115,121,133,136,137,143,152,155,"CTTGTGA","CTGG","GTTATGG","CTGA",2.32336977561836,12,1,9,31,2.63618269851883,4.53132863399364,8.15534519714063,101,"ENSG00000079974.19"
"10959","ENSG00000133216.17_60963",60955,60963,9,"ENSG00000133216.17",1,1,"MVVVVVVVV",0,8,0.90600414078675,69,75,90,93,100,106,133,136,"ATGATGA","CTGA","GTGAAAA","TTTA",2.40181587837838,15,7,27,58,2.11301993906822,4.53128144873102,8.15529801187802,101,"ENSG00000079974.19"
"40305","ENSG00000255501.3_3418",3410,3418,9,"ENSG00000255501.3",1,7,"VVVVVVMVV",0,8,0.885300207039338,112,118,133,136,147,153,161,164,"ATGATGA","ATTA","TTGACAA","CTAA",2.35788276459232,15,11,8,43,2.73711088358685,4.61408232855059,8.15528315670794,101,"ENSG00000079974.19"
"29804","ENSG00000198740.9_56848",56840,56848,9,"ENSG00000198740.9",1,3,"VVMVVVVVV",0,8,0.882815734989648,107,113,133,136,154,160,172,175,"ATGATGA","TTGA","CTGTTGT","CAGA",2.50113668418776,20,18,12,59,1.82116376323673,4.62385208112212,8.15511502108071,101,"ENSG00000079974.19"
"23483","ENSG00000173065.14_43261",43253,43261,9,"ENSG00000173065.14",1,3,"VVMVVVVVV",0,8,0.882815734989648,98,104,133,136,143,149,169,172,"CTGATGT","CAGA","AAGAGGA","CTGA",2.53800133603712,29,7,20,65,1.57497257480985,4.62374537043099,8.15500831038959,101,"ENSG00000079974.19"
"8280","ENSG00000117859.19_119929",119921,119929,9,"ENSG00000117859.19",1,5,"VVVVMVVVV",0,8,0.886542443064182,90,96,106,109,115,121,133,136,"AGGAGGA","CTGA","TTGAGGT","ATGA",2.32418263610924,10,6,12,37,2.94002531109953,4.60864405462362,8.15481382688035,101,"ENSG00000079974.19"
"15480","ENSG00000148484.18_56184",56176,56184,9,"ENSG00000148484.18",0,NA,"UVVVVVVVV",1,8,0.902691511387163,110,116,133,136,177,183,215,218,"ATAATGA","CTAA","GTGGTGG","CTGA",2.59865876058655,17,41,32,99,0.851481425025249,4.54396829056723,8.15473433611588,101,"ENSG00000079974.19"
"19923","ENSG00000164024.12_31392",31384,31392,9,"ENSG00000164024.12",1,6,"VVVVVMVVV",0,8,0.902691511387163,100,106,133,136,145,151,193,196,"TTGATGA","CTCT","CTGAGGA","CTGA",2.56626420209895,27,9,42,87,1.0669925333644,4.54385513683936,8.15462118238801,101,"ENSG00000079974.19"
"7763","ENSG00000115598.10_40466",40458,40466,9,"ENSG00000115598.10",0,NA,"VVVVVUVVV",1,8,0.922153209109731,114,120,133,136,145,151,162,165,"CTGAGCA","ATAA","TTAATGA","CTGA",2.23718516103762,13,9,11,42,2.94939053734931,4.46598956940002,8.15460240583895,101,"ENSG00000079974.19"
"2995","ENSG00000080224.18_247145",247137,247145,9,"ENSG00000080224.18",0,NA,"VVVVUVVVV",1,8,0.889855072463768,113,119,133,136,144,150,199,202,"ATGATGC","AAGA","GGGAATA","CTGA",2.46401772294606,14,8,49,80,1.95359948015112,4.59509607494789,8.15451636480296,101,"ENSG00000079974.19"
"34828","ENSG00000234255.9_13632",13624,13632,9,"ENSG00000234255.9",1,3,"VVMVVVVVV",0,8,0.882815734989648,110,116,133,136,145,151,164,167,"CTGATGC","CTTT","AAGAAGA","CTGA",2.37988682854811,17,9,13,48,2.62653923097365,4.62311285532359,8.15437579528218,101,"ENSG00000079974.19"
"13254","ENSG00000140836.17_156117",156109,156117,9,"ENSG00000140836.17",1,6,"VVVVVMVVV",0,8,0.902691511387163,85,91,102,105,113,119,133,136,"ATGATGG","CTGC","AGGTGGA","ATGA",2.29853255131789,11,8,14,42,2.85020883553461,4.54343979441347,8.15420583996213,101,"ENSG00000079974.19"
"36094","ENSG00000237877.8_46343",46335,46343,9,"ENSG00000237877.8",0,NA,"UVVVVVVVV",1,8,0.902691511387163,23,29,70,73,114,120,133,136,"CTGATGC","CTGA","ATGTGCA","CTGA",2.58711006790135,41,41,13,104,0.92623626138846,4.54340917851604,8.15417522406469,101,"ENSG00000079974.19"
"33527","ENSG00000230131.6_181101",181093,181101,9,"ENSG00000230131.6",0,NA,"VVVUVVVVV",1,8,0.880745341614907,60,66,76,79,115,121,133,136,"CAGATGA","TTGA","CTGCTGG","CTGA",2.4945796235166,10,36,12,67,1.89371364034677,4.63106111594769,8.15404248240732,101,"ENSG00000079974.19"
"13742","ENSG00000143341.12_363374",363366,363374,9,"ENSG00000143341.12",1,1,"MVVVVVVVV",0,8,0.90600414078675,116,122,133,136,138,144,156,159,"ATCTTGA","CAAA","CTGAAGG","CTGA",2.32427334501673,11,2,12,34,2.6248058813537,4.52999037869965,8.15400694184665,101,"ENSG00000079974.19"
"33500","ENSG00000230021.10_193124",193116,193124,9,"ENSG00000230021.10",0,NA,"VVUVVVVVV",1,8,0.883643892339545,112,118,133,136,145,151,161,164,"AGGCTGG","CAGA","GCGAAGA","CTGA",2.3407721069845,15,9,10,43,2.87242091295343,4.61939207321252,8.1539676425707,101,"ENSG00000079974.19"
"3867","ENSG00000089876.12_36142",36134,36142,9,"ENSG00000089876.12",1,6,"VVVVVMVVV",0,8,0.902691511387163,68,74,90,93,103,109,133,136,"TTGATGA","TTGA","TTTATGA","CAGA",2.41837803677889,16,10,24,59,2.04990014480548,4.54310509749951,8.15387114304817,101,"ENSG00000079974.19"
"26811","ENSG00000185046.20_326624",326616,326624,9,"ENSG00000185046.20",1,8,"VVVVVVVMV",0,8,0.884057971014493,116,122,133,136,186,192,205,208,"GTCATCA","CTGA","CTGACAA","CTGA",2.48621826660817,11,50,13,83,1.89477243298779,4.61739021926057,8.15362210331854,101,"ENSG00000079974.19"
"27735","ENSG00000187240.17_292881",292873,292881,9,"ENSG00000187240.17",1,3,"VVMVVVVVV",0,8,0.882815734989648,71,77,92,95,101,107,133,136,"CTGTTGA","CTAA","GTGTAGG","CTGA",2.45394996392821,15,6,26,56,2.12963612038352,4.6223256366429,8.15358857660149,101,"ENSG00000079974.19"
"39712","ENSG00000254101.8_69699",69691,69699,9,"ENSG00000254101.8",1,1,"MVVVVVVVV",0,8,0.90600414078675,112,118,133,136,148,154,171,174,"CTGATAA","CTCT","GCGAAGA","CTGA",2.36175369741643,15,12,17,53,2.37310739038926,4.52953300995803,8.15354957310503,101,"ENSG00000079974.19"
"17644","ENSG00000154655.16_50663",50655,50663,9,"ENSG00000154655.16",1,1,"MVVVVVVVV",0,8,0.90600414078675,108,114,133,136,142,148,157,160,"ATGATGA","ATGT","GTGACTC","CGGA",2.33197131821389,19,6,9,43,2.57165407925597,4.52953238350381,8.1535489466508,101,"ENSG00000079974.19"
"10353","ENSG00000130635.17_77977",77969,77977,9,"ENSG00000130635.17",1,8,"VVVVVUVMV",1,7,0.806211180124224,116,122,133,136,140,146,157,160,"AGGATGG","ATGA","GTGGAGA","CTGA",2.51758784545288,11,4,11,35,2.92998831380578,4.92847682087291,8.15332154136981,101,"ENSG00000079974.19"
"27017","ENSG00000185420.19_542911",542903,542911,9,"ENSG00000185420.19",1,1,"MVVVVVVVV",0,8,0.90600414078675,111,117,133,136,150,156,169,172,"ATGATGT","TTGT","GTGATGT","CTGG",2.36056530133451,16,14,13,52,2.38010254964894,4.52930113963642,8.15331770278342,101,"ENSG00000079974.19"
"25490","ENSG00000181827.16_29129",29121,29129,9,"ENSG00000181827.16",0,NA,"VVVVUVVVV",1,8,0.889855072463768,115,121,133,136,148,154,168,171,"ATCATGA","CACA","GTGATGA","CTGC",2.36027882047652,12,12,14,47,2.64013717591965,4.59383232810745,8.15325261796252,101,"ENSG00000079974.19"
"3473","ENSG00000084731.15_15912",15904,15912,9,"ENSG00000084731.15",1,1,"MVVVVVVVV",0,8,0.90600414078675,114,120,133,136,143,149,166,169,"ACGATTA","GTTA","TTGAGGC","CTGA",2.31278974684543,13,7,17,46,2.69734627205426,4.52898614608929,8.15300270923628,101,"ENSG00000079974.19"
"6038","ENSG00000107798.18_121959",121951,121959,9,"ENSG00000107798.18",1,6,"VVVVVMVVV",0,8,0.902691511387163,70,76,89,92,100,106,133,136,"ATTATGT","CATA","GTGGAGA","CTGA",2.39745134808452,13,8,27,57,2.18581251200448,4.54220537480866,8.15297142035731,101,"ENSG00000079974.19"
"8107","ENSG00000116815.16_18990",18982,18990,9,"ENSG00000116815.16",0,NA,"VVVVVVUVV",1,8,0.886128364389234,110,116,133,136,150,156,206,209,"GTGAGGA","ATGA","GTGGTGG","CTGA",2.55799218989966,17,14,50,90,1.38027217641501,4.60838836060318,8.15290181816012,101,"ENSG00000079974.19"
"26039","ENSG00000183230.18_1039700",1039692,1039700,9,"ENSG00000183230.18",1,8,"VVVVVVUMV",1,7,0.770186335403727,110,116,133,136,153,159,171,174,"ATGATGA","CTCA","CTGATTT","CTGA",2.72203324256672,17,17,12,55,2.14121275796925,5.07202526043685,8.15277060205176,101,"ENSG00000079974.19"
"27411","ENSG00000186094.18_788549",788541,788549,9,"ENSG00000186094.18",1,8,"VVVVVVVMV",0,8,0.884057971014493,88,94,106,109,114,120,133,136,"AAGAAAA","GTGA","TTGATGC","CTGA",2.33553070973556,12,5,13,39,2.89554315851381,4.61643697252106,8.15266885657903,101,"ENSG00000079974.19"
"10701","ENSG00000132432.14_5993",5985,5993,9,"ENSG00000132432.14",1,7,"VVVVVVMVV",0,8,0.885300207039338,39,45,60,63,74,80,133,136,"ATTATGA","CTGC","ATATTGT","CTGA",2.5050113215868,15,11,53,88,1.74578484085281,4.61146507952454,8.15266590768189,101,"ENSG00000079974.19"
"19491","ENSG00000163116.10_423034",423026,423034,9,"ENSG00000163116.10",1,1,"MVVVVVVVV",0,8,0.90600414078675,65,71,83,86,115,121,133,136,"TTGATGG","CTGA","ATGAAGT","CTGT",2.41413093864355,12,29,12,62,2.01946417328746,4.52841760772779,8.15243417087479,101,"ENSG00000079974.19"
"43067","ENSG00000267924.1_34376",34368,34376,9,"ENSG00000267924.1",0,NA,"VVVVUVVVV",1,8,0.889855072463768,116,122,133,136,145,151,159,162,"GTGATAT","TGGA","ATAAAGA","CTGA",2.30811873291255,11,9,8,37,2.98438640412829,4.59296115588633,8.1523814457414,101,"ENSG00000079974.19"
"20087","ENSG00000164270.18_17715",17707,17715,9,"ENSG00000164270.18",1,1,"MVVVVUVVV",1,7,0.82815734989648,53,59,103,106,116,122,133,136,"GTGAGGA","CTGA","AGGCTGA","CTGA",2.6210667044956,44,10,11,74,1.88431722706912,4.83952381425995,8.15215321384587,101,"ENSG00000079974.19"
"39352","ENSG00000253500.6_98778",98770,98778,9,"ENSG00000253500.6",0,NA,"VVVVVUVVV",1,8,0.922153209109731,17,23,63,66,114,120,133,136,"ATGGTGA","CAGA","GTTAAAA","CTGA",2.53980943603903,40,48,13,110,0.922005261423791,4.46351704208766,8.15212987852658,101,"ENSG00000079974.19"
"23094","ENSG00000172260.15_513242",513234,513242,9,"ENSG00000172260.15",1,2,"VMVVVVVVV",0,8,0.884057971014493,114,120,133,136,143,149,175,178,"ACCATGA","CTGT","CTGGAGA","CTGA",2.43463715171595,13,7,26,55,2.23199251032174,4.61572671377368,8.15195859783165,101,"ENSG00000079974.19"
"4052","ENSG00000092621.13_14913",14905,14913,9,"ENSG00000092621.13",1,8,"VVVVVVVMV",0,8,0.884057971014493,50,56,69,72,79,85,133,136,"ACCATGT","CTGA","ATGAGGC","CTGA",2.46949654532797,13,7,48,77,1.99943951928136,4.61568745536695,8.15191933942492,101,"ENSG00000079974.19"
"9383","ENSG00000124374.9_32935",32927,32935,9,"ENSG00000124374.9",1,1,"MVVVVVVVV",0,8,0.90600414078675,116,122,133,136,138,144,156,159,"ATCATAA","CAAA","CTGAGGG","CTGA",2.3230121155445,11,2,12,34,2.6248058813537,4.52788832957925,8.15190489272625,101,"ENSG00000079974.19"
"39975","ENSG00000254562.7_14315",14307,14315,9,"ENSG00000254562.7",1,1,"MVVVVVVVV",0,8,0.90600414078675,114,120,133,136,166,172,184,187,"AAGATGC","TTGA","ATCAGGT","CTGA",2.41595871476381,13,30,12,64,2.00472153873148,4.52777824262255,8.15179480576955,101,"ENSG00000079974.19"
"12992","ENSG00000139793.21_32812",32804,32812,9,"ENSG00000139793.21",0,NA,"VVVVUVVVV",1,8,0.889855072463768,116,122,133,136,143,149,163,166,"CTGCTGA","TTTA","TAGATTA","CTGA",2.32487115457066,11,7,14,41,2.87032262606336,4.5923659141336,8.15178620398867,101,"ENSG00000079974.19"
"2361","ENSG00000073792.16_55532",55524,55532,9,"ENSG00000073792.16",1,3,"VVMVVVVVV",0,8,0.882815734989648,108,114,133,136,145,151,164,167,"ATGATTT","CTTG","TTGAAGA","CTGA",2.40505247377459,19,9,13,50,2.44730626942836,4.62024735698141,8.15151029694001,101,"ENSG00000079974.19"
"21776","ENSG00000168944.17_10003",9995,10003,9,"ENSG00000168944.17",1,2,"UMVVVVVVV",1,7,0.786749482401656,114,120,133,136,143,149,163,166,"ATGATCA","CTGT","GTATTGA","CTGA",2.57071850697735,13,7,14,43,2.87935588587557,5.00436981643114,8.15136774603776,101,"ENSG00000079974.19"
"11944","ENSG00000136628.18_51336",51328,51336,9,"ENSG00000136628.18",1,1,"MVVVVVVVV",0,8,0.90600414078675,102,108,133,136,187,193,204,207,"GTTATGA","CTAA","GTGATAC","CTGA",2.54261242888081,25,51,11,96,1.15824505666909,4.5272486456353,8.15126520878229,101,"ENSG00000079974.19"
"30512","ENSG00000205414.1_5458",5450,5458,9,"ENSG00000205414.1",1,7,"VVVVVVMVV",0,8,0.885300207039338,113,119,133,136,138,144,152,155,"GTGCTGG","GTGC","ATGAGGA","CTGA",2.36407087509203,14,2,8,33,2.67753215470937,4.60950116383073,8.15070199198808,101,"ENSG00000079974.19"
"1603","ENSG00000063601.17_69124",69116,69124,9,"ENSG00000063601.17",0,NA,"UVVVVVVVV",1,8,0.902691511387163,99,105,133,136,146,152,161,164,"TTGATGA","CTGA","AGGATTT","CAGA",2.42764796456024,28,10,9,56,1.97481734528434,4.53978427725481,8.15055032280346,101,"ENSG00000079974.19"
"4057","ENSG00000092847.14_49069",49061,49069,9,"ENSG00000092847.14",1,5,"VVVVMVVVV",0,8,0.886542443064182,79,85,99,102,115,121,133,136,"GGGATTA","CTGT","CTGCTGT","CTGA",2.36987277989882,14,13,12,48,2.61795024237316,4.60427552709133,8.15044529934806,101,"ENSG00000079974.19"
"28922","ENSG00000196712.20_263762",263754,263762,9,"ENSG00000196712.20",1,3,"VVMVVUVVV",1,7,0.804968944099379,94,100,106,109,115,121,133,136,"TTGATGA","CTAA","GCGCTGT","CTGA",2.5626046445439,6,6,12,33,2.63755712937016,4.93039702324904,8.15027279964656,101,"ENSG00000079974.19"
"21260","ENSG00000166926.9_27808",27800,27808,9,"ENSG00000166926.9",0,NA,"VVVVVVUVV",1,8,0.886128364389234,49,55,61,64,74,80,133,136,"TTGATAA","CTGA","GTAAGGT","CTGA",2.55534150946995,6,10,53,78,1.38682096393194,4.60560775676624,8.15012121432317,101,"ENSG00000079974.19"
"18309","ENSG00000157036.13_18278",18270,18278,9,"ENSG00000157036.13",1,7,"VVVVVUMVV",1,7,0.807453416149068,115,121,133,136,150,156,185,188,"CTGATGA","ATGA","GTGAATA","CTGA",2.68638725751491,12,14,29,64,1.77189345708926,4.92028546013049,8.15009912472677,101,"ENSG00000079974.19"
"7004","ENSG00000112425.16_49527",49519,49527,9,"ENSG00000112425.16",1,2,"VMVVVVVVV",0,8,0.884057971014493,39,45,58,61,110,116,133,136,"ATAATGG","CTGA","GTACTCA","CTGA",2.51407260294875,13,49,17,88,1.69433116589321,4.61370379638789,8.14993568044586,101,"ENSG00000079974.19"
"19913","ENSG00000163964.18_78131",78123,78131,9,"ENSG00000163964.18",1,1,"MVVVVVVVV",0,8,0.90600414078675,82,88,133,136,146,152,166,169,"AAGATGA","GTGG","CTTAAGA","CTGA",2.45007104458641,45,10,14,78,1.76981610274687,4.52590576666406,8.14992232981106,101,"ENSG00000079974.19"
"3049","ENSG00000080503.25_181506",181498,181506,9,"ENSG00000080503.25",1,8,"VVVVVVVMV",0,8,0.884057971014493,116,122,133,136,138,144,158,161,"AAGATGT","AAGA","GAGAAGA","CTGA",2.39708255824714,11,2,14,36,2.47395934281073,4.61362743278125,8.14985931683922,101,"ENSG00000079974.19"
"19579","ENSG00000163359.17_72360",72352,72360,9,"ENSG00000163359.17",1,1,"MVVVVVVVV",0,8,0.90600414078675,113,119,133,136,144,150,169,172,"ATGATGA","CTTG","TTGATTC","CAGA",2.33634137417187,14,8,19,50,2.52657795670927,4.52554677946376,8.14956334261076,101,"ENSG00000079974.19"
"47681","ENSG00000288951.2_9673",9665,9673,9,"ENSG00000288951.2",0,NA,"UVVVVVVVV",1,8,0.902691511387163,91,97,104,107,111,117,133,136,"ATGATGT","CTGG","CTGAGTA","CTCA",2.37665997777611,7,4,16,36,2.31060381556523,4.53875091685149,8.14951696240014,101,"ENSG00000079974.19"
"24725","ENSG00000177694.16_180883",180875,180883,9,"ENSG00000177694.16",1,5,"VVVVMVVVV",0,8,0.886542443064182,76,82,94,97,115,121,133,136,"ATGCTGA","CCAA","GTGCTTT","CTGA",2.4121489302053,12,18,12,51,2.33145579318649,4.60311216530545,8.14928193756218,101,"ENSG00000079974.19"
"22355","ENSG00000170390.16_113048",113040,113048,9,"ENSG00000170390.16",1,1,"MVVVVVVVV",0,8,0.90600414078675,111,117,133,136,150,156,176,179,"ACCATGT","CTAA","GTGAGGA","CTGA",2.4184915940375,16,14,20,59,1.97707433971605,4.52508790832485,8.14910447147185,101,"ENSG00000079974.19"
"37968","ENSG00000249279.6_28840",28832,28840,9,"ENSG00000249279.6",1,6,"VVVVVMUVV",1,7,0.788819875776397,61,67,76,79,87,93,133,136,"GTGATGA","CCGA","AGGATGA","CTGA",2.71975447467892,9,8,40,66,1.84333780116621,4.99375857475642,8.14903807786201,101,"ENSG00000079974.19"
"38762","ENSG00000251002.10_59843",59835,59843,9,"ENSG00000251002.10",0,NA,"VVVVVVUVV",1,8,0.886128364389234,81,87,96,99,102,108,133,136,"ATCATGA","AGGA","GGGAAGA","CTGA",2.49054790985466,9,3,25,46,1.81430593408258,4.60448966661174,8.14900312416867,101,"ENSG00000079974.19"
"15453","ENSG00000148357.18_92871",92863,92871,9,"ENSG00000148357.18",0,NA,"VVVVVUVVV",1,8,0.922153209109731,31,37,55,58,77,83,133,136,"GTGATCC","CTGA","GGGAGGA","CTGA",2.52739359419405,18,19,50,96,0.991599841181174,4.46022261728538,8.1488354537243,101,"ENSG00000079974.19"
"22067","ENSG00000169760.18_663940",663932,663940,9,"ENSG00000169760.18",1,8,"VVVVVUVMV",1,7,0.806211180124224,110,116,133,136,143,149,167,170,"CTGATGA","GTGA","ATGTTTT","CTGA",2.59563932090496,17,7,18,51,2.39152362909572,4.92394644211552,8.14879116261242,101,"ENSG00000079974.19"
"27708","ENSG00000187191.16_3015",3007,3015,9,"ENSG00000187191.16",1,3,"VVMVVVVVV",0,8,0.882815734989648,86,92,103,106,111,117,133,136,"TTGATGA","CTTA","TTGTTAA","TTGA",2.36715616073692,11,5,16,41,2.68895975093365,4.61750020562829,8.14876314558688,101,"ENSG00000079974.19"
"28104","ENSG00000188120.16_2918",2910,2918,9,"ENSG00000188120.16",1,3,"VVMVVVVVV",0,8,0.882815734989648,86,92,103,106,111,117,133,136,"TTGATGA","CTTA","TTGTTAA","TTGA",2.36715616073692,11,5,16,41,2.68895975093365,4.61750020562829,8.14876314558688,101,"ENSG00000079974.19"
"30589","ENSG00000205916.12_2992",2984,2992,9,"ENSG00000205916.12",1,3,"VVMVVVVVV",0,8,0.882815734989648,86,92,103,106,111,117,133,136,"TTGATGA","CTTA","TTGTTAA","TTGA",2.36715616073692,11,5,16,41,2.68895975093365,4.61750020562829,8.14876314558688,101,"ENSG00000079974.19"
"30599","ENSG00000205944.12_3002",2994,3002,9,"ENSG00000205944.12",1,3,"VVMVVVVVV",0,8,0.882815734989648,86,92,103,106,111,117,133,136,"TTGATGA","CTTA","TTGTTAA","TTGA",2.36715616073692,11,5,16,41,2.68895975093365,4.61750020562829,8.14876314558688,101,"ENSG00000079974.19"
"30813","ENSG00000213904.11_76123",76115,76123,9,"ENSG00000213904.11",0,NA,"VVVUVVVVV",1,8,0.880745341614907,110,116,133,136,142,148,165,168,"TTGAGGT","TTGA","GTGCTAA","CTGA",2.40982005581552,17,6,17,49,2.43761531228374,4.62577058776346,8.14875195422309,101,"ENSG00000079974.19"
"31937","ENSG00000225325.1_60712",60704,60712,9,"ENSG00000225325.1",0,NA,"VVVVVVUVV",1,8,0.886128364389234,105,111,133,136,146,152,160,163,"ATGGTGT","ATGA","GTAAATA","CTGA",2.42988322348794,22,10,8,49,2.21658621711291,4.60395192675812,8.14846538431506,101,"ENSG00000079974.19"
"22718","ENSG00000171189.18_326695",326687,326695,9,"ENSG00000171189.18",1,2,"VMVVVVVVV",0,8,0.884057971014493,100,106,133,136,146,152,177,180,"ATGATTT","CTGC","TTGATGA","CTGA",2.57622399730062,27,10,25,71,1.27393016732794,4.61218920399969,8.14842108805766,101,"ENSG00000079974.19"
"12369","ENSG00000137975.8_29539",29531,29539,9,"ENSG00000137975.8",0,NA,"VVVVVVUVV",1,8,0.886128364389234,82,88,99,102,111,117,133,136,"GTCAGGG","CTGA","CAGAGGA","CTGA",2.35880667188007,11,9,16,45,2.68993440327286,4.60382805395166,8.14834151150859,101,"ENSG00000079974.19"
"6017","ENSG00000107736.22_326449",326441,326449,9,"ENSG00000107736.22",1,1,"MVVVVVVVV",0,8,0.90600414078675,73,79,94,97,109,115,133,136,"ATGTTGG","CTGC","AGGCTGC","CTGA",2.36785291450293,15,12,18,54,2.31147481177949,4.52429022711643,8.14830679026343,101,"ENSG00000079974.19"
"34542","ENSG00000233359.2_5112",5104,5112,9,"ENSG00000233359.2",1,8,"VVVVVVVMV",0,8,0.884057971014493,100,106,133,136,171,177,187,190,"ATGAAGA","CAGA","ATGGTGG","CTGA",2.59880916662706,27,35,10,81,1.12255054406122,4.6119862470604,8.14821813111837,101,"ENSG00000079974.19"
"43095","ENSG00000268516.4_11972",11964,11972,9,"ENSG00000268516.4",0,NA,"UVVVVVVVV",1,8,0.902691511387163,96,102,133,136,146,152,195,198,"GTGAAGA","CTGA","ATAAAGC","CTGA",2.58122621783746,31,10,43,93,0.941521198287137,4.53742399596755,8.1481900415162,101,"ENSG00000079974.19"
"25990","ENSG00000183117.20_429884",429876,429884,9,"ENSG00000183117.20",0,NA,"VVVVVUVVV",1,8,0.922153209109731,79,85,98,101,107,113,133,136,"GTGATAA","CTAA","GTGAGAA","CTCA",2.30103510781668,13,6,20,48,2.49767175407711,4.45947645154708,8.148089287986,101,"ENSG00000079974.19"
"17156","ENSG00000153283.13_274133",274125,274133,9,"ENSG00000153283.13",1,1,"MVVVVVVVV",0,8,0.90600414078675,114,120,133,136,147,153,163,166,"ATGAAGA","CAGA","AGGAAAA","ATGA",2.28793802763092,13,11,10,43,2.84307618458625,4.5239990921981,8.14801565534509,101,"ENSG00000079974.19"
"18526","ENSG00000157578.14_16231",16223,16231,9,"ENSG00000157578.14",1,8,"VVVVVVVMV",0,8,0.884057971014493,111,117,133,136,144,150,165,168,"ATGGTGC","CTGC","GCTAAGA","CTGA",2.37050858932031,16,8,15,48,2.64346450085946,4.61171377408204,8.14794565814001,101,"ENSG00000079974.19"
"5447","ENSG00000104723.21_80094",80086,80094,9,"ENSG00000104723.21",0,NA,"VVVVVUVVV",1,8,0.922153209109731,116,122,133,136,186,192,218,221,"GTGATGT","GTGG","ATAATGA","CTGA",2.493666907563,11,50,26,96,1.21204690366066,4.45912323852017,8.1477360749591,101,"ENSG00000079974.19"
"41466","ENSG00000259070.9_177499",177491,177499,9,"ENSG00000259070.9",1,8,"VVVVVVVMV",0,8,0.884057971014493,76,82,99,102,109,115,133,136,"AAAATGA","ATGA","ATGTATA","CTGA",2.40812224673843,17,7,18,51,2.39152362909572,4.61141798517131,8.14764986922928,101,"ENSG00000079974.19"
"42452","ENSG00000263321.1_2426",2418,2426,9,"ENSG00000263321.1",1,3,"VVMVVVVVV",0,8,0.882815734989648,113,119,133,136,175,181,194,197,"AGGATGA","TTGG","CTGTGGA","CTGA",2.48596560915231,14,39,13,75,1.89206260550141,4.61629166662921,8.1475546065878,101,"ENSG00000079974.19"
"33054","ENSG00000228566.2_779871",779863,779871,9,"ENSG00000228566.2",0,NA,"VVUVVVVVV",1,8,0.883643892339545,76,82,92,95,108,114,133,136,"TTGCTAA","CTGA","CTGATTT","CTGA",2.4393519092487,10,13,19,51,2.18921436123683,4.6128901057237,8.14746567508188,101,"ENSG00000079974.19"
"17184","ENSG00000153339.15_31440",31432,31440,9,"ENSG00000153339.15",1,8,"VVVVVUVMV",1,7,0.806211180124224,97,103,133,136,145,151,164,167,"GAGATGA","CTGA","ATGTGGA","CTGA",2.66653593431116,30,9,13,61,1.91324181497907,4.92253701093004,8.14738173142693,101,"ENSG00000079974.19"
"30612","ENSG00000206052.11_349692",349684,349692,9,"ENSG00000206052.11",1,5,"UVVVMVVVV",1,7,0.789233954451346,113,119,133,136,144,150,167,170,"AAGATGA","CTGG","ATGGAGA","CTGA",2.59671444173825,14,8,17,48,2.64998840369942,4.99035450382194,8.14729032162732,101,"ENSG00000079974.19"
"38038","ENSG00000249395.4_15700",15692,15700,9,"ENSG00000249395.4",1,1,"MVVVVVVVV",0,8,0.90600414078675,112,118,133,136,143,149,161,164,"TTCATGA","CTAA","TTGATGT","CTTA",2.28191786371377,15,7,12,43,2.87991769593812,4.52317586350748,8.14719242665448,101,"ENSG00000079974.19"
"40382","ENSG00000255872.3_199178",199170,199178,9,"ENSG00000255872.3",1,2,"VMVVVVVVV",0,8,0.884057971014493,111,117,133,136,147,153,168,171,"TTGACAA","ATGA","CTGTTGA","CTGA",2.39290285479885,16,11,15,51,2.49055936472019,4.6108112658448,8.14704314990277,101,"ENSG00000079974.19"
"34397","ENSG00000232956.10_1170",1162,1170,9,"ENSG00000232956.10",0,NA,"VVVVVVUVV",1,8,0.886128364389234,96,102,133,136,160,166,184,187,"ATGATGA","ATGC","ATGTGGA","CTGA",2.63926825761932,31,24,18,82,0.814879752306756,4.60250036744222,8.14701382499916,101,"ENSG00000079974.19"
"6811","ENSG00000111913.20_170394",170386,170394,9,"ENSG00000111913.20",1,2,"VMVVVVVVV",0,8,0.884057971014493,113,119,133,136,147,153,161,164,"CTCATGT","TTCA","ATGAGGA","CTGA",2.34681394754587,14,11,8,42,2.79655794474881,4.61049606543032,8.14672794948829,101,"ENSG00000079974.19"
"17769","ENSG00000155052.15_543858",543850,543858,9,"ENSG00000155052.15",0,NA,"UVVVVVVVV",1,8,0.902691511387163,84,90,105,108,116,122,133,136,"ATGGTTT","CAGA","TTATTGA","CTGA",2.28742376923249,15,8,11,43,2.89427592362447,4.53594192962693,8.14670797517558,101,"ENSG00000079974.19"
"11332","ENSG00000134538.3_32724",32716,32724,9,"ENSG00000134538.3",1,1,"MVVVVVVVV",0,8,0.90600414078675,116,122,133,136,138,144,154,157,"ATGTAGA","AAGA","GGTATGA","CTGA",2.30009603838218,11,2,10,32,2.75657841726969,4.52263800162105,8.14665456476805,101,"ENSG00000079974.19"
"40591","ENSG00000257062.6_116739",116731,116739,9,"ENSG00000257062.6",1,1,"MVVVVVVVV",0,8,0.90600414078675,116,122,133,136,138,144,154,157,"ATGTAGA","AAGA","GGTATGA","CTGA",2.30009603838218,11,2,10,32,2.75657841726969,4.52263800162105,8.14665456476805,101,"ENSG00000079974.19"
"20340","ENSG00000164684.13_38488",38480,38488,9,"ENSG00000164684.13",1,1,"MVVVVVVVV",0,8,0.90600414078675,62,68,87,90,111,117,133,136,"GTGAGGA","CTGA","ATGAGGA","CTGG",2.47748562341452,19,21,16,65,1.57372865349018,4.52257486906342,8.14659143221041,101,"ENSG00000079974.19"
"37110","ENSG00000245384.2_146391",146383,146391,9,"ENSG00000245384.2",1,8,"VVVVVVVMV",0,8,0.884057971014493,116,122,133,136,145,151,182,185,"TTGACTA","CTGA","GTGGTTA","CTGA",2.46132835596712,11,9,31,60,2.03252168717155,4.61034434840475,8.14657623246272,101,"ENSG00000079974.19"
"23396","ENSG00000172915.20_346334",346326,346334,9,"ENSG00000172915.20",1,2,"VMVVVVVVV",0,8,0.884057971014493,111,117,133,136,143,149,187,190,"ATGATGG","ATAA","TTGTTGC","CTGA",2.48597131707722,16,7,38,70,1.86810863092304,4.61031268619279,8.14654457025076,101,"ENSG00000079974.19"
"34735","ENSG00000233919.1_2008",2000,2008,9,"ENSG00000233919.1",1,3,"UVMVVVVVV",1,7,0.785507246376811,114,120,133,136,139,145,163,166,"CTGATGA","CTGG","CTGAAGT","CTGA",2.65091005628364,13,3,18,43,2.34494450562006,5.00441955354441,8.14644853905166,101,"ENSG00000079974.19"
"26012","ENSG00000183137.15_42916",42908,42916,9,"ENSG00000183137.15",0,NA,"UVVVVVVVV",1,8,0.902691511387163,38,44,57,60,77,83,133,136,"GTGACAA","CTGA","ATGCAGA","CTGA",2.50747200976559,13,17,50,89,1.42621929260882,4.53567483942818,8.14644088497684,101,"ENSG00000079974.19"
"3512","ENSG00000085276.19_575803",575795,575803,9,"ENSG00000085276.19",0,NA,"UVVVVVVVV",1,8,0.902691511387163,100,106,133,136,147,153,180,183,"ATCATTA","CTGA","ATGGTAA","CTGA",2.55014370625036,27,11,27,74,1.14134419869763,4.53557556009167,8.14634160564033,101,"ENSG00000079974.19"
"4618","ENSG00000101333.19_432445",432437,432445,9,"ENSG00000101333.19",0,NA,"VVVVVVUVV",1,8,0.886128364389234,115,121,133,136,154,160,172,175,"ATGAGGA","CTTT","GTGGTCT","CTGA",2.41132368839666,12,18,12,51,2.33145579318649,4.60173676229106,8.146250219848,101,"ENSG00000079974.19"
"24328","ENSG00000175806.15_173631",173623,173631,9,"ENSG00000175806.15",0,NA,"VVVUVVVVV",1,8,0.880745341614907,102,108,133,136,149,155,202,205,"ATGATGT","CAGA","ATGTTTA","CTGA",2.64326929365599,25,13,47,94,0.870755558471241,4.6231377123778,8.14611907883743,101,"ENSG00000079974.19"
"11810","ENSG00000136143.16_181813",181805,181813,9,"ENSG00000136143.16",0,NA,"VVVVVUVVV",1,8,0.922153209109731,87,93,133,136,145,151,160,163,"ATAAGGA","TTGA","ATCAACA","CTGA",2.38182922535909,40,9,9,67,1.95061684994316,4.45736958808427,8.1459824245232,101,"ENSG00000079974.19"
"40501","ENSG00000256637.9_198649",198641,198649,9,"ENSG00000256637.9",1,5,"VVUVMVVVV",1,7,0.770186335403727,106,112,133,136,147,153,164,167,"ATGATGG","CTGA","CAGATGC","CTGA",2.70435821539606,21,11,11,52,2.23095793674881,5.06500317651397,8.14574851812887,101,"ENSG00000079974.19"
"32250","ENSG00000226488.2_14502",14494,14502,9,"ENSG00000226488.2",1,1,"MVVVVVVVV",0,8,0.90600414078675,109,115,133,136,161,167,179,182,"ATGAGGA","CCAA","GTTATTA","CTGA",2.45073951223051,18,25,12,64,1.74829762491523,4.52164025994632,8.14565682309332,101,"ENSG00000079974.19"
"1641","ENSG00000064651.14_57268",57260,57268,9,"ENSG00000064651.14",1,2,"VMVVVVVVV",0,8,0.884057971014493,89,95,133,136,147,153,183,186,"ATGATGA","TTAA","ATGGTAA","CTGA",2.62089066146873,38,11,30,88,0.96474323926864,4.60933691226504,8.14556879632301,101,"ENSG00000079974.19"
"555","ENSG00000018510.18_173343",173335,173343,9,"ENSG00000018510.18",0,NA,"VVUVVVVVV",1,8,0.883643892339545,110,116,133,136,145,151,160,163,"CTCATGT","TTGA","CTAATTA","CTGA",2.35957800227644,17,9,9,44,2.71289597308844,4.61085399706618,8.14542956642436,101,"ENSG00000079974.19"
"28783","ENSG00000196482.18_511571",511563,511571,9,"ENSG00000196482.18",1,1,"MVVVVVVVV",0,8,0.90600414078675,112,118,133,136,143,149,167,170,"AGGAAGA","ATGT","CTGCAGA","CTGA",2.33075000241402,15,7,18,49,2.54673175462944,4.52126627601405,8.14528283916105,101,"ENSG00000079974.19"
"21986","ENSG00000169490.17_2491",2483,2491,9,"ENSG00000169490.17",1,5,"VVVVMVVVV",0,8,0.886542443064182,114,120,133,136,156,162,214,217,"ATGAAAA","CTGA","ATGAATA","CTGA",2.56815794932194,13,20,52,94,1.27520549818747,4.59906462341677,8.1452343956735,101,"ENSG00000079974.19"
"4592","ENSG00000101230.6_4342",4334,4342,9,"ENSG00000101230.6",0,NA,"UVVVVVVVV",1,8,0.902691511387163,104,110,133,136,148,154,163,166,"ACGATGT","TTGA","ATATTGG","CTGA",2.41502054123389,23,12,9,53,2.03764683277818,4.53444594358436,8.14521198913302,101,"ENSG00000079974.19"
"9744","ENSG00000126882.14_10921",10913,10921,9,"ENSG00000126882.14",0,NA,"VVUVVUVVV",2,7,0.805797101449275,105,111,133,136,139,145,165,168,"AGGATGA","CTGA","GGGAGGA","CTGA",2.72005414465277,22,3,20,54,1.55439062055149,4.92202122955915,8.14520963535625,101,"ENSG00000079974.19"
"24282","ENSG00000175697.11_65665",65657,65665,9,"ENSG00000175697.11",1,1,"MVVVVVVVV",0,8,0.90600414078675,114,120,133,136,141,147,174,177,"ATTAAGA","CCTA","ATGAAGA","CTGA",2.39302859885892,13,5,27,54,2.13073181262197,4.5210639512537,8.14508051440069,101,"ENSG00000079974.19"
"39218","ENSG00000253314.7_73241",73233,73241,9,"ENSG00000253314.7",1,1,"MVVVVVVVV",0,8,0.90600414078675,109,115,133,136,165,171,186,189,"ATAGTGA","ATGA","GTGAAAA","CTGA",2.4808736104875,18,29,15,71,1.54473154286815,4.52097223652953,8.14498879967653,101,"ENSG00000079974.19"
"27858","ENSG00000187416.13_65738",65730,65738,9,"ENSG00000187416.13",1,1,"MVVVVVVVV",0,8,0.90600414078675,81,87,98,101,109,115,133,136,"AGGTTGC","CTGG","ATGAACA","CTGA",2.32232967853468,11,8,18,46,2.60161669597259,4.52095363821762,8.14497020136462,101,"ENSG00000079974.19"
"28461","ENSG00000189223.15_39355",39347,39355,9,"ENSG00000189223.15",1,6,"VVVVVMVVV",0,8,0.902691511387163,111,117,133,136,147,153,165,168,"ATCATGA","CTGG","TTGAACA","CTGG",2.32545503616119,16,11,12,48,2.63288850677677,4.53398052029617,8.14474656584482,101,"ENSG00000079974.19"
"26539","ENSG00000184384.14_196523",196515,196523,9,"ENSG00000184384.14",1,2,"VMVVVUVVV",1,7,0.806211180124223,46,52,67,70,114,120,133,136,"ATGAGGA","ATGA","ATGAGGA","CTGA",2.67709403477558,15,44,13,81,1.8318446338757,4.91978454976156,8.14462927025846,101,"ENSG00000079974.19"
"2770","ENSG00000078140.14_70381",70373,70381,9,"ENSG00000078140.14",1,1,"MVVVVUVVV",1,7,0.82815734989648,116,122,133,136,137,143,152,155,"ATGGTGA","AAGA","ATGAACA","CTGA",2.49827208360524,11,1,9,30,2.67246561923797,4.83190321081823,8.14453261040415,101,"ENSG00000079974.19"
"6824","ENSG00000111962.8_181704",181696,181704,9,"ENSG00000111962.8",0,NA,"VVVVVVUVV",1,8,0.886128364389234,103,109,133,136,148,154,166,169,"ATTATGA","CCCA","GTTAAGA","CTGA",2.46871013852013,24,12,12,57,1.94191287115471,4.59999511532223,8.14450857287916,101,"ENSG00000079974.19"
"30195","ENSG00000204110.7_24403",24395,24403,9,"ENSG00000204110.7",1,6,"VVVVVMVVV",0,8,0.902691511387163,116,122,133,136,140,146,155,158,"CTGATAT","AGGA","GTAATAA","CTGA",2.26730343876041,11,4,9,33,3.01944027565145,4.53369913351355,8.14446517906221,101,"ENSG00000079974.19"
"28689","ENSG00000196353.13_343972",343964,343972,9,"ENSG00000196353.13",1,8,"VVVVVVVMV",0,8,0.884057971014493,83,89,100,103,114,120,133,136,"ATGTTTA","CTTA","ATAAAGG","CTGA",2.35425846729164,11,11,13,44,2.73771762998642,4.60819351964933,8.14442540370731,101,"ENSG00000079974.19"
"48150","ENSG00000290548.1_23894",23886,23894,9,"ENSG00000290548.1",1,6,"VVVVVMVVV",0,8,0.902691511387163,115,121,133,136,138,144,161,164,"GAGATGA","CGGC","ATTTTGA","CTGA",2.38151802763728,12,2,17,40,2.2561242167255,4.53322776691018,8.14399381245883,101,"ENSG00000079974.19"
"48436","ENSG00000291102.1_28758",28750,28758,9,"ENSG00000291102.1",1,6,"VVVVVMVVV",0,8,0.902691511387163,115,121,133,136,138,144,161,164,"GAGATGA","CGGC","ATTTTGA","CTGA",2.38151802763728,12,2,17,40,2.2561242167255,4.53322776691018,8.14399381245883,101,"ENSG00000079974.19"
"14466","ENSG00000145075.13_219634",219626,219634,9,"ENSG00000145075.13",0,NA,"VVVVUVVVV",1,8,0.889855072463768,110,116,133,136,145,151,193,196,"ACGAGGA","CTGC","ATGATCA","CTGA",2.49279062788675,17,9,42,77,1.71929088592687,4.58447376795963,8.1438940578147,101,"ENSG00000079974.19"
"45046","ENSG00000284862.3_33643",33635,33643,9,"ENSG00000284862.3",0,NA,"VVVVUVVVV",1,8,0.889855072463768,110,116,133,136,145,151,193,196,"ACGAGGA","CTGC","ATGATCA","CTGA",2.49279062788675,17,9,42,77,1.71929088592687,4.58447376795963,8.1438940578147,101,"ENSG00000079974.19"
"18165","ENSG00000156374.16_19984",19976,19984,9,"ENSG00000156374.16",1,1,"MVVVVVVVV",0,8,0.90600414078675,112,118,133,136,138,144,153,156,"ATTATTT","ATGA","GTACTGA","CTGA",2.32715769229337,15,2,9,35,2.56498500700451,4.51984240557341,8.14385896872041,101,"ENSG00000079974.19"
"24403","ENSG00000176204.14_114907",114899,114907,9,"ENSG00000176204.14",1,1,"MVVVVVVVV",0,8,0.90600414078675,114,120,133,136,137,143,152,155,"ATGAGGA","GAGA","ATGAAGA","TTGA",2.32528931597892,13,1,9,32,2.57651761548694,4.51961159716994,8.14362816031694,101,"ENSG00000079974.19"
"14608","ENSG00000145439.12_131671",131663,131671,9,"ENSG00000145439.12",1,8,"UVVVVVVMV",1,7,0.786749482401656,96,102,133,136,145,151,170,173,"CTGATGA","CTGA","ATGTTAA","CTGA",2.76424217751626,31,9,19,68,1.55793143518974,4.99655315465787,8.14355108426449,101,"ENSG00000079974.19"
"7560","ENSG00000114805.18_45353",45345,45353,9,"ENSG00000114805.18",0,NA,"VVVVVVUVV",1,8,0.886128364389234,116,122,133,136,169,175,186,189,"ATGAAGA","CTCC","GAGAAGA","CTGA",2.46085272614402,11,33,11,64,1.98971875998334,4.59885090023587,8.14336435779281,101,"ENSG00000079974.19"
"4299","ENSG00000100099.22_39090",39082,39090,9,"ENSG00000100099.22",1,1,"MVVVVVVVV",0,8,0.90600414078675,116,122,133,136,146,152,177,180,"ATAATGA","TTCA","GAAATGT","CTGA",2.38945405368942,11,10,25,55,2.14609818823404,4.5189479698742,8.1429645330212,101,"ENSG00000079974.19"
"38931","ENSG00000251314.2_411229",411221,411229,9,"ENSG00000251314.2",0,NA,"VVVVVVUVV",1,8,0.886128364389234,113,119,133,136,144,150,165,168,"ATGATGA","ATTA","AGGATCA","CTGG",2.34325317965024,14,8,15,46,2.77174603734722,4.59835847542054,8.14287193297747,101,"ENSG00000079974.19"
"11336","ENSG00000134551.13_5423",5415,5423,9,"ENSG00000134551.13",0,NA,"VVVVVUVVV",1,8,0.922153209109731,114,120,133,136,146,152,208,211,"AATATGA","CTAA","ATGAATG","CTGA",2.38823043132221,13,10,56,88,1.89437631664227,4.45397813136425,8.14259096780318,101,"ENSG00000079974.19"
"36027","ENSG00000237760.1_5945",5937,5945,9,"ENSG00000237760.1",1,1,"MVVVVVVVV",0,8,0.90600414078675,102,108,133,136,184,190,208,211,"ATGATGA","ATGA","GTGATGT","CTAA",2.58964628656235,25,48,18,100,0.809244154376101,4.51838818286461,8.14240474601161,101,"ENSG00000079974.19"
"5003","ENSG00000102683.8_136425",136417,136425,9,"ENSG00000102683.8",1,8,"VVVVVVVMV",0,8,0.884057971014493,98,104,133,136,138,144,153,156,"ATGAAGG","ATGA","CTGCTGA","CTGA",2.52615568243241,29,2,9,49,1.58364168116353,4.60616989101157,8.14240177506954,101,"ENSG00000079974.19"
"45485","ENSG00000285634.3_73384",73376,73384,9,"ENSG00000285634.3",1,8,"VVVVVVVMV",0,8,0.884057971014493,98,104,133,136,138,144,153,156,"ATGAAGG","ATGA","CTGCTGA","CTGA",2.52615568243241,29,2,9,49,1.58364168116353,4.60616989101157,8.14240177506954,101,"ENSG00000079974.19"
"21078","ENSG00000166398.14_33681",33673,33681,9,"ENSG00000166398.14",0,NA,"VVVVVUVVV",1,8,0.922153209109731,114,120,133,136,146,152,166,169,"GTGGGGA","GTTA","CTGAGGC","CTGA",2.25687663101259,13,10,14,46,2.76930580185127,4.45378750215047,8.14240033858939,101,"ENSG00000079974.19"
"26597","ENSG00000184588.18_350568",350560,350568,9,"ENSG00000184588.18",0,NA,"VVVVUVVVV",1,8,0.889855072463768,114,120,133,136,185,191,211,214,"CTGATTA","CAGA","ATGAAGG","CTGA",2.52281293839459,13,49,20,91,1.51313326025931,4.58297154572248,8.14239183557755,101,"ENSG00000079974.19"
"39134","ENSG00000251680.6_71978",71970,71978,9,"ENSG00000251680.6",0,NA,"UVVVVVVVV",1,8,0.902691511387163,113,119,133,136,139,145,165,168,"TTGAAGA","CTCT","TTGATTA","CTGA",2.39116996751504,14,3,20,46,2.18529762519007,4.53160768548925,8.1423737310379,101,"ENSG00000079974.19"
"46552","ENSG00000286803.1_26394",26386,26394,9,"ENSG00000286803.1",1,8,"VVVVVVVMV",0,8,0.884057971014493,73,79,93,96,116,122,133,136,"TTGAATA","CTGA","GTGCAGT","CTGA",2.42951718037727,14,20,11,54,2.22777040045062,4.60613790074144,8.14236978479941,101,"ENSG00000079974.19"
"9912","ENSG00000128487.19_267030",267022,267030,9,"ENSG00000128487.19",1,7,"VVVVVVMVV",0,8,0.885300207039338,90,96,108,111,114,120,133,136,"GTGTTGA","CTGA","GTGGTTT","TTGA",2.35565408780718,12,3,13,37,2.69900917873968,4.60084244103023,8.14204326918758,101,"ENSG00000079974.19"
"42467","ENSG00000263494.1_90813",90805,90813,9,"ENSG00000263494.1",1,7,"VVVVVVMVV",0,8,0.885300207039338,90,96,108,111,114,120,133,136,"GTGTTGA","CTGA","GTGGTTT","TTGA",2.35565408780718,12,3,13,37,2.69900917873968,4.60084244103023,8.14204326918758,101,"ENSG00000079974.19"
"36232","ENSG00000239265.5_42477",42469,42477,9,"ENSG00000239265.5",0,NA,"UVVVVVVVV",1,8,0.902691511387163,116,122,133,136,148,154,165,168,"AAGATAA","CTAT","GGGAGGA","CTGA",2.30774624036521,11,12,11,43,2.73881508114728,4.53094750422884,8.14171354977749,101,"ENSG00000079974.19"
"36841","ENSG00000243273.2_4391",4383,4391,9,"ENSG00000243273.2",0,NA,"UVVVVVVVV",1,8,0.902691511387163,116,122,133,136,148,154,165,168,"AAGATAA","CTAT","GGGAGGA","CTGA",2.30774624036521,11,12,11,43,2.73881508114728,4.53094750422884,8.14171354977749,101,"ENSG00000079974.19"
"2238","ENSG00000072121.17_74768",74760,74768,9,"ENSG00000072121.17",0,NA,"VVUVVUVVV",2,7,0.805797101449275,113,119,133,136,147,153,170,173,"CTGAAGA","GTGA","GTGATTA","CTGA",2.57637278902374,14,11,17,51,2.49708326756014,4.91822546526294,8.14141387106005,101,"ENSG00000079974.19"
"44500","ENSG00000282881.3_3923",3915,3923,9,"ENSG00000282881.3",0,NA,"VVVUVVVVV",1,8,0.880745341614907,113,119,133,136,145,151,192,195,"ATAGTGA","CAGA","GTGAGGG","CTGA",2.48128058034847,14,9,41,73,1.93124879356515,4.61827983230541,8.14126119876504,101,"ENSG00000079974.19"
"40300","ENSG00000255501.3_109626",109618,109626,9,"ENSG00000255501.3",1,8,"VVVVVVVMV",0,8,0.884057971014493,108,114,133,136,147,153,163,166,"AAGATGG","CTAC","ATGATAA","CTGA",2.40104665334579,19,11,10,49,2.41310472045169,4.60502060235591,8.14125248641388,101,"ENSG00000079974.19"
"25858","ENSG00000182993.5_6104",6096,6104,9,"ENSG00000182993.5",1,1,"MVVVVVVVV",0,8,0.90600414078675,111,117,133,136,169,175,222,225,"AAGATGG","CTGA","GTTATTA","CTGA",2.57952302161018,16,33,47,105,0.871940606772025,4.51719018770997,8.14120675085697,101,"ENSG00000079974.19"
"26967","ENSG00000185345.24_694636",694628,694636,9,"ENSG00000185345.24",0,NA,"VVVUVVVVV",1,8,0.880745341614907,110,116,133,136,140,146,177,180,"ATGGTCA","GTGA","GTGATGG","CTGA",2.51594761879353,17,4,31,61,1.69989740002997,4.61822038133004,8.14120174778967,101,"ENSG00000079974.19"
"11331","ENSG00000134538.3_24793",24785,24793,9,"ENSG00000134538.3",0,NA,"VVVVVUVVV",1,8,0.922153209109731,69,75,92,95,102,108,133,136,"TGGAGGA","CTGA","ATACTCA","CTGA",2.36732891148029,17,7,25,58,2.02801733899417,4.45255252054902,8.14116535698795,101,"ENSG00000079974.19"
"40590","ENSG00000257062.6_108808",108800,108808,9,"ENSG00000257062.6",0,NA,"VVVVVUVVV",1,8,0.922153209109731,69,75,92,95,102,108,133,136,"TGGAGGA","CTGA","ATACTCA","CTGA",2.36732891148029,17,7,25,58,2.02801733899417,4.45255252054902,8.14116535698795,101,"ENSG00000079974.19"
"43079","ENSG00000268089.3_5635",5627,5635,9,"ENSG00000268089.3",0,NA,"VVVVVUVVV",1,8,0.922153209109731,78,84,97,100,106,112,133,136,"GTGATGT","CTAA","TTGCTGT","TTGA",2.30534621017824,13,6,21,49,2.44092875003404,4.45247587113891,8.14108870757784,101,"ENSG00000079974.19"
"17673","ENSG00000154736.6_38006",37998,38006,9,"ENSG00000154736.6",1,2,"VMVVVVVVV",0,8,0.884057971014493,115,121,133,136,144,150,168,171,"ATGTTAA","ATAA","CTGATGT","CTGA",2.36904086112726,12,8,18,47,2.62562570194296,4.60480786069785,8.14103974475582,101,"ENSG00000079974.19"
"38998","ENSG00000251398.2_84532",84524,84532,9,"ENSG00000251398.2",1,3,"VVMVVVVVV",0,8,0.882815734989648,90,96,107,110,115,121,133,136,"ATGATGA","TTAA","ATGTCAA","ATGA",2.3243776305807,11,5,12,37,2.94317471065411,4.60975639529802,8.14101933525661,101,"ENSG00000079974.19"
"43041","ENSG00000267707.2_1622",1614,1622,9,"ENSG00000267707.2",1,2,"VMVVVUVVV",1,7,0.806211180124223,83,89,133,136,145,151,161,164,"ATCATGA","CTGG","GTGGTGA","CTGA",2.65695841453957,44,9,10,72,1.95087827807036,4.9159835937502,8.14082831424709,101,"ENSG00000079974.19"
"13866","ENSG00000143776.20_32456",32448,32456,9,"ENSG00000143776.20",1,8,"VVUVVVVMV",1,7,0.767701863354037,83,89,105,108,110,116,133,136,"ATGATGA","CCGA","ATTAAGA","CTGA",2.73159280604134,16,2,17,44,2.06943911844543,5.07001445634692,8.14082190976307,101,"ENSG00000079974.19"
"6444","ENSG00000109911.19_210287",210279,210287,9,"ENSG00000109911.19",1,7,"VVVVVVMVV",0,8,0.885300207039338,47,53,72,75,112,118,133,136,"ATAATGA","CTGG","GTGTTTT","CTGA",2.54857821226601,19,37,15,80,1.40741369727603,4.5994837780957,8.14068460625305,101,"ENSG00000079974.19"
"17911","ENSG00000155816.21_304301",304293,304301,9,"ENSG00000155816.21",0,NA,"UVVVVVVVV",1,8,0.902691511387163,116,122,133,136,139,145,153,156,"TTAATCA","TTGA","AGGATAT","CTGA",2.27273227996627,11,3,8,31,2.96752828093801,4.52976920351162,8.14053524906028,101,"ENSG00000079974.19"
"31517","ENSG00000223944.3_87812",87804,87812,9,"ENSG00000223944.3",1,2,"VMVVVVVVV",0,8,0.884057971014493,92,98,133,136,147,153,167,170,"GTGATGA","AGGA","AAGAAAA","CTGA",2.50529404272005,35,11,14,69,1.71507296791675,4.60425831317928,8.14049019723725,101,"ENSG00000079974.19"
"2277","ENSG00000072422.17_70625",70617,70625,9,"ENSG00000072422.17",1,1,"MVVVUVVVV",1,7,0.795859213250517,108,114,133,136,145,151,168,171,"ATGATGG","ATGA","CTGAAGG","CTGA",2.64043910620552,19,9,17,54,2.2251154186358,4.95701069833481,8.14044755133688,101,"ENSG00000079974.19"
"22297","ENSG00000170242.19_101167",101159,101167,9,"ENSG00000170242.19",1,8,"VVVVVUVMV",1,7,0.806211180124224,61,67,88,91,106,112,133,136,"ATGATGA","CTGT","CTGTGGA","CTGA",2.73568893126543,21,15,21,66,1.42392691324599,4.91546328042055,8.14030800091745,101,"ENSG00000079974.19"
"36336","ENSG00000240057.8_104668",104660,104668,9,"ENSG00000240057.8",0,NA,"VVVVVUVVV",1,8,0.922153209109731,106,112,133,136,141,147,162,165,"GTGCTGG","CTGG","GTCTAGA","CTGA",2.34706640582302,21,5,15,50,2.15912317969505,4.45155813796212,8.14017097440104,101,"ENSG00000079974.19"
"15919","ENSG00000150275.20_408469",408461,408469,9,"ENSG00000150275.20",1,8,"VVVVVVVMV",0,8,0.884057971014493,110,116,133,136,143,149,167,170,"ACGATGT","ATAA","ATCATGA","CTGA",2.40353870583153,17,7,18,51,2.39152362909572,4.60377875032648,8.14001063438445,101,"ENSG00000079974.19"
"27467","ENSG00000186231.17_33815",33807,33815,9,"ENSG00000186231.17",0,NA,"UVVVVUVVV",2,7,0.824844720496894,88,94,133,136,140,146,164,167,"AGGATGA","CTAA","GTGAAGA","CTGA",2.68298500417312,39,4,18,70,1.47588750689888,4.84061355034658,8.13999243233416,101,"ENSG00000079974.19"
"27730","ENSG00000187240.17_209865",209857,209865,9,"ENSG00000187240.17",1,2,"VMVVVVVVV",0,8,0.884057971014493,107,113,133,136,141,147,157,160,"ATGATAT","GTTA","TTGATTA","CTGA",2.39764021128305,20,5,10,44,2.43049359638376,4.60369041790103,8.139922301959,101,"ENSG00000079974.19"
"21140","ENSG00000166569.8_25444",25436,25444,9,"ENSG00000166569.8",1,8,"VVVVVVVMV",0,8,0.884057971014493,115,121,133,136,148,154,165,168,"GAGAAGA","CTGG","TTGCTTA","CTGA",2.34812647038652,12,12,11,44,2.76047784817007,4.60366357935338,8.13989546341136,101,"ENSG00000079974.19"
"42861","ENSG00000267175.5_26100",26092,26100,9,"ENSG00000267175.5",0,NA,"UVVVVVVVV",1,8,0.902691511387163,82,88,133,136,146,152,164,167,"AGGATGG","TTGA","GGGTAGA","CTGA",2.43879108091613,45,10,12,76,1.85651075997686,4.5287794915211,8.13954553706975,101,"ENSG00000079974.19"
"7253","ENSG00000113396.13_210593",210585,210593,9,"ENSG00000113396.13",1,8,"VVVVVVVMV",0,8,0.884057971014493,115,121,133,136,154,160,171,174,"GTTAAGA","TTGA","ATGAACA","CTGA",2.40798632591413,12,18,11,50,2.35946096646261,4.60317578480586,8.13940766886383,101,"ENSG00000079974.19"
"22988","ENSG00000171877.21_283279",283271,283279,9,"ENSG00000171877.21",1,5,"VVVVMUVVV",1,7,0.808695652173913,85,91,100,103,116,122,133,136,"GTGATGC","CTGA","ACTTTGA","CTGA",2.56271874821187,9,13,11,42,2.53360360566319,4.90459881510224,8.13938142379789,101,"ENSG00000079974.19"
"18827","ENSG00000158683.10_158788",158780,158788,9,"ENSG00000158683.10",1,8,"VVVVVUVMV",1,7,0.806211180124224,75,81,106,109,116,122,133,136,"ATGATGG","CTGC","GTGCTTA","CTGA",2.62502869031403,25,7,11,52,2.15781022298257,4.9145003729357,8.13934509343259,101,"ENSG00000079974.19"
"6737","ENSG00000111731.13_20316",20308,20316,9,"ENSG00000111731.13",1,8,"VVVUVVVMV",1,7,0.764803312629399,105,111,133,136,147,153,161,164,"TTGATGA","CTGA","TTCAGGA","CTGA",2.72509608232085,22,11,8,50,2.15303602505002,5.08008581013059,8.13929906064819,101,"ENSG00000079974.19"
"32983","ENSG00000228412.9_484754",484746,484754,9,"ENSG00000228412.9",0,NA,"UVVVVVVVV",1,8,0.902691511387163,56,62,76,79,91,97,133,136,"GTGATGC","CTGA","GTGATTG","TTGA",2.45090045670608,14,12,36,71,1.77386292361429,4.5282998254137,8.13906587096235,101,"ENSG00000079974.19"
"8241","ENSG00000117594.10_18710",18702,18710,9,"ENSG00000117594.10",0,NA,"VVVVVUVVV",1,8,0.922153209109731,82,88,102,105,112,118,133,136,"CTGATGT","CTGC","CTTAGGA","CTGT",2.25221532094103,14,7,15,45,2.78701068822528,4.4504448736247,8.13905771006362,101,"ENSG00000079974.19"
"24465","ENSG00000176438.13_74126",74118,74126,9,"ENSG00000176438.13",1,5,"VVVVMVVVV",0,8,0.886542443064182,49,55,92,95,101,107,133,136,"CTGAGGA","CTGA","ATGGAGT","CTGA",2.57197829445536,37,6,26,78,1.22445594864925,4.59274447792124,8.13891425017797,101,"ENSG00000079974.19"
"21510","ENSG00000168079.17_84778",84770,84778,9,"ENSG00000168079.17",0,NA,"VVVVVUVVV",1,8,0.922153209109731,70,76,93,96,102,108,133,136,"GTGATGA","ATGA","ATCCAGA","CTCA",2.36834849574048,17,6,25,57,2.01184009593864,4.45020751688546,8.13882035332438,101,"ENSG00000079974.19"
"20425","ENSG00000164808.17_217374",217366,217374,9,"ENSG00000164808.17",1,8,"VVVVVVVMV",0,8,0.884057971014493,115,121,133,136,157,163,209,212,"CTGAGGA","GTGA","GTGGTGA","CTGA",2.57482814054676,12,21,46,88,1.24451163139184,4.60250814209255,8.13874002615052,101,"ENSG00000079974.19"
"33478","ENSG00000229981.8_234461",234453,234461,9,"ENSG00000229981.8",1,1,"MVVVVVVVV",0,8,0.90600414078675,78,84,96,99,102,108,133,136,"GTGATAA","CTGA","ATGAGCA","ATGA",2.41251906489865,12,3,25,49,1.97528105672966,4.51468537234684,8.13870193549383,101,"ENSG00000079974.19"
"12094","ENSG00000137218.10_9067",9059,9067,9,"ENSG00000137218.10",1,1,"MVVVVVVVV",0,8,0.90600414078675,115,121,133,136,178,184,193,196,"TGGATGA","AGGA","GTGACAA","CTGA",2.40822854700204,12,42,9,72,2.00366666275412,4.51463091069192,8.13864747383892,101,"ENSG00000079974.19"
"23455","ENSG00000172987.13_300925",300917,300925,9,"ENSG00000172987.13",1,1,"MVVVVVVVV",0,8,0.90600414078675,110,116,133,136,140,146,156,159,"ATTATGG","CAAA","GTGACTG","CTGA",2.31480697144486,17,4,10,40,2.6258528981385,4.51447484360939,8.13849140675638,101,"ENSG00000079974.19"
"1034","ENSG00000044524.11_294403",294395,294403,9,"ENSG00000044524.11",1,8,"VVVVVVVMV",0,8,0.884057971014493,115,121,133,136,153,159,215,218,"ATTATGA","CAGA","ATGTTTT","CTGA",2.54701113977169,12,17,56,94,1.42884925320965,4.60223087958857,8.13846276364654,101,"ENSG00000079974.19"
"8394","ENSG00000118557.16_26768",26760,26768,9,"ENSG00000118557.16",1,8,"VVVVVVVMV",0,8,0.884057971014493,109,115,133,136,146,152,163,166,"AGGATCA","GTGA","AAGAAAA","CTGA",2.37845721510473,18,10,11,48,2.55217806762677,4.60213987541458,8.13837175947255,101,"ENSG00000079974.19"
"1581","ENSG00000062096.15_19309",19301,19309,9,"ENSG00000062096.15",1,1,"MVVVVVVVV",0,8,0.90600414078675,95,101,133,136,165,171,186,189,"GTGATAA","ATGA","GTGAAAA","CTGA",2.5733224460556,32,29,15,85,0.901826085985828,4.51432726492246,8.13834382806946,101,"ENSG00000079974.19"
"353","ENSG00000009694.14_228775",228767,228775,9,"ENSG00000009694.14",0,NA,"VVVVVUVVV",1,8,0.922153209109731,84,90,101,104,107,113,133,136,"GTGTTGA","CTAA","CTGAAGA","ATGA",2.33912669443178,11,3,20,43,2.20447038713624,4.44966208750369,8.13827492394261,101,"ENSG00000079974.19"
"41702","ENSG00000259572.7_42328",42320,42328,9,"ENSG00000259572.7",1,5,"VVVVMVVVV",0,8,0.886542443064182,99,105,133,136,145,151,162,165,"GGGATGA","CTCT","CTGATGC","CTGA",2.45310014928467,28,9,11,57,2.01432052763459,4.59208038071643,8.13825015297316,101,"ENSG00000079974.19"
"40354","ENSG00000255693.3_22518",22510,22518,9,"ENSG00000255693.3",1,3,"VVMVVVVVV",0,8,0.882815734989648,61,67,81,84,105,111,133,136,"GTGATGA","CTGC","GTGAAGA","CAGA",2.52270159336251,14,21,22,66,1.60986391494104,4.60696863433944,8.13823157429803,101,"ENSG00000079974.19"
"47496","ENSG00000288591.1_146416",146408,146416,9,"ENSG00000288591.1",1,3,"VVMVVVVVV",0,8,0.882815734989648,61,67,81,84,105,111,133,136,"GTGATGA","CTGC","GTGAAGA","CAGA",2.52270159336251,14,21,22,66,1.60986391494104,4.60696863433944,8.13823157429803,101,"ENSG00000079974.19"
"47314","ENSG00000287985.1_2904",2896,2904,9,"ENSG00000287985.1",0,NA,"VVVVVUVVV",1,8,0.922153209109731,106,112,133,136,141,147,162,165,"GTTATGA","CACA","GTTACAA","CTGA",2.34588848340843,21,5,15,50,2.15912317969505,4.44959493393782,8.13820777037674,101,"ENSG00000079974.19"
"5298","ENSG00000104313.20_132389",132381,132389,9,"ENSG00000104313.20",1,8,"VVVVVVVMV",0,8,0.884057971014493,70,76,89,92,100,106,133,136,"ATGATGA","TTAA","ATGGTGA","CTCA",2.43323984100541,13,8,27,57,2.18581251200448,4.60185286301013,8.1380847470681,101,"ENSG00000079974.19"
"39306","ENSG00000253438.5_689317",689309,689317,9,"ENSG00000253438.5",1,1,"MVVVVVVVV",0,8,0.90600414078675,89,95,106,109,114,120,133,136,"GTGATGA","GGGA","GTAAAGC","ATGA",2.27554996711396,11,5,13,38,2.88521413468769,4.5138868121952,8.13790337534219,101,"ENSG00000079974.19"
"2936","ENSG00000079482.14_115200",115192,115200,9,"ENSG00000079482.14",1,1,"MVVVVVVVV",0,8,0.90600414078675,78,84,98,101,110,116,133,136,"ATGATGA","GGGA","GGGATTT","CTTA",2.31628549924858,14,9,17,49,2.61329259943963,4.51379898194087,8.13781554508787,101,"ENSG00000079974.19"
"3074","ENSG00000080709.16_282350",282342,282350,9,"ENSG00000080709.16",1,5,"VVVVMVVVV",0,8,0.886542443064182,107,113,133,136,140,146,165,168,"AAGAGGA","CAGG","GTGATGA","CTGA",2.46931679772616,20,4,19,52,1.90368973145922,4.59145042907508,8.1376202013318,101,"ENSG00000079974.19"
"41108","ENSG00000258551.7_209742",209734,209742,9,"ENSG00000258551.7",1,2,"VMVVVVVVV",0,8,0.884057971014493,77,83,96,99,111,117,133,136,"GTGATGA","TGGA","CTGTTGA","GTGA",2.38266885154238,13,12,16,50,2.52076293860985,4.60130548722309,8.13753737128106,101,"ENSG00000079974.19"
"45117","ENSG00000285051.2_265745",265737,265745,9,"ENSG00000285051.2",1,2,"VMVVVUVVV",1,7,0.806211180124223,111,117,133,136,143,149,195,198,"ATGCTGA","CAGA","GTGATTA","CTGA",2.67100501720594,16,7,46,78,1.84382597198101,4.91263152167181,8.13747624216871,101,"ENSG00000079974.19"
"45200","ENSG00000285218.1_295516",295508,295516,9,"ENSG00000285218.1",1,2,"VMVVVUVVV",1,7,0.806211180124223,111,117,133,136,143,149,195,198,"ATGCTGA","CAGA","GTGATTA","CTGA",2.67100501720594,16,7,46,78,1.84382597198101,4.91263152167181,8.13747624216871,101,"ENSG00000079974.19"
"41968","ENSG00000260192.3_516099",516091,516099,9,"ENSG00000260192.3",0,NA,"VVVVUUVVV",2,7,0.812008281573499,114,120,133,136,152,158,214,217,"ATGATGA","TTGA","TTAATGG","CTGA",2.71074696411054,13,16,56,94,1.48482975055441,4.88911904448951,8.1371521707835,101,"ENSG00000079974.19"
"46639","ENSG00000286953.1_76713",76705,76713,9,"ENSG00000286953.1",1,8,"VVVUVVVMV",1,7,0.764803312629399,109,115,133,136,146,152,163,166,"GTGATGA","CTAA","TTGGAGA","CTGA",2.66393036599577,18,10,11,48,2.55217806762677,5.07792846023298,8.13714171075057,101,"ENSG00000079974.19"
"9172","ENSG00000123066.9_223854",223846,223854,9,"ENSG00000123066.9",1,1,"MVVVVVVVV",0,8,0.90600414078675,105,111,133,136,143,149,177,180,"CTAATGA","CTAA","CTGATTT","CTGA",2.48114418134605,22,7,28,66,1.51153176722557,4.51312324404981,8.13713980719681,101,"ENSG00000079974.19"
"15047","ENSG00000146856.14_26832",26824,26832,9,"ENSG00000146856.14",1,1,"MVVVVVVVV",0,8,0.90600414078675,112,118,133,136,149,155,177,180,"ATAATCA","TTGA","TTAATAA","CTGA",2.40616660305082,15,13,22,59,2.01120429644479,4.51307874586257,8.13709530900957,101,"ENSG00000079974.19"
"46605","ENSG00000286896.2_34322",34314,34322,9,"ENSG00000286896.2",1,3,"VVMVUVVVV",1,7,0.772670807453416,108,114,133,136,142,148,160,163,"TTGATGT","CTGA","ATGTTTA","CTGA",2.64936062341452,19,6,12,46,2.52282050316678,5.0463061648159,8.13698939462956,101,"ENSG00000079974.19"
"17653","ENSG00000154678.18_198958",198950,198958,9,"ENSG00000154678.18",1,8,"VVVVVVVMV",0,8,0.884057971014493,116,122,133,136,143,149,157,160,"ATAATGT","CAGG","ATAGAGA","CTGA",2.29742183024633,11,7,8,35,3.08659389029706,4.60068485631815,8.13691674037612,101,"ENSG00000079974.19"
"3618","ENSG00000086991.13_110418",110410,110418,9,"ENSG00000086991.13",1,8,"VVVVVVVMV",0,8,0.884057971014493,114,120,133,136,142,148,195,198,"GAGATGA","CTAA","GAGAGCA","CTGA",2.46265936139908,13,6,47,75,1.98419309534189,4.60048054283393,8.1367124268919,101,"ENSG00000079974.19"
"35695","ENSG00000236780.7_260333",260325,260333,9,"ENSG00000236780.7",1,1,"MVVVVVVVV",0,8,0.90600414078675,86,92,133,136,148,154,163,166,"ATTATGG","ATGA","ATGAACT","CTGA",2.44268535827975,41,12,9,71,1.76545917129853,4.51250705662422,8.13652361977121,101,"ENSG00000079974.19"
"33640","ENSG00000230561.6_1562",1554,1562,9,"ENSG00000230561.6",0,NA,"UVVVVVVVV",1,8,0.902691511387163,111,117,133,136,175,181,191,194,"ATGAAGA","TAGA","ATGTTCT","CTGA",2.43835680641328,16,39,10,74,1.84690554691813,4.52565439741833,8.13642044296698,101,"ENSG00000079974.19"
"29849","ENSG00000198796.7_62651",62643,62651,9,"ENSG00000198796.7",1,8,"VVVVVVVMV",0,8,0.884057971014493,94,100,111,114,115,121,133,136,"AAGATGA","CTGA","AAGGAGA","TTGA",2.39003570389752,11,1,12,33,2.46681669377113,4.60009701327197,8.13632889732994,101,"ENSG00000079974.19"
"3620","ENSG00000086991.13_88952",88944,88952,9,"ENSG00000086991.13",1,8,"VVVVVVVMV",0,8,0.884057971014493,95,101,133,136,142,148,171,174,"AAGATGA","CTGT","TTTAAGA","CTGA",2.55511049423631,32,6,23,70,1.36589792692399,4.59999197212484,8.13622385618282,101,"ENSG00000079974.19"
"21518","ENSG00000168143.9_30592",30584,30592,9,"ENSG00000168143.9",0,NA,"UVVVVVVVV",1,8,0.902691511387163,113,119,133,136,170,176,189,192,"TCAATGA","ATGA","GTGCTGA","CTGA",2.42910985617214,14,34,13,70,1.90712215681076,4.52529696615625,8.13606301170491,101,"ENSG00000079974.19"
"4201","ENSG00000099204.21_106679",106671,106679,9,"ENSG00000099204.21",0,NA,"VVVVVVUVV",1,8,0.886128364389234,107,113,133,136,141,147,192,195,"ATGTGGA","CTGA","TTGGGGA","CTGA",2.54042520599287,20,5,45,79,1.42918210274434,4.5913375356742,8.13585099323113,101,"ENSG00000079974.19"
"28373","ENSG00000188897.10_92286",92278,92286,9,"ENSG00000188897.10",1,1,"MVVVVVVVV",0,8,0.90600414078675,115,121,133,136,151,157,190,193,"ATAATCA","ATGA","GTGATCC","CTGA",2.46258161083082,12,15,33,69,1.62990732458403,4.51177951586404,8.13579607901104,101,"ENSG00000079974.19"
"34497","ENSG00000233217.2_1623",1615,1623,9,"ENSG00000233217.2",0,NA,"VVVVUVVVV",1,8,0.889855072463768,116,122,133,136,144,150,167,170,"CTGGTGT","CTGT","AAGATTA","CTGA",2.34592938740612,11,8,17,45,2.66507824251817,4.57615187297307,8.13557216282814,101,"ENSG00000079974.19"
"16651","ENSG00000151952.16_792422",792414,792422,9,"ENSG00000151952.16",0,NA,"VVVVUVVVV",1,8,0.889855072463768,71,77,86,89,101,107,133,136,"GAGATGA","CTGA","ATGATGG","CTTA",2.46986605014128,9,12,26,56,1.83846253803881,4.57605905141183,8.1354793412669,101,"ENSG00000079974.19"
"43478","ENSG00000271955.2_272997",272989,272997,9,"ENSG00000271955.2",1,8,"VVVUVVVMV",1,7,0.764803312629399,110,116,133,136,146,152,160,163,"ATGATGG","CAGC","GTGATGA","CTGA",2.6493543888223,17,10,8,44,2.64205247418349,5.07610376658304,8.13531701710064,101,"ENSG00000079974.19"
"112","ENSG00000005108.17_209142",209134,209142,9,"ENSG00000005108.17",1,6,"VVVVVMVVV",0,8,0.902691511387163,65,71,82,85,98,104,133,136,"TGGATGA","CTAA","ATGAATG","CTGA",2.44186487027775,11,13,29,62,1.8178881569161,4.52424682302528,8.13501286857393,101,"ENSG00000079974.19"
"29826","ENSG00000198780.13_10734",10726,10734,9,"ENSG00000198780.13",1,1,"MVVVVVVVV",0,8,0.90600414078675,116,122,133,136,138,144,156,159,"ATCCTGA","CACA","CTGGAGA","CTGA",2.31282203878809,11,2,12,34,2.6248058813537,4.51090486831858,8.13492143146557,101,"ENSG00000079974.19"
"15469","ENSG00000148459.16_25987",25979,25987,9,"ENSG00000148459.16",1,2,"VMVVVVVVV",0,8,0.884057971014493,114,120,133,136,141,147,203,206,"AAGAAGA","CTGC","AAGATGA","CTGA",2.46998091141304,13,5,56,83,1.9276046341185,4.5985360108847,8.13476789494267,101,"ENSG00000079974.19"
"28787","ENSG00000196482.18_575514",575506,575514,9,"ENSG00000196482.18",0,NA,"VVVVVVUVV",1,8,0.886128364389234,94,100,133,136,174,180,189,192,"ATGATGA","GTGT","CTGCTCA","CTGA",2.60002526384332,33,38,9,89,1.02663103898003,4.59003319948387,8.13454665704081,101,"ENSG00000079974.19"
"11550","ENSG00000135299.17_54783",54775,54783,9,"ENSG00000135299.17",1,2,"VMVVVVVVV",0,8,0.884057971014493,50,56,66,69,116,122,133,136,"ATGATGG","ATGA","GTGATGT","CTTA",2.47290773554915,10,47,11,77,1.90675381654514,4.5982013467182,8.13443323077617,101,"ENSG00000079974.19"
"46973","ENSG00000287426.1_42054",42046,42054,9,"ENSG00000287426.1",1,8,"VVVVVVVMV",0,8,0.884057971014493,81,87,100,103,110,116,133,136,"GGGATGA","CAGT","ATTTAGA","CTGA",2.35421017279379,13,7,17,46,2.69734627205426,4.59802018933655,8.13425207339452,101,"ENSG00000079974.19"
"32187","ENSG00000226308.2_2665",2657,2665,9,"ENSG00000226308.2",1,5,"VVVVMVVVV",0,8,0.886542443064182,116,122,133,136,143,149,160,163,"ATGAATA","CAGC","CTAAAGA","CTGA",2.2997551093205,11,7,11,38,3.0203974279366,4.58802453918498,8.13419431144171,101,"ENSG00000079974.19"
"6994","ENSG00000112425.16_145238",145230,145238,9,"ENSG00000112425.16",1,1,"MVUVVVVVV",1,7,0.789648033126294,111,117,133,136,155,161,173,176,"ATGATGT","CTGT","GTGAGGT","CTGA",2.66755482371045,16,19,12,56,2.11870318681201,4.97560050288709,8.13419263539227,101,"ENSG00000079974.19"
"22101","ENSG00000169851.16_330246",330238,330246,9,"ENSG00000169851.16",1,1,"MVVVVVVVV",0,8,0.90600414078675,113,119,133,136,139,145,158,161,"ATAATGT","TTTA","GTAAGCA","CTGA",2.31177993835444,14,3,13,39,2.62870264911643,4.51014222620317,8.13415878935017,101,"ENSG00000079974.19"
"32889","ENSG00000228221.6_69949",69941,69949,9,"ENSG00000228221.6",1,7,"VVVVVVMVV",0,8,0.885300207039338,29,35,47,50,92,98,133,136,"ATGATGC","CTAA","ATGGTCA","CTGA",2.59703185801355,12,42,35,98,1.0581789349144,4.59293116375118,8.13413199190853,101,"ENSG00000079974.19"
"28024","ENSG00000188000.6_1741",1733,1741,9,"ENSG00000188000.6",1,6,"VVVVVMVVV",0,8,0.902691511387163,116,122,133,136,145,151,170,173,"ATGATGA","TTGG","TGGATAA","GTGA",2.33863709191267,11,9,19,48,2.50250234349654,4.52335407239525,8.1341201179439,101,"ENSG00000079974.19"
"31266","ENSG00000221866.10_207022",207014,207022,9,"ENSG00000221866.10",1,1,"MVVVVVVVV",0,8,0.90600414078675,111,117,133,136,174,180,194,197,"ATAATGT","ATGA","TTCATTA","CTGA",2.44793144107744,16,38,14,77,1.72030161468306,4.50996113879983,8.13397770194683,101,"ENSG00000079974.19"
"32977","ENSG00000228412.9_239577",239569,239577,9,"ENSG00000228412.9",0,NA,"VVUVVVVVV",1,8,0.883643892339545,114,120,133,136,145,151,191,194,"AGGATGG","CTGC","CTGATTT","CTGA",2.46459297010194,13,9,40,71,1.9666629105373,4.59932067780422,8.1338962471624,101,"ENSG00000079974.19"
"36794","ENSG00000243024.7_43061",43053,43061,9,"ENSG00000243024.7",1,1,"MVVVVVVVV",0,8,0.90600414078675,88,94,133,136,144,150,168,171,"GTGATGG","AGGA","TTGAAGT","CTGA",2.4621860418999,39,8,18,74,1.62477666582073,4.50983756962168,8.13385413276868,101,"ENSG00000079974.19"
"14383","ENSG00000144821.11_13611",13603,13611,9,"ENSG00000144821.11",1,1,"MVVVVVVVV",0,8,0.90600414078675,113,119,133,136,142,148,176,179,"TTGTTGA","CAGT","GTGATTG","CTGA",2.38756331466184,14,6,28,57,2.1222129275597,4.50982542299299,8.13384198613999,101,"ENSG00000079974.19"
"20593","ENSG00000165124.19_197162",197154,197162,9,"ENSG00000165124.19",1,1,"MVVVVVVVV",0,8,0.90600414078675,110,116,133,136,140,146,157,160,"ACTATGA","CGAA","ATGATTG","CTGA",2.31542682008646,17,4,11,41,2.60270341598938,4.50972055414144,8.13373711728844,101,"ENSG00000079974.19"
"28630","ENSG00000196277.16_352607",352599,352607,9,"ENSG00000196277.16",1,3,"VVMVVVVVV",0,8,0.882815734989648,40,46,61,64,114,120,133,136,"ATGATTA","ATGA","AAAATGG","CTGA",2.48704892615249,15,50,13,87,1.82946588527267,4.60244801490566,8.13371095486425,101,"ENSG00000079974.19"
"38422","ENSG00000250149.2_203590",203582,203590,9,"ENSG00000250149.2",0,NA,"VVVVVVUVV",1,8,0.886128364389234,48,54,69,72,87,93,133,136,"GTCATGA","CTAA","GTAAAGA","CTGA",2.53092698284904,15,15,40,79,1.48380134060225,4.58916197323229,8.13367543078923,101,"ENSG00000079974.19"
"18478","ENSG00000157445.15_851654",851646,851654,9,"ENSG00000157445.15",1,2,"VMVVVVVVV",0,8,0.884057971014493,111,117,133,136,143,149,161,164,"ATTAGGA","CACA","GTGACCA","CTGA",2.33776022900724,16,7,12,44,2.80464300286273,4.59742779906109,8.13365968311906,101,"ENSG00000079974.19"
"17261","ENSG00000153707.19_989165",989157,989165,9,"ENSG00000153707.19",0,NA,"VVVVUVVVV",1,8,0.889855072463768,110,116,133,136,146,152,164,167,"TTGTAGA","CTGT","GTGATAT","CTGA",2.3524170302183,17,10,12,48,2.6131047904488,4.57397124797604,8.13339153783111,101,"ENSG00000079974.19"
"9854","ENSG00000127922.10_211291",211283,211291,9,"ENSG00000127922.10",1,8,"VVVVVVVMV",0,8,0.884057971014493,73,79,89,92,101,107,133,136,"ATTATTA","TTGA","TTGCAGA","CTGA",2.44233962990619,10,9,26,54,2.10631495414694,4.59714478838039,8.13337667243836,101,"ENSG00000079974.19"
"35532","ENSG00000236256.9_149501",149493,149501,9,"ENSG00000236256.9",1,8,"VVVVVVVMV",0,8,0.884057971014493,106,112,133,136,147,153,170,173,"ATTATGT","AAGA","ATGAAGA","CTGA",2.46690049059374,21,11,17,58,1.94249317316176,4.59712411094667,8.13335599500464,101,"ENSG00000079974.19"
"31181","ENSG00000218336.9_250487",250479,250487,9,"ENSG00000218336.9",1,5,"VVVVMVVVV",0,8,0.886542443064182,115,121,133,136,149,155,173,176,"GTGATGT","ATTA","GGGTGGA","CTGA",2.40263884884095,12,13,18,52,2.33065410466633,4.58706160756817,8.1332313798249,101,"ENSG00000079974.19"
"46261","ENSG00000286385.1_271655",271647,271655,9,"ENSG00000286385.1",1,1,"MVVVVVUVV",1,7,0.792132505175983,115,121,133,136,147,153,165,168,"AAAATGA","CTGA","TTGAGGC","CTGA",2.55819000457762,12,11,12,44,2.80200557223349,4.96415140068774,8.13268142139167,101,"ENSG00000079974.19"
"41755","ENSG00000259673.6_57166",57158,57166,9,"ENSG00000259673.6",1,8,"VVVVVVVMV",0,8,0.884057971014493,86,92,106,109,115,121,133,136,"GTGATGA","CAGT","CTGATTT","GTGA",2.31836814204063,14,6,12,41,2.92993519723474,4.59643070270974,8.13266258676771,101,"ENSG00000079974.19"
"39516","ENSG00000253699.1_20249",20241,20249,9,"ENSG00000253699.1",1,8,"VVVVVVVMV",0,8,0.884057971014493,115,121,133,136,151,157,174,177,"ATAATTT","CTGA","ATTATCA","CTGA",2.42008209912453,12,15,17,53,2.25175894151834,4.59640990058714,8.13264178464511,101,"ENSG00000079974.19"
"9169","ENSG00000123066.9_151841",151833,151841,9,"ENSG00000123066.9",1,3,"UVMVVVVVV",1,7,0.785507246376811,114,120,133,136,142,148,157,160,"TTTATGA","CTGA","AAGAATA","CTGA",2.53578828034103,13,6,9,37,3.05690452077254,4.99053993076152,8.13256891626877,101,"ENSG00000079974.19"
"32341","ENSG00000226797.2_922",914,922,9,"ENSG00000226797.2",1,2,"VMVVVVVVV",0,8,0.884057971014493,116,122,133,136,162,168,191,194,"ATGATGG","CATA","GTGAAAA","CTGA",2.54210620274511,11,26,23,69,1.43783026748199,4.59630123811235,8.13253312217032,101,"ENSG00000079974.19"
"42481","ENSG00000263644.1_17581",17573,17581,9,"ENSG00000263644.1",1,2,"VMVVVVVVV",0,8,0.884057971014493,116,122,133,136,162,168,191,194,"ATGATGG","CATA","GTGAAAA","CTGA",2.54210620274511,11,26,23,69,1.43783026748199,4.59630123811235,8.13253312217032,101,"ENSG00000079974.19"
"37917","ENSG00000249203.2_153729",153721,153729,9,"ENSG00000249203.2",1,5,"VVVVMVVVV",0,8,0.886542443064182,71,77,87,90,96,102,133,136,"CTGAGGA","CAGA","GGGAATA","CTGA",2.45018912809876,10,6,31,56,2.01028170493244,4.58621897306438,8.13238874532111,101,"ENSG00000079974.19"
"20028","ENSG00000164171.11_66300",66292,66300,9,"ENSG00000164171.11",1,7,"VVVVVUMVV",1,7,0.807453416149068,110,116,133,136,149,155,163,166,"ATGATGG","GTGA","ACCATGA","CTGA",2.57671819662259,17,13,8,47,2.43207233849617,4.90254841232836,8.13236207692464,101,"ENSG00000079974.19"
"46057","ENSG00000286147.1_390654",390646,390654,9,"ENSG00000286147.1",0,NA,"UVVVVVVVV",1,8,0.902691511387163,83,89,102,105,110,116,133,136,"ATAAAGT","TTGA","ATTCTGA","CTGA",2.31777355006488,13,5,17,44,2.6333919465228,4.5213039034055,8.13206994895416,101,"ENSG00000079974.19"
"127","ENSG00000005189.20_20704",20696,20704,9,"ENSG00000005189.20",1,7,"VVVVVVMVV",0,8,0.885300207039338,107,113,133,136,143,149,190,193,"AAGATGT","CTGC","CTGATGC","CTGA",2.52837684925279,20,7,41,77,1.50714201393918,4.59074691890611,8.13194774706346,101,"ENSG00000079974.19"
"35659","ENSG00000236635.3_71026",71018,71026,9,"ENSG00000236635.3",1,2,"VMVVVUVVV",1,7,0.806211180124223,94,100,133,136,139,145,156,159,"ATAATGA","CTGA","GTGAAAG","CTGA",2.68851506322837,33,3,11,56,1.7035632212913,4.90674924403677,8.13159396453366,101,"ENSG00000079974.19"
"16117","ENSG00000150760.13_147347",147339,147347,9,"ENSG00000150760.13",1,6,"VVVVVMVVV",0,8,0.902691511387163,73,79,95,98,113,119,133,136,"TTGAAGA","CTGA","ATGAGCA","ATGA",2.37299895198404,16,15,14,54,2.26316121926427,4.52078855812281,8.13155460367146,101,"ENSG00000079974.19"
"46140","ENSG00000286215.1_790964",790956,790964,9,"ENSG00000286215.1",1,2,"VMVVVVVVV",0,8,0.884057971014493,97,103,133,136,159,165,180,183,"GGGATGA","ATGA","GTAATGA","CTGA",2.60206697437008,30,23,15,77,1.03379004703045,4.59522580237442,8.13145768643239,101,"ENSG00000079974.19"
"33643","ENSG00000230561.6_233237",233229,233237,9,"ENSG00000230561.6",1,2,"VMVVVVVVV",0,8,0.884057971014493,100,106,133,136,150,156,166,169,"ATGATGA","CTTC","GTGATGA","CTCA",2.49830005140354,27,14,10,60,1.72540371737473,4.59518434834958,8.13141623240755,101,"ENSG00000079974.19"
"20717","ENSG00000165409.18_85039",85031,85039,9,"ENSG00000165409.18",1,1,"MVVVVVVVV",0,8,0.90600414078675,116,122,133,136,138,144,156,159,"ATTTTGA","CAAA","CTGACGG","CTGA",2.31062095321067,11,2,12,34,2.6248058813537,4.50723639235621,8.13125295550321,101,"ENSG00000079974.19"
"33447","ENSG00000229855.9_122942",122934,122942,9,"ENSG00000229855.9",0,NA,"UVVVVVVVV",1,8,0.902691511387163,49,55,65,68,111,117,133,136,"ATGATCA","CTGT","ATGATGA","ATGA",2.46001628690013,10,43,16,78,1.6818203023021,4.52048222040907,8.13124826595773,101,"ENSG00000079974.19"
"45645","ENSG00000285774.5_16737",16729,16737,9,"ENSG00000285774.5",1,2,"VMVVVVVVV",0,8,0.884057971014493,100,106,133,136,165,171,183,186,"ATGATGA","TGGA","GTGGCAA","CTGA",2.58867344738355,27,29,12,77,1.12202357456602,4.59496163928076,8.13119352333873,101,"ENSG00000079974.19"
"22319","ENSG00000170310.15_212285",212277,212285,9,"ENSG00000170310.15",1,6,"VVVVVMVVV",0,8,0.902691511387163,84,90,103,106,115,121,133,136,"ATCATGA","CTAA","ATGGTAT","CTTA",2.27472718679833,13,9,12,43,2.91664667958975,4.52037364789464,8.1311396934433,101,"ENSG00000079974.19"
"2462","ENSG00000075035.10_87197",87189,87197,9,"ENSG00000075035.10",0,NA,"VVVVVVUVV",1,8,0.886128364389234,113,119,133,136,148,154,168,171,"ACTATGA","GTGG","GTGAAGG","CTGA",2.36155341836809,14,12,14,49,2.60230465969489,4.58649852887054,8.13101198642748,101,"ENSG00000079974.19"
"36054","ENSG00000237813.4_20084",20076,20084,9,"ENSG00000237813.4",1,3,"VVMVVVVVV",0,8,0.882815734989648,110,116,133,136,142,148,162,165,"ATAATTA","CAGA","AGGATAG","CTGA",2.36769393221481,17,6,14,46,2.61427567441327,4.59972547229466,8.13098841225325,101,"ENSG00000079974.19"
"7853","ENSG00000115896.16_72951",72943,72951,9,"ENSG00000115896.16",1,8,"VVVVVVVMV",0,8,0.884057971014493,113,119,133,136,178,184,226,229,"ATGATGG","CTTA","ATGGTAA","CTGA",2.60941901775035,14,42,42,107,0.982606736581243,4.5946833803959,8.13091526445387,101,"ENSG00000079974.19"
"6273","ENSG00000109163.7_7545",7537,7545,9,"ENSG00000109163.7",1,8,"VVVVVVVMV",0,8,0.884057971014493,87,93,101,104,115,121,133,136,"TGGATGA","ATCA","TTGAAAA","CTGA",2.37311233332277,8,11,12,40,2.5573981424906,4.59453675782727,8.13076864188524,101,"ENSG00000079974.19"
"30365","ENSG00000204740.11_662168",662160,662168,9,"ENSG00000204740.11",1,1,"MVVVVVVVV",0,8,0.90600414078675,78,84,97,100,110,116,133,136,"AAGATGG","GTGA","ATGAAGA","GTGA",2.31514917079038,13,10,17,49,2.59264543972174,4.50674331124773,8.13075987439473,101,"ENSG00000079974.19"
"29297","ENSG00000197603.16_46062",46054,46062,9,"ENSG00000197603.16",0,NA,"UVVVUVVVV",2,7,0.792546583850932,62,68,80,83,90,96,133,136,"GTGAAGA","CTGA","GTGACAA","CTGA",2.67075324486448,12,7,37,65,2.03669471285481,4.96042908632118,8.1306154217249,101,"ENSG00000079974.19"
"18145","ENSG00000156265.16_92910",92902,92910,9,"ENSG00000156265.16",1,2,"VMVVVVVVV",0,8,0.884057971014493,85,91,133,136,141,147,155,158,"AAGATCA","ATGA","GTGATTT","CTGA",2.46975500246522,42,5,8,64,1.91225792184086,4.59432281790225,8.13055470196022,101,"ENSG00000079974.19"
"20027","ENSG00000164171.11_54391",54383,54391,9,"ENSG00000164171.11",1,1,"MVVVVVVVV",0,8,0.90600414078675,87,93,133,136,157,163,183,186,"GAGATGA","ATGA","CTGATTA","CTGA",2.590370203499,40,21,20,90,0.756288153499589,4.50635571087323,8.13037227402023,101,"ENSG00000079974.19"
"47764","ENSG00000289228.2_227515",227507,227515,9,"ENSG00000289228.2",1,1,"MVVVVVVVV",0,8,0.90600414078675,111,117,133,136,149,155,172,175,"TTTATGA","GTGT","TTGAAAA","CTGA",2.36934394958976,16,13,17,55,2.22969745339171,4.50633094599752,8.13034750914452,101,"ENSG00000079974.19"
"34562","ENSG00000233420.2_260353",260345,260353,9,"ENSG00000233420.2",0,NA,"VVVVVUVVV",1,8,0.922153209109731,111,117,133,136,153,159,170,173,"GTGAGGC","CTAC","GGGATGA","CTGA",2.32711363202172,16,17,11,53,2.25195535187037,4.44151155800379,8.13012439444271,101,"ENSG00000079974.19"
"31615","ENSG00000224186.8_225048",225040,225048,9,"ENSG00000224186.8",0,NA,"VVVVVUVVV",1,8,0.922153209109731,114,120,133,136,152,158,172,175,"ATAATCA","ATAA","ATCAAGA","CTGA",2.3114922000809,13,16,14,52,2.3559012426619,4.4414623108003,8.13007514723923,101,"ENSG00000079974.19"
"32196","ENSG00000226320.6_199711",199703,199711,9,"ENSG00000226320.6",1,6,"VVVVVMVVV",0,8,0.902691511387163,99,105,133,136,147,153,169,172,"TTGTTGA","CTAA","CTGATTG","CTGA",2.46083427413821,28,11,16,64,1.67158319195121,4.51928625488482,8.13005230043347,101,"ENSG00000079974.19"
"47313","ENSG00000287981.1_3704",3696,3704,9,"ENSG00000287981.1",1,6,"VVVVVMVVV",0,8,0.902691511387163,99,105,133,136,147,153,169,172,"TTGTTGA","CTAA","CTGATTG","CTGA",2.46083427413821,28,11,16,64,1.67158319195121,4.51928625488482,8.13005230043347,101,"ENSG00000079974.19"
"37272","ENSG00000246528.4_10649",10641,10649,9,"ENSG00000246528.4",1,1,"MVVVVVVVV",0,8,0.90600414078675,24,30,49,52,101,107,133,136,"ATGATGA","CTGA","GAAATGA","ATGA",2.58144305019305,19,49,26,103,0.814339083108998,4.50598985443233,8.13000641757933,101,"ENSG00000079974.19"
"15212","ENSG00000147324.11_107595",107587,107595,9,"ENSG00000147324.11",0,NA,"VVVVVVUVV",1,8,0.886128364389234,110,116,133,136,142,148,186,189,"AGGAAGA","CAGA","GTGACGT","CTGA",2.48567074371226,17,6,38,70,1.76902256446294,4.5850402139695,8.12955367152644,101,"ENSG00000079974.19"
"8114","ENSG00000116871.16_10615",10607,10615,9,"ENSG00000116871.16",1,6,"VVVVVMVVV",0,8,0.902691511387163,84,90,101,104,109,115,133,136,"AGGCAGA","CTGA","ATATTGT","CTGA",2.32804125579355,11,5,18,43,2.55470979196342,4.51874620764677,8.12951225319542,101,"ENSG00000079974.19"
"8404","ENSG00000118600.13_20536",20528,20536,9,"ENSG00000118600.13",0,NA,"VVVVUVVVV",1,8,0.889855072463768,51,57,71,74,78,84,133,136,"ATGATGA","CTTA","ATCATGT","ATGA",2.47130114984464,14,4,49,76,1.80471030244508,4.57001282535234,8.12943311520741,101,"ENSG00000079974.19"
"16970","ENSG00000152894.15_513084",513076,513084,9,"ENSG00000152894.15",1,3,"VVMVVVVVV",0,8,0.882815734989648,51,57,79,82,86,92,133,136,"ATAATGA","CTAA","ATGCTAA","CTGA",2.58007767950547,22,4,41,76,1.19157122708779,4.5980222726144,8.12928521257299,101,"ENSG00000079974.19"
"9299","ENSG00000123892.12_5619",5611,5619,9,"ENSG00000123892.12",0,NA,"VVVUVVVVV",1,8,0.880745341614907,89,95,133,136,139,145,201,204,"ATGATGA","TTGA","GACATAA","CTGA",2.65795980194838,38,3,56,106,0.704463347246304,4.60604884005888,8.12903020651851,101,"ENSG00000079974.19"
"14668","ENSG00000145687.17_7385",7377,7385,9,"ENSG00000145687.17",1,8,"VVUVVVVMV",1,7,0.767701863354037,114,120,133,136,149,155,167,170,"TTGATGA","CTTA","ATGATTT","CTGA",2.6373359387292,13,13,12,47,2.65060692815329,5.05821162992033,8.12901908333647,101,"ENSG00000079974.19"
"6338","ENSG00000109452.13_436417",436409,436417,9,"ENSG00000109452.13",0,NA,"VVVUVVVVV",1,8,0.880745341614907,115,121,133,136,140,146,156,159,"ATGATCT","TTTA","ATGTATA","CTGA",2.31809174813529,12,4,10,35,2.9695409736259,4.60587149029862,8.12885285675825,101,"ENSG00000079974.19"
"15655","ENSG00000149084.13_144689",144681,144689,9,"ENSG00000149084.13",0,NA,"VVVVVVUVV",1,8,0.886128364389234,92,98,107,110,116,122,133,136,"ATGATAA","ATGA","CAGATGG","CGGA",2.3099737600435,9,6,11,35,2.93749081376803,4.58432897018117,8.1288424277381,101,"ENSG00000079974.19"
"44670","ENSG00000283341.4_246480",246472,246480,9,"ENSG00000283341.4",0,NA,"VVVVVVUVV",1,8,0.886128364389234,92,98,107,110,116,122,133,136,"ATGATAA","ATGA","CAGATGG","CGGA",2.3099737600435,9,6,11,35,2.93749081376803,4.58432897018117,8.1288424277381,101,"ENSG00000079974.19"
"5085","ENSG00000103018.18_46615",46607,46615,9,"ENSG00000103018.18",1,1,"MVVVVUVVV",1,7,0.82815734989648,102,108,133,136,144,150,164,167,"CTGATGA","CTGT","GTCAAAA","CTGA",2.58523516283575,25,8,14,56,2.02975484402913,4.8161639824002,8.12879338198612,101,"ENSG00000079974.19"
"20401","ENSG00000164796.18_435972",435964,435972,9,"ENSG00000164796.18",1,2,"VMVVVVVVV",0,8,0.884057971014493,83,89,96,99,105,111,133,136,"ATTATGA","CTGA","CTGATTT","CTAA",2.45370016134064,7,6,22,44,2.01184621953668,4.59246182378524,8.12869370784321,101,"ENSG00000079974.19"
"21783","ENSG00000168952.16_23297",23289,23297,9,"ENSG00000168952.16",0,NA,"VVUVVVVVV",1,8,0.883643892339545,115,121,133,136,146,152,172,175,"TTAATGG","GTAA","GTGATGA","CTGA",2.39413858007054,12,10,20,51,2.41524647620089,4.59404258583445,8.12861815519263,101,"ENSG00000079974.19"
"32962","ENSG00000228340.8_91473",91465,91473,9,"ENSG00000228340.8",1,8,"VVVVVVVMV",0,8,0.884057971014493,91,97,107,110,112,118,133,136,"TTGATGC","TTTA","CTGAGTA","CTGA",2.40068052295457,10,2,15,36,2.36420157562167,4.5921845988297,8.12841648288767,101,"ENSG00000079974.19"
"16166","ENSG00000151025.11_230796",230788,230796,9,"ENSG00000151025.11",1,7,"VVVVVVMVV",0,8,0.885300207039338,92,98,133,136,146,152,161,164,"GTGATGA","CTGC","TTGATTA","CTTA",2.46638523235865,35,10,9,63,1.90543385298321,4.58700051717688,8.12820134533423,101,"ENSG00000079974.19"
"1411","ENSG00000055147.19_31492",31484,31492,9,"ENSG00000055147.19",1,8,"VVVUVVVMV",1,7,0.764803312629399,113,119,133,136,154,160,168,171,"GTGATGT","CTGA","ATGATTC","CTGA",2.69367620973126,14,18,8,49,2.31801325202092,5.06896366255732,8.12817691307492,101,"ENSG00000079974.19"
"31758","ENSG00000224699.11_3856",3848,3856,9,"ENSG00000224699.11",1,8,"VVVVVVVMV",0,8,0.884057971014493,114,120,133,136,153,159,168,171,"ATGGTGC","TAGA","GTGTTGT","CTGA",2.39141415539953,13,17,9,48,2.4242089841333,4.59174250503254,8.12797438909051,101,"ENSG00000079974.19"
"3105","ENSG00000081087.16_5113",5105,5113,9,"ENSG00000081087.16",1,8,"VVUVVVVMV",1,7,0.767701863354037,116,122,133,136,142,148,157,160,"ATGCTGA","ATGA","TTGACCA","CTGA",2.5709358851828,11,6,9,35,3.08888184458108,5.0571136031166,8.12792105653275,101,"ENSG00000079974.19"
"24680","ENSG00000177463.16_60113",60105,60113,9,"ENSG00000177463.16",0,NA,"UVVVVVVVV",1,8,0.902691511387163,109,115,133,136,161,167,184,187,"ATGAGTA","TTGA","AAGATGA","CTGA",2.4871031434197,18,25,17,69,1.48787347050424,4.51714027332557,8.12790631887422,101,"ENSG00000079974.19"
"25800","ENSG00000182771.19_513433",513425,513433,9,"ENSG00000182771.19",1,5,"VVVVMVVVV",0,8,0.886542443064182,86,92,133,136,145,151,176,179,"ATGATGG","CTCA","TGGATAA","CTGA",2.56532726877359,41,9,25,84,1.22466788923359,4.58171242026438,8.12788219252111,101,"ENSG00000079974.19"
"26005","ENSG00000183117.20_844529",844521,844529,9,"ENSG00000183117.20",0,NA,"VVUVVVVVV",1,8,0.883643892339545,88,94,105,108,110,116,133,136,"GTGAAAA","CTGA","GTTCTAA","CTGA",2.4194952936352,11,2,17,39,2.24245415111399,4.59310569383717,8.12768126319535,101,"ENSG00000079974.19"
"9559","ENSG00000125414.19_3757",3749,3757,9,"ENSG00000125414.19",0,NA,"VVVVVVUVV",1,8,0.886128364389234,114,120,133,136,138,144,154,157,"AAAATCA","CTGA","GAGAGCA","CTGA",2.34676687758683,13,2,10,34,2.68753926072926,4.5831629444937,8.12767640205064,101,"ENSG00000079974.19"
"30648","ENSG00000206129.4_174510",174502,174510,9,"ENSG00000206129.4",1,2,"VMVVVUVVV",1,7,0.806211180124223,112,118,133,136,139,145,154,157,"AAGATGT","GTGA","CTGGTGA","CTGA",2.53496500421,15,3,9,36,2.71154812569429,4.9028287051069,8.12767342560379,101,"ENSG00000079974.19"
"23383","ENSG00000172890.13_66923",66915,66923,9,"ENSG00000172890.13",1,7,"VVVVVVMVV",0,8,0.885300207039338,68,74,87,90,115,121,133,136,"GCGATGA","CTGA","GTGAATA","TTGA",2.44013619694526,13,25,12,59,2.07755590240761,4.58628263717733,8.12748346533468,101,"ENSG00000079974.19"
"16451","ENSG00000151553.15_45587",45579,45587,9,"ENSG00000151553.15",1,6,"VVVVVMVVV",0,8,0.902691511387163,114,120,133,136,148,154,173,176,"CTGATGT","CTAG","GTGCTTT","CTGA",2.3594737001409,13,12,19,53,2.33691292363537,4.51668439781034,8.12745044335899,101,"ENSG00000079974.19"
"34887","ENSG00000234352.9_154351",154343,154351,9,"ENSG00000234352.9",1,6,"VVVVVMVVV",0,8,0.902691511387163,115,121,133,136,142,148,165,168,"GTGATCA","CTGT","GTGAACA","TTGA",2.30643688410914,12,6,17,44,2.69027341612019,4.51662982754529,8.12739587309394,101,"ENSG00000079974.19"
"39510","ENSG00000253693.1_252012",252004,252012,9,"ENSG00000253693.1",0,NA,"VVUVVVVVV",1,8,0.883643892339545,97,103,133,136,143,149,162,165,"TTGATCA","CTCA","TTGAGCA","CTGA",2.46121295465354,30,7,13,59,1.96265332716144,4.5926849228796,8.12726049223778,101,"ENSG00000079974.19"
"24501","ENSG00000176635.18_39257",39249,39257,9,"ENSG00000176635.18",0,NA,"VVVVVVUVV",1,8,0.886128364389234,114,120,133,136,141,147,186,189,"CAGATGA","CTGG","TAGAGGA","CTGA",2.456818105741,13,5,39,66,1.9519657726671,4.58268828606844,8.12720174362538,101,"ENSG00000079974.19"
"21303","ENSG00000167074.15_13373",13365,13373,9,"ENSG00000167074.15",1,6,"UVVVVMVVV",1,7,0.805383022774327,78,84,103,106,115,121,133,136,"ATGTTGC","CTGA","ATAAAGA","CTGA",2.57033738484427,19,9,12,49,2.48667521545519,4.90556444527091,8.12709653636822,101,"ENSG00000079974.19"
"14410","ENSG00000144868.14_103190",103182,103190,9,"ENSG00000144868.14",0,NA,"VVUVVVVVV",1,8,0.883643892339545,108,114,133,136,151,157,170,173,"GGGATGA","TTCA","ATGAAGT","CTGA",2.44800615510275,19,15,13,56,2.04979303709686,4.59245851777881,8.12703408713699,101,"ENSG00000079974.19"
"21702","ENSG00000168702.18_794601",794593,794601,9,"ENSG00000168702.18",1,8,"UVVVVVVMV",1,7,0.786749482401656,88,94,106,109,115,121,133,136,"ATGAAGA","CTGA","GTGATTA","GTGA",2.5399455820184,12,6,12,39,2.98682487368228,4.97994885511791,8.12694678472453,101,"ENSG00000079974.19"
"25873","ENSG00000183023.19_476495",476487,476495,9,"ENSG00000183023.19",1,7,"VVVVVVMVV",0,8,0.885300207039338,49,55,68,71,75,81,133,136,"TAGATGA","CTTA","TTGAATA","CTGA",2.47618317737575,13,4,52,78,1.83488768285022,4.58569388300547,8.12689471116282,101,"ENSG00000079974.19"
"7055","ENSG00000112584.14_59004",58996,59004,9,"ENSG00000112584.14",1,1,"MVVVVVVVV",0,8,0.90600414078675,115,121,133,136,138,144,152,155,"ATGTAGA","AGGA","ATGAATC","CTGA",2.27911912044421,12,2,8,31,2.81723734531405,4.50284120373554,8.12685776688253,101,"ENSG00000079974.19"
"28881","ENSG00000196628.20_40497",40489,40497,9,"ENSG00000196628.20",1,2,"UMVVVVVVV",1,7,0.786749482401656,79,85,95,98,108,114,133,136,"ATAATGA","CTGA","ATAATCT","CTGA",2.62854884701215,10,10,19,48,2.39463678824865,4.97957394208241,8.12657187168904,101,"ENSG00000079974.19"
"40239","ENSG00000255311.5_57600",57592,57600,9,"ENSG00000255311.5",1,1,"MVVVVUVVV",1,7,0.82815734989648,53,59,78,81,92,98,133,136,"GTGATGA","CTGC","GTTATGG","CTGA",2.6685449813934,19,11,35,74,1.46498675831531,4.81382165856782,8.12645105815374,101,"ENSG00000079974.19"
"4076","ENSG00000093000.19_20677",20669,20677,9,"ENSG00000093000.19",1,2,"VMVVVVVVV",0,8,0.884057971014493,111,117,133,136,165,171,182,185,"ATGTTGA","GCGA","CTGGAGA","CTGA",2.47135471415947,16,29,11,65,1.88492967788587,4.59015694307059,8.12638882712856,101,"ENSG00000079974.19"
"31238","ENSG00000219682.4_1347",1339,1347,9,"ENSG00000219682.4",1,2,"VMVVVVVVV",0,8,0.884057971014493,111,117,133,136,165,171,182,185,"ATGTTGA","GCGA","CTGGAGA","CTGA",2.47135471415947,16,29,11,65,1.88492967788587,4.59015694307059,8.12638882712856,101,"ENSG00000079974.19"
"45182","ENSG00000285216.1_371178",371170,371178,9,"ENSG00000285216.1",0,NA,"VVVUVVVVV",1,8,0.880745341614907,59,65,76,79,91,97,133,136,"ATGATGA","CTGG","ATGTTGG","ATGA",2.49429336139286,11,12,36,68,1.78475491003589,4.60334432983041,8.12632569629003,101,"ENSG00000079974.19"
"45230","ENSG00000285219.4_93772",93764,93772,9,"ENSG00000285219.4",0,NA,"VVVUVVVVV",1,8,0.880745341614907,59,65,76,79,91,97,133,136,"ATGATGA","CTGG","ATGTTGG","ATGA",2.49429336139286,11,12,36,68,1.78475491003589,4.60334432983041,8.12632569629003,101,"ENSG00000079974.19"
"26315","ENSG00000183831.7_4218",4210,4218,9,"ENSG00000183831.7",0,NA,"VVVUVVVVV",1,8,0.880745341614907,114,120,133,136,169,175,183,186,"TTTAAGA","CTGA","ATGTTGG","CTGA",2.46120080251388,13,33,8,63,2.00490884492039,4.60322854875322,8.12620991521285,101,"ENSG00000079974.19"
"45647","ENSG00000285777.1_4204",4196,4204,9,"ENSG00000285777.1",0,NA,"VVVUVVVVV",1,8,0.880745341614907,114,120,133,136,169,175,183,186,"TTTAAGA","CTGA","ATGTTGG","CTGA",2.46120080251388,13,33,8,63,2.00490884492039,4.60322854875322,8.12620991521285,101,"ENSG00000079974.19"
"37469","ENSG00000248245.1_17565",17557,17565,9,"ENSG00000248245.1",1,6,"VVVVVMVVV",0,8,0.902691511387163,91,97,108,111,116,122,133,136,"GTAATGT","ATTA","ATGTGCA","CTGA",2.26007283098824,11,5,11,36,2.9946049370839,4.51543928591804,8.12620533146669,101,"ENSG00000079974.19"
"41799","ENSG00000259754.2_215408",215400,215408,9,"ENSG00000259754.2",1,3,"VVMVVVVVV",0,8,0.882815734989648,85,91,133,136,140,146,159,162,"AAGATAA","GTGA","CTGATAA","CTGA",2.49331075513029,42,4,13,68,1.75755022645426,4.59490548183071,8.12616842178931,101,"ENSG00000079974.19"
"6314","ENSG00000109339.24_317942",317934,317942,9,"ENSG00000109339.24",1,2,"VMVVVVVVV",0,8,0.884057971014493,106,112,133,136,154,160,168,171,"ATGAAGT","CTGT","ATGCAGA","CTGA",2.48950450804546,21,18,8,56,1.76272519837163,4.58985547966867,8.12608736372664,101,"ENSG00000079974.19"
"48157","ENSG00000290551.1_102546",102538,102546,9,"ENSG00000290551.1",1,2,"VMVVVVVVV",0,8,0.884057971014493,112,118,133,136,173,179,191,194,"ATGATTA","CTTT","GTGTTAA","CTGA",2.47170087707087,15,37,12,73,1.88099215105781,4.58974949954924,8.12598138360721,101,"ENSG00000079974.19"
"44051","ENSG00000277211.1_2188",2180,2188,9,"ENSG00000277211.1",1,8,"VVVVVUVMV",1,7,0.806211180124224,88,94,106,109,115,121,133,136,"AGGATCA","CTGA","GGGACAA","CTGA",2.49258372036468,12,6,12,39,2.98682487368228,4.90101241902837,8.12585713952527,101,"ENSG00000079974.19"
"41148","ENSG00000258583.7_313498",313490,313498,9,"ENSG00000258583.7",1,1,"MVVVVVVVV",0,8,0.90600414078675,79,85,94,97,107,113,133,136,"ATCATGT","CTGA","ATGATCT","ATGA",2.36299137030215,9,10,20,48,2.25271665762252,4.50149811490921,8.12551467805621,101,"ENSG00000079974.19"
"35741","ENSG00000236924.3_18385",18377,18385,9,"ENSG00000236924.3",1,3,"VVMVVVVVV",0,8,0.882815734989648,114,120,133,136,163,169,180,183,"TTGATAT","ATGA","ATGATCA","CTGA",2.44609234677848,13,27,11,60,2.06896943300712,4.59406293621592,8.12532587617451,101,"ENSG00000079974.19"
"34377","ENSG00000232878.3_32707",32699,32707,9,"ENSG00000232878.3",1,3,"VVMVVVVVV",0,8,0.882815734989648,80,86,103,106,112,118,133,136,"CTGAAGA","CTGA","GGGAAGA","CTTA",2.37263008578949,17,6,15,47,2.55867008567054,4.59405099773345,8.12531393769204,101,"ENSG00000079974.19"
"36964","ENSG00000243944.5_4303",4295,4303,9,"ENSG00000243944.5",1,1,"MVVVVVVVV",0,8,0.90600414078675,82,88,105,108,115,121,133,136,"ACGATGA","ATGA","ATTAGGT","ATGA",2.29288770676192,17,7,12,45,2.71907195134568,4.50124749910628,8.12526406225328,101,"ENSG00000079974.19"
"21300","ENSG00000167037.19_17116",17108,17116,9,"ENSG00000167037.19",1,6,"VVVVVMVVV",0,8,0.902691511387163,84,90,104,107,111,117,133,136,"TTTATAA","ATGA","CTTAAGA","CTGA",2.32280716586715,14,4,16,43,2.57257334747953,4.51448861331514,8.12525465886379,101,"ENSG00000079974.19"
"39266","ENSG00000253394.7_124190",124182,124190,9,"ENSG00000253394.7",1,6,"VVVVVMVVV",0,8,0.902691511387163,89,95,133,136,143,149,178,181,"ATAATGA","CTTA","ATGGAAA","CTGA",2.53572113585293,38,7,29,83,1.151977209381,4.51419619543347,8.12496224098212,101,"ENSG00000079974.19"
"5741","ENSG00000106541.12_29120",29112,29120,9,"ENSG00000106541.12",0,NA,"UVVVVVVVV",1,8,0.902691511387163,116,122,133,136,143,149,186,189,"GTGATGA","CTGG","ATAATGT","CTGT",2.4068034856289,11,7,37,64,2.01133804707538,4.51417365448368,8.12493970003234,101,"ENSG00000079974.19"
"13290","ENSG00000140937.14_177068",177060,177068,9,"ENSG00000140937.14",1,8,"VVVVVVVMV",0,8,0.884057971014493,47,53,71,74,84,90,133,136,"ATGATGA","CTAA","GTGAAAA","CAGA",2.51683409311108,18,10,43,80,1.57575008707554,4.58866101028735,8.12489289434532,101,"ENSG00000079974.19"
"2213","ENSG00000071462.12_13002",12994,13002,9,"ENSG00000071462.12",0,NA,"UVVVVVVVV",1,8,0.902691511387163,76,82,97,100,114,120,133,136,"GTGAGGA","CTGA","GTCTTGT","CTCA",2.34051047862688,15,14,13,51,2.45187766402274,4.51382021371715,8.1245862592658,101,"ENSG00000079974.19"
"35542","ENSG00000236283.5_152916",152908,152916,9,"ENSG00000236283.5",0,NA,"UVVVVVVVV",1,8,0.902691511387163,112,118,133,136,138,144,153,156,"GTGCTGA","CGCA","TAAATGA","CTGA",2.32348314560742,15,2,9,35,2.56498500700451,4.51371816109682,8.12448420664548,101,"ENSG00000079974.19"
"41396","ENSG00000258969.2_355004",354996,355004,9,"ENSG00000258969.2",0,NA,"UVVVVUVVV",2,7,0.824844720496894,112,118,133,136,141,147,179,182,"CTGAGGA","CTGA","AAGAAGA","CTGA",2.60533978094185,15,5,32,61,1.9312806884789,4.82505314035613,8.12443202234371,101,"ENSG00000079974.19"
"16729","ENSG00000152208.13_146466",146458,146466,9,"ENSG00000152208.13",1,2,"VMVVVVVVV",0,8,0.884057971014493,79,85,99,102,116,122,133,136,"ATGATAA","CAGA","ATGAACA","ATGA",2.36675741909366,14,14,11,48,2.57431153672816,4.58817358267147,8.12440546672945,101,"ENSG00000079974.19"
"34877","ENSG00000234323.10_641508",641500,641508,9,"ENSG00000234323.10",1,7,"VVVVVVMVV",0,8,0.885300207039338,101,107,133,136,163,169,180,183,"ATGAGGA","ATGG","GTGAGGA","CTGA",2.56882948111053,26,27,11,73,1.2069897097893,4.58312989596487,8.12433072412222,101,"ENSG00000079974.19"
"38563","ENSG00000250433.1_1564",1556,1564,9,"ENSG00000250433.1",1,3,"VVMVVVVVV",0,8,0.882815734989648,102,108,133,136,156,162,181,184,"GTGATGA","TAGA","GTGCTAA","CTGA",2.60203500693208,25,20,19,73,1.02507401326941,4.59299351487081,8.12425645482941,101,"ENSG00000079974.19"
"15979","ENSG00000150477.15_258500",258492,258500,9,"ENSG00000150477.15",0,NA,"VVVVVVUVV",1,8,0.886128364389234,81,87,100,103,113,119,133,136,"CTGATGA","GTGA","ATAAAAA","CTCA",2.33239728422542,13,10,14,46,2.76930580185127,4.57965525750518,8.12416871506212,101,"ENSG00000079974.19"
"47986","ENSG00000289907.1_73034",73026,73034,9,"ENSG00000289907.1",0,NA,"VVUVVVUVV",2,7,0.769772256728778,80,86,100,103,110,116,133,136,"AAGATGA","CTGC","TTGATGC","CTGA",2.62733865951047,14,7,17,47,2.6642800549706,5.04496777959343,8.12405680650854,101,"ENSG00000079974.19"
"24620","ENSG00000177182.11_27570",27562,27570,9,"ENSG00000177182.11",1,2,"VMVVVVVVV",0,8,0.884057971014493,93,99,133,136,163,169,182,185,"ATAATGA","GTGA","CTGCAGA","CTGA",2.59972639580625,34,27,13,83,1.01890425402437,4.58760338984984,8.12383527390782,101,"ENSG00000079974.19"
"30369","ENSG00000204754.3_13929",13921,13929,9,"ENSG00000204754.3",1,7,"VVVVVVMVV",0,8,0.885300207039338,106,112,133,136,143,149,165,168,"TTGATGA","CAGT","GATCTGA","CTGA",2.42429990128375,21,7,16,53,2.16848389453235,4.582620809106,8.12382163726335,101,"ENSG00000079974.19"
"13006","ENSG00000139865.17_429048",429040,429048,9,"ENSG00000139865.17",1,1,"MVVVVVVVV",0,8,0.90600414078675,115,121,133,136,140,146,157,160,"AAGATTA","CAAA","ATGACTC","CTGA",2.26094007526145,12,4,11,36,2.92626049687161,4.49979858298698,8.12381514613398,101,"ENSG00000079974.19"
"16378","ENSG00000151422.14_272920",272912,272920,9,"ENSG00000151422.14",1,1,"MVVVVVVVV",0,8,0.90600414078675,111,117,133,136,143,149,178,181,"TTTATGA","CTCA","GTTTTCA","CTGA",2.40182490128613,16,7,29,61,1.98681763162619,4.4997459100501,8.1237624731971,101,"ENSG00000079974.19"
"3007","ENSG00000080224.18_847426",847418,847426,9,"ENSG00000080224.18",1,7,"VVVVVVMVV",0,8,0.885300207039338,113,119,133,136,143,149,164,167,"ATACTGA","TTGT","ATGATTT","CTGA",2.33146135838309,14,7,15,45,2.78701068822528,4.58252160269481,8.12372243085216,101,"ENSG00000079974.19"
"20239","ENSG00000164494.12_50720",50712,50720,9,"ENSG00000164494.12",1,8,"VVVVVVVMV",0,8,0.884057971014493,115,121,133,136,147,153,166,169,"TTCATGG","CAGA","GTAAAGT","CTGA",2.33809080226764,12,11,13,45,2.76039948308047,4.58691787454952,8.12314975860749,101,"ENSG00000079974.19"
"26105","ENSG00000183340.7_74914",74906,74914,9,"ENSG00000183340.7",1,7,"VVVVVVMVV",0,8,0.885300207039338,85,91,133,136,154,160,174,177,"ATGAGGA","TTGA","CTCATTA","CTGA",2.56240199996856,42,18,14,83,1.24484753963238,4.5818818848557,8.12308271301305,101,"ENSG00000079974.19"
"10474","ENSG00000131171.13_85363",85355,85363,9,"ENSG00000131171.13",1,1,"MVVVVVVVV",0,8,0.90600414078675,87,93,133,136,148,154,170,173,"ATGAAGA","CAAA","ATGTTTA","CTGA",2.47052380993119,40,12,16,77,1.52583066014728,4.49899734825547,8.12301391140247,101,"ENSG00000079974.19"
"31932","ENSG00000225321.2_13261",13253,13261,9,"ENSG00000225321.2",0,NA,"VVVVUVVVV",1,8,0.889855072463768,112,118,133,136,146,152,206,209,"ATGTTGA","GAGA","AAGATGT","CTGA",2.46679030932911,15,10,54,88,1.80863031784275,4.56347476167587,8.12289505153095,101,"ENSG00000079974.19"
"38427","ENSG00000250149.2_297572",297564,297572,9,"ENSG00000250149.2",1,1,"MVVVVVVVV",0,8,0.90600414078675,115,121,133,136,138,144,154,157,"ATAAGGA","ATGT","ATGAACT","CTGA",2.28922032656668,12,2,10,33,2.73361353275093,4.4987705941322,8.1227871572792,101,"ENSG00000079974.19"
"39930","ENSG00000254483.1_4890",4882,4890,9,"ENSG00000254483.1",1,3,"VVMVVVVVV",0,8,0.882815734989648,91,97,133,136,142,148,170,173,"GTGATTG","CTGG","GTGATGA","CTGA",2.5452740413873,36,6,22,73,1.39750558633485,4.59149979889588,8.12276273885447,101,"ENSG00000079974.19"
"40068","ENSG00000254876.5_5086",5078,5086,9,"ENSG00000254876.5",1,3,"VVMVVVVVV",0,8,0.882815734989648,91,97,133,136,142,148,170,173,"GTGATTG","CTGG","GTGATGA","CTGA",2.5452740413873,36,6,22,73,1.39750558633485,4.59149979889588,8.12276273885447,101,"ENSG00000079974.19"
"40119","ENSG00000255036.6_5038",5030,5038,9,"ENSG00000255036.6",1,3,"VVMVVVVVV",0,8,0.882815734989648,91,97,133,136,142,148,170,173,"GTGATTG","CTGG","GTGATGA","CTGA",2.5452740413873,36,6,22,73,1.39750558633485,4.59149979889588,8.12276273885447,101,"ENSG00000079974.19"
"20539","ENSG00000165061.15_323912",323904,323912,9,"ENSG00000165061.15",0,NA,"VVVUVVVVV",1,8,0.880745341614907,105,111,133,136,144,150,195,198,"ATTATTA","CTGA","GTCAGGA","CTGA",2.56013996309294,22,8,45,84,1.33104142432615,4.59966029456978,8.12264166102941,101,"ENSG00000079974.19"
"22597","ENSG00000170927.15_263525",263517,263525,9,"ENSG00000170927.15",1,3,"VVMVVVVVV",0,8,0.882815734989648,104,110,133,136,166,172,185,188,"ATAATGT","ATGA","ATGATGT","CTGA",2.56828617080717,23,30,13,75,1.243220257516,4.59128201572428,8.12254495568287,101,"ENSG00000079974.19"
"23309","ENSG00000172554.12_388788",388780,388788,9,"ENSG00000172554.12",1,1,"MVVVVVVVV",0,8,0.90600414078675,116,122,133,136,142,148,161,164,"CTCATCA","TTGC","GTGAGGG","CTGA",2.26069256586672,11,6,13,39,2.9225369314352,4.49845517596999,8.12247173911699,101,"ENSG00000079974.19"
"16101","ENSG00000150672.19_994981",994973,994981,9,"ENSG00000150672.19",1,8,"VVVVVVVMV",0,8,0.884057971014493,107,113,133,136,146,152,170,173,"AAGAGGA","CAGA","GTAATGG","CTGA",2.44793608112095,20,10,18,57,2.02462308565636,4.586049239949,8.12228112400697,101,"ENSG00000079974.19"
"28959","ENSG00000196826.7_45564",45556,45564,9,"ENSG00000196826.7",1,1,"MVVVVUVVV",1,7,0.82815734989648,90,96,103,106,114,120,133,136,"ATGATTA","CAGA","GCACTGA","CTGA",2.49632413925671,7,8,13,37,2.59635984266714,4.8096301927613,8.12225959234723,101,"ENSG00000079974.19"
"36757","ENSG00000242852.7_7944",7936,7944,9,"ENSG00000242852.7",1,1,"MVVVVUVVV",1,7,0.82815734989648,90,96,103,106,114,120,133,136,"ATGATTA","CAGA","GCACTGA","CTGA",2.49632413925671,7,8,13,37,2.59635984266714,4.8096301927613,8.12225959234723,101,"ENSG00000079974.19"
"3449","ENSG00000084112.15_39351",39343,39351,9,"ENSG00000084112.15",0,NA,"VVVVUVVVV",1,8,0.889855072463768,81,87,96,99,103,109,133,136,"GTGATGA","CTGC","GCGAAGA","GTGA",2.43890574394166,9,4,24,46,1.99196013199794,4.56283293956892,8.12225322942399,101,"ENSG00000079974.19"
"46789","ENSG00000287174.1_8518",8510,8518,9,"ENSG00000287174.1",1,8,"VVVVVVVMV",0,8,0.884057971014493,115,121,133,136,173,179,187,190,"TTGAGGA","ATTA","GTGTTGA","CTGA",2.452521189721,12,37,8,66,1.99373055695833,4.58596795544125,8.12219983949922,101,"ENSG00000079974.19"
"2391","ENSG00000074054.21_69226",69218,69226,9,"ENSG00000074054.21",0,NA,"UVVVVVVVV",1,8,0.902691511387163,101,107,133,136,141,147,162,165,"ATGAAGA","ATGC","GTTAGGT","CTGA",2.42447807708946,26,5,15,55,1.88218296836834,4.51134253724119,8.12210858278984,101,"ENSG00000079974.19"
"30575","ENSG00000205835.9_6497",6489,6497,9,"ENSG00000205835.9",1,2,"VMVVVVVVV",0,8,0.884057971014493,109,115,133,136,142,148,160,163,"AGGATGA","TTGA","CTGAATA","CTGT",2.35931220914941,18,6,12,45,2.6142436504432,4.58574792785982,8.12197981191779,101,"ENSG00000079974.19"
"41886","ENSG00000259905.7_593180",593172,593180,9,"ENSG00000259905.7",1,8,"UVVVVVVMV",1,7,0.786749482401656,111,117,133,136,142,148,156,159,"ATGATAA","CTAA","GTGAAAT","CTGA",2.55795669207485,16,6,8,39,2.84665549196025,4.97492502644814,8.12192295605477,101,"ENSG00000079974.19"
"45994","ENSG00000286110.1_136947",136939,136947,9,"ENSG00000286110.1",1,8,"UVVVVVVMV",1,7,0.786749482401656,111,117,133,136,142,148,156,159,"ATGATAA","CTAA","GTGAAAT","CTGA",2.55795669207485,16,6,8,39,2.84665549196025,4.97492502644814,8.12192295605477,101,"ENSG00000079974.19"
"1797","ENSG00000066032.19_707674",707666,707674,9,"ENSG00000066032.19",1,7,"VVVVVVMVV",0,8,0.885300207039338,104,110,133,136,146,152,170,173,"CAGATGA","CTAA","ATAAAGA","CTGA",2.47733784325072,23,10,18,60,1.80725676740539,4.58071059726922,8.12191142542657,101,"ENSG00000079974.19"
"37417","ENSG00000248138.5_67701",67693,67701,9,"ENSG00000248138.5",1,3,"VVMVVVVVV",0,8,0.882815734989648,116,122,133,136,186,192,202,205,"ATGCTGA","AAGA","ATAATTA","CTGA",2.45801496206945,11,50,10,80,1.97561045757001,4.59059421784159,8.12185715780018,101,"ENSG00000079974.19"
"24701","ENSG00000177575.13_16611",16603,16611,9,"ENSG00000177575.13",1,3,"VVMVVVVVV",0,8,0.882815734989648,110,116,133,136,143,149,162,165,"ATGAAGA","GTGA","TTGAAGG","ATGA",2.3526108238627,17,7,13,46,2.67822954676562,4.59057542646257,8.12183836642116,101,"ENSG00000079974.19"
"8448","ENSG00000118960.13_81020",81012,81020,9,"ENSG00000118960.13",1,7,"VVVVVVMVV",0,8,0.885300207039338,97,103,133,136,151,157,168,171,"AGGATGA","CTGG","GGGGTTA","CTGA",2.51086053693366,30,15,11,65,1.58315186175669,4.58055552699527,8.12175635515262,101,"ENSG00000079974.19"
"21365","ENSG00000167306.21_121318",121310,121318,9,"ENSG00000167306.21",1,1,"MVVVVVVVV",0,8,0.90600414078675,109,115,133,136,144,150,200,203,"ATGTGGA","AGGA","ATGATGA","CTGA",2.45029406656182,18,8,50,85,1.65544575535615,4.49768488310874,8.12170144625574,101,"ENSG00000079974.19"
"8986","ENSG00000121964.15_106617",106609,106617,9,"ENSG00000121964.15",1,6,"VVVVVMVVV",0,8,0.902691511387163,87,93,133,136,142,148,200,203,"TTGATGA","CTTT","GTTATGA","CTGA",2.55841338350815,40,6,52,107,0.986845512917795,4.51073368407636,8.12149972962502,101,"ENSG00000079974.19"
"29451","ENSG00000198010.13_234923",234915,234923,9,"ENSG00000198010.13",1,2,"VMVVVVVVV",0,8,0.884057971014493,88,94,133,136,139,145,155,158,"TTGATGG","GTGA","TTAAGGA","CTGA",2.49564873840291,39,3,10,61,1.70288197003412,4.58513505651337,8.12136694057134,101,"ENSG00000079974.19"
"42676","ENSG00000265656.1_2582",2574,2582,9,"ENSG00000265656.1",0,NA,"UVVVVUVVV",2,7,0.824844720496894,116,122,133,136,144,150,162,165,"ATGATGT","CTGA","GTCAAAA","CTCA",2.45029615306278,11,8,12,40,2.95261791259771,4.82198139992073,8.12136028190831,101,"ENSG00000079974.19"
"22135","ENSG00000169862.21_434906",434898,434906,9,"ENSG00000169862.21",1,5,"VVVVMVVVV",0,8,0.886542443064182,101,107,133,136,140,146,157,160,"GTGATGT","GTGT","CTGACGG","CTGA",2.45121836546646,26,4,11,50,1.95789633919645,4.57483802724322,8.12100779949995,101,"ENSG00000079974.19"
"7400","ENSG00000113971.21_38849",38841,38849,9,"ENSG00000113971.21",1,8,"VVVVVVVMV",0,8,0.884057971014493,54,60,73,76,107,113,133,136,"AAGCTGA","CTGA","ATGAAAT","CTGA",2.51762115193881,13,31,20,73,1.55449601842983,4.58465925783881,8.12089114189678,101,"ENSG00000079974.19"
"43871","ENSG00000274810.4_38876",38868,38876,9,"ENSG00000274810.4",1,8,"VVVVVVVMV",0,8,0.884057971014493,54,60,73,76,107,113,133,136,"AAGCTGA","CTGA","ATGAAAT","CTGA",2.51762115193881,13,31,20,73,1.55449601842983,4.58465925783881,8.12089114189678,101,"ENSG00000079974.19"
"4193","ENSG00000099139.14_207107",207099,207107,9,"ENSG00000099139.14",0,NA,"UVVVVVVVV",1,8,0.902691511387163,111,117,133,136,183,189,204,207,"ATGAGGA","CCTA","GGGATGC","CTGA",2.45748094155094,16,47,15,87,1.65670330478724,4.50997739544838,8.12074344099704,101,"ENSG00000079974.19"
"43408","ENSG00000271860.9_127385",127377,127385,9,"ENSG00000271860.9",1,2,"VMVVVUVVV",1,7,0.806211180124223,71,77,89,92,105,111,133,136,"ATAATGA","TTGA","TTCATGA","CTGA",2.62223500031188,12,13,22,56,2.10190954283411,4.895869052895,8.12071377339189,101,"ENSG00000079974.19"
"16829","ENSG00000152402.11_10935",10927,10935,9,"ENSG00000152402.11",1,6,"VVVVVMVVV",0,8,0.902691511387163,75,81,104,107,115,121,133,136,"ATAATGA","ATGA","ATGCAGA","ATGA",2.3732687339606,23,8,12,52,2.21798894371276,4.50994512586253,8.12071117141118,101,"ENSG00000079974.19"
"42912","ENSG00000267322.4_24319",24311,24319,9,"ENSG00000267322.4",1,6,"VVVVVMVVV",0,8,0.902691511387163,109,115,133,136,147,153,200,203,"ATGAGGA","GTTA","CTGAGGT","CTGA",2.4800048734929,18,11,47,85,1.50625445897546,4.50990507056536,8.12067111611402,101,"ENSG00000079974.19"
"29933","ENSG00000198898.15_109417",109409,109417,9,"ENSG00000198898.15",1,6,"VVVVVMVVV",0,8,0.902691511387163,87,93,100,103,112,118,133,136,"ATGCTGG","CTGA","CTGTAGA","GTGA",2.34394897231766,7,9,15,40,2.41254332267784,4.5097174511989,8.12048349674755,101,"ENSG00000079974.19"
"30264","ENSG00000204406.14_166923",166915,166923,9,"ENSG00000204406.14",1,2,"VMVVVVVVV",0,8,0.884057971014493,95,101,111,114,115,121,133,136,"ATATTTA","CTGA","CTGCTTA","CTGA",2.38137826870625,10,1,12,32,2.45963840581393,4.58387338263057,8.12010526668854,101,"ENSG00000079974.19"
"18182","ENSG00000156463.18_124787",124779,124787,9,"ENSG00000156463.18",1,8,"VVVVVVVMV",0,8,0.884057971014493,47,53,67,70,78,84,133,136,"GTGTGGA","CTGA","CTCATGC","CTGA",2.45721863138721,14,8,49,80,1.95359948015112,4.58376425568313,8.1199961397411,101,"ENSG00000079974.19"
"28286","ENSG00000188641.14_152482",152474,152482,9,"ENSG00000188641.14",0,NA,"VVVVVUVVV",1,8,0.922153209109731,113,119,133,136,143,149,172,175,"TGTATGA","TTGA","TGGATTA","CTGA",2.31033938910434,14,7,23,53,2.32274467541843,4.43125181736185,8.11986465380077,101,"ENSG00000079974.19"
"9826","ENSG00000127603.32_252189",252181,252189,9,"ENSG00000127603.32",1,7,"VVVVVVMVV",0,8,0.885300207039338,108,114,133,136,182,188,200,203,"TTCATGA","CTTA","GTGAAGC","CTGA",2.51657917720409,19,46,12,86,1.5370240186984,4.57855463334809,8.11975546150544,101,"ENSG00000079974.19"
"16962","ENSG00000152894.15_137436",137428,137436,9,"ENSG00000152894.15",1,5,"VVVVMVVVV",0,8,0.886542443064182,89,95,105,108,111,117,133,136,"AGGATGC","AAGA","ATGTTGC","CTGA",2.37832862435559,10,3,16,38,2.43853672168172,4.57351522101308,8.11968499326981,101,"ENSG00000079974.19"
"26233","ENSG00000183715.14_407058",407050,407058,9,"ENSG00000183715.14",0,NA,"UVVVVVUVV",2,7,0.788819875776397,94,100,133,136,143,149,164,167,"ATGATGA","GTGA","ATGTAAA","CTGA",2.70344106230761,33,7,15,64,1.83397944396688,4.96422996483775,8.11950946794333,101,"ENSG00000079974.19"
"24600","ENSG00000177119.17_249846",249838,249846,9,"ENSG00000177119.17",0,NA,"UVVVVVVVV",1,8,0.902691511387163,110,116,133,136,145,151,162,165,"ATAATGA","ATGG","ATGATGT","CTCA",2.30080895828783,17,9,11,46,2.6954680462079,4.50854860869835,8.11931465424701,101,"ENSG00000079974.19"
"26485","ENSG00000184305.16_237370",237362,237370,9,"ENSG00000184305.16",0,NA,"VVUVVVVVV",1,8,0.883643892339545,99,105,133,136,162,168,176,179,"GTGATGA","GTTA","ATGTGGA","CTGA",2.57639326302922,28,26,8,71,1.16247076992956,4.58460646419776,8.11918203355594,101,"ENSG00000079974.19"
"21989","ENSG00000169504.15_33253",33245,33253,9,"ENSG00000169504.15",1,1,"MVVVVVVVV",0,8,0.90600414078675,85,91,133,136,170,176,187,190,"TTGATGA","GAGA","ATGATTT","CTGA",2.54534595124485,42,34,11,96,1.01064397092423,4.4949042448058,8.1189208079528,101,"ENSG00000079974.19"
"28476","ENSG00000189308.11_76641",76633,76641,9,"ENSG00000189308.11",1,8,"VVVVVVVMV",0,8,0.884057971014493,113,119,133,136,139,145,163,166,"AAAATGA","ATAA","GTGATTA","CTGA",2.40314770085337,14,3,18,44,2.30953204958882,4.58262918048615,8.11886106454413,101,"ENSG00000079974.19"
"26218","ENSG00000183704.7_14816",14808,14816,9,"ENSG00000183704.7",1,2,"VMVVVVVVV",0,8,0.884057971014493,116,122,133,136,144,150,159,162,"ATGCTCA","CAGC","TTGATTG","CTGA",2.29368141918718,11,8,9,37,3.03891519075247,4.58253116300008,8.11876304705805,101,"ENSG00000079974.19"
"1207","ENSG00000049323.16_297473",297465,297473,9,"ENSG00000049323.16",1,2,"VMVVVVVVV",0,8,0.884057971014493,114,120,133,136,146,152,163,166,"CTGATAA","TTCA","ATGTTCT","CTGA",2.31569686539668,13,10,11,43,2.89199271304926,4.58249295392344,8.11872483798141,101,"ENSG00000079974.19"
"26716","ENSG00000184939.16_1692",1684,1692,9,"ENSG00000184939.16",1,2,"UMVVVVVVV",1,7,0.786749482401656,65,71,80,83,95,101,133,136,"ATGATGA","TAGA","GTGATGG","CTGA",2.72916050045665,9,12,32,62,1.69245617911036,4.97171487887201,8.11871280847864,101,"ENSG00000079974.19"
"46511","ENSG00000286749.1_55376",55368,55376,9,"ENSG00000286749.1",0,NA,"UVVVVVVVV",1,8,0.902691511387163,73,79,92,95,109,115,133,136,"AAGAAGA","CTGA","GTTATGA","GTGA",2.36654619904333,13,14,18,54,2.25456332875014,4.50788449725975,8.11865054280841,101,"ENSG00000079974.19"
"6211","ENSG00000108684.15_116813",116805,116813,9,"ENSG00000108684.15",1,1,"MVVVVVVVV",0,8,0.90600414078675,82,88,100,103,111,117,133,136,"AAGATGA","CCGA","ATAAGGT","ATGA",2.28406214893499,12,8,16,45,2.75134207376402,4.49460576666599,8.11862232981299,101,"ENSG00000079974.19"
"42635","ENSG00000265356.2_97849",97841,97849,9,"ENSG00000265356.2",1,1,"MVVVVVVVV",0,8,0.90600414078675,82,88,100,103,111,117,133,136,"AAGATGA","CCGA","ATAAGGT","ATGA",2.28406214893499,12,8,16,45,2.75134207376402,4.49460576666599,8.11862232981299,101,"ENSG00000079974.19"
"44211","ENSG00000279668.4_20949",20941,20949,9,"ENSG00000279668.4",1,1,"MVVVVVVVV",0,8,0.90600414078675,82,88,100,103,111,117,133,136,"AAGATGA","CCGA","ATAAGGT","ATGA",2.28406214893499,12,8,16,45,2.75134207376402,4.49460576666599,8.11862232981299,101,"ENSG00000079974.19"
"16207","ENSG00000151136.15_225813",225805,225813,9,"ENSG00000151136.15",1,1,"MVVVVUVVV",1,7,0.82815734989648,114,120,133,136,165,171,181,184,"ATGATGG","CTCA","GTGGGAA","CTGA",2.57504010661143,13,29,10,61,2.05684225260823,4.80594407417111,8.11857347375703,101,"ENSG00000079974.19"
"17597","ENSG00000154556.20_36871",36863,36871,9,"ENSG00000154556.20",1,1,"MVVVVVVVV",0,8,0.90600414078675,90,96,133,136,138,144,152,155,"AAGATGA","AAGA","AAGATAA","CTGA",2.47028423336968,37,2,8,56,1.5096501380846,4.49455292347062,8.11856948661762,101,"ENSG00000079974.19"
"354","ENSG00000009694.14_363182",363174,363182,9,"ENSG00000009694.14",0,NA,"UVVVVVVVV",1,8,0.902691511387163,112,118,133,136,142,148,161,164,"CTGTTGT","TCGA","ATGACAA","CTGA",2.28076530754531,15,6,13,43,2.82479659184204,4.50747466053602,8.11824070608467,101,"ENSG00000079974.19"
"14159","ENSG00000144460.13_12039",12031,12039,9,"ENSG00000144460.13",1,7,"VVVVVVMVV",0,8,0.885300207039338,103,109,133,136,171,177,188,191,"ATGATGC","ATTA","ATGTTGA","CTGA",2.56265823219749,24,35,11,79,1.22370118229884,4.5770223492372,8.11822317739455,101,"ENSG00000079974.19"
"14436","ENSG00000145012.14_147296",147288,147296,9,"ENSG00000145012.14",1,1,"MVVVVVVVV",0,8,0.90600414078675,105,111,133,136,145,151,166,169,"GTTAAGA","CAGA","GTTATTA","CTGA",2.38077114139293,22,9,15,55,2.10473558355608,4.49413579821058,8.11815236135757,101,"ENSG00000079974.19"
"47640","ENSG00000288794.1_125",117,125,9,"ENSG00000288794.1",1,1,"MVVVVVVVV",0,8,0.90600414078675,99,105,127,130,139,145,160,163,"GTTAAGA","CAGA","GTTATTA","CTGA",2.38077114139293,22,9,15,55,2.10473558355608,4.49413579821058,8.11815236135757,101,"ENSG00000079974.19"
"8304","ENSG00000118058.24_30447",30439,30447,9,"ENSG00000118058.24",0,NA,"UVVVVVVVV",1,8,0.902691511387163,105,111,133,136,152,158,187,190,"GTGATGA","CTCC","GTGGTGC","CTGA",2.55823025098714,22,16,29,76,0.974653813516365,4.50738053835767,8.11814658390632,101,"ENSG00000079974.19"
"45719","ENSG00000285827.1_65301",65293,65301,9,"ENSG00000285827.1",0,NA,"UVVVVVVVV",1,8,0.902691511387163,105,111,133,136,152,158,187,190,"GTGATGA","CTCC","GTGGTGC","CTGA",2.55823025098714,22,16,29,76,0.974653813516365,4.50738053835767,8.11814658390632,101,"ENSG00000079974.19"
"39924","ENSG00000254459.1_5765",5757,5765,9,"ENSG00000254459.1",1,6,"VVVVVMVVV",0,8,0.902691511387163,76,82,95,98,107,113,133,136,"GTGATGA","CTGC","AGGCTCA","ATGA",2.3348697883432,13,9,20,51,2.46308116229681,4.50721993781287,8.11798598336153,101,"ENSG00000079974.19"
"40282","ENSG00000255449.1_3594",3586,3594,9,"ENSG00000255449.1",1,6,"VVVVVMVVV",0,8,0.902691511387163,76,82,95,98,107,113,133,136,"GTGATGA","CTGC","AGGCTCA","ATGA",2.3348697883432,13,9,20,51,2.46308116229681,4.50721993781287,8.11798598336153,101,"ENSG00000079974.19"
"34115","ENSG00000231918.1_149125",149117,149125,9,"ENSG00000231918.1",1,2,"VMVVVUVVV",1,7,0.806211180124223,111,117,133,136,145,151,162,165,"ATGATCA","CTAA","GCGAGAA","CTGA",2.51882192171875,16,9,11,45,2.78027541315198,4.89310538948591,8.1179501099828,101,"ENSG00000079974.19"
"8819","ENSG00000120800.5_11160",11152,11160,9,"ENSG00000120800.5",1,2,"VMVVVVVVV",0,8,0.884057971014493,106,112,133,136,180,186,204,207,"ATGATGA","TAGA","GGGAGGC","CTGA",2.59149158153773,21,44,18,92,1.04915114709496,4.58144042266996,8.11767230672793,101,"ENSG00000079974.19"
"12276","ENSG00000137770.14_10291",10283,10291,9,"ENSG00000137770.14",1,1,"MVVVVVVVV",0,8,0.90600414078675,93,99,110,113,115,121,133,136,"ATGAAGA","TTGA","AGAATGA","CAGA",2.3023938009552,11,2,12,34,2.6248058813537,4.49352447193043,8.11754103507743,101,"ENSG00000079974.19"
"42905","ENSG00000267313.7_83529",83521,83529,9,"ENSG00000267313.7",1,3,"UVMVVVVVV",1,7,0.785507246376811,94,100,109,112,116,122,133,136,"ATGAGGA","ATGA","ATGAACG","CTGA",2.55505011585666,9,4,11,33,2.86804924483839,4.97542917097071,8.11745815647795,101,"ENSG00000079974.19"
"17092","ENSG00000153107.13_134601",134593,134601,9,"ENSG00000153107.13",1,3,"VVMVVVVVV",0,8,0.882815734989648,112,118,133,136,152,158,169,172,"ATGATTA","CAGA","TTGATGG","CTCA",2.39397737284744,15,16,11,51,2.38436912323151,4.58605456888695,8.11731750884554,101,"ENSG00000079974.19"
"15880","ENSG00000149972.12_960740",960732,960740,9,"ENSG00000149972.12",1,2,"VMVVVVUVV",1,7,0.770186335403727,112,118,133,136,143,149,160,163,"ATGAGGA","TAGA","GTGATGT","CTGA",2.58503850928764,15,7,11,42,2.91266155369768,5.03656290390382,8.11730824551873,101,"ENSG00000079974.19"
"28543","ENSG00000196090.13_963595",963587,963595,9,"ENSG00000196090.13",1,8,"VVVVVVVMV",0,8,0.884057971014493,95,101,107,110,113,119,133,136,"ATTATTA","ATGA","GTGCCAA","CTGA",2.40120396201051,6,3,14,32,2.31624199854976,4.58106710298829,8.11729898704626,101,"ENSG00000079974.19"
"44078","ENSG00000277654.6_130982",130974,130982,9,"ENSG00000277654.6",0,NA,"VVUVVVVVV",1,8,0.883643892339545,109,115,133,136,181,187,201,204,"AAGAGGA","ATGA","CTGAAGA","CTGA",2.51847505720592,18,45,14,86,1.54034761424466,4.5825453322377,8.11712090159587,101,"ENSG00000079974.19"
"15887","ENSG00000150093.20_19962",19954,19962,9,"ENSG00000150093.20",1,8,"VVVVVVVMV",0,8,0.884057971014493,115,121,133,136,152,158,200,203,"AATATGA","ATGA","ATGATGT","CTGA",2.52312032747619,12,16,42,79,1.50251884933417,4.58083025812719,8.11706214218516,101,"ENSG00000079974.19"
"29056","ENSG00000197085.11_398436",398428,398436,9,"ENSG00000197085.11",1,8,"VVVVVVVMV",0,8,0.884057971014493,116,122,133,136,145,151,160,163,"AAAAGGA","CTGA","AAATTGA","CTGA",2.30089233773293,11,9,9,38,2.98383488654197,4.58077928452372,8.11701116858169,101,"ENSG00000079974.19"
"13669","ENSG00000143153.14_15689",15681,15689,9,"ENSG00000143153.14",0,NA,"VVVUVVVVV",1,8,0.880745341614907,114,120,133,136,151,157,168,171,"ATTTTGT","CAGA","TTGCTGA","CTGA",2.37583976991913,13,15,11,48,2.53706209726462,4.59399847418137,8.116979840641,101,"ENSG00000079974.19"
"16222","ENSG00000151150.22_570663",570655,570663,9,"ENSG00000151150.22",1,2,"VMVVVVVVV",0,8,0.884057971014493,93,99,133,136,146,152,162,165,"ATAATGA","AAGA","ATGAAAT","CTGA",2.46184394984339,34,10,10,63,1.91028546809079,4.58064461676168,8.11687650081965,101,"ENSG00000079974.19"
"35533","ENSG00000236256.9_154850",154842,154850,9,"ENSG00000236256.9",1,5,"VVVVMVVVV",0,8,0.886542443064182,110,116,133,136,144,150,161,164,"AGGATGT","CTGT","GTGAAGA","CTTA",2.33240867878793,17,8,11,45,2.73343017903204,4.5707053427379,8.11687511499463,101,"ENSG00000079974.19"
"24722","ENSG00000177694.16_1284402",1284394,1284402,9,"ENSG00000177694.16",1,6,"VVVVVMVVV",0,8,0.902691511387163,109,115,133,136,143,149,168,171,"CTGAGGA","CACA","TTGGAGA","CTGA",2.36732372201684,18,7,19,53,2.24178614757089,4.50598607358745,8.11675211913611,101,"ENSG00000079974.19"
"18437","ENSG00000157423.18_105955",105947,105955,9,"ENSG00000157423.18",1,1,"MVVVVVVVV",0,8,0.90600414078675,112,118,133,136,142,148,174,177,"CTGCTCA","AAGA","GTGATGA","CTGA",2.37612117475708,15,6,26,56,2.12963612038352,4.49261098802435,8.11662755117135,101,"ENSG00000079974.19"
"44029","ENSG00000276975.4_38738",38730,38738,9,"ENSG00000276975.4",1,1,"MVVVVVVVV",0,8,0.90600414078675,112,118,133,136,142,148,174,177,"CTGCTCA","AAGA","GTGATGA","CTGA",2.37612117475708,15,6,26,56,2.12963612038352,4.49261098802435,8.11662755117135,101,"ENSG00000079974.19"
"48527","ENSG00000291242.1_113539",113531,113539,9,"ENSG00000291242.1",1,1,"MVVVVVVVV",0,8,0.90600414078675,112,118,133,136,142,148,174,177,"CTGCTCA","AAGA","GTGATGA","CTGA",2.37612117475708,15,6,26,56,2.12963612038352,4.49261098802435,8.11662755117135,101,"ENSG00000079974.19"
"20907","ENSG00000165973.19_518603",518595,518603,9,"ENSG00000165973.19",1,2,"VMVVVVVVV",0,8,0.884057971014493,107,113,133,136,153,159,172,175,"AAGATGA","CTGA","ATGAATA","CTGT",2.47259482551914,20,17,13,59,1.83758708014635,4.58038814590182,8.11662002995979,101,"ENSG00000079974.19"
"18052","ENSG00000156052.11_64513",64505,64513,9,"ENSG00000156052.11",1,7,"VVVVVVMVV",0,8,0.885300207039338,51,57,65,68,110,116,133,136,"TTGATGA","CTGA","GTGATTT","CGGA",2.53014555143282,8,42,17,76,1.43364196222338,4.57531974294388,8.11652057110123,101,"ENSG00000079974.19"
"1872","ENSG00000066933.16_133989",133981,133989,9,"ENSG00000066933.16",1,1,"MVVVVVVVV",0,8,0.90600414078675,86,92,104,107,114,120,133,136,"ATGAAGA","CTTA","AAGAGCA","CTAA",2.25388669325301,12,7,13,41,2.94344333656671,4.49233865623002,8.11635521937702,101,"ENSG00000079974.19"
"16658","ENSG00000152034.11_6650",6642,6650,9,"ENSG00000152034.11",1,8,"VVVVVVVMV",0,8,0.884057971014493,113,119,133,136,142,148,164,167,"ATAATGT","TGGA","GTGTCAA","CTGA",2.34123345711099,14,6,16,45,2.71225618073006,4.58011980703417,8.11635169109214,101,"ENSG00000079974.19"
"13416","ENSG00000141376.23_560493",560485,560493,9,"ENSG00000141376.23",1,1,"MVVUVVVVV",1,7,0.786749482401656,114,120,133,136,172,178,187,190,"ATGATGA","TTGC","GTTATGA","CTGA",2.6799816282177,13,36,9,67,2.01059285001978,4.96928425953445,8.11628218914108,101,"ENSG00000079974.19"
"13202","ENSG00000140563.16_131224",131216,131224,9,"ENSG00000140563.16",1,7,"VVVVVVMVV",0,8,0.885300207039338,109,115,133,136,150,156,164,167,"GTAATGA","ATCA","TTGAGCA","CTGA",2.40446991929619,18,14,8,49,2.27050048107152,4.57507498576152,8.11627581391887,101,"ENSG00000079974.19"
"22353","ENSG00000170382.12_9366",9358,9366,9,"ENSG00000170382.12",1,6,"VVVVVMVVV",0,8,0.902691511387163,85,91,133,136,144,150,159,162,"TTGATCA","CAGA","AAGATCC","CTGA",2.40539730248698,42,8,9,68,1.98592308901199,4.50547627639797,8.11624232194663,101,"ENSG00000079974.19"
"7225","ENSG00000113360.17_101991",101983,101991,9,"ENSG00000113360.17",1,7,"VVVVVVMVV",0,8,0.885300207039338,104,110,133,136,161,167,178,181,"ATAATGA","CTGG","ATGGAAA","CTGA",2.53759848253628,23,25,11,68,1.3826861338825,4.57500233769777,8.11620316585512,101,"ENSG00000079974.19"
"2081","ENSG00000070010.19_28519",28511,28519,9,"ENSG00000070010.19",1,1,"MVVVVVVVV",0,8,0.90600414078675,115,121,133,136,146,152,160,163,"GTCATTG","AAGA","GTGAGGA","CTGA",2.25670193635849,12,10,8,39,2.92332041146315,4.4919999967966,8.1160165599436,101,"ENSG00000079974.19"
"7403","ENSG00000114013.16_42342",42334,42342,9,"ENSG00000114013.16",1,6,"UVVVVMVVV",1,7,0.805383022774327,86,92,100,103,115,121,133,136,"ATGAGGA","GTGA","GTGGAAA","CTGA",2.56480893600347,8,12,12,41,2.47920517986674,4.89448285497247,8.11601494606978,101,"ENSG00000079974.19"
"10908","ENSG00000133105.8_3656",3648,3656,9,"ENSG00000133105.8",1,1,"MVVVVVVVV",0,8,0.90600414078675,92,98,107,110,115,121,133,136,"GTGATAA","TTGA","TTTAAGA","TTGA",2.2665756332563,9,5,12,35,2.8574286246152,4.49198321158097,8.11599977472796,101,"ENSG00000079974.19"
"45524","ENSG00000285681.2_63236",63228,63236,9,"ENSG00000285681.2",1,2,"VMVVVVVVV",0,8,0.884057971014493,106,112,133,136,165,171,182,185,"TTGATCA","TTGA","GTGAATA","CTGA",2.52931856808926,21,29,11,70,1.45685882464078,4.57974565297562,8.11597753703359,101,"ENSG00000079974.19"
"8175","ENSG00000117114.21_477847",477839,477847,9,"ENSG00000117114.21",1,8,"VVVVVVVMV",0,8,0.884057971014493,98,104,133,136,185,191,201,204,"ATGATCA","GTTA","ATGATGA","CTGA",2.58880171064409,29,49,10,97,1.0596929489827,4.57959275498583,8.1158246390438,101,"ENSG00000079974.19"
"10658","ENSG00000132205.11_4077",4069,4077,9,"ENSG00000132205.11",1,8,"VVUVVVVMV",1,7,0.767701863354037,86,92,105,108,116,122,133,136,"ATGAAGA","CAGA","ATCATGG","CTGA",2.57811659905949,13,8,11,41,2.99220180982414,5.04491145088852,8.11571890430467,101,"ENSG00000079974.19"
"4679","ENSG00000101596.17_35816",35808,35816,9,"ENSG00000101596.17",1,7,"VVVVVVMVV",0,8,0.885300207039338,100,106,133,136,151,157,170,173,"AAGATGT","CTCA","GTGAAAA","CTGA",2.50837137365829,27,15,13,64,1.57559189154093,4.57451692898239,8.11571775713974,101,"ENSG00000079974.19"
"33021","ENSG00000228541.3_9751",9743,9751,9,"ENSG00000228541.3",1,8,"VVVVVVVMV",0,8,0.884057971014493,51,57,70,73,90,96,133,136,"ATGATTA","CTGA","GTGGTGA","CTGG",2.52858627858628,13,17,37,76,1.4603365780828,4.57939460883116,8.11562649288913,101,"ENSG00000079974.19"
"18609","ENSG00000157837.16_117969",117961,117969,9,"ENSG00000157837.16",0,NA,"VVUVVVUVV",2,7,0.769772256728778,84,90,101,104,110,116,133,136,"ATGATAA","CTGA","ATTATTT","CTGA",2.62163056228423,11,6,17,43,2.6686106490974,5.03653693274807,8.11562595966318,101,"ENSG00000079974.19"
"7244","ENSG00000113391.19_392868",392860,392868,9,"ENSG00000113391.19",1,8,"VVVVVVVMV",0,8,0.884057971014493,116,122,133,136,149,155,168,171,"GAGATGA","AGGA","ATAAAGG","CTGA",2.35849938947471,11,13,13,46,2.59219767661185,4.57888173494415,8.11511361900212,101,"ENSG00000079974.19"
"8781","ENSG00000120659.16_2977",2969,2977,9,"ENSG00000120659.16",0,NA,"VVVUVVVVV",1,8,0.880745341614907,112,118,133,136,148,154,162,165,"ATTAAGA","TGGA","GTGTTGG","CTGA",2.35560587027928,15,12,8,44,2.66417751031479,4.5920541613775,8.11503552783712,101,"ENSG00000079974.19"
"38154","ENSG00000249736.1_429",421,429,9,"ENSG00000249736.1",1,1,"MVVVVVVVV",0,8,0.90600414078675,109,115,133,136,142,148,158,161,"ATGAGGA","GTGA","ACTATGA","CTAA",2.29523243986447,18,6,10,43,2.66252010637791,4.4910174263686,8.1150339895156,101,"ENSG00000079974.19"
"16820","ENSG00000152377.14_365513",365505,365513,9,"ENSG00000152377.14",1,2,"VMVVVVVVV",0,8,0.884057971014493,109,115,133,136,142,148,157,160,"ATTATAT","CTGA","GAAATCA","CTGA",2.34729676085754,18,6,9,42,2.66619820572753,4.57871081952778,8.11494270358575,101,"ENSG00000079974.19"
"35482","ENSG00000236130.2_149050",149042,149050,9,"ENSG00000236130.2",0,NA,"VVVVVUVVV",1,8,0.922153209109731,114,120,133,136,142,148,166,169,"GTGAGGG","GGGA","ATGCAGT","CTGA",2.26278908709391,13,6,18,46,2.61960602599267,4.42621665165468,8.1148294880936,101,"ENSG00000079974.19"
"14052","ENSG00000144290.17_547542",547534,547542,9,"ENSG00000144290.17",1,6,"VVVVVMVVV",0,8,0.902691511387163,113,119,133,136,185,191,204,207,"ATTATGA","CACA","GAGAAAA","CTGA",2.41980451747355,14,49,13,85,1.88410543120968,4.504033886925,8.11479993247366,101,"ENSG00000079974.19"
"2505","ENSG00000075391.18_203593",203585,203593,9,"ENSG00000075391.18",1,3,"VVMVVVVVV",0,8,0.882815734989648,95,101,112,115,116,122,133,136,"ATTATGT","CTGA","ATGAGAA","CTAA",2.36867416189377,11,1,11,32,2.54284999452133,4.58350276845329,8.11476570841188,101,"ENSG00000079974.19"
"2615","ENSG00000076716.9_38452",38444,38452,9,"ENSG00000076716.9",1,8,"VVVVVVVMV",0,8,0.884057971014493,115,121,133,136,142,148,156,159,"AAAATGA","GGGA","GGGAAGG","CTGA",2.28271633394203,12,6,8,35,3.09576072844806,4.57846740534873,8.1146992894067,101,"ENSG00000079974.19"
"35932","ENSG00000237499.7_32917",32909,32917,9,"ENSG00000237499.7",1,1,"MVVVVVVVV",0,8,0.90600414078675,93,99,108,111,114,120,133,136,"CTGAAGA","CTGA","ATGTCCA","CTTA",2.30083954524895,9,3,13,34,2.62297316155915,4.4904758658047,8.1144924289517,101,"ENSG00000079974.19"
"11290","ENSG00000134504.14_112151",112143,112151,9,"ENSG00000134504.14",1,2,"VMVVVVVVV",0,8,0.884057971014493,115,121,133,136,146,152,160,163,"CTGATAC","TTGA","ATTTAGA","CTGA",2.30842340510694,12,10,8,39,2.92332041146315,4.57820244471068,8.11443432876866,101,"ENSG00000079974.19"
"44071","ENSG00000277534.1_541",533,541,9,"ENSG00000277534.1",1,2,"VMVVVVVVV",0,8,0.884057971014493,115,121,133,136,146,152,160,163,"CTGATAC","TTGA","ATTTAGA","CTGA",2.30842340510694,12,10,8,39,2.92332041146315,4.57820244471068,8.11443432876866,101,"ENSG00000079974.19"
"10726","ENSG00000132549.20_786429",786421,786429,9,"ENSG00000132549.20",1,2,"VMVVVVVVV",0,8,0.884057971014493,98,104,133,136,144,150,184,187,"ATGATGA","CTTG","CTTAGGA","CTGA",2.58058003247302,29,8,34,80,1.10883022264383,4.57817427644933,8.1144061605073,101,"ENSG00000079974.19"
"41101","ENSG00000258546.1_372",364,372,9,"ENSG00000258546.1",1,8,"VVVVVVVMV",0,8,0.884057971014493,114,120,133,136,153,159,171,174,"AAAATGA","AGGA","GCGATGA","CTGA",2.38951156784928,13,17,12,51,2.38227935566718,4.57808911866559,8.11432100272356,101,"ENSG00000079974.19"
"1509","ENSG00000058091.17_95269",95261,95269,9,"ENSG00000058091.17",1,1,"MVVVVVVVV",0,8,0.90600414078675,71,77,89,92,105,111,133,136,"CTGATGA","ATGA","GTGGAAA","ATGA",2.37889449689715,12,13,22,56,2.10190954283411,4.49030154720377,8.11431811035077,101,"ENSG00000079974.19"
"26357","ENSG00000183960.9_244317",244309,244317,9,"ENSG00000183960.9",1,1,"MVVVVUVVV",1,7,0.82815734989648,112,118,133,136,140,146,167,170,"ATGTTGA","CAGA","ATGAATC","CTGA",2.54966681458907,15,4,21,49,2.20874369421249,4.8016306145349,8.11426001412082,101,"ENSG00000079974.19"
"47219","ENSG00000287862.1_187706",187698,187706,9,"ENSG00000287862.1",1,8,"VVVVVVVMV",0,8,0.884057971014493,83,89,101,104,114,120,133,136,"ATGATCA","CTAA","ATGCTCA","ATGA",2.32281564758747,12,10,13,44,2.82618681826955,4.57790611721318,8.11413800127115,101,"ENSG00000079974.19"
"7880","ENSG00000115944.15_26765",26757,26765,9,"ENSG00000115944.15",1,8,"VVVVVVVMV",0,8,0.884057971014493,57,63,75,78,105,111,133,136,"AGGAAGA","CAGA","ATGATGG","CTGA",2.52241060857713,12,27,22,70,1.49535986938525,4.57785764830819,8.11408953236616,101,"ENSG00000079974.19"
"18326","ENSG00000157077.16_71025",71017,71025,9,"ENSG00000157077.16",0,NA,"UVVVVVVVV",1,8,0.902691511387163,110,116,133,136,138,144,155,158,"ATGCTCA","CTGG","GTTATTT","CTGA",2.35528555696074,17,2,11,39,2.31080608762786,4.50317745017487,8.11394349572353,101,"ENSG00000079974.19"
"21040","ENSG00000166268.11_4631",4623,4631,9,"ENSG00000166268.11",1,7,"VVVVUVMVV",1,7,0.775155279503105,89,95,104,107,116,122,133,136,"TTGATTA","CTGA","CAGAAGA","CTGA",2.58307425279902,9,9,11,38,2.83244385572892,5.01323471859727,8.11385583660969,101,"ENSG00000079974.19"
"40891","ENSG00000258052.1_28189",28181,28189,9,"ENSG00000258052.1",1,7,"VVVVUVMVV",1,7,0.775155279503105,89,95,104,107,116,122,133,136,"TTGATTA","CTGA","CAGAAGA","CTGA",2.58307425279902,9,9,11,38,2.83244385572892,5.01323471859727,8.11385583660969,101,"ENSG00000079974.19"
"20204","ENSG00000164418.22_682443",682435,682443,9,"ENSG00000164418.22",0,NA,"VVVVVUVVV",1,8,0.922153209109731,114,120,133,136,146,152,165,168,"ATAATGG","TTGA","AAGAAGA","CTAA",2.23227009794732,13,10,13,45,2.8189809746876,4.42519540691744,8.11380824335636,101,"ENSG00000079974.19"
"24284","ENSG00000175697.11_84395",84387,84395,9,"ENSG00000175697.11",1,1,"MVVVVVVVV",0,8,0.90600414078675,86,92,133,136,170,176,186,189,"AGGATGT","CTGC","ATGATCA","CTGA",2.54007362012387,41,34,10,94,1.02514316573779,4.48974182497423,8.11375838812123,101,"ENSG00000079974.19"
"16581","ENSG00000151812.15_350898",350890,350898,9,"ENSG00000151812.15",1,8,"VVVVVVVMV",0,8,0.884057971014493,86,92,133,136,152,158,170,173,"GTGATGT","GTGA","GTCAAAA","CTGA",2.52929632609292,41,16,12,78,1.447711186915,4.57742167355029,8.11365355760826,101,"ENSG00000079974.19"
"6207","ENSG00000108669.17_96263",96255,96263,9,"ENSG00000108669.17",1,8,"VVVVVVVMV",0,8,0.884057971014493,84,90,104,107,113,119,133,136,"AAGATAC","GTGA","CTGAGAA","CTGA",2.32166851038025,14,6,14,43,2.83144750097253,4.57730939254354,8.11354127660151,101,"ENSG00000079974.19"
"27172","ENSG00000185716.12_39043",39035,39043,9,"ENSG00000185716.12",0,NA,"VVUVVVVVV",1,8,0.883643892339545,116,122,133,136,140,146,155,158,"ATCATCA","CAAA","GTGAAAG","CTGA",2.29443477762083,11,4,9,33,3.01944027565145,4.57891803161424,8.11349360097242,101,"ENSG00000079974.19"
"5257","ENSG00000104154.7_3006",2998,3006,9,"ENSG00000104154.7",1,2,"VMVVVVVVV",0,8,0.884057971014493,91,97,133,136,146,152,163,166,"ATGATTA","TTAA","GTCTTGA","CTGA",2.4628215346496,36,10,11,66,1.89006012037765,4.57721758784375,8.11344947190172,101,"ENSG00000079974.19"
"22151","ENSG00000169891.18_134536",134528,134536,9,"ENSG00000169891.18",0,NA,"VVVVVVUVV",1,8,0.886128364389234,114,120,133,136,137,143,151,154,"CTCAGGA","GTGA","TTGAAGC","CTGA",2.34934164929192,13,1,8,31,2.6131738857098,4.56886288691398,8.11337634447091,101,"ENSG00000079974.19"
"30183","ENSG00000204007.8_2381",2373,2381,9,"ENSG00000204007.8",1,1,"MVVVVVVVV",0,8,0.90600414078675,84,90,133,136,186,192,204,207,"ATGCTGT","ATGA","CTGAGGA","CTGA",2.54967677762782,43,50,12,114,0.959483412067527,4.48933214906325,8.11334871221025,101,"ENSG00000079974.19"
"3104","ENSG00000081087.16_24219",24211,24219,9,"ENSG00000081087.16",0,NA,"VVVVVVUVV",1,8,0.886128364389234,113,119,133,136,143,149,162,165,"TTCATGC","TTGA","ATAAGGC","CTGA",2.3068730942103,14,7,13,43,2.89540137332488,4.56863883368172,8.11315229123865,101,"ENSG00000079974.19"
"4249","ENSG00000099864.18_23359",23351,23359,9,"ENSG00000099864.18",1,2,"VMVVVVVVV",0,8,0.884057971014493,114,120,133,136,148,154,173,176,"GTGATGG","CAGC","GAGAGGC","CTGA",2.39553970610854,13,12,19,53,2.33691292363537,4.5767944077564,8.11302629181437,101,"ENSG00000079974.19"
"46127","ENSG00000286214.1_5264",5256,5264,9,"ENSG00000286214.1",1,2,"VMVVVVVVV",0,8,0.884057971014493,84,90,103,106,113,119,133,136,"ATAATAT","GTGA","GTGAGTT","CTGA",2.31411812080577,13,7,14,43,2.87935588587557,4.57670250614518,8.11293439020315,101,"ENSG00000079974.19"
"37172","ENSG00000245768.7_170876",170868,170876,9,"ENSG00000245768.7",1,8,"VVVVVVVMV",0,8,0.884057971014493,54,60,72,75,82,88,133,136,"CAGAAGA","CTGA","GTGAAAT","CTGA",2.44488707347079,12,7,45,73,2.00748260023596,4.57668243917697,8.11291432323494,101,"ENSG00000079974.19"
"1179","ENSG00000048740.19_227539",227531,227539,9,"ENSG00000048740.19",0,NA,"VVVVVVUVV",1,8,0.886128364389234,82,88,133,136,148,154,173,176,"GTGAAGA","CAGA","TTGAGGG","CTGA",2.53967353796735,45,12,19,85,1.3414086784099,4.56814139954806,8.11265485710499,101,"ENSG00000079974.19"
"25119","ENSG00000179583.21_10225",10217,10225,9,"ENSG00000179583.21",0,NA,"VVUVVUVVV",2,7,0.805797101449275,90,96,108,111,114,120,133,136,"GTGATGT","AAGA","CTGTTGA","CTGA",2.52866050175169,12,3,13,37,2.69900917873968,4.88918646427106,8.11237487006816,101,"ENSG00000079974.19"
"30639","ENSG00000206120.11_458539",458531,458539,9,"ENSG00000206120.11",1,6,"VVVVVMVVV",0,8,0.902691511387163,114,120,133,136,140,146,159,162,"TTTATTA","CTCA","CAGATCA","CTGA",2.28134023392647,13,4,13,39,2.79731102162552,4.50156147861716,8.11232752416581,101,"ENSG00000079974.19"
"39574","ENSG00000253853.3_22190",22182,22190,9,"ENSG00000253853.3",1,8,"VVVVVVVMV",0,8,0.884057971014493,115,121,133,136,140,146,155,158,"AAAATGC","CAGA","CAGATAA","CTGA",2.29516399887639,12,4,9,34,3.00325370030578,4.57608675653709,8.11231864059506,101,"ENSG00000079974.19"
"34174","ENSG00000232044.8_66647",66639,66647,9,"ENSG00000232044.8",1,5,"VVVVMVVVV",0,8,0.886542443064182,44,50,62,65,73,79,133,136,"CTGATGA","CTGA","ATGGCCA","CTGT",2.44148638601047,12,8,54,83,1.98770992090816,4.56607145691116,8.11224122916788,101,"ENSG00000079974.19"
"4688","ENSG00000101639.19_129494",129486,129494,9,"ENSG00000101639.19",1,6,"VVVVVMVVV",0,8,0.902691511387163,116,122,133,136,141,147,158,161,"ATCATGT","CTAA","GTGATCT","ATGA",2.25159790549817,11,5,11,36,2.9946049370839,4.50131441010126,8.11208045564992,101,"ENSG00000079974.19"
"13013","ENSG00000139915.21_257121",257113,257121,9,"ENSG00000139915.21",0,NA,"VVVVUVVVV",1,8,0.889855072463768,112,118,133,136,152,158,169,172,"GTGAGGA","ATCA","GTGGGTA","CTGA",2.37377543246638,15,16,11,51,2.38436912323151,4.55238466825184,8.11180495810691,101,"ENSG00000079974.19"
"22116","ENSG00000169855.21_34511",34503,34511,9,"ENSG00000169855.21",1,1,"MVVVVVVVV",0,8,0.90600414078675,87,93,133,136,142,148,158,161,"CTGATGG","GAGA","ATAGTGA","CTGA",2.39484688345793,40,6,10,65,1.98518518883741,4.48770776963924,8.11172433278624,101,"ENSG00000079974.19"
"6012","ENSG00000107736.22_202408",202400,202408,9,"ENSG00000107736.22",1,2,"VMVVVVVVV",0,8,0.884057971014493,53,59,73,76,110,116,133,136,"TTGTTGA","TTGA","CTGAGCA","CTGA",2.49243416251219,14,34,17,74,1.68562964718649,4.57546434931694,8.11169623337491,101,"ENSG00000079974.19"
"32201","ENSG00000226320.6_40931",40923,40931,9,"ENSG00000226320.6",1,2,"VMVVVVVVV",0,8,0.884057971014493,71,77,96,99,113,119,133,136,"GTGTTGA","CTGA","GTGTAGA","TTGA",2.43462368240178,19,14,14,56,2.07099698911109,4.57545538461407,8.11168726867204,101,"ENSG00000079974.19"
"46949","ENSG00000287394.1_87430",87422,87430,9,"ENSG00000287394.1",1,1,"MVVVVVVVV",0,8,0.90600414078675,112,118,133,136,165,171,186,189,"GAGATAA","ATGA","GTGAAAA","CTGA",2.42441630632377,15,29,15,68,1.78784611332247,4.48765537220357,8.11167193535057,101,"ENSG00000079974.19"
"14309","ENSG00000144668.12_181645",181637,181645,9,"ENSG00000144668.12",0,NA,"VVVVVUVVV",1,8,0.922153209109731,113,119,133,136,138,144,162,165,"ATGGTGT","ATCA","TTGTTTA","CTGA",2.3330820065952,14,2,18,43,2.13757834694207,4.42286459772752,8.11147743416644,101,"ENSG00000079974.19"
"43936","ENSG00000275649.1_38103",38095,38103,9,"ENSG00000275649.1",0,NA,"VVVVVUVVV",1,8,0.922153209109731,112,118,133,136,139,145,156,159,"AATAGGA","ATGA","GTGCTAC","CTGA",2.25526522819907,15,3,11,38,2.65595836413498,4.42276497136553,8.11137780780445,101,"ENSG00000079974.19"
"3376","ENSG00000083067.25_702411",702403,702411,9,"ENSG00000083067.25",1,6,"VVVVVMVVV",0,8,0.902691511387163,79,85,99,102,112,118,133,136,"ATAATAA","CTGA","ATGCTTA","CTGT",2.29820064481762,14,10,15,48,2.68104352732841,4.50059528986147,8.11136133541012,101,"ENSG00000079974.19"
"32930","ENSG00000228262.11_759113",759105,759113,9,"ENSG00000228262.11",1,6,"VVUVVMVVV",1,7,0.786335403726708,95,101,133,136,164,170,182,185,"ATGATGA","GTGA","GTGATCA","CTGA",2.82126200825356,32,28,12,81,1.05485745419599,4.96581771063827,8.1111593255451,101,"ENSG00000079974.19"
"46963","ENSG00000287414.1_3164",3156,3164,9,"ENSG00000287414.1",1,8,"VVVVVVVMV",0,8,0.884057971014493,115,121,133,136,173,179,188,191,"ATAATTA","CTTA","ATGGAGA","CTGA",2.44310809011488,12,37,9,67,2.01220856458785,4.5748989580051,8.11113084206307,101,"ENSG00000079974.19"
"26789","ENSG00000185019.17_6370",6362,6370,9,"ENSG00000185019.17",1,6,"VVVVVMVVV",0,8,0.902691511387163,109,115,133,136,146,152,163,166,"ATGCTCA","CATA","CTGAAAA","CTGA",2.31734539527215,18,10,11,48,2.55217806762677,4.50028684236027,8.11105288790892,101,"ENSG00000079974.19"
"31013","ENSG00000215251.5_6039",6031,6039,9,"ENSG00000215251.5",1,6,"VVVVVMVVV",0,8,0.902691511387163,109,115,133,136,146,152,163,166,"ATGCTCA","CATA","CTGAAAA","CTGA",2.31734539527215,18,10,11,48,2.55217806762677,4.50028684236027,8.11105288790892,101,"ENSG00000079974.19"
"25098","ENSG00000179399.15_68629",68621,68629,9,"ENSG00000179399.15",1,8,"UVVVVVVMV",1,7,0.786749482401656,62,68,94,97,110,116,133,136,"ATGATGG","CTGA","GGGAAGA","CTGA",2.74954402620687,26,13,17,65,1.52535159433062,4.9639112755941,8.11090920520073,101,"ENSG00000079974.19"
"28871","ENSG00000196620.10_413",405,413,9,"ENSG00000196620.10",1,5,"VVVVMVVVV",0,8,0.886542443064182,111,117,133,136,146,152,161,164,"ATTATGA","CTGT","GTTTTGA","CTTA",2.32732948835897,16,10,9,44,2.74342649492762,4.56473910433019,8.11090887658692,101,"ENSG00000079974.19"
"38452","ENSG00000250195.1_77925",77917,77925,9,"ENSG00000250195.1",1,2,"VMVVVVVVV",0,8,0.884057971014493,114,120,133,136,172,178,195,198,"ATAAAGA","CTAA","TTGAGGA","CTGA",2.48817601248912,13,36,17,75,1.70961654509942,4.57436415709006,8.11059604114803,101,"ENSG00000079974.19"
"11484","ENSG00000135083.17_70644",70636,70644,9,"ENSG00000135083.17",0,NA,"VVVVVVUVV",1,8,0.886128364389234,114,120,133,136,140,146,155,158,"CTGTTGT","GTGG","GTGAGGC","CTGA",2.29508853252247,13,4,9,35,2.9636559347714,4.56606153789697,8.11057499545391,101,"ENSG00000079974.19"
"14438","ENSG00000145012.14_147636",147628,147636,9,"ENSG00000145012.14",1,5,"VVVVMUVVV",1,7,0.808695652173913,75,81,92,95,108,114,133,136,"ATGATGA","TTGA","ATGAAGA","GTGA",2.58879353746962,11,13,19,52,2.24451987943717,4.87578586564199,8.11056847433764,101,"ENSG00000079974.19"
"47642","ENSG00000288794.1_465",457,465,9,"ENSG00000288794.1",1,5,"VVVVMUVVV",1,7,0.808695652173913,75,81,92,95,108,114,133,136,"ATGATGA","TTGA","ATGAAGA","GTGA",2.58879353746962,11,13,19,52,2.24451987943717,4.87578586564199,8.11056847433764,101,"ENSG00000079974.19"
"24540","ENSG00000176771.18_720075",720067,720075,9,"ENSG00000176771.18",1,8,"VVVVVVVMV",0,8,0.884057971014493,109,115,133,136,143,149,179,182,"ATAATGA","GTTA","ATGTTGC","CTGA",2.47522638734973,18,7,30,64,1.79292778048339,4.57360925737041,8.10984114142838,101,"ENSG00000079974.19"
"37903","ENSG00000249102.3_6605",6597,6605,9,"ENSG00000249102.3",0,NA,"VVVVVUVVV",1,8,0.922153209109731,114,120,133,136,150,156,202,205,"GGGATGA","CCTA","CTGATAT","CTGA",2.40905861087517,13,14,46,82,1.62437437021831,4.42119127734653,8.10980411378546,101,"ENSG00000079974.19"
"1018","ENSG00000044459.15_259765",259757,259765,9,"ENSG00000044459.15",1,2,"VMVVVVVVV",0,8,0.884057971014493,109,115,133,136,138,144,159,162,"ATACTGA","GTGA","CTGGAGA","CTGA",2.44150706585527,18,2,15,44,2.01737625167293,4.57352250601035,8.10975439006832,101,"ENSG00000079974.19"
"19539","ENSG00000163235.16_32120",32112,32120,9,"ENSG00000163235.16",1,2,"UMVVVVVVV",1,7,0.786749482401656,69,75,90,93,102,108,133,136,"GAGATGA","CTGA","GAGAGGA","CTGA",2.65766769106792,15,9,25,58,2.13308984466722,4.96271861294667,8.1097165425533,101,"ENSG00000079974.19"
"44696","ENSG00000283380.1_69063",69055,69063,9,"ENSG00000283380.1",0,NA,"VVVVVVUVV",1,8,0.886128364389234,93,99,133,136,146,152,167,170,"GTGATGG","CAGT","GTGAGTA","CTGA",2.47998383813167,34,10,15,68,1.72742486928406,4.56516261420714,8.10967607176407,101,"ENSG00000079974.19"
"10417","ENSG00000131013.4_29677",29669,29677,9,"ENSG00000131013.4",1,6,"VVVVVMVVV",0,8,0.902691511387163,105,111,133,136,142,148,160,163,"GTGTTGA","TTGT","GTTAGAA","CTGA",2.35732043685111,22,6,12,49,2.28009067933204,4.49889006458487,8.10965611013352,101,"ENSG00000079974.19"
"2548","ENSG00000075673.12_18912",18904,18912,9,"ENSG00000075673.12",0,NA,"VVVUVUVVV",2,7,0.802898550724638,65,71,82,85,94,100,133,136,"GTCATGA","TTGA","GTGAGGA","CTGA",2.63854038473653,11,9,33,62,2.00128133217454,4.89788764093785,8.10948184383641,101,"ENSG00000079974.19"
"32826","ENSG00000228035.1_56710",56702,56710,9,"ENSG00000228035.1",1,8,"VVVVVVVMV",0,8,0.884057971014493,111,117,133,136,169,175,201,204,"AGGATGA","CTGG","TTGTTGT","CTGA",2.57842810450123,16,33,26,84,1.10346309982482,4.57324594912492,8.10947783318289,101,"ENSG00000079974.19"
"22112","ENSG00000169855.21_188278",188270,188278,9,"ENSG00000169855.21",0,NA,"UVVVVVVVV",1,8,0.902691511387163,90,96,133,136,146,152,164,167,"ATGTTGA","GTGT","TTAATAA","CTGA",2.42012989343763,37,10,12,68,1.86053340534371,4.49868317373197,8.10944921928062,101,"ENSG00000079974.19"
"8331","ENSG00000118263.16_23098",23090,23098,9,"ENSG00000118263.16",1,2,"VMVVVVVVV",0,8,0.884057971014493,112,118,133,136,141,147,157,160,"ATGCTGA","GTGA","GAAATGA","TTGA",2.31093722463463,15,5,10,39,2.88571763744857,4.57299145041985,8.10922333447782,101,"ENSG00000079974.19"
"38175","ENSG00000249740.4_10067",10059,10067,9,"ENSG00000249740.4",1,1,"MVVVVUVVV",1,7,0.82815734989648,65,71,87,90,101,107,133,136,"AAGAAGA","CTGA","GTGAGGC","CTGA",2.5915401662248,16,11,26,62,1.90931333192623,4.79656194335622,8.10919134294215,101,"ENSG00000079974.19"
"13503","ENSG00000141627.14_170009",170001,170009,9,"ENSG00000141627.14",0,NA,"UVVVVVVVV",1,8,0.902691511387163,116,122,133,136,146,152,163,166,"GTGTTCA","CAAA","ATGAACA","CTGA",2.26653216170216,11,10,11,41,2.88295945323706,4.49829346614619,8.10905951169484,101,"ENSG00000079974.19"
"28853","ENSG00000196588.21_186893",186885,186893,9,"ENSG00000196588.21",1,8,"VVVVVVVMV",0,8,0.884057971014493,111,117,133,136,155,161,174,177,"GTGAGGA","CAGA","AATATGC","CTGA",2.43170997057144,16,19,13,57,2.07975136178488,4.57278779139862,8.10901967545659,101,"ENSG00000079974.19"
"17815","ENSG00000155189.12_49283",49275,49283,9,"ENSG00000155189.12",1,8,"VVVVVVVMV",0,8,0.884057971014493,116,122,133,136,144,150,170,173,"TTCATGG","CTGT","ATGATTT","CTGA",2.37166687286264,11,8,20,48,2.47968242405704,4.57269872745199,8.10893061150997,101,"ENSG00000079974.19"
"19576","ENSG00000163349.22_39023",39015,39023,9,"ENSG00000163349.22",1,1,"MVVVVVVVV",0,8,0.90600414078675,115,121,133,136,176,182,193,196,"ATGATTA","ATCA","ATTTGGA","CTGA",2.39193689844894,12,40,11,72,1.99330434252316,4.4848875830457,8.1089041461927,101,"ENSG00000079974.19"
"27665","ENSG00000187097.13_5677",5669,5677,9,"ENSG00000187097.13",1,6,"VVVVVMVVV",0,8,0.902691511387163,25,31,55,58,107,113,133,136,"TTAATGA","CTGA","TTGTTTA","CTGA",2.5884422266303,24,49,20,102,0.735571992262719,4.49796337578285,8.1087294213315,101,"ENSG00000079974.19"
"46944","ENSG00000287394.1_120701",120693,120701,9,"ENSG00000287394.1",1,8,"UVVVVVVMV",1,7,0.786749482401656,116,122,133,136,143,149,181,184,"AAGATGA","CTGG","GTGATGG","CTGA",2.6672380903869,11,7,32,59,2.0651358157593,4.96168077125133,8.10867870085795,101,"ENSG00000079974.19"
"18939","ENSG00000159398.16_24893",24885,24893,9,"ENSG00000159398.16",1,8,"VVVVVVVMV",0,8,0.884057971014493,95,101,110,113,116,122,133,136,"ATGAAGA","CAGA","GTGGAGT","CTGG",2.3264274098703,9,3,11,32,2.7794809799021,4.57224926142603,8.108481145484,101,"ENSG00000079974.19"
"17929","ENSG00000155849.16_361484",361476,361484,9,"ENSG00000155849.16",1,2,"VMVVVVVVV",0,8,0.884057971014493,113,119,133,136,163,169,214,217,"ATGATAA","CGGC","ATGATGA","CTGA",2.58450116912386,14,27,45,95,1.05892257202811,4.5722325915468,8.10846447560477,101,"ENSG00000079974.19"
"24352","ENSG00000175899.15_2625",2617,2625,9,"ENSG00000175899.15",1,8,"UVVVVVVMV",1,7,0.786749482401656,114,120,133,136,142,148,173,176,"ATGATGA","CTGT","GCAATGC","CTGA",2.63898285018435,13,6,25,53,2.25263884457577,4.9614644614512,8.10846239105782,101,"ENSG00000079974.19"
"2439","ENSG00000074755.15_100511",100503,100511,9,"ENSG00000074755.15",1,8,"VVVVVVVMV",0,8,0.884057971014493,83,89,133,136,146,152,161,164,"ATGCTGA","GTTA","CTGAGCA","CTGA",2.45872848065687,44,10,9,72,1.89715855311994,4.57217043937477,8.10840232343274,101,"ENSG00000079974.19"
"46780","ENSG00000287161.1_28533",28525,28533,9,"ENSG00000287161.1",0,NA,"VVVUVVVVV",1,8,0.880745341614907,77,83,102,105,113,119,133,136,"TTGCTGT","GTGA","ATGTTGG","CTGA",2.38588303144683,19,8,14,50,2.43559322941617,4.58537002643209,8.10835139289172,101,"ENSG00000079974.19"
"42289","ENSG00000261520.5_11688",11680,11688,9,"ENSG00000261520.5",1,5,"VVVUMVVVV",1,7,0.767287784679089,82,88,96,99,111,117,133,136,"TTGATGA","TTGA","GTGTGGA","CTGA",2.68415385724221,8,12,16,45,2.26152616336205,5.03897130291086,8.10812244162721,101,"ENSG00000079974.19"
"33532","ENSG00000230133.2_42384",42376,42384,9,"ENSG00000230133.2",1,2,"VMVVVVVVV",0,8,0.884057971014493,115,121,133,136,140,146,164,167,"AGGAGGA","TTGG","GTGAAAA","CTGA",2.37013753690222,12,4,18,43,2.48636535175112,4.57182056610815,8.10805245016612,101,"ENSG00000079974.19"
"29265","ENSG00000197584.13_14011",14003,14011,9,"ENSG00000197584.13",0,NA,"VVVVUVVVV",1,8,0.889855072463768,84,90,133,136,155,161,176,179,"ATGAAGA","CAGG","GTGATGG","CTGA",2.55811218052957,43,19,15,86,1.14036459807842,4.54861145040223,8.1080317402573,101,"ENSG00000079974.19"
"2851","ENSG00000078328.23_948865",948857,948865,9,"ENSG00000078328.23",1,6,"VVVVVMVVV",0,8,0.902691511387163,115,121,133,136,154,160,168,171,"ATTAAAA","GTGA","GTAATGA","CTGA",2.34496012856865,12,18,8,47,2.35584576824569,4.49722832300918,8.10799436855783,101,"ENSG00000079974.19"
"25663","ENSG00000182389.20_90169",90161,90169,9,"ENSG00000182389.20",1,7,"VVVVVVMVV",0,8,0.885300207039338,111,117,133,136,145,151,199,202,"CTGATGG","CTGT","TTCATTA","CTGA",2.47118121606964,16,9,48,82,1.79232234682367,4.56671594682199,8.10791677497934,101,"ENSG00000079974.19"
"15548","ENSG00000148655.15_728706",728698,728706,9,"ENSG00000148655.15",0,NA,"UVVVVVVVV",1,8,0.902691511387163,113,119,133,136,157,163,171,174,"ATAATTG","CTTA","ATGATCA","CTGA",2.37086157578121,14,21,8,52,2.18270976639425,4.49711340123392,8.10787944678257,101,"ENSG00000079974.19"
"36193","ENSG00000238242.2_716",708,716,9,"ENSG00000238242.2",1,1,"MVVVVVVVV",0,8,0.90600414078675,115,121,133,136,149,155,173,176,"ATAATAT","CAGA","CTGATAT","CTGA",2.34066154079021,12,13,18,52,2.33065410466633,4.48376609415027,8.10778265729727,101,"ENSG00000079974.19"
"3239","ENSG00000082516.9_9857",9849,9857,9,"ENSG00000082516.9",1,1,"MVVVVVVVV",0,8,0.90600414078675,84,90,133,136,153,159,169,172,"ATTATGA","CACA","GTTAGGA","CTGA",2.47597005801409,43,17,10,79,1.42859602662105,4.48376577001208,8.10778233315908,101,"ENSG00000079974.19"
"2923","ENSG00000079335.20_121980",121972,121980,9,"ENSG00000079335.20",1,6,"VVVVVMVVV",0,8,0.902691511387163,100,106,133,136,171,177,188,191,"GGGATGA","CAGA","GTGAAAT","CTGA",2.53195029558241,27,35,11,82,1.10835488214767,4.49700587984093,8.10777192538959,101,"ENSG00000079974.19"
"45840","ENSG00000285961.1_137658",137650,137658,9,"ENSG00000285961.1",0,NA,"VVVVVVUVV",1,8,0.886128364389234,103,109,133,136,144,150,169,172,"ATGAGGA","CTAT","ATGTGGA","CTGA",2.47088293475191,24,8,19,60,1.77990390892887,4.56311420181873,8.10762765937566,101,"ENSG00000079974.19"
"16256","ENSG00000151240.17_292715",292707,292715,9,"ENSG00000151240.17",1,6,"VVVVVMVVV",0,8,0.902691511387163,96,102,133,136,139,145,154,157,"AAGATGA","AGGA","TTCATGC","CTGA",2.43832758570199,31,3,9,52,1.73185569213954,4.4968432325382,8.10760927808686,101,"ENSG00000079974.19"
"27885","ENSG00000187555.17_23613",23605,23613,9,"ENSG00000187555.17",1,1,"MVVVVVUVV",1,7,0.792132505175983,81,87,99,102,107,113,133,136,"ATGCTGG","CTGA","ATGGAGA","CTGA",2.59554766922886,12,5,20,46,2.45213813458746,4.93894731569497,8.1074773363989,101,"ENSG00000079974.19"
"2841","ENSG00000078328.23_54143",54135,54143,9,"ENSG00000078328.23",0,NA,"UVVVVVVVV",1,8,0.902691511387163,32,38,70,73,79,85,133,136,"ATGATGA","CTGA","ATGCTTT","CTGC",2.54633204633205,32,6,48,95,1.01109655656085,4.49666088302696,8.10742692857561,101,"ENSG00000079974.19"
"25855","ENSG00000182985.18_81636",81628,81636,9,"ENSG00000182985.18",1,7,"VVVVVVMVV",0,8,0.885300207039338,114,120,133,136,138,144,153,156,"GAGATGA","CTTA","TTGAGGA","CTGG",2.3304649799087,13,2,9,33,2.72772849389642,4.56604042332194,8.10724125147929,101,"ENSG00000079974.19"
"43912","ENSG00000275342.5_58653",58645,58653,9,"ENSG00000275342.5",1,5,"VVVVMVVVV",0,8,0.886542443064182,113,119,133,136,147,153,177,180,"AAGCTGA","CTGC","GGGATGC","CTGA",2.4197105457757,14,11,24,58,2.1127909417063,4.56104864505275,8.10721841730948,101,"ENSG00000079974.19"
"30555","ENSG00000205696.5_971",963,971,9,"ENSG00000205696.5",1,1,"MVVVVVVVV",0,8,0.90600414078675,104,110,133,136,147,153,167,170,"ATGATTA","TTGA","AGGATGA","ATGA",2.39298913072771,23,11,14,57,1.97944904520958,4.48317747918191,8.10719404232891,101,"ENSG00000079974.19"
"19932","ENSG00000164035.10_183179",183171,183179,9,"ENSG00000164035.10",0,NA,"VVUVVUVVV",2,7,0.805797101449275,79,85,99,102,115,121,133,136,"CTGATTT","CTGA","GTGAAAA","CTGA",2.53761664584486,14,13,12,48,2.61795024237316,4.88384863700138,8.10703704279848,101,"ENSG00000079974.19"
"36952","ENSG00000243818.7_21367",21359,21367,9,"ENSG00000243818.7",1,7,"VVVVVVMVV",0,8,0.885300207039338,75,81,91,94,108,114,133,136,"ATGTTGA","CTGT","GTGAAGA","CTGC",2.42180466124584,10,14,19,52,2.11766958508476,4.56575849834759,8.10695932650495,101,"ENSG00000079974.19"
"20218","ENSG00000164440.15_34407",34399,34407,9,"ENSG00000164440.15",1,3,"VVMVVVVVV",0,8,0.882815734989648,68,74,83,86,96,102,133,136,"TTGATAG","CTGA","TTGATCT","CTGA",2.46915918432547,9,10,31,59,1.84161137725235,4.5756681515222,8.10693109148079,101,"ENSG00000079974.19"
"43576","ENSG00000272446.5_19590",19582,19590,9,"ENSG00000272446.5",1,3,"VVMVVVVVV",0,8,0.882815734989648,68,74,83,86,96,102,133,136,"TTGATAG","CTGA","TTGATCT","CTGA",2.46915918432547,9,10,31,59,1.84161137725235,4.5756681515222,8.10693109148079,101,"ENSG00000079974.19"
"24911","ENSG00000178568.15_809476",809468,809476,9,"ENSG00000178568.15",0,NA,"VVVVVVUVV",1,8,0.886128364389234,114,120,133,136,161,167,182,185,"ATGTTGA","CTAT","TTGAAAA","CTGA",2.44693387983955,13,25,15,62,1.93659430185274,4.5623717085291,8.10688516608603,101,"ENSG00000079974.19"
"35670","ENSG00000236699.9_59867",59859,59867,9,"ENSG00000236699.9",0,NA,"VVUVVVVVV",1,8,0.883643892339545,116,122,133,136,147,153,188,191,"GTCATGA","CCTA","CTGATGT","CTGA",2.46394027226486,11,11,35,66,1.8629197387305,4.57229705512406,8.10687262448224,101,"ENSG00000079974.19"
"20480","ENSG00000164938.14_1457",1449,1457,9,"ENSG00000164938.14",0,NA,"VVVVVVUVV",1,8,0.886128364389234,56,62,77,80,115,121,133,136,"ATAATGA","CTGA","TTGCAGA","CTGG",2.45414006322837,15,35,12,71,1.88741819608003,4.56208798773395,8.10660144529089,101,"ENSG00000079974.19"
"33993","ENSG00000231689.3_403707",403699,403707,9,"ENSG00000231689.3",1,1,"MVVVVVVVV",0,8,0.90600414078675,116,122,133,136,148,154,171,174,"ATGTTGA","TTGA","ATCTTGA","CTTA",2.32362427710254,11,12,17,49,2.43946780781975,4.48257408045916,8.10659064360616,101,"ENSG00000079974.19"
"21922","ENSG00000169306.10_277237",277229,277237,9,"ENSG00000169306.10",1,8,"VVVVVVVMV",0,8,0.884057971014493,116,122,133,136,170,176,185,188,"GAGATGA","GGGA","ATGAAGG","CTGA",2.44258253394584,11,34,9,63,1.99749908284033,4.57034566061982,8.10657754467779,101,"ENSG00000079974.19"
"35262","ENSG00000235495.1_16310",16302,16310,9,"ENSG00000235495.1",1,8,"VVVVVVVMV",0,8,0.884057971014493,66,72,94,97,105,111,133,136,"AGGATGG","CAGA","GAGATAA","CTGA",2.48252184234088,22,8,22,61,1.73123380696392,4.57034485564245,8.10657673970042,101,"ENSG00000079974.19"
"40175","ENSG00000255171.7_75227",75219,75227,9,"ENSG00000255171.7",0,NA,"UVVVVVVVV",1,8,0.902691511387163,95,101,133,136,149,155,172,175,"TTGATGA","CAAA","TGGATGT","CTGA",2.48515669440352,32,13,17,71,1.41517120773306,4.49572062593914,8.10648667148779,101,"ENSG00000079974.19"
"9750","ENSG00000126953.8_2581",2573,2581,9,"ENSG00000126953.8",1,2,"VMVVVVVVV",0,8,0.884057971014493,100,106,133,136,140,146,154,157,"ATTTTGA","CTCA","GTGTGGA","CTGA",2.45375912423526,27,4,8,48,1.92240794352868,4.57020052627428,8.10643241033225,101,"ENSG00000079974.19"
"41884","ENSG00000259905.7_539870",539862,539870,9,"ENSG00000259905.7",1,8,"VVVVVVVMV",0,8,0.884057971014493,92,98,133,136,147,153,168,171,"GTGATGC","GTCA","ATGCTGA","CTGA",2.49283832335647,35,11,15,70,1.66081535318411,4.56993437722348,8.10616626128145,101,"ENSG00000079974.19"
"46004","ENSG00000286110.1_83637",83629,83637,9,"ENSG00000286110.1",1,8,"VVVVVVVMV",0,8,0.884057971014493,92,98,133,136,147,153,168,171,"GTGATGC","GTCA","ATGCTGA","CTGA",2.49283832335647,35,11,15,70,1.66081535318411,4.56993437722348,8.10616626128145,101,"ENSG00000079974.19"
"39192","ENSG00000253288.2_196006",195998,196006,9,"ENSG00000253288.2",0,NA,"VVVVUVUVV",2,7,0.775983436853002,114,120,133,136,152,158,170,173,"GTGCTGA","CTGA","ATCAAGA","CTGA",2.63484098733525,13,16,12,50,2.44308430673262,5.00217272224191,8.10610646965392,101,"ENSG00000079974.19"
"2014","ENSG00000069020.19_338469",338461,338469,9,"ENSG00000069020.19",1,1,"MVVVVVVVV",0,8,0.90600414078675,116,122,133,136,144,150,165,168,"CTGATGA","CTCT","GTGGTAA","CTGG",2.2705285405376,11,8,15,43,2.79091879929339,4.48194393405269,8.10596049719969,101,"ENSG00000079974.19"
"14922","ENSG00000146147.15_313485",313477,313485,9,"ENSG00000146147.15",1,8,"VVVVVVVMV",0,8,0.884057971014493,100,106,133,136,139,145,153,156,"ATAATGA","GGGA","GAGTTGA","CTGA",2.47385220340359,27,3,8,47,1.78645625679972,4.56970106987257,8.10593295393054,101,"ENSG00000079974.19"
"32745","ENSG00000227712.3_5214",5206,5214,9,"ENSG00000227712.3",1,1,"MVVVVVVVV",0,8,0.90600414078675,111,117,133,136,138,144,181,184,"ATGATGC","CCCA","ATAAAGA","CTGA",2.47919664169585,16,2,37,64,1.39967058755162,4.48191204971432,8.10592861286132,101,"ENSG00000079974.19"
"22212","ENSG00000169946.14_607898",607890,607898,9,"ENSG00000169946.14",0,NA,"VVVVVUVVV",1,8,0.922153209109731,114,120,133,136,140,146,163,166,"AGTATGA","GTGC","GAGGAGA","CTGA",2.2688781501688,13,4,17,43,2.54338473928771,4.4173097684366,8.10592260487552,101,"ENSG00000079974.19"
"12963","ENSG00000139722.7_4279",4271,4279,9,"ENSG00000139722.7",0,NA,"VVVUVVVVV",1,8,0.880745341614907,86,92,133,136,173,179,190,193,"ATGCTGA","CTGG","GTGATTT","CTGA",2.59964787314072,41,37,11,98,1.00030119317018,4.58282175352708,8.10580311998671,101,"ENSG00000079974.19"
"36791","ENSG00000243024.7_102173",102165,102173,9,"ENSG00000243024.7",0,NA,"VVVVVVUVV",1,8,0.886128364389234,101,107,133,136,145,151,162,165,"AGGATGA","ATGT","GTAAGAA","CTGA",2.42603004780874,26,9,11,55,2.06998370779745,4.56087933996393,8.10539279752086,101,"ENSG00000079974.19"
"36873","ENSG00000243295.2_392292",392284,392292,9,"ENSG00000243295.2",1,8,"VVVVVVVMV",0,8,0.884057971014493,109,115,133,136,139,145,156,159,"CTGATGG","CAGT","TAGAAGA","CTGA",2.38486502268602,18,3,11,41,2.37717512748084,4.56906881968025,8.10530070373822,101,"ENSG00000079974.19"
"10834","ENSG00000132938.22_329743",329735,329743,9,"ENSG00000132938.22",1,8,"VVVVVVVMV",0,8,0.884057971014493,97,103,133,136,158,164,178,181,"ATGAAGA","TTGA","GTGTGGC","CTGA",2.57365948628339,30,22,14,75,1.11847319247929,4.5690507752588,8.10528265931677,101,"ENSG00000079974.19"
"45373","ENSG00000285534.1_107182",107174,107182,9,"ENSG00000285534.1",1,8,"VVVVVVVMV",0,8,0.884057971014493,89,95,106,109,116,122,133,136,"ATGATCA","CTGG","ATGGAGG","ATGA",2.28836009926694,11,7,11,38,3.0203974279366,4.56903285576238,8.10526473982035,101,"ENSG00000079974.19"
"19246","ENSG00000162618.15_385390",385382,385390,9,"ENSG00000162618.15",1,1,"MVVVVVUVV",1,7,0.792132505175983,113,119,133,136,145,151,159,162,"ATTCTGA","CTGA","TTAAAGA","CTGA",2.52282759779893,14,9,8,40,2.92774994011655,4.93665014802735,8.10518016873128,101,"ENSG00000079974.19"
"40508","ENSG00000256672.1_8105",8097,8105,9,"ENSG00000256672.1",1,7,"VVVVVVMVV",0,8,0.885300207039338,113,119,133,136,160,166,178,181,"GTGCTGC","CAGA","ATGAATA","CTGA",2.42798052217456,14,24,12,59,2.06862297279151,4.56378994682215,8.1049907749795,101,"ENSG00000079974.19"
"44417","ENSG00000281778.1_6798",6790,6798,9,"ENSG00000281778.1",0,NA,"UVVVVVVVV",1,8,0.902691511387163,109,115,133,136,160,166,186,189,"AGGATGA","ATGC","GTGATTC","CTGA",2.49699132119101,18,24,20,71,1.32946083274639,4.49401741017161,8.10478345572027,101,"ENSG00000079974.19"
"12499","ENSG00000138411.13_95434",95426,95434,9,"ENSG00000138411.13",1,8,"VVVVVVVMV",0,8,0.884057971014493,113,119,133,136,151,157,168,171,"TTAATTA","CTTA","GTGAAAA","CTGA",2.36541701027358,14,15,11,49,2.50469874044195,4.56853636889978,8.10476825295775,101,"ENSG00000079974.19"
"37250","ENSG00000246316.8_96402",96394,96402,9,"ENSG00000246316.8",0,NA,"VVVVUVVVV",1,8,0.889855072463768,103,109,133,136,149,155,173,176,"ATGCTTA","CTGA","GGGAAAA","CTGA",2.494944651338,24,13,18,64,1.5482134034586,4.54529443642798,8.10471472628305,101,"ENSG00000079974.19"
"4170","ENSG00000096093.16_99712",99704,99712,9,"ENSG00000096093.16",1,8,"VVVVVVVMV",0,8,0.884057971014493,64,70,83,86,96,102,133,136,"CTGATGA","CTGA","ATTAGTA","TTGA",2.44085294006452,13,10,31,63,2.00097704281049,4.56833249414349,8.10456437820146,101,"ENSG00000079974.19"
"3245","ENSG00000082701.17_171329",171321,171329,9,"ENSG00000082701.17",1,1,"MVVVVVVVV",0,8,0.90600414078675,116,122,133,136,149,155,166,169,"ATTATTA","GTGG","ATTATTA","CTGA",2.28876241768145,11,13,11,44,2.6634266443293,4.48046069055141,8.10447725369841,101,"ENSG00000079974.19"
"20956","ENSG00000166035.11_57493",57485,57493,9,"ENSG00000166035.11",1,3,"VVMVVVVVV",0,8,0.882815734989648,114,120,133,136,139,145,153,156,"ATGATGC","CGGT","ATGATAA","GTGA",2.31115149990423,13,3,8,33,2.88489831338736,4.57314374485389,8.10440668481248,101,"ENSG00000079974.19"
"23568","ENSG00000173258.13_5328",5320,5328,9,"ENSG00000173258.13",1,7,"VVVVVVMVV",0,8,0.885300207039338,114,120,133,136,144,150,160,163,"ATCTTGT","CTGG","GACATGA","CTGA",2.28561812576808,13,8,10,40,3.01535129197326,4.56320136594012,8.10440219409747,101,"ENSG00000079974.19"
"46304","ENSG00000286475.1_118802",118794,118802,9,"ENSG00000286475.1",1,2,"VMVVVVVVV",0,8,0.884057971014493,98,104,133,136,149,155,211,214,"TTGATGA","CTCA","TTGAAGG","CTGA",2.62787256813082,29,13,56,107,0.753362046034443,4.56812812505997,8.10436000911794,101,"ENSG00000079974.19"
"24543","ENSG00000176771.18_836990",836982,836990,9,"ENSG00000176771.18",1,8,"VVVVVVVMV",0,8,0.884057971014493,115,121,133,136,148,154,176,179,"CTGATTA","ATGC","GTGAGGT","CTGA",2.41478252453267,12,12,22,55,2.17363713207623,4.56804682390684,8.10427870796481,101,"ENSG00000079974.19"
"5377","ENSG00000104381.14_195392",195384,195392,9,"ENSG00000104381.14",1,6,"VVVVVMVVV",0,8,0.902691511387163,80,86,97,100,113,119,133,136,"ATGATAA","TTGA","CTAATTA","ATGA",2.31458071172296,11,13,14,47,2.54308597207888,4.49340601255799,8.10417205810664,101,"ENSG00000079974.19"
"43394","ENSG00000271826.5_36101",36093,36101,9,"ENSG00000271826.5",0,NA,"VVVVUVVVV",1,8,0.889855072463768,73,79,94,97,114,120,133,136,"GTGATGG","CTGA","TTTATGC","CTCA",2.38831500951627,15,17,13,54,2.25681095909287,4.54472775563367,8.10414804548874,101,"ENSG00000079974.19"
"39511","ENSG00000253693.1_271547",271539,271547,9,"ENSG00000253693.1",1,7,"VVVVVVMVV",0,8,0.885300207039338,116,122,133,136,140,146,155,158,"AGGTTGA","AAGA","ATGGGCA","CTGA",2.28477144464589,11,4,9,33,3.01944027565145,4.562812476656,8.10401330481336,101,"ENSG00000079974.19"
"8730","ENSG00000120526.12_74747",74739,74747,9,"ENSG00000120526.12",1,1,"MVVVVVVVV",0,8,0.90600414078675,47,53,62,65,114,120,133,136,"ATAATGA","CTGA","TAGATGC","ATGA",2.42451892423223,9,49,13,80,1.75644764822834,4.47997678577746,8.10399334892446,101,"ENSG00000079974.19"
"27306","ENSG00000185942.13_25571",25563,25571,9,"ENSG00000185942.13",0,NA,"VVVVUVVVV",1,8,0.889855072463768,112,118,133,136,141,147,156,159,"ATGAGAA","TTAA","ATTATTA","CTGA",2.29181139474611,15,5,9,38,2.89939127144395,4.54453347577117,8.10395376562625,101,"ENSG00000079974.19"
"2949","ENSG00000079691.19_244088",244080,244088,9,"ENSG00000079691.19",1,8,"VVVVVVVMV",0,8,0.884057971014493,112,118,133,136,150,156,173,176,"GAGATGA","GTGG","ATCAAGA","CTGA",2.4061381186294,15,14,17,55,2.22992779161346,4.56771214561903,8.103944029677,101,"ENSG00000079974.19"
"36966","ENSG00000243944.5_67922",67914,67922,9,"ENSG00000243944.5",1,7,"VVVVVVMVV",0,8,0.885300207039338,84,90,133,136,139,145,153,156,"GTGATGA","TTAA","GAAAGGA","CTGA",2.48531922199821,43,3,8,63,1.68145940291135,4.56256355405818,8.10376438221553,101,"ENSG00000079974.19"
"8335","ENSG00000118271.12_23094",23086,23094,9,"ENSG00000118271.12",1,8,"VVVVVVVMV",0,8,0.884057971014493,91,97,106,109,115,121,133,136,"GTGATGA","CCAA","TTGAAGT","CTGT",2.30840927242321,9,6,12,36,2.88069458060241,4.56752243252261,8.10375431658058,101,"ENSG00000079974.19"
"10811","ENSG00000132906.18_10871",10863,10871,9,"ENSG00000132906.18",0,NA,"UVVVVVVVV",1,8,0.902691511387163,116,122,133,136,173,179,231,234,"GTGATGG","CTGT","TTGTTGT","CTGA",2.54729665313692,11,37,52,109,0.989866526200967,4.4929610534451,8.10372709899375,101,"ENSG00000079974.19"
"18891","ENSG00000159216.19_1106980",1106972,1106980,9,"ENSG00000159216.19",1,1,"MVVVVVVVV",0,8,0.90600414078675,115,121,133,136,155,161,175,178,"ATGAGGG","GTCA","ATGTTGT","CTGA",2.3585990426149,12,19,14,54,2.1943386975864,4.47958307875477,8.10359964190176,101,"ENSG00000079974.19"
"966","ENSG00000042317.17_81209",81201,81209,9,"ENSG00000042317.17",0,NA,"UVVVVVVVV",1,8,0.902691511387163,104,110,133,136,147,153,161,164,"GAGATGG","CTTA","CTAAGGA","CTGA",2.38237387098044,23,11,8,51,2.0887299741822,4.49280561184628,8.10357165739493,101,"ENSG00000079974.19"
"6252","ENSG00000108984.15_59545",59537,59545,9,"ENSG00000108984.15",1,6,"UVVVVMVVV",1,7,0.805383022774327,112,118,133,136,183,189,206,209,"ATGTTGG","CTGA","TTGATGA","CTGA",2.68789189904442,15,47,17,88,1.60881258590615,4.88202297821724,8.10355506931455,101,"ENSG00000079974.19"
"38003","ENSG00000249332.2_143420",143412,143420,9,"ENSG00000249332.2",1,1,"MVVVVUVVV",1,7,0.82815734989648,112,118,133,136,171,177,190,193,"ATGATGA","TTAA","ATAATTA","CTGA",2.59724201282008,15,35,13,72,1.84848724653022,4.79085849966602,8.10348789925194,101,"ENSG00000079974.19"
"6523","ENSG00000110436.13_49923",49915,49923,9,"ENSG00000110436.13",1,6,"VVVVVMVVV",0,8,0.902691511387163,116,122,133,136,142,148,184,187,"ATGCTGT","CTTG","CTGATGG","CTGA",2.3951894328049,11,6,36,62,2.00268759171064,4.49265428593583,8.10342033148448,101,"ENSG00000079974.19"
"3219","ENSG00000082397.18_90480",90472,90480,9,"ENSG00000082397.18",0,NA,"VVVVVUVVV",1,8,0.922153209109731,79,85,102,105,115,121,133,136,"GTAAGGA","TTGT","GTGAAAT","CTGA",2.25686225769454,17,10,12,48,2.6131047904488,4.41471329376977,8.10332613020869,101,"ENSG00000079974.19"
"11640","ENSG00000135604.11_15058",15050,15058,9,"ENSG00000135604.11",1,6,"VVVVVMVVV",0,8,0.902691511387163,116,122,133,136,146,152,161,164,"ATAGTGA","CCTA","TTCCTGA","CTGA",2.25788213888448,11,10,9,39,2.91644152759617,4.49224728003985,8.1030133255885,101,"ENSG00000079974.19"
"11330","ENSG00000134533.6_2359",2351,2359,9,"ENSG00000134533.6",1,1,"MVVVVVVVV",0,8,0.90600414078675,35,41,56,59,108,114,133,136,"ATGATGC","CTGA","ATTTTGA","TTGA",2.46442797725768,15,49,19,92,1.48587100541495,4.47884771344987,8.10286427659687,101,"ENSG00000079974.19"
"29985","ENSG00000198947.18_1750535",1750527,1750535,9,"ENSG00000198947.18",1,2,"VMVVVVVVV",0,8,0.884057971014493,114,120,133,136,144,150,206,209,"ATGACAA","CTAA","GTGTTAA","CTGA",2.4425452547024,13,8,56,86,1.98279237407987,4.5666068513573,8.10283873541528,101,"ENSG00000079974.19"
"12400","ENSG00000138081.22_6876",6868,6876,9,"ENSG00000138081.22",0,NA,"VVVUVVVVV",1,8,0.880745341614907,115,121,133,136,151,157,167,170,"AGTATGA","CAGA","GATATGG","CTGA",2.36419366280284,12,15,10,46,2.55807491051647,4.57984149896718,8.10282286542681,101,"ENSG00000079974.19"
"9723","ENSG00000126775.9_37735",37727,37735,9,"ENSG00000126775.9",1,8,"VVVVVVVMV",0,8,0.884057971014493,92,98,133,136,145,151,164,167,"TCGATGA","CTCA","GTGAATT","CTGA",2.45813498253887,35,9,13,66,1.87831445428497,4.56647025113603,8.102702135194,101,"ENSG00000079974.19"
"40874","ENSG00000258028.3_117429",117421,117429,9,"ENSG00000258028.3",1,7,"VVVVUVMVV",1,7,0.775155279503105,102,108,133,136,143,149,159,162,"ATGATGA","CTGA","CTGAAGA","CTGG",2.67525337837838,25,7,10,51,2.17220053707831,5.00180576490021,8.10242688291263,101,"ENSG00000079974.19"
"35719","ENSG00000236858.2_3334",3326,3334,9,"ENSG00000236858.2",1,5,"VVVVMVVVV",0,8,0.886542443064182,83,89,101,104,114,120,133,136,"CTGATGA","CTGA","CTGGTGA","GTGC",2.3098201215317,12,10,13,44,2.82618681826955,4.55624690712023,8.10241667937695,101,"ENSG00000079974.19"
"28083","ENSG00000188107.15_256954",256946,256954,9,"ENSG00000188107.15",0,NA,"VVVVVUVVV",1,8,0.922153209109731,113,119,133,136,177,183,195,198,"CTGATTT","TGGA","GTGATAA","CTGA",2.35897590403922,14,41,12,76,1.92798420103079,4.41362255698973,8.10223539342866,101,"ENSG00000079974.19"
"10832","ENSG00000132938.22_298076",298068,298076,9,"ENSG00000132938.22",0,NA,"VVUVUVVVV",2,7,0.773498964803312,64,70,92,95,108,114,133,136,"GTGATGG","CTGA","GTGATGC","CTGA",2.76388812727689,22,13,19,63,1.60644073866747,5.00809039679502,8.10208625600827,101,"ENSG00000079974.19"
"14824","ENSG00000145934.17_545837",545829,545837,9,"ENSG00000145934.17",1,1,"MVVVVVVVV",0,8,0.90600414078675,115,121,133,136,148,154,207,210,"ATGATGG","ATGC","ATTACAA","CTGA",2.42175147301538,12,12,53,86,1.76720924409634,4.47805476604972,8.10207132919672,101,"ENSG00000079974.19"
"21237","ENSG00000166866.13_9406",9398,9406,9,"ENSG00000166866.13",1,3,"VVMVVVVVV",0,8,0.882815734989648,96,102,133,136,145,151,160,163,"ATGATAA","CTAC","GAGATGG","CTGA",2.44526568050633,31,9,9,58,1.98125443454102,4.57075640947915,8.10201934943774,101,"ENSG00000079974.19"
"20900","ENSG00000165973.19_188018",188010,188018,9,"ENSG00000165973.19",1,8,"VVVVVUVMV",1,7,0.806211180124224,69,75,90,93,115,121,133,136,"TTGATGA","GTGA","GTGAGTG","CTGA",2.61561484733117,15,22,12,58,2.0710442124013,4.87711913198561,8.1019638524825,101,"ENSG00000079974.19"
"30957","ENSG00000214942.6_31444",31436,31444,9,"ENSG00000214942.6",0,NA,"VVVVVVUVV",1,8,0.886128364389234,47,53,61,64,114,120,133,136,"ATGATGA","CTGG","CTGAAAA","CTGT",2.48663168185618,8,50,13,80,1.65108091071049,4.55715636410459,8.10166982166153,101,"ENSG00000079974.19"
"3244","ENSG00000082701.17_127495",127487,127495,9,"ENSG00000082701.17",1,1,"MVVVVVVVV",0,8,0.90600414078675,106,112,133,136,165,171,182,185,"TTGATTA","ATGA","AAGATTA","CTGA",2.46805717063551,21,29,11,70,1.45685882464078,4.47764332388604,8.10165988703304,101,"ENSG00000079974.19"
"2429","ENSG00000074590.14_42055",42047,42055,9,"ENSG00000074590.14",1,2,"UMVVVVVVV",1,7,0.786749482401656,88,94,102,105,112,118,133,136,"ATGATGG","TTAA","ATGAGGA","CTGA",2.58369482281073,8,7,15,39,2.59301425950687,4.95441160289461,8.10140953250123,101,"ENSG00000079974.19"
"37550","ENSG00000248457.1_11369",11361,11369,9,"ENSG00000248457.1",1,1,"MVVVVVUVV",1,7,0.792132505175983,116,122,133,136,139,145,168,171,"ATAATGA","CTGT","CTGAAGA","CTGA",2.65393372422353,11,3,23,46,2.03848953930171,4.93284525853131,8.10137527923524,101,"ENSG00000079974.19"
"9374","ENSG00000124275.15_12088",12080,12088,9,"ENSG00000124275.15",1,1,"MVVVVVVVV",0,8,0.90600414078675,110,116,133,136,144,150,192,195,"GTAAAGA","GTGA","GTGAGAA","CTGA",2.42292896499506,17,8,42,76,1.75534155870758,4.47705033133533,8.10106689448232,101,"ENSG00000079974.19"
"42379","ENSG00000261835.1_339",331,339,9,"ENSG00000261835.1",0,NA,"VVVVUVVVV",1,8,0.889855072463768,111,117,133,136,151,157,176,179,"CTGATGA","CAGA","GTGTTGT","CTGT",2.42991681424847,16,15,19,59,1.96697726712914,4.54160567386307,8.10102596371814,101,"ENSG00000079974.19"
"13217","ENSG00000140577.17_69387",69379,69387,9,"ENSG00000140577.17",1,7,"VVVVVVMVV",0,8,0.885300207039338,112,118,133,136,142,148,156,159,"CTGATGT","CTGT","GTGCTGC","CTGG",2.29581727149698,15,6,8,38,2.93326392823231,4.55967810121972,8.10087892937707,101,"ENSG00000079974.19"
"44857","ENSG00000283886.3_43587",43579,43587,9,"ENSG00000283886.3",1,7,"VVVVVVMVV",0,8,0.885300207039338,20,26,71,74,114,120,133,136,"ATGATGC","CAGA","GTGCAAA","CTGA",2.59677129159607,45,40,13,107,0.926849061934064,4.55966441814363,8.10086524630097,101,"ENSG00000079974.19"
"48495","ENSG00000291181.1_275686",275678,275686,9,"ENSG00000291181.1",1,7,"VVVVVVMVV",0,8,0.885300207039338,20,26,71,74,114,120,133,136,"ATGATGC","CAGA","GTGCAAA","CTGA",2.59677129159607,45,40,13,107,0.926849061934064,4.55966441814363,8.10086524630097,101,"ENSG00000079974.19"
"1241","ENSG00000050405.14_71655",71647,71655,9,"ENSG00000050405.14",1,1,"MVVVVVVVV",0,8,0.90600414078675,96,102,133,136,140,146,157,160,"ATGATTA","CTAA","GTGATAA","CAGA",2.40775145277844,31,4,11,55,1.85564178792783,4.47682953494602,8.10084609809302,101,"ENSG00000079974.19"
"333","ENSG00000008394.13_198815",198807,198815,9,"ENSG00000008394.13",0,NA,"VVVVVVUVV",1,8,0.886128364389234,107,113,133,136,150,156,174,177,"AAGATGA","CTAG","GTGTTTA","CTGA",2.47138516612346,20,14,18,61,1.74919895396961,4.55627501536484,8.10078847292178,101,"ENSG00000079974.19"
"6346","ENSG00000109452.13_604655",604647,604655,9,"ENSG00000109452.13",1,1,"MVVVVVVVV",0,8,0.90600414078675,113,119,133,136,147,153,166,169,"GGGATGT","GAGA","GGGAGGG","CTGA",2.27789914222694,14,11,13,47,2.72089110698782,4.47672134712518,8.10073791027218,101,"ENSG00000079974.19"
"24729","ENSG00000177694.16_45196",45188,45196,9,"ENSG00000177694.16",1,8,"VVUVVVVMV",1,7,0.767701863354037,102,108,133,136,148,154,163,166,"ATGAGGA","CTGA","ATGAAAA","CTGA",2.72749963045261,25,12,9,55,1.93626823421288,5.02989977597424,8.10070722939039,101,"ENSG00000079974.19"
"22375","ENSG00000170417.16_198740",198732,198740,9,"ENSG00000170417.16",0,NA,"VVVVVUVVV",1,8,0.922153209109731,114,120,133,136,185,191,210,213,"ATGCAGA","CTAA","TTGATAT","CTGA",2.41128959228275,13,49,19,90,1.57200385227712,4.41181695020719,8.10042978664612,101,"ENSG00000079974.19"
"12392","ENSG00000138068.12_10717",10709,10717,9,"ENSG00000138068.12",0,NA,"VVVVUVVVV",1,8,0.889855072463768,67,73,82,85,103,109,133,136,"CTGATGA","CTGA","AGGATGG","TTGA",2.49617388601047,9,18,24,60,1.52282063832954,4.54099496959983,8.10041525945491,101,"ENSG00000079974.19"
"10703","ENSG00000132434.10_16962",16954,16962,9,"ENSG00000132434.10",1,2,"VMVVVVVVV",0,8,0.884057971014493,101,107,133,136,146,152,164,167,"ATGAGGA","TTAA","CTCATGG","CTGA",2.44002880543485,26,10,12,57,1.98985264061269,4.56417783587793,8.1004097199359,101,"ENSG00000079974.19"
"6272","ENSG00000109163.7_270",262,270,9,"ENSG00000109163.7",1,8,"VVVVVVVMV",0,8,0.884057971014493,83,89,133,136,140,146,161,164,"TTGTTGA","CTCA","ATGAAGC","CTGA",2.49020692745486,44,4,15,72,1.65518043860884,4.56413998874364,8.10037187280161,101,"ENSG00000079974.19"
"14072","ENSG00000144339.12_8782",8774,8782,9,"ENSG00000144339.12",0,NA,"VVVVVVUVV",1,8,0.886128364389234,116,122,133,136,156,162,173,176,"AAGATTA","CTAA","ATAATCA","CTGA",2.39750964702345,11,20,11,51,2.23906693182003,4.55561614466075,8.10012960221768,101,"ENSG00000079974.19"
"27421","ENSG00000186111.11_61050",61042,61050,9,"ENSG00000186111.11",1,8,"VVVVUVVMV",1,7,0.773913043478261,50,56,98,101,114,120,133,136,"GTGATGA","CTGA","ATGAAAG","CTGA",2.76054342539434,42,13,13,77,1.61397773718496,5.00440014328681,8.10005231719986,101,"ENSG00000079974.19"
"11987","ENSG00000136828.19_173448",173440,173448,9,"ENSG00000136828.19",0,NA,"UVVVVVUVV",2,7,0.788819875776397,80,86,97,100,113,119,133,136,"TTAATGA","ATGA","GTGATGG","CTGA",2.58533392825057,11,13,14,47,2.54308597207888,4.94466137343733,8.09994087654292,101,"ENSG00000079974.19"
"33627","ENSG00000230533.5_103647",103639,103647,9,"ENSG00000230533.5",1,1,"MVVVVUVVV",1,7,0.82815734989648,76,82,96,99,112,118,133,136,"AACATGA","GTGA","GGGATGA","CTGA",2.50092343132095,14,13,15,51,2.47562110031658,4.78711099394739,8.09974039353331,101,"ENSG00000079974.19"
"133","ENSG00000005339.15_32059",32051,32059,9,"ENSG00000005339.15",1,6,"VVVVVMVVV",0,8,0.902691511387163,106,112,133,136,167,173,187,190,"ATGAAGT","ATGA","CTGAATA","CTGA",2.49479511623813,21,31,14,75,1.32363894283202,4.48890159610489,8.09966764165355,101,"ENSG00000079974.19"
"7264","ENSG00000113441.16_62084",62076,62084,9,"ENSG00000113441.16",1,1,"MVVVVVVVV",0,8,0.90600414078675,79,85,96,99,107,113,133,136,"GTAATGA","TTGA","GTGGTGC","CTAA",2.31337084848615,11,8,20,48,2.47968242405704,4.47553868682451,8.0995552499715,101,"ENSG00000079974.19"
"10439","ENSG00000131044.19_15897",15889,15897,9,"ENSG00000131044.19",0,NA,"UVVVVVVVV",1,8,0.902691511387163,116,122,133,136,185,191,203,206,"GTTAAGA","CAGA","CTGAGGT","CTGA",2.40315289814969,11,49,12,81,1.9339283015469,4.48873690563621,8.09950295118486,101,"ENSG00000079974.19"
"10309","ENSG00000130449.6_145574",145566,145574,9,"ENSG00000130449.6",1,5,"VVVVMVVVV",0,8,0.886542443064182,51,57,69,72,115,121,133,136,"ATTATGA","CTGA","CTTAAGA","CTCA",2.43765286404335,12,43,12,76,1.96219407236737,4.55330329149742,8.09947306375415,101,"ENSG00000079974.19"
"38768","ENSG00000251003.9_249327",249319,249327,9,"ENSG00000251003.9",1,8,"VVVVVVVMV",0,8,0.884057971014493,83,89,101,104,108,114,133,136,"ATGTAGA","ATGA","AAGAAGC","CTGA",2.37458790744147,12,4,19,44,2.42189389354475,4.56311998578864,8.09935186984661,101,"ENSG00000079974.19"
"12468","ENSG00000138336.9_87873",87865,87873,9,"ENSG00000138336.9",1,7,"VVVVVVMVV",0,8,0.885300207039338,72,78,98,101,112,118,133,136,"CTTAGGA","CTGA","TTTATTA","CTGA",2.41349819517824,20,11,15,55,2.14258642665929,4.55814359862856,8.09934442678591,101,"ENSG00000079974.19"
"18438","ENSG00000157423.18_111852",111844,111852,9,"ENSG00000157423.18",0,NA,"VVVVUVVVV",1,8,0.889855072463768,112,118,133,136,151,157,166,169,"GTCATGG","CAGG","GAGATGA","CTGA",2.35437832140581,15,15,9,48,2.46377057221836,4.53990651206427,8.09932680191934,101,"ENSG00000079974.19"
"44030","ENSG00000276975.4_44629",44621,44629,9,"ENSG00000276975.4",0,NA,"VVVVUVVVV",1,8,0.889855072463768,112,118,133,136,151,157,166,169,"GTCATGG","CAGG","GAGATGA","CTGA",2.35437832140581,15,15,9,48,2.46377057221836,4.53990651206427,8.09932680191934,101,"ENSG00000079974.19"
"48528","ENSG00000291242.1_119430",119422,119430,9,"ENSG00000291242.1",0,NA,"VVVVUVVVV",1,8,0.889855072463768,112,118,133,136,151,157,166,169,"GTCATGG","CAGG","GAGATGA","CTGA",2.35437832140581,15,15,9,48,2.46377057221836,4.53990651206427,8.09932680191934,101,"ENSG00000079974.19"
"4086","ENSG00000094841.14_148077",148069,148077,9,"ENSG00000094841.14",1,2,"VMVVVVVVV",0,8,0.884057971014493,114,120,133,136,146,152,164,167,"ATGCTTT","CTAA","ATGTTCA","CTGA",2.30866032222229,13,10,12,44,2.86058706384062,4.56291396966396,8.09914585372194,101,"ENSG00000079974.19"
"12603","ENSG00000138678.11_46556",46548,46556,9,"ENSG00000138678.11",0,NA,"VVUVVUVVV",2,7,0.805797101449275,116,122,133,136,142,148,161,164,"AACATGA","CTGC","GGGATGA","CTGA",2.48715622230968,11,6,13,39,2.9225369314352,4.87589460337494,8.09908300917204,101,"ENSG00000079974.19"
"27720","ENSG00000187239.19_137490",137482,137490,9,"ENSG00000187239.19",1,2,"VMVVVVVVV",0,8,0.884057971014493,82,88,100,103,110,116,133,136,"ATAGAGA","CTGA","ATTAAAA","CTGA",2.33211402563467,12,7,17,45,2.70378843106325,4.56280381715693,8.0990357012149,101,"ENSG00000079974.19"
"37332","ENSG00000247213.7_51883",51875,51883,9,"ENSG00000247213.7",0,NA,"VVVVVUVVV",1,8,0.922153209109731,82,88,98,101,112,118,133,136,"CTGAGGA","TTGA","ATGTTCA","GTGA",2.25958939949254,10,11,15,45,2.57752100538807,4.41036258383459,8.09897542027351,101,"ENSG00000079974.19"
"17393","ENSG00000154027.19_89938",89930,89938,9,"ENSG00000154027.19",1,1,"MVVVVUVVV",1,7,0.82815734989648,116,122,133,136,145,151,163,166,"GTGATCA","TTGC","ATGAAGG","CTGA",2.43560530499964,11,9,12,41,2.90761341977754,4.78624552994378,8.0988749295297,101,"ENSG00000079974.19"
"4609","ENSG00000101333.19_162103",162095,162103,9,"ENSG00000101333.19",1,8,"VVVVVVVMV",0,8,0.884057971014493,111,117,133,136,164,170,184,187,"GTGATTA","GGGA","GTAATGA","CTGA",2.47015941172341,16,28,14,67,1.78260242176204,4.56258295831286,8.09881484237083,101,"ENSG00000079974.19"
"32316","ENSG00000226695.1_726",718,726,9,"ENSG00000226695.1",1,1,"MVVVVVVVV",0,8,0.90600414078675,111,117,133,136,181,187,199,202,"GTGAAGA","AGGA","AGGAAGA","CTGA",2.4150815648929,16,45,12,82,1.7985763190138,4.47478002124161,8.09879658438861,101,"ENSG00000079974.19"
"17433","ENSG00000154162.15_465503",465495,465503,9,"ENSG00000154162.15",1,8,"VVVVVVVMV",0,8,0.884057971014493,17,23,64,67,78,84,133,136,"ATGATGA","CTGA","ATGATAC","CTGG",2.61148648648649,41,11,49,110,0.839254237418363,4.56229103683207,8.09852292089004,101,"ENSG00000079974.19"
"30605","ENSG00000206043.7_1739",1731,1739,9,"ENSG00000206043.7",1,2,"VMVVVVVVV",0,8,0.884057971014493,68,74,82,85,97,103,133,136,"GTGATGA","CTAA","ATGATGG","GTGA",2.49383504746295,8,12,30,59,1.62354765570473,4.56227865969777,8.09851054375574,101,"ENSG00000079974.19"
"2079","ENSG00000069974.17_107908",107900,107908,9,"ENSG00000069974.17",1,8,"VVVVVVVMV",0,8,0.884057971014493,115,121,133,136,138,144,152,155,"ATCCTGA","CAAA","CTGGAGA","CTGA",2.31469938547144,12,2,8,31,2.81723734531405,4.56214164544759,8.09837352950556,101,"ENSG00000079974.19"
"26751","ENSG00000185008.19_167905",167897,167905,9,"ENSG00000185008.19",1,1,"MVVVVVVVV",0,8,0.90600414078675,116,122,133,136,142,148,163,166,"ATTATGA","AGGA","ATGAAGT","GTGA",2.26457046978605,11,6,15,41,2.79987486950126,4.47425283368539,8.09826939683239,101,"ENSG00000079974.19"
"21896","ENSG00000169282.18_60562",60554,60562,9,"ENSG00000169282.18",0,NA,"VVVVVUVVV",1,8,0.922153209109731,96,102,133,136,156,162,171,174,"TTGATGG","GTGG","CTGATTA","CTGA",2.44946188744055,31,20,9,69,1.30871420087971,4.40961502928752,8.09822786572644,101,"ENSG00000079974.19"
"38741","ENSG00000250971.3_52859",52851,52859,9,"ENSG00000250971.3",1,3,"VVMVVVVVV",0,8,0.882815734989648,111,117,133,136,162,168,176,179,"AAGAGGA","TAGA","TTGATGA","CTGA",2.45175736955581,16,26,8,59,1.92235087620351,4.5668500016439,8.09811294160249,101,"ENSG00000079974.19"
"23191","ENSG00000172292.15_260783",260775,260783,9,"ENSG00000172292.15",1,1,"MVVVVVVVV",0,8,0.90600414078675,72,78,89,92,99,105,133,136,"ATCATGA","CTGT","GTGCTGT","ATGA",2.36191576047391,11,7,28,55,2.14934927732014,4.47386358678656,8.09788014993356,101,"ENSG00000079974.19"
"24549","ENSG00000176788.9_36745",36737,36745,9,"ENSG00000176788.9",0,NA,"UVVVVVVVV",1,8,0.902691511387163,116,122,133,136,152,158,172,175,"CTTATGA","AAGA","GGGAATA","CTGA",2.34192880269201,11,16,14,50,2.3355633506582,4.48710550881789,8.09787155436655,101,"ENSG00000079974.19"
"11409","ENSG00000134852.15_51806",51798,51806,9,"ENSG00000134852.15",1,1,"MVVVVVVVV",0,8,0.90600414078675,111,117,133,136,156,162,188,191,"TTGTTGA","TGGA","TTGATGA","CTGA",2.48142483497439,16,20,26,71,1.35226789603989,4.47377503230062,8.09779159544762,101,"ENSG00000079974.19"
"15243","ENSG00000147481.17_545094",545086,545094,9,"ENSG00000147481.17",0,NA,"VVVVVVUVV",1,8,0.886128364389234,103,109,133,136,139,145,156,159,"ATTATCT","CTGA","CTGAGTA","CTGA",2.44583090942036,24,3,11,47,1.90743934913589,4.5532446863179,8.09775814387484,101,"ENSG00000079974.19"
"38693","ENSG00000250891.3_536523",536515,536523,9,"ENSG00000250891.3",1,6,"VVVVUMVVV",1,7,0.792546583850932,84,90,133,136,142,148,169,172,"ATGATGT","CTGA","CTGACTA","CTGA",2.73972062217475,43,6,21,79,1.44460658411192,4.9273526829859,8.09753901838962,101,"ENSG00000079974.19"
"6611","ENSG00000111058.8_168257",168249,168257,9,"ENSG00000111058.8",1,2,"VMVVVVVVV",0,8,0.884057971014493,110,116,133,136,166,172,185,188,"AGGATGA","CTTG","TTCATGA","CTGA",2.47799904199066,17,30,13,69,1.72518065903185,4.56129356807573,8.0975254521337,101,"ENSG00000079974.19"
"31724","ENSG00000224577.4_132480",132472,132480,9,"ENSG00000224577.4",1,1,"MVVVVVVVV",0,8,0.90600414078675,114,120,133,136,145,151,162,165,"ATGAAGA","CAGT","GTGCTTA","GTGA",2.24168318476508,13,9,11,42,2.94939053734931,4.47348627561246,8.09750283875946,101,"ENSG00000079974.19"
"33816","ENSG00000231231.5_6708",6700,6708,9,"ENSG00000231231.5",1,1,"MVVVVVVVV",0,8,0.90600414078675,113,119,133,136,160,166,196,199,"TTCATGA","TTAA","ATGATGA","CTGA",2.49845633361582,14,24,30,77,1.23722345217979,4.47339975240465,8.09741631555165,101,"ENSG00000079974.19"
"23490","ENSG00000173068.19_327495",327487,327495,9,"ENSG00000173068.19",0,NA,"VVVVVUUVV",2,7,0.808281573498965,64,70,85,88,109,115,133,136,"CTGATTA","CTGA","TTGTTGA","CTGA",2.65093656421065,15,21,18,63,1.78389884106296,4.86420231728348,8.09732861127934,101,"ENSG00000079974.19"
"41577","ENSG00000259283.2_46966",46958,46966,9,"ENSG00000259283.2",1,2,"VMVVVUVVV",1,7,0.806211180124223,113,119,133,136,144,150,160,163,"ATGATCA","CATA","CTGAAGG","CTGA",2.47725391441232,14,8,10,41,2.97467924659022,4.87242633566808,8.09727105616498,101,"ENSG00000079974.19"
"24969","ENSG00000178913.9_1795",1787,1795,9,"ENSG00000178913.9",1,1,"MVVVVVVVV",0,8,0.90600414078675,59,65,82,85,95,101,133,136,"AGGAAGA","CTCA","AAGAGGA","CTGA",2.42239855804098,17,10,32,68,1.74357204364903,4.47322394098056,8.09724050412756,101,"ENSG00000079974.19"
"43956","ENSG00000275832.5_14148",14140,14148,9,"ENSG00000275832.5",0,NA,"UVVVVVVVV",1,8,0.902691511387163,13,19,36,39,71,77,133,136,"ATGAGGT","CTGA","ATTATTA","CTGA",2.57321687424898,17,32,56,114,0.790863299937852,4.48641061539944,8.09717666094809,101,"ENSG00000079974.19"
"22175","ENSG00000169933.17_41313",41305,41313,9,"ENSG00000169933.17",1,1,"MVVVVVVVV",0,8,0.90600414078675,78,84,98,101,112,118,133,136,"ATAATGA","CTGC","GTGCTTC","TTGA",2.29128616555947,14,11,15,49,2.61728620527664,4.4731318272516,8.0971483903986,101,"ENSG00000079974.19"
"29608","ENSG00000198399.16_27069",27061,27069,9,"ENSG00000198399.16",1,1,"MVVVVUVVV",1,7,0.82815734989648,116,122,133,136,144,150,167,170,"GTGAAGA","GTGT","ATGCTGA","CTGA",2.47094742762672,11,8,17,45,2.66507824251817,4.78451527334074,8.09714467292666,101,"ENSG00000079974.19"
"42374","ENSG00000261818.1_57574",57566,57574,9,"ENSG00000261818.1",1,8,"VVVVVVVMV",0,8,0.884057971014493,116,122,133,136,144,150,158,161,"GTGGTGT","CGGG","GAGATCA","CTGA",2.27991984984294,11,8,8,36,3.0441558848178,4.56090538760935,8.09713727166732,101,"ENSG00000079974.19"
"26145","ENSG00000183566.11_4257",4249,4257,9,"ENSG00000183566.11",1,5,"VVVVMUVVV",1,7,0.808695652173913,89,95,106,109,115,121,133,136,"TTGAAGA","TAGA","ATGAGGA","CTGA",2.47088532116656,11,6,12,38,2.97649584985615,4.86226616440831,8.09704877310396,101,"ENSG00000079974.19"
"48313","ENSG00000290942.1_8884",8876,8884,9,"ENSG00000290942.1",1,5,"VVVVMUVVV",1,7,0.808695652173913,89,95,106,109,115,121,133,136,"TTGAAGA","TAGA","ATGAGGA","CTGA",2.47088532116656,11,6,12,38,2.97649584985615,4.86226616440831,8.09704877310396,101,"ENSG00000079974.19"
"15932","ENSG00000150275.20_770851",770843,770851,9,"ENSG00000150275.20",1,5,"VVVVMVVVV",0,8,0.886542443064182,107,113,133,136,144,150,172,175,"TTGAGGC","CTGA","GTGCACA","CTGA",2.44776090045585,20,8,22,59,1.88456987426832,4.55074396932684,8.09691374158357,101,"ENSG00000079974.19"
"14375","ENSG00000144802.11_22399",22391,22399,9,"ENSG00000144802.11",1,1,"MVVVVVVVV",0,8,0.90600414078675,86,92,133,136,160,166,180,183,"GTCATGA","TTGA","GTTATCA","CTGA",2.53085457392572,41,24,14,88,1.01909964207571,4.4728658670618,8.0968824302088,101,"ENSG00000079974.19"
"23135","ENSG00000172264.19_1661827",1661819,1661827,9,"ENSG00000172264.19",1,2,"VMVVVVVVV",0,8,0.884057971014493,116,122,133,136,186,192,224,227,"ATGCTGA","ATGA","AGGATGT","CTGA",2.57642575004767,11,50,32,102,1.06609159232617,4.56056581482765,8.09679769888562,101,"ENSG00000079974.19"
"45709","ENSG00000285817.1_95228",95220,95228,9,"ENSG00000285817.1",1,8,"VVVVVVVMV",0,8,0.884057971014493,108,114,133,136,146,152,167,170,"ATACTGA","TAGA","CTGATAA","CTGA",2.39247988238268,19,10,15,53,2.29230370715312,4.56054239742609,8.09677428148406,101,"ENSG00000079974.19"
"16913","ENSG00000152672.8_11506",11498,11506,9,"ENSG00000152672.8",1,6,"VVVVVMVVV",0,8,0.902691511387163,104,110,133,136,146,152,166,169,"ATGCTGC","CTGT","GTTTTGG","CTGA",2.38513478899684,23,10,14,56,2.04258211627276,4.48587017739626,8.09663622294491,101,"ENSG00000079974.19"
"2738","ENSG00000077943.8_36100",36092,36100,9,"ENSG00000077943.8",1,7,"VVVVVVMVV",0,8,0.885300207039338,108,114,133,136,143,149,169,172,"TTGATGT","TGGA","CTGATCT","CTGA",2.41919961133862,19,7,20,55,2.09326859963822,4.55531650214058,8.09651733029793,101,"ENSG00000079974.19"
"38126","ENSG00000249631.7_126657",126649,126657,9,"ENSG00000249631.7",1,6,"VVVVVMVVV",0,8,0.902691511387163,81,87,102,105,113,119,133,136,"GTGATCT","CTGA","GGGATTA","CTGC",2.27562904799143,15,8,14,46,2.77158901242648,4.48561233309234,8.096378378641,101,"ENSG00000079974.19"
"12651","ENSG00000138759.20_311808",311800,311808,9,"ENSG00000138759.20",1,8,"UVVVVVVMV",1,7,0.786749482401656,78,84,98,101,113,119,133,136,"ATGATGA","TTGG","ATGGAAA","CTGA",2.57925605909414,14,12,14,49,2.60230465969489,4.94933626341395,8.09633419302058,101,"ENSG00000079974.19"
"10318","ENSG00000130508.11_85881",85873,85881,9,"ENSG00000130508.11",0,NA,"VVVVUVVVV",1,8,0.889855072463768,116,122,133,136,138,144,153,156,"GAGATGA","GTGA","ATGAGCA","CAGA",2.3005694193987,11,2,9,31,2.81035846144707,4.53687198102627,8.09629227088134,101,"ENSG00000079974.19"
"16602","ENSG00000151838.12_67004",66996,67004,9,"ENSG00000151838.12",1,1,"MVVVVVVVV",0,8,0.90600414078675,114,120,133,136,149,155,177,180,"GGGATAA","CTGC","ATGGTTA","CTGA",2.3687600937358,13,13,22,57,2.09735796337806,4.47227298040418,8.09628954355118,101,"ENSG00000079974.19"
"41298","ENSG00000258782.3_15629",15621,15629,9,"ENSG00000258782.3",1,1,"MVVVVVVVV",0,8,0.90600414078675,114,120,133,136,149,155,177,180,"GGGATAA","CTGC","ATGGTTA","CTGA",2.3687600937358,13,13,22,57,2.09735796337806,4.47227298040418,8.09628954355118,101,"ENSG00000079974.19"
"34003","ENSG00000231711.2_1672",1664,1672,9,"ENSG00000231711.2",1,5,"VVVVMVVVV",0,8,0.886542443064182,94,100,133,136,145,151,204,207,"GGGATGA","CTGG","GTCATGA","CTGA",2.5847485569226,33,9,53,104,0.968763981340073,4.55010525687268,8.09627502912941,101,"ENSG00000079974.19"
"26234","ENSG00000183715.14_417511",417503,417511,9,"ENSG00000183715.14",1,7,"VVVVVVMVV",0,8,0.885300207039338,109,115,133,136,144,150,160,163,"TTGAAGA","CAAA","CAGATAA","CTGA",2.33413340576556,18,8,10,45,2.65898769979868,4.55496926789226,8.09617009604961,101,"ENSG00000079974.19"
"35193","ENSG00000235288.3_16692",16684,16692,9,"ENSG00000235288.3",1,8,"VVVVVVVMV",0,8,0.884057971014493,110,116,133,136,144,150,159,162,"TTAATGC","CAGA","GAGCAGA","CTGA",2.32288243714528,17,8,9,43,2.7526408765568,4.55963094771467,8.09586283177264,101,"ENSG00000079974.19"
"25632","ENSG00000182247.10_49981",49973,49981,9,"ENSG00000182247.10",0,NA,"VVVVUVVVV",1,8,0.889855072463768,112,118,133,136,141,147,162,165,"ATAAAGA","TTTA","ATGCTTA","CTGA",2.32179616267686,15,5,15,44,2.666730280727,4.53634284130985,8.09576313116492,101,"ENSG00000079974.19"
"18634","ENSG00000157954.15_28143",28135,28143,9,"ENSG00000157954.15",1,2,"VMVUVVVVV",1,7,0.764803312629399,101,107,133,136,139,145,184,187,"ATGATGA","CAGA","GTGATGA","CTGA",2.89299123904881,26,3,39,77,0.859401118875028,5.03650234480011,8.09571559531771,101,"ENSG00000079974.19"
"33140","ENSG00000228824.8_138417",138409,138417,9,"ENSG00000228824.8",1,5,"VVVVMVVVV",0,8,0.886542443064182,107,113,133,136,145,151,160,163,"ATTATAA","AGGA","ATTATGA","CTGA",2.36330648573823,20,9,9,47,2.44234172667085,4.54942957456476,8.09559934682149,101,"ENSG00000079974.19"
"36973","ENSG00000243978.9_25445",25437,25445,9,"ENSG00000243978.9",1,8,"VVVVVVVMV",0,8,0.884057971014493,115,121,133,136,185,191,200,203,"ATTATAC","CTGA","ATGATCT","CTGA",2.43551159663545,12,49,9,79,1.99983803963293,4.55914550430065,8.09537738835862,101,"ENSG00000079974.19"
"11145","ENSG00000134046.12_28523",28515,28523,9,"ENSG00000134046.12",1,2,"VMVVVVVVV",0,8,0.884057971014493,88,94,133,136,151,157,170,173,"ATCATGG","ATGA","GTGAATA","CTGA",2.51419247981554,39,15,13,76,1.47503985673398,4.55908076387607,8.09531264793404,101,"ENSG00000079974.19"
"11372","ENSG00000134769.23_370439",370431,370439,9,"ENSG00000134769.23",1,1,"MVVVVUVVV",1,7,0.82815734989648,109,115,133,136,146,152,168,171,"TTGATTA","CTGA","AAGATCT","CTGA",2.52099655009632,18,10,16,53,2.32325104645034,4.78247367843979,8.09510307802571,101,"ENSG00000079974.19"
"23777","ENSG00000174021.12_7130",7122,7130,9,"ENSG00000174021.12",1,1,"MVVVVVVVV",0,8,0.90600414078675,9,15,28,31,76,82,133,136,"ATGATGG","CTGA","TTGGTGA","GTGA",2.53257370767405,13,45,51,118,1.00026725806382,4.47102299397271,8.09503955711971,101,"ENSG00000079974.19"
"45735","ENSG00000285851.1_57237",57229,57237,9,"ENSG00000285851.1",1,1,"MVVVVVVVV",0,8,0.90600414078675,9,15,28,31,76,82,133,136,"ATGATGG","CTGA","TTGGTGA","GTGA",2.53257370767405,13,45,51,118,1.00026725806382,4.47102299397271,8.09503955711971,101,"ENSG00000079974.19"
"24178","ENSG00000175471.20_113486",113478,113486,9,"ENSG00000175471.20",1,1,"MVVVVVVVV",0,8,0.90600414078675,82,88,133,136,165,171,186,189,"ATAATGA","ATGA","GCGAAAA","CTGA",2.5506939270108,45,29,15,98,0.878696675365736,4.47083071385943,8.09484727700643,101,"ENSG00000079974.19"
"6204","ENSG00000108666.10_8829",8821,8829,9,"ENSG00000108666.10",1,1,"MVVVVVVVV",0,8,0.90600414078675,110,116,133,136,153,159,211,214,"GTGATGA","CTTC","GTGCTTT","CTGA",2.50477132428823,17,17,52,95,1.18469382545777,4.47079233017816,8.09480889332516,101,"ENSG00000079974.19"
"18224","ENSG00000156639.12_120674",120666,120674,9,"ENSG00000156639.12",1,1,"MVVVVVVVV",0,8,0.90600414078675,116,122,133,136,149,155,164,167,"ATGATGA","GGGA","GCCATTA","CTAA",2.27969645484703,11,13,9,42,2.68499463647624,4.47074275053078,8.09475931367778,101,"ENSG00000079974.19"
"40558","ENSG00000256995.8_59449",59441,59449,9,"ENSG00000256995.8",1,2,"VMVVVVVVV",0,8,0.884057971014493,78,84,97,100,108,114,133,136,"AAGATGA","ATGA","GTAATGC","ATGA",2.35130361208149,13,8,19,49,2.55873418354306,4.55852289935492,8.09475478341289,101,"ENSG00000079974.19"
"46507","ENSG00000286749.1_239419",239411,239419,9,"ENSG00000286749.1",0,NA,"VVVVVVUVV",1,8,0.886128364389234,80,86,103,106,116,122,133,136,"CTGATTC","CAGA","GTAAAGT","CTGA",2.33385650445536,17,10,11,47,2.64175466940634,4.55019950811052,8.09471296566746,101,"ENSG00000079974.19"
"24514","ENSG00000176728.10_6496",6488,6496,9,"ENSG00000176728.10",0,NA,"VVVVUVVVV",1,8,0.889855072463768,60,66,73,76,82,88,133,136,"ATGATGA","CTTA","GTTATGG","GTGA",2.4807425108485,7,6,45,67,1.60286390671487,4.53528682809289,8.09470711794796,101,"ENSG00000079974.19"
"13761","ENSG00000143355.16_10734",10726,10734,9,"ENSG00000143355.16",0,NA,"VVVVVUVVV",1,8,0.922153209109731,54,60,68,71,115,121,133,136,"ATGATAA","CTGA","AAGAGGT","CTGG",2.38978934606802,8,44,12,73,1.69239060663778,4.40607989510614,8.09469273154506,101,"ENSG00000079974.19"
"44458","ENSG00000282278.1_520056",520048,520056,9,"ENSG00000282278.1",1,8,"VVVVVVVMV",0,8,0.884057971014493,85,91,107,110,115,121,133,136,"AGGAAGA","CTAA","AAAATAA","CTGA",2.32334685067028,16,5,12,42,2.74482874259766,4.55845193676655,8.09468382082452,101,"ENSG00000079974.19"
"46074","ENSG00000286162.4_54271",54263,54271,9,"ENSG00000286162.4",1,1,"MVVVVVVVV",0,8,0.90600414078675,108,114,133,136,152,158,172,175,"CTAATGA","ATGC","ATGATAT","CTGA",2.39185657944503,19,16,14,58,1.93681228826782,4.47063070447533,8.09464726762233,101,"ENSG00000079974.19"
"44694","ENSG00000283380.1_575813",575805,575813,9,"ENSG00000283380.1",1,2,"VMVVVVVVV",0,8,0.884057971014493,114,120,133,136,142,148,188,191,"ATAATGA","CAAA","CTCATTA","CTGA",2.43506216179752,13,6,40,68,1.9998766744161,4.55840610493323,8.0946379889912,101,"ENSG00000079974.19"
"1652","ENSG00000064692.20_139615",139607,139615,9,"ENSG00000064692.20",0,NA,"VVVVVUVVV",1,8,0.922153209109731,87,93,133,136,148,154,165,168,"GTGAGGA","TAGA","GCGCAGA","CTGA",2.38063261035766,40,12,11,72,1.75305868551922,4.40598568864257,8.0945985250815,101,"ENSG00000079974.19"
"19944","ENSG00000164037.17_85571",85563,85571,9,"ENSG00000164037.17",1,2,"VMVVVVVVV",0,8,0.884057971014493,102,108,133,136,144,150,159,162,"ATAATCA","CTGC","TTGATTG","CTGA",2.41127592466906,25,8,9,51,2.15749300635472,4.55816645937045,8.09439834342842,101,"ENSG00000079974.19"
"32630","ENSG00000227367.1_14932",14924,14932,9,"ENSG00000227367.1",1,2,"VMVVVVVVV",0,8,0.884057971014493,102,108,133,136,144,150,159,162,"ATAATCA","CTGC","TTGATTG","CTGA",2.41127592466906,25,8,9,51,2.15749300635472,4.55816645937045,8.09439834342842,101,"ENSG00000079974.19"
"34710","ENSG00000233867.2_15161",15153,15161,9,"ENSG00000233867.2",1,2,"VMVVVVVVV",0,8,0.884057971014493,102,108,133,136,144,150,159,162,"ATAATCA","CTGC","TTGATTG","CTGA",2.41127592466906,25,8,9,51,2.15749300635472,4.55816645937045,8.09439834342842,101,"ENSG00000079974.19"
"44814","ENSG00000283659.1_15166",15158,15166,9,"ENSG00000283659.1",1,2,"VMVVVVVVV",0,8,0.884057971014493,102,108,133,136,144,150,159,162,"ATAATCA","CTGC","TTGATTG","CTGA",2.41127592466906,25,8,9,51,2.15749300635472,4.55816645937045,8.09439834342842,101,"ENSG00000079974.19"
"48119","ENSG00000290458.1_6430",6422,6430,9,"ENSG00000290458.1",1,2,"VMVVVVVVV",0,8,0.884057971014493,102,108,133,136,144,150,159,162,"ATAATCA","CTGC","TTGATTG","CTGA",2.41127592466906,25,8,9,51,2.15749300635472,4.55816645937045,8.09439834342842,101,"ENSG00000079974.19"
"9342","ENSG00000124198.10_109394",109386,109394,9,"ENSG00000124198.10",1,5,"VVVVMVVVV",0,8,0.886542443064182,116,122,133,136,148,154,181,184,"ATTATGA","CTTG","TTGATTG","CTGA",2.43730263589861,11,12,27,59,1.94419800259401,4.54822056047952,8.09439033273625,101,"ENSG00000079974.19"
"30815","ENSG00000213923.13_1872",1864,1872,9,"ENSG00000213923.13",0,NA,"VVVVUVVVV",1,8,0.889855072463768,109,115,133,136,146,152,182,185,"ATGGTGT","CTGC","ATGCTGG","CTGA",2.46725996975861,18,10,30,67,1.69115790492614,4.53488942582922,8.0943097156843,101,"ENSG00000079974.19"
"44861","ENSG00000283900.1_82310",82302,82310,9,"ENSG00000283900.1",0,NA,"VVVVUVVVV",1,8,0.889855072463768,109,115,133,136,146,152,182,185,"ATGGTGT","CTGC","ATGCTGG","CTGA",2.46725996975861,18,10,30,67,1.69115790492614,4.53488942582922,8.0943097156843,101,"ENSG00000079974.19"
"11956","ENSG00000136709.12_40109",40101,40109,9,"ENSG00000136709.12",0,NA,"UVVVVVVVV",1,8,0.902691511387163,93,99,133,136,144,150,168,171,"ATGATGC","TTCA","ATGTTTT","CTGA",2.44483728625155,34,8,18,69,1.63481962657428,4.48343371706281,8.09419976261147,101,"ENSG00000079974.19"
"13886","ENSG00000143858.12_14009",14001,14009,9,"ENSG00000143858.12",0,NA,"UVVVVVVVV",1,8,0.902691511387163,106,112,133,136,146,152,162,165,"ATGATCA","CTTA","GTGTTTA","CTTA",2.3436738722747,21,10,10,50,2.30875419617235,4.48331166950093,8.09407771504958,101,"ENSG00000079974.19"
"44407","ENSG00000281641.3_32107",32099,32107,9,"ENSG00000281641.3",1,8,"VVVVVVVMV",0,8,0.884057971014493,110,116,133,136,142,148,158,161,"ATCAGGA","AGGA","AAGAGGA","CTGA",2.32108808084781,17,6,10,42,2.7561906869595,4.55752780648622,8.09375969054419,101,"ENSG00000079974.19"
"30251","ENSG00000204300.7_2652",2644,2652,9,"ENSG00000204300.7",1,1,"MVVVVVVVV",0,8,0.90600414078675,107,113,133,136,140,146,166,169,"ATTATGG","CTGG","ATGGTTT","CTGA",2.405096670562,20,4,20,53,1.84469167856199,4.46966737057716,8.09368393372416,101,"ENSG00000079974.19"
"29411","ENSG00000197959.15_225042",225034,225042,9,"ENSG00000197959.15",0,NA,"VVVUVVVVV",1,8,0.880745341614907,87,93,133,136,139,145,189,192,"TTGATGA","AAGA","GTGAGGA","CTGA",2.6356715905575,40,3,44,96,0.711446775996701,4.57064767826168,8.0936290447213,101,"ENSG00000079974.19"
"30896","ENSG00000214558.5_1475",1467,1475,9,"ENSG00000214558.5",0,NA,"UVVVVUVVV",2,7,0.824844720496894,114,120,133,136,187,193,214,217,"GTTATGA","CCGA","ATGATGA","CTGA",2.65798045648289,13,51,21,94,1.45662733464379,4.79412426113242,8.09350314312,101,"ENSG00000079974.19"
"31118","ENSG00000215817.9_1472",1464,1472,9,"ENSG00000215817.9",0,NA,"UVVVVUVVV",2,7,0.824844720496894,114,120,133,136,187,193,214,217,"GTTATGA","CCGA","ATGATGA","CTGA",2.65798045648289,13,51,21,94,1.45662733464379,4.79412426113242,8.09350314312,101,"ENSG00000079974.19"
"30106","ENSG00000203710.12_6616",6608,6616,9,"ENSG00000203710.12",0,NA,"VVVVVUVVV",1,8,0.922153209109731,47,53,68,71,81,87,133,136,"GTGATGA","CTGG","GTAAGAA","CAGA",2.37087805126597,15,10,46,80,1.81363718601904,4.40487271528137,8.0934855517203,101,"ENSG00000079974.19"
"29511","ENSG00000198105.16_25227",25219,25227,9,"ENSG00000198105.16",1,1,"MVVVVVVVV",0,8,0.90600414078675,116,122,133,136,150,156,168,171,"ATTATTA","CTGT","CTGATGA","GTGA",2.29760857582556,11,14,12,46,2.55977849698248,4.46929225062155,8.09330881376855,101,"ENSG00000079974.19"
"3947","ENSG00000091157.15_322395",322387,322395,9,"ENSG00000091157.15",0,NA,"UVVUVVVVV",2,7,0.78343685300207,90,96,104,107,113,119,133,136,"ATGAGGA","CTGT","CTGATAG","CTGA",2.57594194009642,8,6,14,37,2.66513930226418,4.95952139239342,8.0932688044017,101,"ENSG00000079974.19"
"8085","ENSG00000116748.22_417",409,417,9,"ENSG00000116748.22",1,2,"VMVVVUVVV",1,7,0.806211180124223,111,117,133,136,177,183,191,194,"TTGATGA","CTGT","GTGCTGC","CTGA",2.64744041899169,16,41,8,74,1.8240637443708,4.86841663441219,8.09326135490908,101,"ENSG00000079974.19"
"37130","ENSG00000245534.7_150452",150444,150452,9,"ENSG00000245534.7",0,NA,"VVUVUVVVV",2,7,0.773498964803312,61,67,77,80,110,116,133,136,"CTGATGT","CTGA","GTGAGGA","CTGA",2.74931752942074,10,30,17,66,1.66797111333036,4.99918866070049,8.09318451991374,101,"ENSG00000079974.19"
"3457","ENSG00000084444.14_66545",66537,66545,9,"ENSG00000084444.14",1,6,"VVVVVMVVV",0,8,0.902691511387163,114,120,133,136,145,151,163,166,"TTGCTTA","AGGA","GTGAATA","CTGA",2.25195351314673,13,9,12,43,2.91664667958975,4.48241752514198,8.09318357069063,101,"ENSG00000079974.19"
"34462","ENSG00000233108.1_10063",10055,10063,9,"ENSG00000233108.1",1,8,"VVVVVVVMV",0,8,0.884057971014493,72,78,95,98,111,117,133,136,"GTGATCA","CTGA","GTTAAGA","CTGG",2.40300543353869,17,13,16,55,2.20770838002646,4.55693615090443,8.0931680349624,101,"ENSG00000079974.19"
"11454","ENSG00000134996.12_5837",5829,5837,9,"ENSG00000134996.12",1,3,"VVMVVVVVV",0,8,0.882815734989648,104,110,133,136,146,152,169,172,"GTTATGA","TTGA","AAGGTGG","CTGA",2.45681366860615,23,10,17,59,1.86881163764214,4.56189235708745,8.09315529704604,101,"ENSG00000079974.19"
"8014","ENSG00000116478.12_24960",24952,24960,9,"ENSG00000116478.12",1,8,"VVVVVVVMV",0,8,0.884057971014493,78,84,93,96,109,115,133,136,"GTTATGT","CTGT","GTAATTA","CTGA",2.40897625793579,9,13,18,49,2.16767380659495,4.55687888154172,8.09311076559969,101,"ENSG00000079974.19"
"15446","ENSG00000148290.10_1466",1458,1466,9,"ENSG00000148290.10",1,1,"MVVVVVVVV",0,8,0.90600414078675,116,122,133,136,157,163,172,175,"TTCTTGA","ATGA","GTGGTCA","CTGA",2.34954511146978,11,21,9,50,2.21256821357761,4.4690505725107,8.0930671356577,101,"ENSG00000079974.19"
"32636","ENSG00000227400.2_6587",6579,6587,9,"ENSG00000227400.2",0,NA,"UVVVVUVVV",2,7,0.824844720496894,89,95,133,136,145,151,161,164,"CTGATGA","CTGT","GTAAGGC","CTGA",2.58312367634926,38,9,10,66,1.9535159738637,4.79358512071469,8.09296400270227,101,"ENSG00000079974.19"
"31339","ENSG00000223475.1_2616",2608,2616,9,"ENSG00000223475.1",1,8,"VVVVVVVMV",0,8,0.884057971014493,83,89,100,103,108,114,133,136,"AGGATGA","GTGA","ATGATTT","CTCA",2.36042208919977,11,5,19,44,2.49023833375704,4.5565963987722,8.09282828283017,101,"ENSG00000079974.19"
"13805","ENSG00000143499.14_33402",33394,33402,9,"ENSG00000143499.14",1,8,"VVVVVUVMV",1,7,0.806211180124224,110,116,133,136,142,148,195,198,"ATAATGA","ATGA","TTGAGGA","CTGA",2.6592243324162,17,6,47,79,1.7435838788443,4.86793652373808,8.09278124423497,101,"ENSG00000079974.19"
"36041","ENSG00000237773.8_288089",288081,288089,9,"ENSG00000237773.8",1,6,"VVVVVMVVV",0,8,0.902691511387163,111,117,133,136,143,149,182,185,"TTAATGA","TTCA","ATGAAGT","CTGA",2.40213459546973,16,7,33,65,1.91379627957775,4.48200672901065,8.0927727745593,101,"ENSG00000079974.19"
"8393","ENSG00000118526.7_6070",6062,6070,9,"ENSG00000118526.7",0,NA,"VVVVVUUVV",2,7,0.808281573498965,75,81,96,99,116,122,133,136,"GTGATAA","CTGC","CTGATTA","CTGA",2.56720257070466,15,17,11,52,2.32366327493513,4.85958676990821,8.09271306390407,101,"ENSG00000079974.19"
"39022","ENSG00000251504.1_57034",57026,57034,9,"ENSG00000251504.1",1,8,"VVVVVVVMV",0,8,0.884057971014493,96,102,133,136,145,151,173,176,"AAGATGA","CCGA","GTCATCT","CTGA",2.52525423387707,31,9,22,71,1.39026015332162,4.5563220947922,8.09255397885017,101,"ENSG00000079974.19"
"14459","ENSG00000145012.14_559964",559956,559964,9,"ENSG00000145012.14",1,2,"UMVVVVVVV",1,7,0.786749482401656,115,121,133,136,150,156,165,168,"ATGAGGA","CAGA","TTCAAGA","CTGA",2.57277127490683,12,14,9,44,2.63027484009447,4.94552083486833,8.09251876447496,101,"ENSG00000079974.19"
"30747","ENSG00000213071.12_10816",10808,10816,9,"ENSG00000213071.12",1,1,"MVUVVVVVV",1,7,0.789648033126294,113,119,133,136,140,146,158,161,"ATGCTGA","CAGA","ATGGACA","CTGA",2.53967055774648,14,4,12,39,2.80452374081856,4.93391519811544,8.09250733062061,101,"ENSG00000079974.19"
"48213","ENSG00000290613.1_20078",20070,20078,9,"ENSG00000290613.1",1,1,"MVUVVVVVV",1,7,0.789648033126294,113,119,133,136,140,146,158,161,"ATGCTGA","CAGA","ATGGACA","CTGA",2.53967055774648,14,4,12,39,2.80452374081856,4.93391519811544,8.09250733062061,101,"ENSG00000079974.19"
"25308","ENSG00000180708.6_585",577,585,9,"ENSG00000180708.6",1,1,"MVVVVUVVV",1,7,0.82815734989648,109,115,133,136,175,181,198,201,"ATAATGA","CTGT","GTGCTGA","CTGA",2.66195737287218,18,39,17,83,1.37304098249926,4.77985586707844,8.09248526666437,101,"ENSG00000079974.19"
"17903","ENSG00000155816.21_102187",102179,102187,9,"ENSG00000155816.21",1,3,"VVMVVVVVV",0,8,0.882815734989648,109,115,133,136,150,156,168,171,"ATCATGA","TTAA","ATCAACA","CTGA",2.39962714318686,18,14,12,53,2.24737198526487,4.56122156829432,8.09248450825291,101,"ENSG00000079974.19"
"47021","ENSG00000287523.1_52878",52870,52878,9,"ENSG00000287523.1",0,NA,"VVVVVVUVV",1,8,0.886128364389234,81,87,99,102,110,116,133,136,"AAGATGA","GTGA","ATTATGG","CTAA",2.32549896697733,12,8,17,46,2.68852378018518,4.54796255667518,8.09247601423212,101,"ENSG00000079974.19"
"25033","ENSG00000179242.16_102966",102958,102966,9,"ENSG00000179242.16",1,8,"VVVVVVVMV",0,8,0.884057971014493,89,95,104,107,112,118,133,136,"CTGAACA","CTGG","TTGAAGT","CTGA",2.33702782984407,9,5,15,38,2.64464311629981,4.55620716214841,8.09243904620638,101,"ENSG00000079974.19"
"6029","ENSG00000107758.16_6043",6035,6043,9,"ENSG00000107758.16",1,6,"VVVVVMVVV",0,8,0.902691511387163,111,117,133,136,144,150,186,189,"GTAATGA","CTAC","GTAAAGA","CTGA",2.40867333657454,16,8,36,69,1.8686352575467,4.48161437534424,8.09238042089289,101,"ENSG00000079974.19"
"38254","ENSG00000249853.9_18625",18617,18625,9,"ENSG00000249853.9",1,7,"VVVVVVMVV",0,8,0.885300207039338,113,119,133,136,141,147,162,165,"ATGTTTG","ATGT","ATGATGA","CTGA",2.32194732402992,14,5,15,43,2.72483913333804,4.55112199005104,8.09232281820839,101,"ENSG00000079974.19"
"34176","ENSG00000232046.7_67233",67225,67233,9,"ENSG00000232046.7",1,1,"MVVVVVVVV",0,8,0.90600414078675,99,105,133,136,141,147,200,203,"TTGATGA","GAGA","ATTAAGA","CTGA",2.52929865394755,28,5,53,95,1.01067644811203,4.46816686860726,8.09218343175425,101,"ENSG00000079974.19"
"15234","ENSG00000147481.17_21386",21378,21386,9,"ENSG00000147481.17",1,5,"VVVVMVVVV",0,8,0.886542443064182,35,41,59,62,74,80,133,136,"ATAAAGA","CTGA","ATGCAAA","CTGA",2.51257623404986,18,12,53,92,1.43343118844657,4.54598485386141,8.09215462611813,101,"ENSG00000079974.19"
"39822","ENSG00000254275.6_154526",154518,154526,9,"ENSG00000254275.6",1,2,"VMVVVVVVV",0,8,0.884057971014493,115,121,133,136,137,143,155,158,"ATTATGA","CTTG","ATTTTTA","CTGA",2.36593439265537,12,1,12,34,2.45063011842546,4.55588151736531,8.09211340142328,101,"ENSG00000079974.19"
"40872","ENSG00000258017.3_40602",40594,40602,9,"ENSG00000258017.3",1,2,"VMVVVVVVV",0,8,0.884057971014493,101,107,133,136,149,155,165,168,"ATGCTGA","AAGA","GTGAGCT","CTGA",2.45928185396134,26,13,10,58,1.82770126545201,4.55572840629857,8.09196029035654,101,"ENSG00000079974.19"
"6798","ENSG00000111885.7_93075",93067,93075,9,"ENSG00000111885.7",1,5,"VVVVMUVVV",1,7,0.808695652173913,86,92,107,110,116,122,133,136,"GTGAAGT","ATGA","CTGGTGA","CTGA",2.47873381190275,15,6,11,41,2.90323199383234,4.857031018296,8.09181362699165,101,"ENSG00000079974.19"
"2987","ENSG00000079974.19_10707",10699,10707,9,"ENSG00000079974.19",0,NA,"VVVVVUVVV",1,8,0.922153209109731,116,122,133,136,141,147,157,160,"CTGGCGA","CTTG","CTGACCA","CTGA",2.18619518582327,11,5,10,35,3.03788541383819,4.40312999649833,8.09174283293725,101,"ENSG00000079974.19"
"46979","ENSG00000287448.1_12128",12120,12128,9,"ENSG00000287448.1",0,NA,"UVVUVVVVV",2,7,0.78343685300207,116,122,133,136,138,144,153,156,"GTAATGA","TAGA","CTGATGA","CTGA",2.55321898907936,11,2,9,31,2.81035846144707,4.9579545971607,8.09170200916898,101,"ENSG00000079974.19"
"22247","ENSG00000170035.16_47211",47203,47211,9,"ENSG00000170035.16",1,8,"VVVVVVVMV",0,8,0.884057971014493,108,114,133,136,187,193,223,226,"AGGATGA","TTGA","GTGATTG","CTGA",2.62759164930385,19,51,30,109,0.704199661587337,4.55536933090326,8.09160121496123,101,"ENSG00000079974.19"
"37379","ENSG00000247950.9_34930",34922,34930,9,"ENSG00000247950.9",1,1,"MVVVVVVVV",0,8,0.90600414078675,86,92,106,109,116,122,133,136,"ATTATTT","CTGC","AAGCTGG","CTGA",2.23446687099648,14,7,11,41,2.97383677531519,4.46757064548959,8.09158720863659,101,"ENSG00000079974.19"
"140","ENSG00000005483.23_16046",16038,16046,9,"ENSG00000005483.23",1,2,"VMVVVVVVV",0,8,0.884057971014493,62,68,76,79,88,94,133,136,"GTGATTA","CTGA","GTGCTGA","TTGA",2.47714249355591,8,9,39,65,1.70658520754137,4.55521712447853,8.0914490085365,101,"ENSG00000079974.19"
"16341","ENSG00000151348.16_150451",150443,150451,9,"ENSG00000151348.16",0,NA,"VVVVVUVVV",1,8,0.922153209109731,112,118,133,136,146,152,170,173,"GGGACGA","AGGA","CTGTTGT","CTGA",2.27505499324362,15,10,18,52,2.44403609772123,4.402767346503,8.09138018294193,101,"ENSG00000079974.19"
"31695","ENSG00000224467.1_14247",14239,14247,9,"ENSG00000224467.1",1,1,"MVVVVVVVV",0,8,0.90600414078675,55,61,104,107,115,121,133,136,"ATGAAGA","CTGA","GGGACTA","CTAA",2.38852183684466,43,8,12,72,1.94516277177803,4.46716042101894,8.09117698416594,101,"ENSG00000079974.19"
"15547","ENSG00000148655.15_726877",726869,726877,9,"ENSG00000148655.15",0,NA,"VVVVVUVVV",1,8,0.922153209109731,109,115,133,136,137,143,152,155,"GTGATTT","CAGT","CTTATGA","CTGA",2.33109468565881,18,1,9,37,2.06953411318097,4.40254133772658,8.09115417416551,101,"ENSG00000079974.19"
"10475","ENSG00000131196.18_103188",103180,103188,9,"ENSG00000131196.18",0,NA,"VVVVUVVVV",1,8,0.889855072463768,115,121,133,136,142,148,198,201,"AGGCTGA","CTGG","GTAATTA","CTGA",2.42105336914484,12,6,50,77,1.98638684208093,4.53168565909497,8.09110594895004,101,"ENSG00000079974.19"
"13894","ENSG00000143882.12_34710",34702,34710,9,"ENSG00000143882.12",1,1,"MVVVVVVVV",0,8,0.90600414078675,82,88,133,136,146,152,197,200,"GTGCTGA","CAGA","CTGAAGG","CTGA",2.54430182097866,45,10,45,109,0.905900437003628,4.46697814421534,8.09099470736234,101,"ENSG00000079974.19"
"25406","ENSG00000181355.21_315243",315235,315243,9,"ENSG00000181355.21",1,1,"MVVVVVVVV",0,8,0.90600414078675,100,106,133,136,142,148,164,167,"GGGATGA","ATGG","TTGACTA","CTGA",2.40343079908341,27,6,16,58,1.84496747394389,4.46695986695832,8.09097643010531,101,"ENSG00000079974.19"
"16664","ENSG00000152056.18_90683",90675,90683,9,"ENSG00000152056.18",0,NA,"VVVVVUVVV",1,8,0.922153209109731,115,121,133,136,138,144,152,155,"GTCATGA","GTGG","ATGCTGA","CTGT",2.21879521884384,12,2,8,31,2.81723734531405,4.40230136773491,8.09091420417383,101,"ENSG00000079974.19"
"48299","ENSG00000290919.1_88183",88175,88183,9,"ENSG00000290919.1",0,NA,"UVVVVVVVV",1,8,0.902691511387163,101,107,133,136,139,145,160,163,"ATGATGA","TAGA","TTGATAA","CAGA",2.44015832864198,26,3,15,53,1.65172665175957,4.47986221067653,8.09062825622518,101,"ENSG00000079974.19"
"10044","ENSG00000128918.15_213387",213379,213387,9,"ENSG00000128918.15",0,NA,"VVUVVVVVV",1,8,0.883643892339545,16,22,37,40,89,95,133,136,"GTGTTGA","CTGA","TTAGTGA","CTGA",2.59247237931298,15,49,38,111,0.940881452048911,4.55600766186719,8.09058323122536,101,"ENSG00000079974.19"
"6373","ENSG00000109654.16_69965",69957,69965,9,"ENSG00000109654.16",1,1,"MVVVVVVVV",0,8,0.90600414078675,87,93,133,136,144,150,167,170,"GAGAGGA","CTAA","GTCATGA","CTGA",2.42706777563547,40,8,17,74,1.68569121836406,4.46653576398347,8.09055232713047,101,"ENSG00000079974.19"
"47531","ENSG00000288637.1_69693",69685,69693,9,"ENSG00000288637.1",1,1,"MVVVVVVVV",0,8,0.90600414078675,87,93,133,136,144,150,167,170,"GAGAGGA","CTAA","GTCATGA","CTGA",2.42706777563547,40,8,17,74,1.68569121836406,4.46653576398347,8.09055232713047,101,"ENSG00000079974.19"
"12567","ENSG00000138650.9_22252",22244,22252,9,"ENSG00000138650.9",0,NA,"UVVVVUVVV",2,7,0.824844720496894,115,121,133,136,182,188,196,199,"AACATGT","CTGA","ATGATGA","CTGA",2.57732123443133,12,46,8,75,1.98238838826949,4.79113248778625,8.09051136977383,101,"ENSG00000079974.19"
"9622","ENSG00000125851.10_186390",186382,186390,9,"ENSG00000125851.10",1,1,"MVVVVVVVV",0,8,0.90600414078675,82,88,133,136,186,192,205,208,"TTAATGA","ATGA","TTGATTA","CTGA",2.54183730662895,45,50,13,117,0.920316518762144,4.46647464073878,8.09049120388578,101,"ENSG00000079974.19"
"18821","ENSG00000158623.14_2696",2688,2696,9,"ENSG00000158623.14",1,6,"VVVVVMUVV",1,7,0.788819875776397,74,80,93,96,100,106,133,136,"ATTATGA","CAGA","GTAATGA","CTGA",2.6555415451771,13,4,27,53,2.03711286680686,4.93518079199688,8.09046029510247,101,"ENSG00000079974.19"
"18185","ENSG00000156463.18_37287",37279,37287,9,"ENSG00000156463.18",1,1,"MVVVVVVVV",0,8,0.90600414078675,93,99,106,109,115,121,133,136,"GTGAGGA","ATGA","GTGAATG","GTGA",2.27176511461008,7,6,12,34,2.7203245076012,4.4663563179171,8.0903728810641,101,"ENSG00000079974.19"
"20873","ENSG00000165934.13_19938",19930,19938,9,"ENSG00000165934.13",1,6,"UVVVVMVVV",1,7,0.805383022774327,115,121,133,136,161,167,188,191,"ATTATGA","TTGA","ATGAAGA","CTGA",2.68360132429289,12,25,21,67,1.58435584029033,4.86875783389406,8.09028992499137,101,"ENSG00000079974.19"
"47142","ENSG00000287706.3_8979",8971,8979,9,"ENSG00000287706.3",1,1,"MVVVVVVVV",0,8,0.90600414078675,109,115,133,136,145,151,173,176,"TTGGTGA","ATAA","ATGAACA","CTGA",2.3760780566679,18,9,22,58,2.02450861332465,4.46625724777766,8.09027381092466,101,"ENSG00000079974.19"
"24855","ENSG00000178234.13_76519",76511,76519,9,"ENSG00000178234.13",1,1,"MVVVVVVVV",0,8,0.90600414078675,114,120,133,136,141,147,177,180,"GTGATTT","CTCA","TTTATGT","CTGA",2.37166059574912,13,5,30,57,2.05366594745078,4.46618414644456,8.09020070959156,101,"ENSG00000079974.19"
"36984","ENSG00000244052.1_399",391,399,9,"ENSG00000244052.1",0,NA,"VVVVVUUVV",2,7,0.808281573498965,85,91,102,105,112,118,133,136,"ATGAAGG","GTGA","ATGAATA","CTGA",2.4928401782549,11,7,15,42,2.80930442936659,4.85705973776647,8.09018603176233,101,"ENSG00000079974.19"
"5188","ENSG00000103671.10_36034",36026,36034,9,"ENSG00000103671.10",0,NA,"VVVVVVUVV",1,8,0.886128364389234,115,121,133,136,147,153,166,169,"GGGATCA","GTCA","GAGATGA","CTGA",2.3133142884712,12,11,13,45,2.76039948308047,4.54562368488878,8.09013714244572,101,"ENSG00000079974.19"
"27138","ENSG00000185630.20_304874",304866,304874,9,"ENSG00000185630.20",1,2,"UMVVVVVVV",1,7,0.786749482401656,60,66,79,82,89,95,133,136,"ATAATGA","CTGA","TTTATTA","CTGA",2.66191033349864,13,7,38,67,2.02582205003495,4.94297273500647,8.08997066461309,101,"ENSG00000079974.19"
"32608","ENSG00000227303.1_132484",132476,132484,9,"ENSG00000227303.1",1,8,"VVVVVVVMV",0,8,0.884057971014493,86,92,133,136,170,176,191,194,"ATGATGG","ATGA","GTGAGCT","CTGA",2.60581072782714,41,34,15,99,0.842283831787012,4.55358883765865,8.08982072171662,101,"ENSG00000079974.19"
"31333","ENSG00000223442.1_23613",23605,23613,9,"ENSG00000223442.1",1,8,"VVVVVVVMV",0,8,0.884057971014493,100,106,133,136,166,172,186,189,"ATGATGA","CCTA","CTCATGG","CTGA",2.5783765813686,27,30,14,80,1.02511855544402,4.55357394114201,8.08980582519998,101,"ENSG00000079974.19"
"20833","ENSG00000165806.21_1935",1927,1935,9,"ENSG00000165806.21",0,NA,"UVVVVVVVV",1,8,0.902691511387163,70,76,96,99,114,120,133,136,"ATGATGT","CTGC","TTCATGA","CAGA",2.39292608744021,20,15,13,57,1.96330233516468,4.47903572952486,8.08980177507351,101,"ENSG00000079974.19"
"17849","ENSG00000155511.18_79918",79910,79918,9,"ENSG00000155511.18",1,8,"VVVVVVVMV",0,8,0.884057971014493,103,109,133,136,179,185,196,199,"CTGCTGA","CCGA","ATGATAA","CTGA",2.55087578874175,24,43,11,87,1.20781352351838,4.55341302878251,8.08964491284048,101,"ENSG00000079974.19"
"23533","ENSG00000173175.16_23043",23035,23043,9,"ENSG00000173175.16",1,6,"VVVVVMVVV",0,8,0.902691511387163,48,54,63,66,72,78,133,136,"ATGATGC","CAGA","GTGTAGA","CTCA",2.41418803870031,9,6,55,79,1.82075168660743,4.47883465281905,8.0896006983677,101,"ENSG00000079974.19"
"19189","ENSG00000162434.14_140792",140784,140792,9,"ENSG00000162434.14",1,5,"VVVVMUVVV",1,7,0.808695652173913,111,117,133,136,150,156,166,169,"ATGATGA","CTTG","ATGTCCA","CTGA",2.54341787031086,16,14,10,49,2.46186698304762,4.85449652961334,8.08927913830899,101,"ENSG00000079974.19"
"27701","ENSG00000187164.20_80906",80898,80906,9,"ENSG00000187164.20",1,1,"MVUVVVVVV",1,7,0.789648033126294,111,117,133,136,152,158,166,169,"ATGATGT","TTGA","GGCATGA","CTGA",2.61220745115016,16,16,8,49,2.30788362546635,4.93064999161685,8.08924212412203,101,"ENSG00000079974.19"
"983","ENSG00000042781.14_66299",66291,66299,9,"ENSG00000042781.14",1,2,"UMVVVVVVV",1,7,0.786749482401656,90,96,109,112,116,122,133,136,"ATGATGT","CTCA","ATACTAA","CTGA",2.53058832420093,13,4,11,37,2.89801098999725,4.94214995450086,8.08914788410749,101,"ENSG00000079974.19"
"39950","ENSG00000254530.2_410972",410964,410972,9,"ENSG00000254530.2",0,NA,"UVVVVVVVV",1,8,0.902691511387163,78,84,103,106,116,122,133,136,"ATATTGA","CTGA","TTTATGA","CTGC",2.31762065807364,19,10,11,49,2.4620212489147,4.47820640901808,8.08897245456673,101,"ENSG00000079974.19"
"33819","ENSG00000231236.2_38094",38086,38094,9,"ENSG00000231236.2",1,2,"VMVVVVVVV",0,8,0.884057971014493,97,103,133,136,137,143,152,155,"ATGAAGG","ATGA","CTGCTGA","CTGA",2.52615568243241,30,1,9,49,1.36908802384362,4.5525314766816,8.08876336073957,101,"ENSG00000079974.19"
"30627","ENSG00000206120.11_148131",148123,148131,9,"ENSG00000206120.11",1,1,"MVVVVVVVV",0,8,0.90600414078675,112,118,133,136,140,146,157,160,"AAGTTGT","GTGA","AAGAATA","CTGA",2.2621642283989,15,4,11,39,2.77782053741616,4.46472884835221,8.08874541149921,101,"ENSG00000079974.19"
"37992","ENSG00000249307.8_327917",327909,327917,9,"ENSG00000249307.8",0,NA,"VVVVVUUVV",2,7,0.808281573498965,88,94,133,136,141,147,158,161,"AGGATGA","TTGA","TTAATGA","CTGA",2.62548016281737,39,5,11,64,1.91927462198574,4.85561892685871,8.08874522085457,101,"ENSG00000079974.19"
"12490","ENSG00000138400.13_8389",8381,8389,9,"ENSG00000138400.13",1,8,"VVVVUVVMV",1,7,0.773913043478261,38,44,62,65,73,79,133,136,"ATGATGT","CTGA","ATGGTAA","CTGA",2.7477442708234,18,8,54,89,1.65393186525589,4.99305675101964,8.08870892493268,101,"ENSG00000079974.19"
"15487","ENSG00000148498.17_125403",125395,125403,9,"ENSG00000148498.17",1,2,"VMVVVVVVV",0,8,0.884057971014493,112,118,133,136,148,154,170,173,"ATAAATA","GTGA","ATGATGT","CTGA",2.36622519656537,15,12,16,52,2.43414168460168,4.55224408209271,8.08847596615068,101,"ENSG00000079974.19"
"23873","ENSG00000174469.23_2108225",2108217,2108225,9,"ENSG00000174469.23",1,2,"VMVVVVVVV",0,8,0.884057971014493,91,97,133,136,158,164,176,179,"ATGATGT","AAGA","GTGTTGC","CTGA",2.5561238331141,36,22,12,79,1.16771296896246,4.55213463076412,8.08836651482209,101,"ENSG00000079974.19"
"2719","ENSG00000077684.16_58446",58438,58446,9,"ENSG00000077684.16",1,8,"VVVVVVVMV",0,8,0.884057971014493,111,117,133,136,168,174,182,185,"ATCATGT","ATGA","GTGTTCT","CTGA",2.45327110281045,16,32,8,65,1.85325091517546,4.55209790014461,8.08832978420259,101,"ENSG00000079974.19"
"9859","ENSG00000127928.13_290806",290798,290806,9,"ENSG00000127928.13",1,2,"VMVVVVVVV",0,8,0.884057971014493,41,47,62,65,76,82,133,136,"ATGATGA","CTAA","TTGTTGT","CTGG",2.46926531897981,15,11,51,86,1.74652556571771,4.5520735897291,8.08830547378707,101,"ENSG00000079974.19"
"18578","ENSG00000157680.16_387689",387681,387689,9,"ENSG00000157680.16",1,8,"UVVVVVVMV",1,7,0.786749482401656,83,89,103,106,112,118,133,136,"AAGATAA","CTGA","CTGATTT","CTGA",2.54873793606592,14,6,15,44,2.77349567328223,4.94127047843042,8.08826840803705,101,"ENSG00000079974.19"
"48501","ENSG00000291188.1_23553",23545,23553,9,"ENSG00000291188.1",1,6,"VVVVVMVVV",0,8,0.902691511387163,113,119,133,136,144,150,163,166,"TTGATGA","CCCA","GGGATGG","CTGG",2.25473564444242,14,8,13,44,2.87835395180259,4.47748122868802,8.08824727423668,101,"ENSG00000079974.19"
"41481","ENSG00000259087.5_4454",4446,4454,9,"ENSG00000259087.5",1,3,"VVMVVVVVV",0,8,0.882815734989648,111,117,133,136,152,158,166,169,"ATGGTCA","GTGA","GTGTTTC","CTGA",2.38799153771245,16,16,8,49,2.30788362546635,4.556956802554,8.08821974251259,101,"ENSG00000079974.19"
"10624","ENSG00000131966.14_4552",4544,4552,9,"ENSG00000131966.14",1,5,"VVVVMUVVV",1,7,0.808695652173913,86,92,106,109,114,120,133,136,"AAAATGT","CTGA","GTGCAGA","CTGA",2.48625522134696,14,5,13,41,2.83865348206628,4.85342207276151,8.08820468145716,101,"ENSG00000079974.19"
"24981","ENSG00000178971.17_441",433,441,9,"ENSG00000178971.17",1,8,"VVVVVVVMV",0,8,0.884057971014493,81,87,98,101,114,120,133,136,"ATAATAA","CTGA","GTGTAGA","CCGA",2.34224022010719,11,13,13,46,2.59219767661185,4.55178311933162,8.08801500338959,101,"ENSG00000079974.19"
"4260","ENSG00000099968.18_98086",98078,98086,9,"ENSG00000099968.18",0,NA,"VVVVVVUVV",1,8,0.886128364389234,115,121,133,136,160,166,181,184,"CTGAAGA","TAGA","GTGAGAA","CTGA",2.43148411906467,12,24,15,60,1.96391485903387,4.54345224653292,8.08796570408986,101,"ENSG00000079974.19"
"21692","ENSG00000168702.18_553112",553104,553112,9,"ENSG00000168702.18",0,NA,"VVVVUVVVV",1,8,0.889855072463768,113,119,133,136,182,188,204,207,"AGGCTGA","CTGC","GTGATAT","CTGA",2.45843434367381,14,46,16,85,1.72454823601617,4.52852763179373,8.08794792164881,101,"ENSG00000079974.19"
"38735","ENSG00000250954.6_73007",72999,73007,9,"ENSG00000250954.6",1,6,"VVVVVMVVV",0,8,0.902691511387163,114,120,133,136,139,145,200,203,"TTGATTT","ATGA","TTGATAA","CTGA",2.43159536037783,13,3,55,80,1.6971853384011,4.47695526856332,8.08772131411197,101,"ENSG00000079974.19"
"34394","ENSG00000232949.2_3125",3117,3125,9,"ENSG00000232949.2",1,8,"VVVVVUVMV",1,7,0.806211180124224,112,118,133,136,158,164,176,179,"GTGATGA","AGGA","GTGAGGC","CTGA",2.6070676913687,15,22,12,58,2.0710442124013,4.86287387204816,8.08771859254506,101,"ENSG00000079974.19"
"2847","ENSG00000078328.23_752287",752279,752287,9,"ENSG00000078328.23",1,2,"VMVVVVVVV",0,8,0.884057971014493,113,119,133,136,144,150,201,204,"GAGATGA","TTCA","GTGATCT","CTGA",2.43799857342086,14,8,51,82,1.95246843525191,4.55144806451441,8.08767994857238,101,"ENSG00000079974.19"
"27068","ENSG00000185532.20_199360",199352,199360,9,"ENSG00000185532.20",1,1,"MVVVVVVVV",0,8,0.90600414078675,82,88,133,136,146,152,160,163,"ATGATTA","GTAA","GTAATAC","CTGA",2.39639401122505,45,10,8,72,1.87858539145809,4.46363636657294,8.08765292971994,101,"ENSG00000079974.19"
"47862","ENSG00000289524.2_4244",4236,4244,9,"ENSG00000289524.2",0,NA,"VVVVUVVVV",1,8,0.889855072463768,116,122,133,136,143,149,164,167,"ATTCTGT","CTGT","TTGGTAA","CTGA",2.29553444853641,11,7,15,42,2.80930442936659,4.52821685490233,8.0876371447574,101,"ENSG00000079974.19"
"279","ENSG00000007237.19_58957",58949,58957,9,"ENSG00000007237.19",0,NA,"VVVVVUVVV",1,8,0.922153209109731,112,118,133,136,185,191,209,212,"ATGTTGA","ATCA","GTCAGAA","CTGA",2.40727281702454,15,49,18,91,1.54664823273126,4.39878341989039,8.08739625632931,101,"ENSG00000079974.19"
"9289","ENSG00000123636.19_81511",81503,81511,9,"ENSG00000123636.19",1,5,"VVVVMVVVV",0,8,0.886542443064182,93,99,109,112,116,122,133,136,"ATGTTAA","CTGA","ATTAAGA","CTGG",2.28801897566232,10,4,11,34,2.9095552101882,4.54075376198426,8.08692353424099,101,"ENSG00000079974.19"
"46056","ENSG00000286147.1_371432",371424,371432,9,"ENSG00000286147.1",1,8,"VVVVVVVMV",0,8,0.884057971014493,100,106,133,136,143,149,160,163,"ATGATCA","ATGG","GAGAGGG","CTGA",2.41706888582929,27,7,11,54,2.08850561077034,4.55057454574141,8.08680642979938,101,"ENSG00000079974.19"
"7595","ENSG00000115041.14_27649",27641,27649,9,"ENSG00000115041.14",1,8,"VVVVVVVMV",0,8,0.884057971014493,113,119,133,136,143,149,162,165,"GGGAGGA","CAGG","GTGACAA","CTGA",2.29603334534294,14,7,13,43,2.89540137332488,4.55057258556945,8.08680446962742,101,"ENSG00000079974.19"
"8645","ENSG00000120029.13_22064",22056,22064,9,"ENSG00000120029.13",1,2,"VMVVVVVVV",0,8,0.884057971014493,115,121,133,136,149,155,168,171,"AGCATGC","CTGT","GTGATCT","CTGA",2.33775285342683,12,13,13,47,2.61620668258222,4.55030642635694,8.08653831041491,101,"ENSG00000079974.19"
"18047","ENSG00000156052.11_289770",289762,289770,9,"ENSG00000156052.11",1,7,"VVVVVVMVV",0,8,0.885300207039338,111,117,133,136,146,152,163,166,"CTGGTGT","CTGG","ATGGACA","CTGA",2.31827657815131,16,10,11,46,2.72599856804707,4.54529393893061,8.08649476708796,101,"ENSG00000079974.19"
"12405","ENSG00000138101.20_102453",102445,102453,9,"ENSG00000138101.20",1,1,"MVVVVVVVV",0,8,0.90600414078675,81,87,105,108,114,120,133,136,"ATGATAA","CGGA","GTAAAGG","TTGA",2.29145497026767,18,6,13,46,2.57340124586314,4.46244192857856,8.08645849172556,101,"ENSG00000079974.19"
"16751","ENSG00000152208.13_917721",917713,917721,9,"ENSG00000152208.13",1,8,"VVVVVVVMV",0,8,0.884057971014493,114,120,133,136,138,144,157,160,"ATGATGA","ATAA","GTGTAGC","GTGA",2.3522272426078,13,2,13,37,2.51883054643972,4.55008637428959,8.08631825834756,101,"ENSG00000079974.19"
"18893","ENSG00000159216.19_210888",210880,210888,9,"ENSG00000159216.19",1,6,"VVVVVMVVV",0,8,0.902691511387163,110,116,133,136,146,152,162,165,"GTAATTA","ATAA","CTCATGA","CTGA",2.28670719321447,17,10,10,46,2.65729832325609,4.47550323617147,8.08626928172012,101,"ENSG00000079974.19"
"22847","ENSG00000171530.15_80252",80244,80252,9,"ENSG00000171530.15",1,1,"MVVVVVVVV",0,8,0.90600414078675,112,118,133,136,140,146,176,179,"ATGATAA","TTTA","ATAACGT","CTGA",2.39622211253285,15,4,30,58,1.87381874575715,4.46215820732738,8.08617477047437,101,"ENSG00000079974.19"
"23016","ENSG00000171943.12_58742",58734,58742,9,"ENSG00000171943.12",0,NA,"VVVVVUVVV",1,8,0.922153209109731,116,122,133,136,143,149,159,162,"TTGAAGT","CTTT","AAGAAGC","CTGA",2.18047220353142,11,7,10,37,3.05362272147605,4.39752601958804,8.08613885602696,101,"ENSG00000079974.19"
"28716","ENSG00000196369.12_58770",58762,58770,9,"ENSG00000196369.12",0,NA,"VVVVVUVVV",1,8,0.922153209109731,116,122,133,136,143,149,159,162,"TTGAAGT","CTTT","AAGAAGC","CTGA",2.18047220353142,11,7,10,37,3.05362272147605,4.39752601958804,8.08613885602696,101,"ENSG00000079974.19"
"42718","ENSG00000266028.8_58728",58720,58728,9,"ENSG00000266028.8",0,NA,"VVVVVUVVV",1,8,0.922153209109731,116,122,133,136,143,149,159,162,"TTGAAGT","CTTT","AAGAAGC","CTGA",2.18047220353142,11,7,10,37,3.05362272147605,4.39752601958804,8.08613885602696,101,"ENSG00000079974.19"
"43295","ENSG00000270872.2_56104",56096,56104,9,"ENSG00000270872.2",0,NA,"VVVVVUVVV",1,8,0.922153209109731,116,122,133,136,143,149,159,162,"TTGAAGT","CTTT","AAGAAGC","CTGA",2.18047220353142,11,7,10,37,3.05362272147605,4.39752601958804,8.08613885602696,101,"ENSG00000079974.19"
"46724","ENSG00000287100.3_146430",146422,146430,9,"ENSG00000287100.3",1,1,"MVVVVVVVV",0,8,0.90600414078675,110,116,133,136,147,153,162,165,"AGGAGGA","CAAA","CTCATTA","CTGA",2.28827317097184,17,11,9,46,2.59283179279446,4.46199656648501,8.086013129632,101,"ENSG00000079974.19"
"3519","ENSG00000085377.15_156803",156795,156803,9,"ENSG00000085377.15",0,NA,"VVVUVUVVV",2,7,0.802898550724638,77,83,99,102,109,115,133,136,"CCGATGA","CTGG","ATGATGC","CTGA",2.55338530852953,16,7,18,50,2.4747132907515,4.87432050357043,8.08591470646898,101,"ENSG00000079974.19"
"36422","ENSG00000240666.2_22868",22860,22868,9,"ENSG00000240666.2",1,3,"VVMVVVVVV",0,8,0.882815734989648,116,122,133,136,185,191,203,206,"CTGAAGA","TTGA","CAAATGA","CTGA",2.44263139352938,11,49,12,81,1.9339283015469,4.55453439793568,8.08579733789428,101,"ENSG00000079974.19"
"43701","ENSG00000273257.2_10575",10567,10575,9,"ENSG00000273257.2",1,8,"VVVVVVUMV",1,7,0.770186335403727,48,54,95,98,106,112,133,136,"ATGATGA","ATGA","GTGAAAA","CTGA",2.78574305297162,41,8,21,79,1.44795459760162,5.00489373768644,8.08563907930134,101,"ENSG00000079974.19"
"47562","ENSG00000288695.1_37984",37976,37984,9,"ENSG00000288695.1",1,8,"VVVVVVUMV",1,7,0.770186335403727,48,54,95,98,106,112,133,136,"ATGATGA","ATGA","GTGAAAA","CTGA",2.78574305297162,41,8,21,79,1.44795459760162,5.00489373768644,8.08563907930134,101,"ENSG00000079974.19"
"19672","ENSG00000163590.14_45604",45596,45604,9,"ENSG00000163590.14",1,8,"VVVVVVVMV",0,8,0.884057971014493,115,121,133,136,182,188,236,239,"TTGATGA","AAGA","TTGGTGA","CTGA",2.57866145542237,12,46,48,115,1.00619105944295,4.54931685723135,8.08554874128932,101,"ENSG00000079974.19"
"12348","ENSG00000137936.18_23886",23878,23886,9,"ENSG00000137936.18",0,NA,"VVVVVUVVV",1,8,0.922153209109731,74,80,87,90,100,106,133,136,"TTAATGG","TTGA","GGGATGC","CTGA",2.38108118992069,7,10,27,53,1.71368802469218,4.39689065604086,8.08550349247978,101,"ENSG00000079974.19"
"14784","ENSG00000145888.11_15538",15530,15538,9,"ENSG00000145888.11",0,NA,"UVVVVVVVV",1,8,0.902691511387163,110,116,133,136,142,148,158,161,"ATGGTGC","CACA","AGGAAGC","CTGA",2.27136597439625,17,6,10,42,2.7561906869595,4.47465762906695,8.0854236746156,101,"ENSG00000079974.19"
"14963","ENSG00000146414.17_56837",56829,56837,9,"ENSG00000146414.17",0,NA,"VVVVVUVVV",1,8,0.922153209109731,116,122,133,136,179,185,194,197,"CTGAAGT","AGGA","ATGTTGA","CTGA",2.34135566891929,11,43,9,72,1.97738981998163,4.39660690319423,8.08521973963316,101,"ENSG00000079974.19"
"6550","ENSG00000110693.19_502413",502405,502413,9,"ENSG00000110693.19",0,NA,"VVVVVUVVV",1,8,0.922153209109731,115,121,133,136,140,146,188,191,"ATAATGG","GTCA","GTCAAGA","CTGA",2.36015501593119,12,4,42,67,1.85159242551675,4.39648979959784,8.08510263603677,101,"ENSG00000079974.19"
"26850","ENSG00000185053.14_147032",147024,147032,9,"ENSG00000185053.14",0,NA,"UVVVVVVVV",1,8,0.902691511387163,92,98,105,108,110,116,133,136,"ATGATGA","CTAA","GATATAA","GTGA",2.38954162206861,7,2,17,35,1.96624371617454,4.47413029915798,8.08489634470664,101,"ENSG00000079974.19"
"27215","ENSG00000185737.13_953705",953697,953705,9,"ENSG00000185737.13",0,NA,"VVUVVVVVV",1,8,0.883643892339545,113,119,133,136,184,190,200,203,"CTGATGG","TTAA","CAGATGA","CTGA",2.43535254086753,14,48,10,81,1.96521943964397,4.55022576135688,8.08480133071506,101,"ENSG00000079974.19"
"31124","ENSG00000215869.4_115225",115217,115225,9,"ENSG00000215869.4",1,8,"VVVVVVVMV",0,8,0.884057971014493,114,120,133,136,171,177,210,213,"ATGATAA","CAAA","GTGAAGA","CTGA",2.56539049869123,13,35,33,90,1.09149797338865,4.54852532449921,8.08475720855718,101,"ENSG00000079974.19"
"6447","ENSG00000109911.19_245744",245736,245744,9,"ENSG00000109911.19",1,3,"VVMVVVVVV",0,8,0.882815734989648,108,114,133,136,186,192,201,204,"ATCATGA","CTGA","ATCATGA","CAGA",2.49564647206562,19,50,9,87,1.57632337268661,4.55349162994769,8.08475456990628,101,"ENSG00000079974.19"
"40721","ENSG00000257470.2_43875",43867,43875,9,"ENSG00000257470.2",1,7,"VVVVVVMVV",0,8,0.885300207039338,110,116,133,136,146,152,169,172,"ATTATCA","CTTT","ATGATGT","CTGA",2.37346475059507,17,10,17,53,2.35098235425796,4.5435201728896,8.08472100104695,101,"ENSG00000079974.19"
"40939","ENSG00000258131.1_82240",82232,82240,9,"ENSG00000258131.1",1,7,"VVVVVVMVV",0,8,0.885300207039338,110,116,133,136,146,152,169,172,"ATTATCA","CTTT","ATGATGT","CTGA",2.37346475059507,17,10,17,53,2.35098235425796,4.5435201728896,8.08472100104695,101,"ENSG00000079974.19"
"41548","ENSG00000259234.8_104094",104086,104094,9,"ENSG00000259234.8",1,5,"VVVVMVVVV",0,8,0.886542443064182,79,85,101,104,116,122,133,136,"ATGAGCA","CTCA","ATAACCA","CTGA",2.33439352981233,16,12,11,48,2.59136078271335,4.53849607869889,8.08466585095562,101,"ENSG00000079974.19"
"28100","ENSG00000188107.15_919608",919600,919608,9,"ENSG00000188107.15",1,1,"MVVVVVVVV",0,8,0.90600414078675,115,121,133,136,137,143,151,154,"AAGAGGA","ATAA","TTCATTA","CTGA",2.27448024105059,12,1,8,30,2.67934450310494,4.46063652752722,8.08465309067421,101,"ENSG00000079974.19"
"16586","ENSG00000151834.16_166347",166339,166347,9,"ENSG00000151834.16",1,1,"MVVVVVVVV",0,8,0.90600414078675,115,121,133,136,183,189,206,209,"ATCATGT","CTTT","ATGATGT","CTGA",2.42145345913423,12,47,17,85,1.69947613153201,4.46062479810672,8.08464136125372,101,"ENSG00000079974.19"
"34611","ENSG00000233607.1_28878",28870,28878,9,"ENSG00000233607.1",0,NA,"VVVUVVVVV",1,8,0.880745341614907,87,93,103,106,115,121,133,136,"ATCATGA","TTGA","GAGAAAA","ATGA",2.30783527980551,10,9,12,40,2.86106706963059,4.56165890041683,8.08464026687646,101,"ENSG00000079974.19"
"14172","ENSG00000144468.17_99336",99328,99336,9,"ENSG00000144468.17",1,6,"VVVVVMVVV",0,8,0.902691511387163,116,122,133,136,179,185,198,201,"GTGCTGG","CTGT","TTGAAGC","CTGA",2.39963475561837,11,43,13,76,1.8979061301203,4.47386779189402,8.08463383744267,101,"ENSG00000079974.19"
"38933","ENSG00000251314.2_485188",485180,485188,9,"ENSG00000251314.2",0,NA,"VVVVUVVVV",1,8,0.889855072463768,108,114,133,136,169,175,184,187,"AAAATGA","ATGA","GTGATAC","CTGA",2.4744229224141,19,33,9,70,1.60462659947995,4.52519485389349,8.08461514374857,101,"ENSG00000079974.19"
"34300","ENSG00000232593.8_76627",76619,76627,9,"ENSG00000232593.8",0,NA,"UVVVVVVVV",1,8,0.902691511387163,116,122,133,136,146,152,172,175,"ATCATGA","TTGA","GTGTATA","CTTA",2.32575275084798,11,10,20,50,2.39018323324557,4.47380039305803,8.08456643860668,101,"ENSG00000079974.19"
"207","ENSG00000006607.14_125866",125858,125866,9,"ENSG00000006607.14",1,1,"MVVVVVVVV",0,8,0.90600414078675,105,111,133,136,146,152,162,165,"TTGATGA","CTGT","GGGAGGT","GTGA",2.34094307343185,22,10,10,51,2.2356869146,4.46049351770308,8.08451008085008,101,"ENSG00000079974.19"
"827","ENSG00000035928.17_58373",58365,58373,9,"ENSG00000035928.17",0,NA,"VVVVVVUVV",1,8,0.886128364389234,99,105,133,136,144,150,168,171,"ATGATGT","CCAA","TTAATGT","CTGA",2.46887266611481,28,8,18,63,1.70065509814344,4.53995155139388,8.08446500895081,101,"ENSG00000079974.19"
"18552","ENSG00000157654.19_338520",338512,338520,9,"ENSG00000157654.19",1,1,"MVVVVVVVV",0,8,0.90600414078675,66,72,85,88,95,101,133,136,"GTGATGG","ATGA","GTGAGAA","ATGA",2.36333774395507,13,7,32,61,2.08595446593717,4.46038485640941,8.08440141955641,101,"ENSG00000079974.19"
"28561","ENSG00000196104.11_465912",465904,465912,9,"ENSG00000196104.11",1,1,"MVVVVVVVV",0,8,0.90600414078675,66,72,85,88,95,101,133,136,"GTGATGG","ATGA","GTGAGAA","ATGA",2.36333774395507,13,7,32,61,2.08595446593717,4.46038485640941,8.08440141955641,101,"ENSG00000079974.19"
"32311","ENSG00000226688.9_313420",313412,313420,9,"ENSG00000226688.9",1,1,"MVVVVVVVV",0,8,0.90600414078675,66,72,85,88,95,101,133,136,"GTGATGG","ATGA","GTGAGAA","ATGA",2.36333774395507,13,7,32,61,2.08595446593717,4.46038485640941,8.08440141955641,101,"ENSG00000079974.19"
"46474","ENSG00000286738.1_48051",48043,48051,9,"ENSG00000286738.1",1,1,"MVVVVVVVV",0,8,0.90600414078675,66,72,85,88,95,101,133,136,"GTGATGG","ATGA","GTGAGAA","ATGA",2.36333774395507,13,7,32,61,2.08595446593717,4.46038485640941,8.08440141955641,101,"ENSG00000079974.19"
"45188","ENSG00000285216.1_495909",495901,495909,9,"ENSG00000285216.1",1,8,"UVVVVVVMV",1,7,0.786749482401656,90,96,110,113,116,122,133,136,"AAGATGA","TTGA","ATGCATA","CTGA",2.55297258113547,14,3,11,37,2.72940261748816,4.93730495626449,8.08430288587112,101,"ENSG00000079974.19"
"45212","ENSG00000285219.4_218503",218495,218503,9,"ENSG00000285219.4",1,8,"UVVVVVVMV",1,7,0.786749482401656,90,96,110,113,116,122,133,136,"AAGATGA","TTGA","ATGCATA","CTGA",2.55297258113547,14,3,11,37,2.72940261748816,4.93730495626449,8.08430288587112,101,"ENSG00000079974.19"
"11046","ENSG00000133742.14_29563",29555,29563,9,"ENSG00000133742.14",0,NA,"UVVVVVVVV",1,8,0.902691511387163,112,118,133,136,178,184,236,239,"GTGATAA","ATGA","GGGAAGA","CTGA",2.54671771632587,15,42,52,118,0.9160182016515,4.47353407762266,8.08430012317131,101,"ENSG00000079974.19"
"12151","ENSG00000137478.15_219199",219191,219199,9,"ENSG00000137478.15",1,1,"MVVVVVVVV",0,8,0.90600414078675,112,118,133,136,141,147,159,162,"ATTATTA","ATGA","CTGATAA","TTGA",2.25264580563985,15,5,12,41,2.82316980467952,4.4602021272363,8.0842186903833,101,"ENSG00000079974.19"
"45241","ENSG00000285253.1_163498",163490,163498,9,"ENSG00000285253.1",0,NA,"VVVVVVUVV",1,8,0.886128364389234,114,120,133,136,141,147,156,159,"GCAATGT","TTAA","TTGATGA","CTGA",2.26957745694451,13,5,9,36,3.02827255804952,4.5396972344199,8.08421069197684,101,"ENSG00000079974.19"
"17576","ENSG00000154493.20_237620",237612,237620,9,"ENSG00000154493.20",1,2,"VMVVVVVVV",0,8,0.884057971014493,73,79,98,101,112,118,133,136,"ATGGTGA","CTGA","GCGAGCA","GTGA",2.39437490548442,19,11,15,54,2.22910902447281,4.54790209859224,8.08413398265021,101,"ENSG00000079974.19"
"29652","ENSG00000198554.12_65660",65652,65660,9,"ENSG00000198554.12",0,NA,"VVVVVVUVV",1,8,0.886128364389234,115,121,133,136,142,148,156,159,"AGGGTGG","CAGA","AAGAGAA","CTGA",2.25940760689867,12,6,8,35,3.09576072844806,4.53961952694312,8.08413298450006,101,"ENSG00000079974.19"
"37149","ENSG00000245685.9_152001",151993,152001,9,"ENSG00000245685.9",1,1,"MVVVVVUVV",1,7,0.792132505175983,108,114,133,136,141,147,164,167,"ATGATGA","AAGA","CTCAGGA","CTGA",2.61834577850692,19,5,17,50,2.20667671158569,4.91557880874129,8.08410882944522,101,"ENSG00000079974.19"
"21826","ENSG00000169084.15_251390",251382,251390,9,"ENSG00000169084.15",1,8,"VVVVVVVMV",0,8,0.884057971014493,112,118,133,136,143,149,201,204,"ATGCTGA","CTTT","AAGAAGA","CTGA",2.44198986312821,15,7,52,83,1.91099720460945,4.54773240636604,8.08396429042401,101,"ENSG00000079974.19"
"21831","ENSG00000169084.15_PAR_Y_251390",251382,251390,9,"ENSG00000169084.15_PAR_Y",1,8,"VVVVVVVMV",0,8,0.884057971014493,112,118,133,136,143,149,201,204,"ATGCTGA","CTTT","AAGAAGA","CTGA",2.44198986312821,15,7,52,83,1.91099720460945,4.54773240636604,8.08396429042401,101,"ENSG00000079974.19"
"34098","ENSG00000231902.2_46169",46161,46169,9,"ENSG00000231902.2",1,5,"VVVVMVVVV",0,8,0.886542443064182,94,100,133,136,180,186,198,201,"ATTATGA","TTGA","ATAATTA","CTGA",2.57591551348207,33,44,12,98,0.978277143455739,4.53776180833406,8.08393158059079,101,"ENSG00000079974.19"
"41661","ENSG00000259468.1_1625",1617,1625,9,"ENSG00000259468.1",0,NA,"VVVVVVUVV",1,8,0.886128364389234,113,119,133,136,154,160,168,171,"CTGATTA","ATTA","TTGAGGT","CTGA",2.37594650061764,14,18,8,49,2.31801325202092,4.53941414736797,8.0839276049249,101,"ENSG00000079974.19"
"18749","ENSG00000158321.19_643521",643513,643521,9,"ENSG00000158321.19",1,8,"VVVVVVVMV",0,8,0.884057971014493,111,117,133,136,182,188,200,203,"ATGTTGC","TTGA","CTGCCGA","CTGA",2.45887151111697,16,46,12,83,1.79806975357036,4.54763662358754,8.08386850764551,101,"ENSG00000079974.19"
"11311","ENSG00000134532.20_144510",144502,144510,9,"ENSG00000134532.20",1,2,"VMVVVVVVV",0,8,0.884057971014493,105,111,133,136,147,153,175,178,"AAGATGT","TTGA","CTGATTT","CTGA",2.49159523033725,22,11,22,64,1.57970228752209,4.54758428910927,8.08381617316724,101,"ENSG00000079974.19"
"26444","ENSG00000184261.5_33805",33797,33805,9,"ENSG00000184261.5",1,3,"VVMVVVVVV",0,8,0.882815734989648,106,112,133,136,167,173,183,186,"ATAATGA","ATTA","AAGATGA","CTGA",2.51360945909482,21,31,10,71,1.45224069019604,4.55240927104038,8.08367221099897,101,"ENSG00000079974.19"
"7466","ENSG00000114374.13_120943",120935,120943,9,"ENSG00000114374.13",1,8,"VVVVVVVMV",0,8,0.884057971014493,75,81,94,97,106,112,133,136,"ATGTTAA","TTGA","ATAAACA","CTGA",2.36743148031341,13,9,21,52,2.40678863774675,4.54741629329237,8.08364817735034,101,"ENSG00000079974.19"
"31475","ENSG00000223812.8_113700",113692,113700,9,"ENSG00000223812.8",1,1,"MVVVVVVVV",0,8,0.90600414078675,49,55,76,79,114,120,133,136,"ATGAGAA","CTGA","ATAATTT","CTGA",2.47328559814225,21,35,13,78,1.34883633082054,4.45935174627555,8.08336830942255,101,"ENSG00000079974.19"
"22018","ENSG00000169607.13_8538",8530,8538,9,"ENSG00000169607.13",1,8,"VVVVVVVMV",0,8,0.884057971014493,110,116,133,136,151,157,181,184,"ATAATGG","CAGA","TTGAAAA","CTGA",2.48476654470026,17,15,24,65,1.62262965811928,4.54693498903026,8.08316687308823,101,"ENSG00000079974.19"
"19800","ENSG00000163697.17_51165",51157,51165,9,"ENSG00000163697.17",0,NA,"VVUVVVVVV",1,8,0.883643892339545,115,121,133,136,164,170,213,216,"AAGATGA","ATAA","GTGAGGA","CTGA",2.56640628627365,12,28,43,92,1.08474542669552,4.54853016712997,8.08310573648814,101,"ENSG00000079974.19"
"20566","ENSG00000165084.16_90016",90008,90016,9,"ENSG00000165084.16",0,NA,"VVVVVUVVV",1,8,0.922153209109731,109,115,133,136,149,155,172,175,"CTGAGGT","AAGA","ATAATGA","CTGA",2.32784874919108,18,13,17,57,2.05810914154574,4.3942752007049,8.08288803714383,101,"ENSG00000079974.19"
"14981","ENSG00000146426.19_678",670,678,9,"ENSG00000146426.19",0,NA,"VVVVVUVVV",1,8,0.922153209109731,81,87,100,103,112,118,133,136,"GAGAAGA","CTGA","GTGAACC","CAGA",2.22144290629096,13,9,15,46,2.76741358991009,4.39425824129578,8.08287107773471,101,"ENSG00000079974.19"
"30752","ENSG00000213079.10_99997",99989,99997,9,"ENSG00000213079.10",0,NA,"VVVVVUVVV",1,8,0.922153209109731,81,87,100,103,112,118,133,136,"GAGAAGA","CTGA","GTGAACC","CAGA",2.22144290629096,13,9,15,46,2.76741358991009,4.39425824129578,8.08287107773471,101,"ENSG00000079974.19"
"28440","ENSG00000189108.13_744720",744712,744720,9,"ENSG00000189108.13",1,2,"VMVVVVVVV",0,8,0.884057971014493,73,79,92,95,107,113,133,136,"TTTATGT","CTAA","ATGCAGA","CTGA",2.38624381609018,13,12,20,54,2.27795983930753,4.54656298664386,8.08279487070183,101,"ENSG00000079974.19"
"33760","ENSG00000231061.1_1360",1352,1360,9,"ENSG00000231061.1",1,1,"MVUVVVVVV",1,7,0.789648033126294,77,83,99,102,112,118,133,136,"ATAATGT","TTGA","ATGATGT","CTGA",2.57141508194609,16,10,15,50,2.553965310048,4.92418313075549,8.08277526326066,101,"ENSG00000079974.19"
"4520","ENSG00000100883.13_1951",1943,1951,9,"ENSG00000100883.13",0,NA,"VVVVVUVVV",1,8,0.922153209109731,113,119,133,136,147,153,171,174,"ATAAAGA","GTGG","GTGCTCC","CTGA",2.27118179674647,14,11,18,52,2.43533852907193,4.39413762684544,8.08275046328436,101,"ENSG00000079974.19"
"42663","ENSG00000265542.5_36314",36306,36314,9,"ENSG00000265542.5",0,NA,"UVVVVVVVV",1,8,0.902691511387163,110,116,133,136,161,167,210,213,"ATGATTT","CTAA","GTGTTGA","CTGA",2.54964992244354,17,25,43,94,0.890139478766331,4.47195140709748,8.08271745264613,101,"ENSG00000079974.19"
"9761","ENSG00000127124.16_341603",341595,341603,9,"ENSG00000127124.16",1,1,"MVVVVVVVV",0,8,0.90600414078675,110,116,133,136,143,149,160,163,"ATTATAA","CGGG","ATGCAAA","CTGA",2.26279550072318,17,7,11,44,2.74945851448307,4.4586904631594,8.08270702630639,101,"ENSG00000079974.19"
"18496","ENSG00000157540.22_124253",124245,124253,9,"ENSG00000157540.22",0,NA,"UVVVVVVVV",1,8,0.902691511387163,102,108,133,136,146,152,161,164,"GTGAGGT","CTTT","ATGAAGA","CTGA",2.37273638461441,25,10,9,53,2.06875483584945,4.47174934998637,8.08251539553503,101,"ENSG00000079974.19"
"24653","ENSG00000177311.12_59255",59247,59255,9,"ENSG00000177311.12",1,1,"MVVVVVVVV",0,8,0.90600414078675,101,107,133,136,152,158,181,184,"ATGTTGA","CCCA","GTGGTGA","CTGA",2.52795365117534,26,16,23,74,0.980952224823483,4.4584941414981,8.0825107046451,101,"ENSG00000079974.19"
"45185","ENSG00000285216.1_402910",402902,402910,9,"ENSG00000285216.1",0,NA,"UVVVVVVVV",1,8,0.902691511387163,113,119,133,136,143,149,157,160,"ATACTGA","TTGG","ATCCTAA","CTGA",2.23244030588504,14,7,8,38,3.00386870971515,4.47170102057051,8.08246706611917,101,"ENSG00000079974.19"
"45209","ENSG00000285219.4_125504",125496,125504,9,"ENSG00000285219.4",0,NA,"UVVVVVVVV",1,8,0.902691511387163,113,119,133,136,143,149,157,160,"ATACTGA","TTGG","ATCCTAA","CTGA",2.23244030588504,14,7,8,38,3.00386870971515,4.47170102057051,8.08246706611917,101,"ENSG00000079974.19"
"18630","ENSG00000157890.19_81937",81929,81937,9,"ENSG00000157890.19",1,1,"MVVVVVUVV",1,7,0.792132505175983,112,118,133,136,146,152,162,165,"ATGATGA","CTGT","GTGAAGC","GTGA",2.52589766678667,15,10,10,44,2.8163612972043,4.91391976894552,8.08244978964946,101,"ENSG00000079974.19"
"24921","ENSG00000178607.17_69868",69860,69868,9,"ENSG00000178607.17",1,8,"VVVVVVVMV",0,8,0.884057971014493,112,118,133,136,182,188,239,242,"GTGATGT","TTGA","CTGTGGA","CTGA",2.59065628194991,15,46,51,121,0.913627845761284,4.54616743135683,8.0823993154148,101,"ENSG00000079974.19"
"7904","ENSG00000116016.14_72659",72651,72659,9,"ENSG00000116016.14",0,NA,"VVVUVVVVV",1,8,0.880745341614907,114,120,133,136,154,160,172,175,"GTTTTGA","ATGA","TTGAAGG","CTGA",2.38654276543991,13,18,12,52,2.32673044223487,4.5592538862919,8.08223525275153,101,"ENSG00000079974.19"
"41233","ENSG00000258710.8_97368",97360,97368,9,"ENSG00000258710.8",1,1,"MVVVVVVVV",0,8,0.90600414078675,115,121,133,136,140,146,157,160,"GTGATTA","CAGA","ATGACAC","CTTA",2.23587335615685,12,4,11,36,2.92626049687161,4.45802071781264,8.08203728095964,101,"ENSG00000079974.19"
"36768","ENSG00000242880.2_35484",35476,35484,9,"ENSG00000242880.2",1,1,"MVVVVVVVV",0,8,0.90600414078675,114,120,133,136,162,168,181,184,"ATGGAGA","CAGT","GAGATGA","CTGA",2.37194129488271,13,26,13,61,2.01905096585633,4.45799823293526,8.08201479608226,101,"ENSG00000079974.19"
"38702","ENSG00000250910.8_114954",114946,114954,9,"ENSG00000250910.8",0,NA,"UVVVUVVVV",2,7,0.792546583850932,114,120,133,136,148,154,171,174,"AAGATGA","ATGA","ATTATGG","CTGA",2.57813758891547,13,12,17,51,2.45956235031932,4.91178656910561,8.08197290450934,101,"ENSG00000079974.19"
"15891","ENSG00000150275.20_1070986",1070978,1070986,9,"ENSG00000150275.20",1,1,"MVVVVVVVV",0,8,0.90600414078675,43,49,66,69,105,111,133,136,"AAGATGA","CTGA","TTGATCA","CTAA",2.49790249926431,17,36,22,84,1.17900879349828,4.45792303048176,8.08193959362875,101,"ENSG00000079974.19"
"46799","ENSG00000287204.1_483",475,483,9,"ENSG00000287204.1",1,2,"VMVVVUVVV",1,7,0.806211180124223,95,101,108,111,116,122,133,136,"ATTAAGA","CTGA","GTCAGCA","CTGA",2.49623985532816,7,5,11,32,2.78555061077569,4.85678741157419,8.08163213207108,101,"ENSG00000079974.19"
"29621","ENSG00000198429.10_19362",19354,19362,9,"ENSG00000198429.10",1,1,"MVVVVVVVV",0,8,0.90600414078675,82,88,133,136,164,170,185,188,"TGGATGA","ATGA","GTGAAAA","CTGA",2.54085949616146,45,28,15,97,0.890775789839419,4.45745977439562,8.08147633754261,101,"ENSG00000079974.19"
"18237","ENSG00000156650.14_106226",106218,106226,9,"ENSG00000156650.14",0,NA,"VVVUVVVVV",1,8,0.880745341614907,101,107,133,136,163,169,188,191,"GTGTTGA","CTGG","GTGAAGA","CTGA",2.61554228510738,26,27,19,81,0.796527540048489,4.55836902685776,8.08135039331738,101,"ENSG00000079974.19"
"39068","ENSG00000251574.8_632379",632371,632379,9,"ENSG00000251574.8",1,1,"MVUVVVVVV",1,7,0.789648033126294,77,83,98,101,111,117,133,136,"TTGATTT","CTGA","ATGATGT","CTGA",2.5685719020008,15,10,16,50,2.56698142449996,4.92269852612633,8.0812906586315,101,"ENSG00000079974.19"
"40427","ENSG00000256128.7_15184",15176,15184,9,"ENSG00000256128.7",0,NA,"VVVVVUVVV",1,8,0.922153209109731,82,88,133,136,137,143,155,158,"AAGATGT","TGGA","ATGATAA","CTGA",2.44300144333999,45,1,12,67,1.28396692796869,4.39266080422549,8.08127364066441,101,"ENSG00000079974.19"
"37394","ENSG00000248079.4_295240",295232,295240,9,"ENSG00000248079.4",1,6,"VVVVVMVVV",0,8,0.902691511387163,45,51,63,66,77,83,133,136,"GTGATGA","CTGC","TTGCTGT","CTGT",2.40660000069841,12,11,50,82,1.83769556320324,4.47042389196484,8.08118993751349,101,"ENSG00000079974.19"
"26023","ENSG00000183166.11_49548",49540,49548,9,"ENSG00000183166.11",1,2,"VMVVVVVVV",0,8,0.884057971014493,97,103,133,136,141,147,157,160,"TTCATGT","CTGC","TTGAGGA","CTGA",2.4306932557263,30,5,10,54,1.97507828177788,4.54492499665497,8.08115688071295,101,"ENSG00000079974.19"
"16673","ENSG00000152061.24_390164",390156,390164,9,"ENSG00000152061.24",1,2,"VMVVVVVVV",0,8,0.884057971014493,115,121,133,136,160,166,178,181,"GAGATGA","GAGA","CTCAAGA","CTGA",2.41119458701894,12,24,12,57,2.10489271676695,4.5448808242233,8.08111270828127,101,"ENSG00000079974.19"
"34336","ENSG00000232790.3_106985",106977,106985,9,"ENSG00000232790.3",1,2,"VMVVVVVVV",0,8,0.884057971014493,107,113,133,136,143,149,164,167,"ATGATAA","CACA","ATTATAC","CTGA",2.38065842227814,20,7,15,51,2.30792524705135,4.54474534889308,8.08097723295105,101,"ENSG00000079974.19"
"37021","ENSG00000244337.2_316",308,316,9,"ENSG00000244337.2",1,2,"VMVVVVVVV",0,8,0.884057971014493,42,48,91,94,107,113,133,136,"GAGATGA","CAGA","GTAATGT","CTGA",2.54516906525187,43,13,20,85,1.21107982943535,4.54471839944528,8.08095028350325,101,"ENSG00000079974.19"
"28345","ENSG00000188786.10_47794",47786,47794,9,"ENSG00000188786.10",1,6,"VVVVVMVVV",0,8,0.902691511387163,114,120,133,136,146,152,163,166,"GAGATCA","CAGG","AAGATGT","CTGA",2.24828543865008,13,10,11,43,2.89199271304926,4.47014057601245,8.0809066215611,101,"ENSG00000079974.19"
"34422","ENSG00000233005.2_551529",551521,551529,9,"ENSG00000233005.2",0,NA,"UVVVVVVVV",1,8,0.902691511387163,116,122,133,136,141,147,156,159,"ATCATAA","CTTA","GTGAAGG","ATGA",2.22133035600917,11,5,9,34,3.07159814051807,4.4701167951448,8.08088284069345,101,"ENSG00000079974.19"
"23146","ENSG00000172264.19_1939176",1939168,1939176,9,"ENSG00000172264.19",0,NA,"VVVVVVUVV",1,8,0.886128364389234,116,122,133,136,139,145,156,159,"CAGATGA","GTCA","GTTTTTA","CTGA",2.29756709941553,11,3,11,34,2.8281652332091,4.53631980732815,8.08083326488508,101,"ENSG00000079974.19"
"39847","ENSG00000254349.6_124871",124863,124871,9,"ENSG00000254349.6",1,1,"MVVVVVVVV",0,8,0.90600414078675,41,47,63,66,83,89,133,136,"ATGATGA","TTGA","ATTTTGA","GTGA",2.482796915848,16,17,44,86,1.27513335156253,4.45677819763729,8.08079476078429,101,"ENSG00000079974.19"
"45969","ENSG00000286084.3_137730",137722,137730,9,"ENSG00000286084.3",0,NA,"UVVVVVVVV",1,8,0.902691511387163,106,112,133,136,139,145,153,156,"AAGATGG","GAGA","AGGAAGA","CTGA",2.36472221485849,21,3,8,41,2.11500193526329,4.46995417524665,8.0807202207953,101,"ENSG00000079974.19"
"3607","ENSG00000086717.19_15340",15332,15340,9,"ENSG00000086717.19",1,7,"VVVVVVMVV",0,8,0.885300207039338,114,120,133,136,167,173,182,185,"ATGAAGT","TTAA","TTGATGT","CTGA",2.41820285987038,13,31,9,62,2.03667242802348,4.53950620678983,8.08070703494718,101,"ENSG00000079974.19"
"29428","ENSG00000197969.14_220863",220855,220863,9,"ENSG00000197969.14",1,3,"VVMVVVUVV",1,7,0.768944099378882,103,109,133,136,145,151,162,165,"ATCATGA","CTGG","GTGAAGA","CTGA",2.67976246859362,24,9,11,53,2.15453053997604,5.00490341598338,8.0806798134989,101,"ENSG00000079974.19"
"45723","ENSG00000285834.1_80221",80213,80221,9,"ENSG00000285834.1",1,2,"VMVVVVVVV",0,8,0.884057971014493,110,116,133,136,145,151,167,170,"ATGAATA","TTTA","ATTATGA","CTGA",2.35696872938612,17,9,16,51,2.46457668551793,4.54442538702302,8.08065727108099,101,"ENSG00000079974.19"
"37601","ENSG00000248515.2_428483",428475,428483,9,"ENSG00000248515.2",1,2,"VMVVVVVVV",0,8,0.884057971014493,109,115,133,136,145,151,168,171,"ATGATTT","CTGC","GACATGG","CTGA",2.37943345676008,18,9,17,53,2.31470959797641,4.54439982742757,8.08063171148554,101,"ENSG00000079974.19"
"33127","ENSG00000228742.11_53651",53643,53651,9,"ENSG00000228742.11",0,NA,"UVVVVVVVV",1,8,0.902691511387163,83,89,100,103,114,120,133,136,"ATTATTT","CTGT","GTATAGA","CTGA",2.27119140842502,11,11,13,44,2.73771762998642,4.4697484215383,8.08051446708696,101,"ENSG00000079974.19"
"15026","ENSG00000146648.21_72311",72303,72311,9,"ENSG00000146648.21",0,NA,"UVVVVVVVV",1,8,0.902691511387163,69,75,92,95,105,111,133,136,"ATGATGA","CAGT","GTAATTA","ATGA",2.37270767996675,17,10,22,58,2.0607813696062,4.46970814234614,8.08047418789479,101,"ENSG00000079974.19"
"1780","ENSG00000066032.19_1415793",1415785,1415793,9,"ENSG00000066032.19",1,8,"VVVVVVVMV",0,8,0.884057971014493,105,111,133,136,152,158,185,188,"CTGATGA","CTGA","CTGATGT","CAGA",2.57194608678267,22,16,27,74,1.02926010759415,4.54389183820299,8.08012372226096,101,"ENSG00000079974.19"
"34104","ENSG00000231918.1_1167664",1167656,1167664,9,"ENSG00000231918.1",0,NA,"UVVVVVVVV",1,8,0.902691511387163,110,116,133,136,144,150,182,185,"CTGATGA","CTCA","GTGAGCA","CTGC",2.40676287182043,17,8,32,66,1.83198826685374,4.46926851974749,8.08003456529614,101,"ENSG00000079974.19"
"505","ENSG00000014824.14_8535",8527,8535,9,"ENSG00000014824.14",1,7,"VVVVVVMVV",0,8,0.885300207039338,112,118,133,136,146,152,161,164,"ATGAAGA","CTTA","TTTAAGA","CTGG",2.30049021641903,15,10,9,43,2.81870118800301,4.53882565769913,8.08002648585648,101,"ENSG00000079974.19"
"33253","ENSG00000229140.12_715543",715535,715543,9,"ENSG00000229140.12",1,2,"VMVVVVVVV",0,8,0.884057971014493,116,122,133,136,147,153,178,181,"ATGGTGG","CAGG","ATGATAA","CTGA",2.41377471939165,11,11,25,56,2.08295261454956,4.54369601929015,8.07992790334812,101,"ENSG00000079974.19"
"16971","ENSG00000152894.15_531447",531439,531447,9,"ENSG00000152894.15",1,2,"VMVVVVVVV",0,8,0.884057971014493,85,91,133,136,145,151,159,162,"ATGTGGA","ATGA","GTAATAA","CTGA",2.43638785355908,42,9,8,68,1.93139430238781,4.54349499819542,8.07972688225339,101,"ENSG00000079974.19"
"2983","ENSG00000079931.15_79209",79201,79209,9,"ENSG00000079931.15",1,1,"MVVVVVVVV",0,8,0.90600414078675,84,90,133,136,138,144,154,157,"ATGTTGA","ATGT","AGGATAA","CTGA",2.4445771543719,43,2,10,64,1.52564334549446,4.45570609366012,8.07972265680712,101,"ENSG00000079974.19"
"40495","ENSG00000256615.1_35228",35220,35228,9,"ENSG00000256615.1",1,7,"VVVVVVMVV",0,8,0.885300207039338,105,111,133,136,138,144,152,155,"ATGTTGA","ATGG","ATCTTGA","CTGA",2.44310677754952,22,2,8,41,1.86658047511166,4.53848974802712,8.07969057618447,101,"ENSG00000079974.19"
"17449","ENSG00000154162.15_915235",915227,915235,9,"ENSG00000154162.15",1,8,"VVVVVVVMV",0,8,0.884057971014493,82,88,99,102,110,116,133,136,"ATCAAGA","TTAA","TTGAGGT","CTGA",2.3263065572516,11,8,17,45,2.66507824251817,4.54344715604887,8.07967904010684,101,"ENSG00000079974.19"
"13744","ENSG00000143341.12_375340",375332,375340,9,"ENSG00000143341.12",1,6,"VVVVVMVVV",0,8,0.902691511387163,113,119,133,136,144,150,159,162,"GTAATGG","ATTA","AGGAAGG","CTGA",2.23400096475009,14,8,9,40,2.98227872674073,4.46890462293533,8.07967066848398,101,"ENSG00000079974.19"
"27471","ENSG00000186260.17_167388",167380,167388,9,"ENSG00000186260.17",0,NA,"VVVUVVVVV",1,8,0.880745341614907,111,117,133,136,183,189,199,202,"ATGTTGA","TTGG","GTCCTGA","CTGA",2.45806001301277,16,47,10,82,1.83956263874377,4.55665734804056,8.07963871450019,101,"ENSG00000079974.19"
"47163","ENSG00000287722.1_484060",484052,484060,9,"ENSG00000287722.1",1,8,"VVVVVUVMV",1,7,0.806211180124224,111,117,133,136,148,154,172,175,"TTGTTGA","TTGA","GTGATGC","CTGA",2.57689362197165,16,12,18,55,2.2398415730199,4.85478309654106,8.07962781703795,101,"ENSG00000079974.19"
"17364","ENSG00000153956.17_68608",68600,68608,9,"ENSG00000153956.17",1,8,"VVVVVVVMV",0,8,0.884057971014493,95,101,133,136,145,151,167,170,"GTGATGT","CAGG","ATGACAA","CTGA",2.46615627349339,32,9,16,66,1.73248919080279,4.54338275352301,8.07961463758098,101,"ENSG00000079974.19"
"20799","ENSG00000165675.19_250156",250148,250156,9,"ENSG00000165675.19",1,8,"VVVVVVVMV",0,8,0.884057971014493,110,116,133,136,137,143,157,160,"ATGATTA","AGGA","ATGAGTC","CTGA",2.42958689591199,17,1,14,41,1.97622649900025,4.54336811793671,8.07960000199468,101,"ENSG00000079974.19"
"36751","ENSG00000242808.12_829536",829528,829536,9,"ENSG00000242808.12",1,6,"VVVVVMVVV",0,8,0.902691511387163,107,113,133,136,167,173,183,186,"TTGATCA","TTGA","GTGGTAG","CTGA",2.45119356808926,20,31,10,70,1.53279559163046,4.46852151138971,8.07928755693836,101,"ENSG00000079974.19"
"16763","ENSG00000152217.20_132889",132881,132889,9,"ENSG00000152217.20",1,1,"MVVVVVVVV",0,8,0.90600414078675,110,116,133,136,184,190,208,211,"AGGATGT","ATGA","GTGACTT","CTGA",2.46426781979914,17,48,18,92,1.39244784771039,4.45522499492616,8.07924155807316,101,"ENSG00000079974.19"
"33144","ENSG00000228826.3_7383",7375,7383,9,"ENSG00000228826.3",0,NA,"UVVVVUVVV",2,7,0.824844720496894,89,95,133,136,145,151,167,170,"GTGATGA","CTGT","ATCAGGT","CTGA",2.61109722152464,38,9,16,72,1.71209206076649,4.77985171773269,8.07923059972027,101,"ENSG00000079974.19"
"3073","ENSG00000080709.16_269057",269049,269057,9,"ENSG00000080709.16",1,7,"VVVVVVMVV",0,8,0.885300207039338,91,97,133,136,157,163,179,182,"ATCATGA","CTGT","ATAAGGA","CTGA",2.5722801427133,36,21,16,82,1.00304276316537,4.53789426198017,8.07909509013752,101,"ENSG00000079974.19"
"45299","ENSG00000285367.3_199333",199325,199333,9,"ENSG00000285367.3",1,6,"VVVVVMUVV",1,7,0.788819875776397,54,60,75,78,90,96,133,136,"CTGATGG","CTGA","CTGATGG","CTGA",2.69748552804745,15,12,37,73,1.71191016328317,4.92378675423322,8.07906625733881,101,"ENSG00000079974.19"
"26997","ENSG00000185420.19_106989",106981,106989,9,"ENSG00000185420.19",0,NA,"VVUVVVVVV",1,8,0.883643892339545,78,84,99,102,110,116,133,136,"ATGTTGA","CTGG","GCGAAGA","CTTA",2.33738302959721,15,8,17,49,2.59492865029695,4.54437054523625,8.07894611459443,101,"ENSG00000079974.19"
"13241","ENSG00000140743.8_37862",37854,37862,9,"ENSG00000140743.8",1,6,"VVUVVMVVV",1,7,0.786335403726708,74,80,112,115,116,122,133,136,"AAGATGA","CTGA","CTGATAA","CTGA",2.75987764405196,32,1,11,53,1.33502965796296,4.93355348791067,8.0788951028175,101,"ENSG00000079974.19"
"35467","ENSG00000236107.10_302060",302052,302060,9,"ENSG00000236107.10",1,7,"VVVVVVMVV",0,8,0.885300207039338,100,106,133,136,174,180,193,196,"GTGGTGA","CAGA","GTGAGAA","CTGA",2.56766705062256,27,38,13,87,1.03287106801284,4.53766285137414,8.07886367953149,101,"ENSG00000079974.19"
"6359","ENSG00000109472.14_56464",56456,56464,9,"ENSG00000109472.14",1,8,"VVVVVVVMV",0,8,0.884057971014493,95,101,107,110,115,121,133,136,"ATGATTT","CAGA","GTGATGT","CTAA",2.33048853556274,6,5,12,32,2.63352824096754,4.54252961951311,8.07876150357108,101,"ENSG00000079974.19"
"19903","ENSG00000163947.12_141433",141425,141433,9,"ENSG00000163947.12",1,6,"VVVVVMUVV",1,7,0.788819875776397,84,90,103,106,116,122,133,136,"CTGATTA","CAGA","GTGTTAA","CTGA",2.52027915461081,13,10,11,43,2.89199271304926,4.923463435947,8.07874293905259,101,"ENSG00000079974.19"
"40455","ENSG00000256346.1_51",43,51,9,"ENSG00000256346.1",0,NA,"UVVVVVVVV",1,8,0.902691511387163,26,32,53,56,72,78,95,98,"TTCATGA","TTGA","ATGGTTT","CTGA",2.44135317679818,21,16,17,63,1.59604055149071,4.46793209920297,8.07869814475163,101,"ENSG00000079974.19"
"21275","ENSG00000166960.17_335857",335849,335857,9,"ENSG00000166960.17",0,NA,"UVVVVVVVV",1,8,0.902691511387163,86,92,102,105,113,119,133,136,"ATGGTGA","CAGA","ATAGTGT","CTAA",2.26052010206219,10,8,14,41,2.80146926504232,4.46790081969757,8.07866686524622,101,"ENSG00000079974.19"
"14295","ENSG00000144648.16_51251",51243,51251,9,"ENSG00000144648.16",1,5,"VVVVMVVVV",0,8,0.886542443064182,62,68,87,90,98,104,133,136,"AAGATCA","CAGA","GTGTTTA","CTGA",2.46256062097484,19,8,29,65,1.71241510235692,4.53237147721397,8.0785412494707,101,"ENSG00000079974.19"
"43714","ENSG00000273291.5_46557",46549,46557,9,"ENSG00000273291.5",1,5,"VVVVMVVVV",0,8,0.886542443064182,62,68,87,90,98,104,133,136,"AAGATCA","CAGA","GTGTTTA","CTGA",2.46256062097484,19,8,29,65,1.71241510235692,4.53237147721397,8.0785412494707,101,"ENSG00000079974.19"
"43730","ENSG00000273328.5_46589",46581,46589,9,"ENSG00000273328.5",1,5,"VVVVMVVVV",0,8,0.886542443064182,62,68,87,90,98,104,133,136,"AAGATCA","CAGA","GTGTTTA","CTGA",2.46256062097484,19,8,29,65,1.71241510235692,4.53237147721397,8.0785412494707,101,"ENSG00000079974.19"
"48053","ENSG00000290317.1_46520",46512,46520,9,"ENSG00000290317.1",1,5,"VVVVMVVVV",0,8,0.886542443064182,62,68,87,90,98,104,133,136,"AAGATCA","CAGA","GTGTTTA","CTGA",2.46256062097484,19,8,29,65,1.71241510235692,4.53237147721397,8.0785412494707,101,"ENSG00000079974.19"
"24700","ENSG00000177570.15_87472",87464,87472,9,"ENSG00000177570.15",1,1,"MVVVVVVVV",0,8,0.90600414078675,82,88,133,136,165,171,186,189,"TGGATGA","ATGA","GTGAAAA","CTGA",2.54085949616146,45,29,15,98,0.878696675365736,4.4544399957772,8.07845655892419,101,"ENSG00000079974.19"
"2057","ENSG00000069667.16_455122",455114,455122,9,"ENSG00000069667.16",0,NA,"VVVVVUVVV",1,8,0.922153209109731,105,111,133,136,145,151,196,199,"ATGATCA","GGGA","TTTAGGA","CTGA",2.43962347264389,22,9,45,85,1.29499075174715,4.38978680900994,8.07839964544886,101,"ENSG00000079974.19"
"47357","ENSG00000288035.1_188350",188342,188350,9,"ENSG00000288035.1",1,6,"UVVVVMVVV",1,7,0.805383022774327,101,107,133,136,146,152,160,163,"ATGATGA","ATTA","AAGAGGA","CTGA",2.61225655802862,26,10,8,53,2.0121167995927,4.85679012994587,8.07832222104318,101,"ENSG00000079974.19"
"13292","ENSG00000140937.14_35533",35525,35533,9,"ENSG00000140937.14",1,1,"MVVVVVVVV",0,8,0.90600414078675,114,120,133,136,140,146,155,158,"CTGTTGT","CCGC","ATAATTA","CTGA",2.22801989943382,13,4,9,35,2.9636559347714,4.45428048274921,8.07829704589621,101,"ENSG00000079974.19"
"33852","ENSG00000231304.2_432209",432201,432209,9,"ENSG00000231304.2",1,3,"VVMVVVVVV",0,8,0.882815734989648,52,58,68,71,104,110,133,136,"TAGATGA","ATGA","GTGTGGA","CTGA",2.53211880637146,10,33,23,75,1.30718506148874,4.54699427599128,8.07825721594987,101,"ENSG00000079974.19"
"32963","ENSG00000228351.3_41190",41182,41190,9,"ENSG00000228351.3",1,6,"VVVVVMVVV",0,8,0.902691511387163,62,68,82,85,90,96,133,136,"TTGATCA","CAGC","GTGACAA","CTGA",2.39067926389144,14,5,37,65,1.93190485835439,4.46744165440767,8.07820769995632,101,"ENSG00000079974.19"
"24174","ENSG00000175449.14_1798",1790,1798,9,"ENSG00000175449.14",0,NA,"UVVVVVVVV",1,8,0.902691511387163,81,87,101,104,114,120,133,136,"ATCATGA","AAGA","GTGTTAA","CTCA",2.26264089922119,14,10,13,46,2.78535128930058,4.46740598769379,8.07817203324245,101,"ENSG00000079974.19"
"41938","ENSG00000260086.5_121860",121852,121860,9,"ENSG00000260086.5",1,7,"VVVVVVMVV",0,8,0.885300207039338,69,75,88,91,97,103,133,136,"ATGAAGA","CTGG","GTGGTGA","CTGG",2.40625269823752,13,6,30,58,2.1060038015787,4.53692211412387,8.07812294228122,101,"ENSG00000079974.19"
"36281","ENSG00000239498.1_262306",262298,262306,9,"ENSG00000239498.1",0,NA,"VVVUVVUVV",2,7,0.766873706004141,83,89,104,107,112,118,133,136,"ATAATCA","CTGA","CTGTTGA","CTGA",2.60631490921055,15,5,15,44,2.666730280727,5.01054075219934,8.0780355762159,101,"ENSG00000079974.19"
"14861","ENSG00000145990.11_109801",109793,109801,9,"ENSG00000145990.11",1,2,"UMVVVVVVV",1,7,0.786749482401656,115,121,133,136,170,176,184,187,"TTGATGG","CTGA","ATGTAGA","CTGA",2.65791713555475,12,34,8,63,2.0043779667073,4.93095638426808,8.0779543138747,101,"ENSG00000079974.19"
"48235","ENSG00000290711.1_38704",38696,38704,9,"ENSG00000290711.1",1,2,"UMVVVVVVV",1,7,0.786749482401656,83,89,100,103,109,115,133,136,"CTGAGGA","ATGA","ATGATAA","CTGA",2.56802540148103,11,6,18,44,2.6033663319076,4.93088391877862,8.07788184838525,101,"ENSG00000079974.19"
"48330","ENSG00000290983.1_43832",43824,43832,9,"ENSG00000290983.1",1,2,"UMVVVVVVV",1,7,0.786749482401656,83,89,100,103,109,115,133,136,"CTGAGGA","ATGA","ATGATAA","CTGA",2.56802540148103,11,6,18,44,2.6033663319076,4.93088391877862,8.07788184838525,101,"ENSG00000079974.19"
"24977","ENSG00000178965.14_21795",21787,21795,9,"ENSG00000178965.14",1,1,"MVVVVVVVV",0,8,0.90600414078675,116,122,133,136,153,159,169,172,"ATGATGT","TTCA","TTGACGA","CTGG",2.31143663966283,11,17,10,47,2.4056754857139,4.45381327086652,8.07782983401352,101,"ENSG00000079974.19"
"7999","ENSG00000116299.17_18988",18980,18988,9,"ENSG00000116299.17",1,5,"VVVVMVVVV",0,8,0.886542443064182,88,94,133,136,144,150,166,169,"ATGATAA","ATGC","GGGATCA","CTGA",2.4568447658495,39,8,16,72,1.74723358968838,4.53154967383793,8.07771944609465,101,"ENSG00000079974.19"
"28309","ENSG00000188641.14_774769",774761,774769,9,"ENSG00000188641.14",1,6,"VVVVVMVVV",0,8,0.902691511387163,69,75,81,84,90,96,133,136,"ATGATGA","CTGT","CTAATGC","ATGA",2.45395630578281,6,6,37,58,1.50778409617815,4.46687320034922,8.07763924589787,101,"ENSG00000079974.19"
"18391","ENSG00000157181.16_44789",44781,44789,9,"ENSG00000157181.16",1,8,"VVVVVVVMV",0,8,0.884057971014493,111,117,133,136,140,146,165,168,"TTATTGA","CTCA","ATGTTGA","CTGA",2.38691455825079,16,4,19,48,2.25277682808803,4.54138513743999,8.07761702149796,101,"ENSG00000079974.19"
"8499","ENSG00000119231.11_36506",36498,36506,9,"ENSG00000119231.11",1,7,"VVUVVVMVV",1,7,0.768944099378882,53,59,72,75,81,87,133,136,"TTGAAGA","CTGA","GTGAAGA","CTGA",2.70329576665586,13,6,46,74,1.98534912272963,5.00183022510884,8.07760662262437,101,"ENSG00000079974.19"
"35608","ENSG00000236451.3_215",207,215,9,"ENSG00000236451.3",1,6,"UVVVVMVVV",1,7,0.805383022774327,113,119,133,136,146,152,160,163,"TTGATGT","CTGG","TAGATGG","CTGA",2.48366363731704,14,10,8,41,2.86643073501561,4.8560470792823,8.07757917037961,101,"ENSG00000079974.19"
"39911","ENSG00000254420.1_81332",81324,81332,9,"ENSG00000254420.1",0,NA,"VVVVVUVVV",1,8,0.922153209109731,75,81,95,98,103,109,133,136,"GTCATGA","CTGC","GTGGTGT","ATGA",2.30195086465593,14,5,24,52,2.20946136002723,4.38895011443336,8.07756295087228,101,"ENSG00000079974.19"
"30692","ENSG00000206573.11_33693",33685,33693,9,"ENSG00000206573.11",1,1,"MVVVVVVVV",0,8,0.90600414078675,83,89,104,107,114,120,133,136,"AGGAAGA","CTGA","GTCACCA","TTGA",2.24648621315766,15,7,13,44,2.83729252071384,4.45346681877456,8.07748338192155,101,"ENSG00000079974.19"
"37781","ENSG00000248858.7_135642",135634,135642,9,"ENSG00000248858.7",1,1,"MVVVVVVVV",0,8,0.90600414078675,115,121,133,136,137,143,155,158,"AGGATGT","TTAA","ATAAGGG","CTGA",2.30448299586381,12,1,12,34,2.45063011842546,4.45346252271272,8.07747908585972,101,"ENSG00000079974.19"
"38601","ENSG00000250551.1_100770",100762,100770,9,"ENSG00000250551.1",1,2,"VMVVVVVVV",0,8,0.884057971014493,115,121,133,136,184,190,198,201,"ATGCAGA","CAGA","CTGCTGC","CTGA",2.42749862045986,12,48,8,77,1.98163590960444,4.54124001150088,8.07747189555885,101,"ENSG00000079974.19"
"38928","ENSG00000251314.2_188884",188876,188884,9,"ENSG00000251314.2",1,2,"VMVVVVVVV",0,8,0.884057971014493,115,121,133,136,184,190,198,201,"ATGCAGA","CAGA","CTGCTGC","CTGA",2.42749862045986,12,48,8,77,1.98163590960444,4.54124001150088,8.07747189555885,101,"ENSG00000079974.19"
"38871","ENSG00000251199.6_234581",234573,234581,9,"ENSG00000251199.6",1,8,"VVVVVVVMV",0,8,0.884057971014493,113,119,133,136,157,163,173,176,"TGGATGA","CATA","TTTATGA","CTGA",2.39438470080916,14,21,10,54,2.20233226734202,4.54122423485077,8.07745611890874,101,"ENSG00000079974.19"
"45421","ENSG00000285567.2_117104",117096,117104,9,"ENSG00000285567.2",1,6,"VVVVUMVVV",1,7,0.792546583850932,111,117,133,136,145,151,167,170,"TTGATGC","ATGA","ATCATGA","CTGA",2.5621698635154,16,9,16,50,2.5477663471737,4.90722469265243,8.07741102805616,101,"ENSG00000079974.19"
"36818","ENSG00000243156.9_186049",186041,186049,9,"ENSG00000243156.9",1,6,"VVVVVMVVV",0,8,0.902691511387163,109,115,133,136,144,150,160,163,"TTGAGGA","CGGA","TTGATGC","CTGC",2.28099275589204,18,8,10,45,2.65898769979868,4.46640151810306,8.07716756365172,101,"ENSG00000079974.19"
"40926","ENSG00000258100.3_38223",38215,38223,9,"ENSG00000258100.3",1,1,"MVVVVVVVV",0,8,0.90600414078675,64,70,79,82,89,95,133,136,"TTGATGT","CAGA","GTGAAGA","CTAA",2.39186320416218,9,7,38,63,1.86644724739306,4.45305048545189,8.07706704859889,101,"ENSG00000079974.19"
"10896","ENSG00000133083.15_170612",170604,170612,9,"ENSG00000133083.15",0,NA,"VVVVVUUVV",2,7,0.808281573498965,56,62,73,76,80,86,133,136,"ATCATGT","CTGA","GTGAGAA","CTGA",2.63374426605505,11,4,47,71,1.81731459744625,4.84390242611997,8.07702872011583,101,"ENSG00000079974.19"
"47485","ENSG00000288563.1_82899",82891,82899,9,"ENSG00000288563.1",1,7,"VVVVVVMVV",0,8,0.885300207039338,85,91,99,102,111,117,133,136,"ACTATGA","CAGA","GGAATCA","CTGA",2.35278031093651,8,9,16,42,2.45764469612324,4.53571169225832,8.07691252041567,101,"ENSG00000079974.19"
"297","ENSG00000007545.16_3090",3082,3090,9,"ENSG00000007545.16",0,NA,"VVVVUVVVV",1,8,0.889855072463768,116,122,133,136,138,144,152,155,"AAGATGG","GAGA","AGGATCC","CTGA",2.28237424188552,11,2,8,30,2.85352026603319,4.5173371363175,8.07675742617257,101,"ENSG00000079974.19"
"36227","ENSG00000239212.2_406",398,406,9,"ENSG00000239212.2",1,8,"VVVVVVVMV",0,8,0.884057971014493,110,116,133,136,144,150,183,186,"CTGTTGA","CTCA","CAGAGGA","CTGA",2.45165031994756,17,8,33,67,1.81754688689305,4.54047058830253,8.0767024723605,101,"ENSG00000079974.19"
"10004","ENSG00000128739.23_64356",64348,64356,9,"ENSG00000128739.23",0,NA,"UVVVVVVVV",1,8,0.902691511387163,104,110,133,136,144,150,161,164,"ATAATGT","TTAA","ATTATTA","CTGA",2.34262296849347,23,8,11,51,2.24589501421982,4.46584536771073,8.07661141325939,101,"ENSG00000079974.19"
"46002","ENSG00000286110.1_329933",329925,329933,9,"ENSG00000286110.1",0,NA,"UVVVVVVVV",1,8,0.902691511387163,104,110,133,136,144,150,161,164,"ATAATGT","TTAA","ATTATTA","CTGA",2.34262296849347,23,8,11,51,2.24589501421982,4.46584536771073,8.07661141325939,101,"ENSG00000079974.19"
"11642","ENSG00000135605.13_30303",30295,30303,9,"ENSG00000135605.13",0,NA,"VVUVVVVVV",1,8,0.883643892339545,69,75,92,95,107,113,133,136,"TTGATTA","CAAA","CTGATGC","CTGA",2.41957067569251,17,12,20,58,2.0372306662741,4.54192545938937,8.07650102874755,101,"ENSG00000079974.19"
"37795","ENSG00000248869.7_61034",61026,61034,9,"ENSG00000248869.7",1,1,"MVVVVUVVV",1,7,0.82815734989648,94,100,133,136,160,166,178,181,"ATGATGG","CTGT","GTGGTGA","CTGA",2.69004714666149,33,24,12,78,1.12169823754019,4.76383647048754,8.07646587007346,101,"ENSG00000079974.19"
"30461","ENSG00000205038.12_105292",105284,105292,9,"ENSG00000205038.12",1,8,"VVVVVVVMV",0,8,0.884057971014493,65,71,97,100,114,120,133,136,"ATAATGA","CTGA","CTGAAAA","TTGA",2.47281163658744,26,14,13,62,1.67549586673365,4.54022669432914,8.07645857838711,101,"ENSG00000079974.19"
"14569","ENSG00000145388.15_12727",12719,12727,9,"ENSG00000145388.15",1,1,"MVVVVVVVV",0,8,0.90600414078675,54,60,83,86,101,107,133,136,"GTGATGT","CTGA","CTGAAGA","CAGA",2.5119375514301,23,15,26,73,1.06320359566246,4.45236348463244,8.07638004777944,101,"ENSG00000079974.19"
"25635","ENSG00000182255.7_2935",2927,2935,9,"ENSG00000182255.7",0,NA,"VVUVVVVVV",1,8,0.883643892339545,80,86,96,99,115,121,133,136,"GTTATGT","CTGC","TTCATTA","CTGA",2.36971793672346,10,16,12,47,2.36877943120715,4.54172475234089,8.07630032169907,101,"ENSG00000079974.19"
"34490","ENSG00000233183.3_16153",16145,16153,9,"ENSG00000233183.3",1,8,"VVVVVVVMV",0,8,0.884057971014493,89,95,133,136,146,152,160,163,"CTGAGGA","CAGA","AAGAGGT","CTGA",2.44174318215282,38,10,8,65,1.88131832380526,4.53990155120601,8.07613343526398,101,"ENSG00000079974.19"
"36979","ENSG00000244038.11_2186",2178,2186,9,"ENSG00000244038.11",1,8,"VVVVVVVMV",0,8,0.884057971014493,82,88,133,136,137,143,158,161,"AAGATGA","GTGA","ATGAGAC","CTGA",2.5524234360893,45,1,15,70,1.14301456417931,4.53979270119366,8.07602458525163,101,"ENSG00000079974.19"
"15890","ENSG00000150093.20_75699",75691,75699,9,"ENSG00000150093.20",1,1,"MVVVVVVVV",0,8,0.90600414078675,83,89,105,108,115,121,133,136,"TTGATGT","CTTA","ATTATTA","TTGA",2.25045786399276,16,7,12,44,2.80464300286273,4.45192385737027,8.07594042051727,101,"ENSG00000079974.19"
"25517","ENSG00000182050.14_519941",519933,519941,9,"ENSG00000182050.14",1,8,"VVVVVVVMV",0,8,0.884057971014493,91,97,133,136,152,158,173,176,"ATGTTGA","TAGA","TTGATCA","CTGA",2.5268833732942,36,16,15,76,1.31184964544061,4.53943470018383,8.0756665842418,101,"ENSG00000079974.19"
"7009","ENSG00000112499.13_64214",64206,64214,9,"ENSG00000112499.13",1,1,"MVVVVVVVV",0,8,0.90600414078675,97,103,133,136,182,188,199,202,"AAGAAGA","ATGA","ATGATGG","CTGA",2.51621903000723,30,46,11,96,1.03150485252722,4.45157459647719,8.07559115962419,101,"ENSG00000079974.19"
"36681","ENSG00000242593.8_184470",184462,184470,9,"ENSG00000242593.8",0,NA,"UVVVVVVVV",1,8,0.902691511387163,111,117,133,136,143,149,164,167,"ATAATGA","CACA","ATGCTGA","CTGT",2.28019253712189,16,7,15,47,2.65775615213065,4.46475993323581,8.07552597878447,101,"ENSG00000079974.19"
"46332","ENSG00000286481.2_658743",658735,658743,9,"ENSG00000286481.2",0,NA,"VVVVVVUVV",1,8,0.886128364389234,112,118,133,136,150,156,175,178,"GAGAAGA","CTTA","GTGAGTA","CTGA",2.40241466424371,15,14,19,57,2.1075462139903,4.53091099390375,8.07542445146069,101,"ENSG00000079974.19"
"2793","ENSG00000078304.20_141141",141133,141141,9,"ENSG00000078304.20",0,NA,"VVVVUVVVV",1,8,0.889855072463768,112,118,133,136,153,159,169,172,"GTGATAG","CTGG","GTAAAGT","CTGA",2.35875751427444,15,17,10,51,2.33805358903087,4.51577592104846,8.07519621090353,101,"ENSG00000079974.19"
"27804","ENSG00000187391.22_491471",491463,491471,9,"ENSG00000187391.22",0,NA,"UVVVVVVVV",1,8,0.902691511387163,86,92,104,107,114,120,133,136,"ATGATAA","TTTA","ATGTTGT","TTGA",2.23710652372976,12,7,13,41,2.94344333656671,4.46437170702462,8.07513775257327,101,"ENSG00000079974.19"
"41048","ENSG00000258478.1_8639",8631,8639,9,"ENSG00000258478.1",1,8,"VVVVVVVMV",0,8,0.884057971014493,106,112,133,136,140,146,185,188,"ATGAAGA","ATCA","CTGAGGA","CTGA",2.53242868257605,21,4,39,73,1.27248034348141,4.53883455683044,8.07506644088841,101,"ENSG00000079974.19"
"11615","ENSG00000135537.17_75405",75397,75405,9,"ENSG00000135537.17",1,6,"VVUVVMVVV",1,7,0.786335403726708,101,107,133,136,143,149,185,188,"ATGATGA","GTGA","GTGAGGG","CTGA",2.78114376501032,26,7,36,78,1.17772888737293,4.92967183019376,8.07501344510059,101,"ENSG00000079974.19"
"7522","ENSG00000114573.11_9727",9719,9727,9,"ENSG00000114573.11",1,3,"VVMVVVVVV",0,8,0.882815734989648,112,118,133,136,140,146,158,161,"TTGTTGA","GTAA","TTAATAA","CTGA",2.31545776887826,15,4,12,40,2.73842218679623,4.54370182816282,8.07496476812141,101,"ENSG00000079974.19"
"16016","ENSG00000150636.17_320309",320301,320309,9,"ENSG00000150636.17",1,1,"MVVVVVVVV",0,8,0.90600414078675,94,100,133,136,140,146,160,163,"ACGATAA","GTGA","TGGAGGA","CTGA",2.41166849845936,33,4,14,60,1.72600080871489,4.45094769961099,8.07496426275799,101,"ENSG00000079974.19"
"5136","ENSG00000103404.15_37211",37203,37211,9,"ENSG00000103404.15",1,8,"VVVVVVVMV",0,8,0.884057971014493,112,118,133,136,169,175,216,219,"ATGAAGA","CTTG","ATGATGA","CTGA",2.57989458167289,15,33,41,98,0.955508693546124,4.53870147617469,8.07493336023266,101,"ENSG00000079974.19"
"26940","ENSG00000185345.24_1294300",1294292,1294300,9,"ENSG00000185345.24",1,6,"VVVVVMVVV",0,8,0.902691511387163,110,116,133,136,153,159,168,171,"GTAATGA","TTTA","ATTAAAA","CTGA",2.35118382265511,17,17,9,52,2.18202822786746,4.46414676139206,8.07491280694071,101,"ENSG00000079974.19"
"35830","ENSG00000237325.3_404",396,404,9,"ENSG00000237325.3",1,8,"VVVVVVVMV",0,8,0.884057971014493,86,92,133,136,146,152,160,163,"AGGATGA","GTGC","GGTATGA","CTGA",2.44129406025673,41,10,8,68,1.87933245043506,4.53865654636999,8.07488843042796,101,"ENSG00000079974.19"
"1683","ENSG00000065183.16_33564",33556,33564,9,"ENSG00000065183.16",1,6,"VVVVVMVVV",0,8,0.902691511387163,95,101,109,112,114,120,133,136,"ATAATGG","CTTC","AAGATTA","CTGA",2.31362144778858,8,2,13,32,2.43204887041017,4.46404796391685,8.0748140094655,101,"ENSG00000079974.19"
"20606","ENSG00000165164.14_143170",143162,143170,9,"ENSG00000165164.14",1,1,"MVVVVVVVV",0,8,0.90600414078675,39,45,61,64,115,121,133,136,"GTGATTA","CTGA","ATGCTGC","ATGA",2.40097815957908,16,51,12,88,1.7966332383831,4.4507885755609,8.0748051387079,101,"ENSG00000079974.19"
"13468","ENSG00000141506.15_27353",27345,27353,9,"ENSG00000141506.15",1,2,"VMVVVVVVV",0,8,0.884057971014493,81,87,99,102,110,116,133,136,"ATGTTGA","ATGA","CTCAAGA","CTGC",2.319831755925,12,8,17,46,2.68852378018518,4.5385172049213,8.07474908897927,101,"ENSG00000079974.19"
"36063","ENSG00000237819.7_2301",2293,2301,9,"ENSG00000237819.7",1,2,"VMVVVVVVV",0,8,0.884057971014493,92,98,133,136,145,151,164,167,"ATGATTT","ATGA","TTAATTA","CTGA",2.44129657535427,35,9,13,66,1.87831445428497,4.53840623916169,8.07463812321966,101,"ENSG00000079974.19"
"637","ENSG00000021645.20_786955",786947,786955,9,"ENSG00000021645.20",1,8,"VVVVVVVMV",0,8,0.884057971014493,114,120,133,136,145,151,160,163,"GTGCGGA","TTAA","TGGATGA","CTGA",2.27630560358092,13,9,9,40,2.9779462793036,4.53832924246076,8.07456112651873,101,"ENSG00000079974.19"
"25465","ENSG00000181722.18_788856",788848,788856,9,"ENSG00000181722.18",1,6,"VVVVVMVVV",0,8,0.902691511387163,115,121,133,136,149,155,206,209,"TAGATAA","CTTA","GTGAAGA","CTGA",2.4238272531735,12,13,51,85,1.69625576303343,4.46377602938085,8.07454207492951,101,"ENSG00000079974.19"
"29124","ENSG00000197254.4_1405",1397,1405,9,"ENSG00000197254.4",1,8,"VVVVVVVMV",0,8,0.884057971014493,35,41,53,56,107,113,133,136,"ATGATGT","CTGA","CTGACTA","GTGA",2.49530097931761,12,51,20,92,1.51725590576852,4.53814894197148,8.07438082602945,101,"ENSG00000079974.19"
"13306","ENSG00000140945.17_264220",264212,264220,9,"ENSG00000140945.17",0,NA,"VVUVUVVVV",2,7,0.773498964803312,88,94,108,111,114,120,133,136,"ATTATGT","CTGA","CTGATCT","CTGA",2.59390944181655,14,3,13,39,2.62870264911643,4.98035806530669,8.07435392451994,101,"ENSG00000079974.19"
"501","ENSG00000014257.17_49578",49570,49578,9,"ENSG00000014257.17",1,1,"MVVVVUVVV",1,7,0.82815734989648,63,69,76,79,85,91,133,136,"ATGATAA","GTGA","GTGATTT","CTGA",2.61561216513239,7,6,42,64,1.60921660043432,4.76165775866256,8.07428715824848,101,"ENSG00000079974.19"
"23100","ENSG00000172260.15_683126",683118,683126,9,"ENSG00000172260.15",0,NA,"VVVVVVUVV",1,8,0.886128364389234,112,118,133,136,142,148,166,169,"TTGTTAA","TAGA","TTGATGA","CTGA",2.33813704492632,15,6,18,48,2.53118672654907,4.52969175651446,8.07420521407139,101,"ENSG00000079974.19"
"29067","ENSG00000197099.8_49810",49802,49810,9,"ENSG00000197099.8",1,2,"VMVVVVVVV",0,8,0.884057971014493,73,79,94,97,102,108,133,136,"GTGATGG","CTGA","ATCATTA","CTCA",2.40562919870546,15,5,25,54,2.11407273456934,4.53790018148477,8.07413206554274,101,"ENSG00000079974.19"
"9948","ENSG00000128573.28_333691",333683,333691,9,"ENSG00000128573.28",0,NA,"UVVVVVVVV",1,8,0.902691511387163,32,38,73,76,83,89,133,136,"ATGCTGT","CTGA","GTATTAA","CTGA",2.52533575168323,35,7,44,95,1.01776047448002,4.46333303809205,8.07409908364071,101,"ENSG00000079974.19"
"6717","ENSG00000111684.11_22039",22031,22039,9,"ENSG00000111684.11",1,5,"UVVVMVVVV",1,7,0.789233954451346,69,75,92,95,108,114,133,136,"ATGATAA","CTGA","ATGGTAT","CTGA",2.64654610282477,17,13,19,58,2.02440705236399,4.91701193446562,8.073947752271,101,"ENSG00000079974.19"
"14936","ENSG00000146243.14_71819",71811,71819,9,"ENSG00000146243.14",0,NA,"UVVVVVVVV",1,8,0.902691511387163,109,115,133,136,146,152,162,165,"ATGATAA","CAGA","ATGTGCA","CTGT",2.29279506388131,18,10,10,47,2.56731219017298,4.46315315401209,8.07391919956074,101,"ENSG00000079974.19"
"4191","ENSG00000099139.14_183283",183275,183283,9,"ENSG00000099139.14",1,1,"MVVVVVVVV",0,8,0.90600414078675,116,122,133,136,139,145,156,159,"AAGAAGA","GTTA","ATTAGAA","CTGA",2.24565013899482,11,3,11,34,2.8281652332091,4.4497915399603,8.0738081031073,101,"ENSG00000079974.19"
"8158","ENSG00000117069.15_115000",114992,115000,9,"ENSG00000117069.15",1,1,"MVVVVVVVV",0,8,0.90600414078675,82,88,133,136,165,171,186,189,"TTAATGA","ATGA","GTGAAAA","CTGA",2.53803663095327,45,29,15,98,0.878696675365736,4.44973522043022,8.07375178357722,101,"ENSG00000079974.19"
"10071","ENSG00000129084.18_44200",44192,44200,9,"ENSG00000129084.18",1,1,"MVVVVVVVV",0,8,0.90600414078675,82,88,133,136,165,171,186,189,"TTAATGA","ATGA","GTGAAAA","CTGA",2.53803663095327,45,29,15,98,0.878696675365736,4.44973522043022,8.07375178357722,101,"ENSG00000079974.19"
"19041","ENSG00000160321.16_55424",55416,55424,9,"ENSG00000160321.16",1,1,"MVVVVVVVV",0,8,0.90600414078675,82,88,133,136,165,171,186,189,"TTAATGA","ATGA","GTGAAAA","CTGA",2.53803663095327,45,29,15,98,0.878696675365736,4.44973522043022,8.07375178357722,101,"ENSG00000079974.19"
"32310","ENSG00000226688.9_284062",284054,284062,9,"ENSG00000226688.9",1,1,"MVVVVVVVV",0,8,0.90600414078675,82,88,133,136,165,171,186,189,"TTAATGA","ATGA","GTGAAAA","CTGA",2.53803663095327,45,29,15,98,0.878696675365736,4.44973522043022,8.07375178357722,101,"ENSG00000079974.19"
"32988","ENSG00000228420.1_30092",30084,30092,9,"ENSG00000228420.1",1,1,"MVVVVVVVV",0,8,0.90600414078675,82,88,133,136,165,171,186,189,"TTAATGA","ATGA","GTGAAAA","CTGA",2.53803663095327,45,29,15,98,0.878696675365736,4.44973522043022,8.07375178357722,101,"ENSG00000079974.19"
"33269","ENSG00000229151.3_89325",89317,89325,9,"ENSG00000229151.3",1,7,"VVVVVVMVV",0,8,0.885300207039338,71,77,89,92,101,107,133,136,"ATGATTA","CAGA","TTGATAA","CTCA",2.39144358906366,12,9,26,56,2.18708596256015,4.53251080574614,8.07371163390349,101,"ENSG00000079974.19"
"21629","ENSG00000168646.14_15892",15884,15892,9,"ENSG00000168646.14",0,NA,"UVVVVVVVV",1,8,0.902691511387163,98,104,133,136,139,145,162,165,"CTGCTGA","CTGT","AAGATGG","CTGA",2.45911042747936,29,3,17,58,1.45705712045877,4.46278165924696,8.07354770479562,101,"ENSG00000079974.19"
"42732","ENSG00000266076.1_95277",95269,95277,9,"ENSG00000266076.1",0,NA,"UVVVVVVVV",1,8,0.902691511387163,98,104,133,136,139,145,162,165,"CTGCTGA","CTGT","AAGATGG","CTGA",2.45911042747936,29,3,17,58,1.45705712045877,4.46278165924696,8.07354770479562,101,"ENSG00000079974.19"
"29671","ENSG00000198589.15_372069",372061,372069,9,"ENSG00000198589.15",1,6,"VVVVVMVVV",0,8,0.902691511387163,113,119,133,136,149,155,174,177,"TTTTTGA","CTGG","TAGATGA","CTGA",2.34264524816218,14,13,19,55,2.23336522368198,4.46275005285746,8.07351609840611,101,"ENSG00000079974.19"
"3577","ENSG00000086062.13_26949",26941,26949,9,"ENSG00000086062.13",0,NA,"VVVVUVVVV",1,8,0.889855072463768,81,87,101,104,112,118,133,136,"ATGATGA","AGGA","ATATTCA","CTTA",2.29259086829096,14,8,15,46,2.77174603734722,4.51392128982174,8.07334157967681,101,"ENSG00000079974.19"
"38579","ENSG00000250481.2_32851",32843,32851,9,"ENSG00000250481.2",0,NA,"UVVVVVVVV",1,8,0.902691511387163,113,119,133,136,145,151,184,187,"ATGATGA","AGGA","ATGCTGG","CTGT",2.3789205014956,14,9,33,65,1.99038750027353,4.46246437756104,8.0732304231097,101,"ENSG00000079974.19"
"13369","ENSG00000141252.21_82603",82595,82603,9,"ENSG00000141252.21",1,1,"MVVVVVVVV",0,8,0.90600414078675,116,122,133,136,165,171,199,202,"ATAAAGA","ATGA","GTGAAAA","CTGA",2.48793077350796,11,29,28,77,1.21063143600866,4.44920914818211,8.0732257113291,101,"ENSG00000079974.19"
"45956","ENSG00000286072.1_137359",137351,137359,9,"ENSG00000286072.1",1,8,"VVVVVVVMV",0,8,0.884057971014493,75,81,100,103,116,122,133,136,"ATGATGT","TTGA","GTCGTGA","CTCA",2.383593792849,19,13,11,52,2.25704930139589,4.53691864676397,8.07315053082194,101,"ENSG00000079974.19"
"7794","ENSG00000115761.17_84759",84751,84759,9,"ENSG00000115761.17",1,1,"MVVVVVVVV",0,8,0.90600414078675,114,120,133,136,137,143,153,156,"ATTACGT","CTGG","GTGGATA","CTGA",2.28999696429256,13,1,10,33,2.52955007314668,4.44904912544094,8.07306568858794,101,"ENSG00000079974.19"
"8715","ENSG00000120458.13_6051",6043,6051,9,"ENSG00000120458.13",1,8,"VVVVVVVMV",0,8,0.884057971014493,106,112,133,136,143,149,175,178,"AAGATAA","CTCA","CTGATAA","CTGA",2.47516307052453,21,7,26,63,1.64612332678087,4.53680261590277,8.07303449996074,101,"ENSG00000079974.19"
"46779","ENSG00000287159.1_22993",22985,22993,9,"ENSG00000287159.1",1,1,"MVVVVVVVV",0,8,0.90600414078675,109,115,133,136,175,181,193,196,"TTGATGA","TTGA","ATGAGAA","ATGA",2.42438069121904,18,39,12,78,1.63346441739042,4.44900058971268,8.07301715285967,101,"ENSG00000079974.19"
"13716","ENSG00000143248.13_18864",18856,18864,9,"ENSG00000143248.13",0,NA,"UVVVVVVVV",1,8,0.902691511387163,107,113,133,136,138,144,153,156,"ATAATGA","ATGA","TTCATGA","CTAA",2.37022216060153,20,2,9,40,2.04734082773195,4.46220547460221,8.07297152015086,101,"ENSG00000079974.19"
"34405","ENSG00000232995.7_18967",18959,18967,9,"ENSG00000232995.7",0,NA,"UVVVVVVVV",1,8,0.902691511387163,107,113,133,136,138,144,153,156,"ATAATGA","ATGA","TTCATGA","CTAA",2.37022216060153,20,2,9,40,2.04734082773195,4.46220547460221,8.07297152015086,101,"ENSG00000079974.19"
"8830","ENSG00000120907.18_107710",107702,107710,9,"ENSG00000120907.18",0,NA,"VVVUVVVVV",1,8,0.880745341614907,108,114,133,136,148,154,163,166,"GAGGTGA","GAGA","TTGATGA","CTGA",2.3785364326578,19,12,9,49,2.34251123797833,4.54985519725759,8.07283656371722,101,"ENSG00000079974.19"
"26177","ENSG00000183621.15_123681",123673,123681,9,"ENSG00000183621.15",1,1,"MVVVVVVVV",0,8,0.90600414078675,94,100,133,136,138,144,158,161,"ATTAGGA","TTGA","ATGATAC","CTGA",2.4571313601509,33,2,14,58,1.41347541511196,4.44858778736283,8.07260435050983,101,"ENSG00000079974.19"
"26781","ENSG00000185009.13_5073",5065,5073,9,"ENSG00000185009.13",1,1,"MVVVVVVVV",0,8,0.90600414078675,105,111,133,136,164,170,179,182,"ATGATTA","TTTA","CTGGTGG","CTGA",2.45773863964571,22,28,9,68,1.40900578502901,4.44848251233344,8.07249907548043,101,"ENSG00000079974.19"
"45685","ENSG00000285784.1_34596",34588,34596,9,"ENSG00000285784.1",0,NA,"VVVVVUVVV",1,8,0.922153209109731,108,114,133,136,148,154,184,187,"TTGAAGA","TTTA","GTGAAAA","CTGA",2.40989745203962,19,12,30,70,1.46929477507886,4.38381944716907,8.072432283608,101,"ENSG00000079974.19"
"41022","ENSG00000258394.1_307871",307863,307871,9,"ENSG00000258394.1",1,8,"VVVVVVVMV",0,8,0.884057971014493,102,108,133,136,144,150,196,199,"TTGATGA","CACA","ATGAAGT","CTGA",2.54704623961206,25,8,46,88,1.16437318121363,4.53617036132351,8.07240224538148,101,"ENSG00000079974.19"
"20286","ENSG00000164603.12_105230",105222,105230,9,"ENSG00000164603.12",1,8,"VVVVVVVMV",0,8,0.884057971014493,111,117,133,136,155,161,173,176,"TTAATGA","TGGA","GTGATTC","CTGA",2.4038893226625,16,19,12,56,2.11870318681201,4.53615800114051,8.07238988519848,101,"ENSG00000079974.19"
"25104","ENSG00000179399.15_940091",940083,940091,9,"ENSG00000179399.15",1,2,"VMVVVVVVV",0,8,0.884057971014493,114,120,133,136,182,188,200,203,"GTGGTGA","ATCA","CAGATGA","CTGA",2.42822913413912,13,46,12,80,1.95578306264,4.53599432255853,8.0722262066165,101,"ENSG00000079974.19"
"40225","ENSG00000255282.6_18273",18265,18273,9,"ENSG00000255282.6",0,NA,"VVVVVUVVV",1,8,0.922153209109731,109,115,133,136,177,183,198,201,"ATGAGGA","CTCA","GTGATTA","CAGA",2.40673002552899,18,41,15,83,1.48950281515553,4.38359241300386,8.07220524944278,101,"ENSG00000079974.19"
"22056","ENSG00000169760.18_324645",324637,324645,9,"ENSG00000169760.18",0,NA,"UVVUVVVVV",2,7,0.78343685300207,110,116,133,136,156,162,178,181,"ATGATGA","TGGA","TTGAAGA","CTGA",2.69424777170788,17,20,16,62,1.79151418258677,4.93829149849316,8.07203891050144,101,"ENSG00000079974.19"
"19798","ENSG00000163697.17_341549",341541,341549,9,"ENSG00000163697.17",1,1,"MVVVVVVVV",0,8,0.90600414078675,116,122,133,136,172,178,226,229,"CTGATGG","ATGA","ACGATGT","CTGA",2.51954614858664,11,36,48,104,0.995090978003053,4.4480163254785,8.0720328886255,101,"ENSG00000079974.19"
"7785","ENSG00000115750.17_7230",7222,7230,9,"ENSG00000115750.17",0,NA,"UVVVVVVVV",1,8,0.902691511387163,57,63,78,81,91,97,133,136,"TTGAAGT","CAGA","TTGAAGT","CTGA",2.39892992517672,15,10,36,70,1.85179964436226,4.46116645305176,8.07193249860041,101,"ENSG00000079974.19"
"48010","ENSG00000290000.1_31275",31267,31275,9,"ENSG00000290000.1",0,NA,"VVVVVUVVV",1,8,0.922153209109731,113,119,133,136,142,148,161,164,"ATTTTTA","ATAA","GTGAAAA","CTGA",2.19733066734138,14,6,13,42,2.88424365300399,4.3832786921533,8.07189152859223,101,"ENSG00000079974.19"
"31637","ENSG00000224228.2_282482",282474,282482,9,"ENSG00000224228.2",1,1,"MVVVVUVVV",1,7,0.82815734989648,115,121,133,136,145,151,168,171,"TTGATGA","CCCA","GTCAAGC","CTGA",2.45786064444242,12,9,17,47,2.6511251156644,4.75921568632014,8.07184508590606,101,"ENSG00000079974.19"
"29225","ENSG00000197498.13_13702",13694,13702,9,"ENSG00000197498.13",1,1,"MVVVVVVVV",0,8,0.90600414078675,65,71,82,85,103,109,133,136,"GTGGTGA","CTGA","GTGGAGA","CTGT",2.41948758763552,11,18,24,62,1.66136578443378,4.44782075883432,8.07183732198132,101,"ENSG00000079974.19"
"2265","ENSG00000072315.4_171290",171282,171290,9,"ENSG00000072315.4",1,8,"VVVVVVVMV",0,8,0.884057971014493,113,119,133,136,139,145,154,157,"ATGATAC","GGGA","ATGGAGC","CTGA",2.30204843068238,14,3,9,35,2.7950475622623,4.53550927503621,8.07174115909418,101,"ENSG00000079974.19"
"1778","ENSG00000066032.19_1331858",1331850,1331858,9,"ENSG00000066032.19",1,1,"MVVVVVVVV",0,8,0.90600414078675,87,93,133,136,139,145,153,156,"ATGAAGA","ATGG","GGGAACA","CTGA",2.416235616074,40,3,8,60,1.68241684717531,4.44766357191717,8.07168013506416,101,"ENSG00000079974.19"
"41005","ENSG00000258312.1_75735",75727,75735,9,"ENSG00000258312.1",1,8,"VVVVVVVMV",0,8,0.884057971014493,82,88,133,136,187,193,206,209,"ATGATGC","AGGA","GTGATCA","CTGA",2.5832435077108,45,51,13,118,0.920133389723754,4.53543919361561,8.07167107767358,101,"ENSG00000079974.19"
"41089","ENSG00000258535.1_15128",15120,15128,9,"ENSG00000258535.1",0,NA,"VVVVVUVVV",1,8,0.922153209109731,107,113,133,136,182,188,207,210,"GTGATGC","CTGG","GGAAGGA","CTGA",2.46965689724952,20,46,19,94,1.06780344905151,4.38304569101207,8.07165852745099,101,"ENSG00000079974.19"
"1694","ENSG00000065413.20_20658",20650,20658,9,"ENSG00000065413.20",1,7,"UVVVVVMVV",1,7,0.787991718426501,44,50,68,71,84,90,133,136,"TTGATGA","ATGA","GTGAAGA","CTGA",2.74605872988707,18,13,43,83,1.37170454837318,4.91969068690508,8.07165756061108,101,"ENSG00000079974.19"
"35752","ENSG00000236977.1_12004",11996,12004,9,"ENSG00000236977.1",1,7,"UVVVVVMVV",1,7,0.787991718426501,44,50,68,71,84,90,133,136,"TTGATGA","ATGA","GTGAAGA","CTGA",2.74605872988707,18,13,43,83,1.37170454837318,4.91969068690508,8.07165756061108,101,"ENSG00000079974.19"
"28066","ENSG00000188107.15_1445009",1445001,1445009,9,"ENSG00000188107.15",0,NA,"VVVVVUVVV",1,8,0.922153209109731,107,113,133,136,169,175,184,187,"GTGTTGG","CTAA","ATGACAA","CTGA",2.40207564341857,20,33,9,71,1.51815676852401,4.38299859782862,8.07161143426754,101,"ENSG00000079974.19"
"28667","ENSG00000196313.13_51100",51092,51100,9,"ENSG00000196313.13",0,NA,"VVVVVUVVV",1,8,0.922153209109731,96,102,133,136,137,143,162,165,"GTGATCA","CAGA","ATGTACA","CTGA",2.48983113204696,31,1,19,60,0.933028911440821,4.38297578127181,8.07158861771073,101,"ENSG00000079974.19"
"19817","ENSG00000163746.13_67341",67333,67341,9,"ENSG00000163746.13",1,2,"VMVVVVVVV",0,8,0.884057971014493,114,120,133,136,146,152,160,163,"CTGAGGG","CATA","CAGATGA","CTGA",2.28511490260587,13,10,8,40,2.90710278039866,4.53530053277612,8.07153241683409,101,"ENSG00000079974.19"
"22293","ENSG00000170231.16_49676",49668,49676,9,"ENSG00000170231.16",1,1,"MVVVVVVVV",0,8,0.90600414078675,110,116,133,136,162,168,186,189,"GTGTTGA","CAAA","GTGAAAA","CTGA",2.44417150490916,17,26,18,70,1.49539516416751,4.44746796589048,8.07148452903748,101,"ENSG00000079974.19"
"18959","ENSG00000159625.15_20708",20700,20708,9,"ENSG00000159625.15",1,7,"VVVVUVMVV",1,7,0.775155279503105,86,92,107,110,115,121,133,136,"ATGATTG","CTGT","GTGAAGA","CTGA",2.55900504686939,15,5,12,41,2.82316980467952,4.97080086261887,8.07142198063129,101,"ENSG00000079974.19"
"32434","ENSG00000226994.9_368758",368750,368758,9,"ENSG00000226994.9",1,2,"VMVVVVVVV",0,8,0.884057971014493,116,122,133,136,137,143,151,154,"ATGTAGG","CTGG","CTGTAGA","CTGA",2.31289459728194,11,1,8,29,2.72142089428563,4.53517955237464,8.07141143643261,101,"ENSG00000079974.19"
"20098","ENSG00000164296.7_4620",4612,4620,9,"ENSG00000164296.7",1,8,"VVVVVVVMV",0,8,0.884057971014493,41,47,59,62,74,80,133,136,"ATGATGA","CTGT","TTCAAGA","CTAA",2.4559772999913,12,12,53,86,1.76720924409634,4.53509781100959,8.07132969506756,101,"ENSG00000079974.19"
"1190","ENSG00000049130.16_80002",79994,80002,9,"ENSG00000049130.16",1,5,"VVVVMVVVV",0,8,0.886542443064182,80,86,101,104,115,121,133,136,"AGGCTGA","CTGA","TTGAGGC","ATGA",2.30924070273268,15,11,12,47,2.70540742960106,4.52508636195472,8.07125613421145,101,"ENSG00000079974.19"
"46173","ENSG00000286251.2_152051",152043,152051,9,"ENSG00000286251.2",1,3,"VVMVVVVVV",0,8,0.882815734989648,79,85,95,98,107,113,133,136,"AGCATAA","CTGA","GTGGCGG","CTGA",2.36577591838486,10,9,20,48,2.38813158108992,4.53999275924725,8.07125569920584,101,"ENSG00000079974.19"
"1995","ENSG00000068781.21_41951",41943,41951,9,"ENSG00000068781.21",1,1,"MVVVVVVVV",0,8,0.90600414078675,67,73,93,96,104,110,133,136,"AAGATGA","CTGA","AAGAGAA","TTGA",2.3929917849786,20,8,23,60,1.83566570787166,4.44723606859891,8.07125263174591,101,"ENSG00000079974.19"
"36837","ENSG00000243244.7_42493",42485,42493,9,"ENSG00000243244.7",1,1,"MVVVVVVVV",0,8,0.90600414078675,67,73,93,96,104,110,133,136,"AAGATGA","CTGA","AAGAGAA","TTGA",2.3929917849786,20,8,23,60,1.83566570787166,4.44723606859891,8.07125263174591,101,"ENSG00000079974.19"
"10573","ENSG00000131626.19_36697",36689,36697,9,"ENSG00000131626.19",1,1,"MVVVVVVVV",0,8,0.90600414078675,89,95,133,136,141,147,170,173,"ATTATGA","AGGA","GTTATGC","CTGA",2.47436173426481,38,5,23,75,1.29315023753636,4.44722378315877,8.07124034630577,101,"ENSG00000079974.19"
"32304","ENSG00000226674.11_561023",561015,561023,9,"ENSG00000226674.11",0,NA,"VVVVVUVVV",1,8,0.922153209109731,71,77,104,107,116,122,133,136,"ATGAGGA","CTTA","CTGGTGT","CTCA",2.32371028801926,27,9,11,56,2.03901558767135,4.38260437694994,8.07121721338886,101,"ENSG00000079974.19"
"19859","ENSG00000163820.16_14898",14890,14898,9,"ENSG00000163820.16",1,2,"VMVVVVVVV",0,8,0.884057971014493,78,84,99,102,115,121,133,136,"TTGATGG","CTGC","GTGCTGA","CTGC",2.33649060275071,15,13,12,49,2.56289048897069,4.5348736268272,8.07110551088517,101,"ENSG00000079974.19"
"14367","ENSG00000144771.8_24875",24867,24875,9,"ENSG00000144771.8",1,7,"VVVVVVMVV",0,8,0.885300207039338,91,97,107,110,115,121,133,136,"ATGCTGG","GGGA","GGGCTGG","CTGA",2.28122264724192,10,5,12,36,2.9113933483765,4.52988608249732,8.07108691065467,101,"ENSG00000079974.19"
"370","ENSG00000010017.13_54075",54067,54075,9,"ENSG00000010017.13",1,2,"VMVVVVVVV",0,8,0.884057971014493,115,121,133,136,137,143,155,158,"CTGATAA","CTTA","ATGATGA","CTGT",2.35331288578413,12,1,12,34,2.45063011842546,4.53484567257991,8.07107755663788,101,"ENSG00000079974.19"
"20904","ENSG00000165973.19_395004",394996,395004,9,"ENSG00000165973.19",0,NA,"UVVVVVVVV",1,8,0.902691511387163,103,109,133,136,146,152,164,167,"TGGATGT","CAGA","GTGTGCA","CTGA",2.36502425035934,24,10,12,55,2.0743184679141,4.46028670091077,8.07105274645942,101,"ENSG00000079974.19"
"29690","ENSG00000198597.10_396535",396527,396535,9,"ENSG00000198597.10",1,6,"VVVVVMVVV",0,8,0.902691511387163,107,113,133,136,145,151,162,165,"ATGCTGC","CAGC","GTGGGGG","CTGA",2.31192513926576,20,9,11,49,2.4279168125345,4.46018776857656,8.07095381412521,101,"ENSG00000079974.19"
"21092","ENSG00000166435.17_30166",30158,30166,9,"ENSG00000166435.17",0,NA,"VVVVUVVVV",1,8,0.889855072463768,109,115,133,136,143,149,170,173,"GGGAAGA","TTGA","GAGATCA","CTGA",2.38787192119536,18,7,21,55,2.12668241430721,4.51145713890241,8.07087742875748,101,"ENSG00000079974.19"
"3736","ENSG00000088538.13_694584",694576,694584,9,"ENSG00000088538.13",1,1,"MVVVVVVVV",0,8,0.90600414078675,90,96,133,136,165,171,179,182,"ATGAAGC","ATGA","GTGAAAA","CTGA",2.5112194114755,37,29,8,83,1.04574612951057,4.44680221817014,8.07081878131714,101,"ENSG00000079974.19"
"44899","ENSG00000284377.2_8339",8331,8339,9,"ENSG00000284377.2",1,1,"MVVVVVUVV",1,7,0.792132505175983,105,111,133,136,142,148,170,173,"ATGATGA","TTTA","TTGAGGA","CTGA",2.68210844214051,22,6,22,59,1.72840448680613,4.90228185860239,8.07081187930632,101,"ENSG00000079974.19"
"46397","ENSG00000286565.1_1679",1671,1679,9,"ENSG00000286565.1",0,NA,"UVVVVVVVV",1,8,0.902691511387163,76,82,95,98,107,113,133,136,"TGGGTGA","CTGT","ATAATAA","CTGA",2.3065424903644,13,9,20,51,2.46308116229681,4.46000777451488,8.07077382006353,101,"ENSG00000079974.19"
"46704","ENSG00000287069.1_4357",4349,4357,9,"ENSG00000287069.1",1,2,"VMVVVVVVV",0,8,0.884057971014493,70,76,90,93,111,117,133,136,"GTGATGA","ATGA","CAGATAA","CTCA",2.40635525249724,14,18,16,57,2.09517862186455,4.53438674296153,8.0706186270195,101,"ENSG00000079974.19"
"22483","ENSG00000170624.14_454697",454689,454697,9,"ENSG00000170624.14",1,6,"VVVVVMVVV",0,8,0.902691511387163,101,107,133,136,153,159,171,174,"ATGATAA","CAGT","TTGTTCA","CTGA",2.44794586773361,26,17,12,64,1.51976313773982,4.45985056399097,8.07061660953963,101,"ENSG00000079974.19"
"26459","ENSG00000184304.17_336427",336419,336427,9,"ENSG00000184304.17",0,NA,"VVUVVVVVV",1,8,0.883643892339545,115,121,133,136,184,190,203,206,"ATGATCC","CTGG","CTAAAGA","CTGA",2.4335011556752,12,48,13,82,1.92063033898194,4.53599284420415,8.07056841356233,101,"ENSG00000079974.19"
"39398","ENSG00000253553.9_547937",547929,547937,9,"ENSG00000253553.9",1,6,"VVVVVMVVV",0,8,0.902691511387163,113,119,133,136,142,148,202,205,"ATGCTGT","AAGA","GTTAGGA","CTGA",2.38354639505501,14,6,54,83,1.9486240278742,4.45973333206024,8.07049937760889,101,"ENSG00000079974.19"
"22658","ENSG00000171094.18_176697",176689,176697,9,"ENSG00000171094.18",1,3,"VVMVVUVVV",1,7,0.804968944099379,116,122,133,136,139,145,156,159,"CTGATGA","GTGG","GTGACAC","CTGA",2.48610787534801,11,3,11,34,2.8281652332091,4.85055443388229,8.07043021027981,101,"ENSG00000079974.19"
"31940","ENSG00000225407.3_10140",10132,10140,9,"ENSG00000225407.3",1,6,"VVVVVMVVV",0,8,0.902691511387163,92,98,133,136,144,150,174,177,"CTGATGA","GTGG","TTCTTGA","CTGA",2.47935111859125,35,8,24,76,1.30910463641229,4.45952802342183,8.07029406897048,101,"ENSG00000079974.19"
"35266","ENSG00000235527.7_944",936,944,9,"ENSG00000235527.7",1,3,"VVMVVVVVV",0,8,0.882815734989648,76,82,105,108,114,120,133,136,"TTGATTT","CAGA","ATGATTT","CTGA",2.39695165456313,23,6,13,51,2.17641568243738,4.53902334488122,8.07028628483982,101,"ENSG00000079974.19"
"1801","ENSG00000066032.19_734493",734485,734493,9,"ENSG00000066032.19",1,1,"MVVVUVVVV",1,7,0.795859213250517,80,86,99,102,110,116,133,136,"ATGATGA","CTTC","ATTAACA","CTGA",2.52970087186686,13,8,17,47,2.68264508947955,4.88682939214799,8.07026624515006,101,"ENSG00000079974.19"
"43447","ENSG00000271901.2_6250",6242,6250,9,"ENSG00000271901.2",1,6,"VVVVVMVVV",0,8,0.902691511387163,115,121,133,136,143,149,162,165,"ATGCTGT","ATGA","CTGTTGG","ATGA",2.23416036836141,12,7,13,41,2.94344333656671,4.45946144807736,8.07022749362602,101,"ENSG00000079974.19"
"38009","ENSG00000249335.5_16769",16761,16769,9,"ENSG00000249335.5",1,8,"VVVVVVVMV",0,8,0.884057971014493,109,115,133,136,159,165,186,189,"AAGATGT","CTGT","CTGATTA","CTGA",2.52540544073538,18,23,21,71,1.29976537029936,4.53395041046715,8.07018229452512,101,"ENSG00000079974.19"
"38021","ENSG00000249352.4_3084",3076,3084,9,"ENSG00000249352.4",1,8,"VVVVVVVMV",0,8,0.884057971014493,109,115,133,136,159,165,186,189,"AAGATGT","CTGT","CTGATTA","CTGA",2.52540544073538,18,23,21,71,1.29976537029936,4.53395041046715,8.07018229452512,101,"ENSG00000079974.19"
"16229","ENSG00000151151.6_29917",29909,29917,9,"ENSG00000151151.6",1,5,"UVVVMVVVV",1,7,0.789233954451346,86,92,133,136,144,150,163,166,"ATGAAGA","CTGA","TGGTTGA","CTGA",2.66189900865933,41,8,13,71,1.90674287701947,4.91318406702042,8.0701198848258,101,"ENSG00000079974.19"
"32489","ENSG00000227088.2_329658",329650,329658,9,"ENSG00000227088.2",1,1,"MVVVVVVVV",0,8,0.90600414078675,107,113,133,136,151,157,170,173,"AAGTTGA","AAGA","GTGAAAA","CTGA",2.37315913323426,20,15,13,57,1.96330233516468,4.44609080584828,8.07010736899527,101,"ENSG00000079974.19"
"14704","ENSG00000145743.18_172110",172102,172110,9,"ENSG00000145743.18",1,5,"UVVVMVVVV",1,7,0.789233954451346,91,97,103,106,111,117,133,136,"ATGAGGA","TTGA","CTGAATA","CTGA",2.60589862159018,6,5,16,36,2.27999430220081,4.91316294486717,8.07009876267256,101,"ENSG00000079974.19"
"15382","ENSG00000148120.18_193225",193217,193225,9,"ENSG00000148120.18",0,NA,"VVVVVVUVV",1,8,0.886128364389234,112,118,133,136,156,162,171,174,"ATGTTGA","TTGA","TTGATAA","CTGT",2.38714985625311,15,20,9,53,2.18627959285558,4.52515299196908,8.06966644952602,101,"ENSG00000079974.19"
"28251","ENSG00000188580.15_418308",418300,418308,9,"ENSG00000188580.15",1,8,"VVVVVVVMV",0,8,0.884057971014493,112,118,133,136,144,150,162,165,"ATGATGT","AAGA","ATGTTAA","CTTA",2.29061948948476,15,8,12,44,2.86287027441583,4.53341671774522,8.06964860180319,101,"ENSG00000079974.19"
"4666","ENSG00000101542.10_217924",217916,217924,9,"ENSG00000101542.10",1,8,"VVVVVVVMV",0,8,0.884057971014493,50,56,68,71,115,121,133,136,"ATCATGC","CAGA","TTTCTGA","CTGA",2.42576115169258,12,44,12,77,1.96143912402861,4.53329503382811,8.06952691788608,101,"ENSG00000079974.19"
"21835","ENSG00000169087.11_10278",10270,10278,9,"ENSG00000169087.11",0,NA,"UVVVVVVVV",1,8,0.902691511387163,58,64,76,79,103,109,133,136,"ATGTTAA","CTGC","GTGAGGG","CTGA",2.45615566679651,12,24,24,69,1.46066905849061,4.45876004261684,8.06952608816549,101,"ENSG00000079974.19"
"18240","ENSG00000156650.14_194908",194900,194908,9,"ENSG00000156650.14",1,3,"VVMVVVVVV",0,8,0.882815734989648,115,121,133,136,147,153,162,165,"GTAATGC","TTCA","ATGCTGG","CTGA",2.29423361271209,12,11,9,41,2.85804558259554,4.53823408350237,8.06949702346097,101,"ENSG00000079974.19"
"38712","ENSG00000250917.1_2418",2410,2418,9,"ENSG00000250917.1",1,1,"MVVVVVVVV",0,8,0.90600414078675,101,107,133,136,184,190,205,208,"ATGATGT","ATGG","GAGAGGA","CTGA",2.52446263499483,26,48,15,98,0.952105499531316,4.44546409987421,8.06948066302121,101,"ENSG00000079974.19"
"4914","ENSG00000102362.16_44638",44630,44638,9,"ENSG00000102362.16",1,1,"MVVVVVVVV",0,8,0.90600414078675,107,113,133,136,149,155,171,174,"ATGAACA","TTGA","AAGAGGC","CTGA",2.37574987280611,20,13,16,58,1.94302154990257,4.44533850881916,8.06935507196616,101,"ENSG00000079974.19"
"22889","ENSG00000171711.3_1929",1921,1929,9,"ENSG00000171711.3",1,8,"VVVVVVVMV",0,8,0.884057971014493,115,121,133,136,144,150,159,162,"AAAATGC","ATGA","AAGAAGC","CTGA",2.26308473171812,12,8,9,38,3.04524255703313,4.53311852545514,8.06935040951311,101,"ENSG00000079974.19"
"24638","ENSG00000177257.3_1898",1890,1898,9,"ENSG00000177257.3",1,8,"VVVVVVVMV",0,8,0.884057971014493,115,121,133,136,144,150,159,162,"AAAATGC","ATGA","AAGAAGC","CTGA",2.26308473171812,12,8,9,38,3.04524255703313,4.53311852545514,8.06935040951311,101,"ENSG00000079974.19"
"20420","ENSG00000164796.18_969458",969450,969458,9,"ENSG00000164796.18",1,6,"VVVVVMVVV",0,8,0.902691511387163,115,121,133,136,143,149,157,160,"AAGTTGC","CGCA","GTGTGGA","CTGA",2.21269164662785,12,7,8,36,3.08286607336289,4.45853592938713,8.06930197493578,101,"ENSG00000079974.19"
"9129","ENSG00000122786.20_136493",136485,136493,9,"ENSG00000122786.20",1,1,"MVVVVUVVV",1,7,0.82815734989648,65,71,77,80,115,121,133,136,"TTGATGA","ATGA","GTTGTGA","CTGA",2.63414994610328,6,35,12,62,1.46534444973115,4.75658602260493,8.06921542219085,101,"ENSG00000079974.19"
"15960","ENSG00000150471.17_271216",271208,271216,9,"ENSG00000150471.17",1,8,"VVVVVVVMV",0,8,0.884057971014493,113,119,133,136,164,170,183,186,"ATTATAA","GTGA","TTGATCT","CTGA",2.42630436315257,14,28,13,64,1.95636184574649,4.5329310666909,8.06916295074887,101,"ENSG00000079974.19"
"35214","ENSG00000235376.5_1489",1481,1489,9,"ENSG00000235376.5",1,2,"VMVVVVVVV",0,8,0.884057971014493,88,94,105,108,115,121,133,136,"ATGCTGT","CTGA","AGGAAAA","CTGT",2.27310360882609,11,7,12,39,2.97765803553128,4.53292052359296,8.06915240765093,101,"ENSG00000079974.19"
"40697","ENSG00000257342.1_19297",19289,19297,9,"ENSG00000257342.1",1,8,"UVVVVVVMV",1,7,0.786749482401656,115,121,133,136,145,151,162,165,"GGGATGA","TTGG","GTGATGG","CTGA",2.50917795346557,12,9,11,41,2.96068183600898,4.9221337147782,8.06913164438483,101,"ENSG00000079974.19"
"23530","ENSG00000173163.11_7988",7980,7988,9,"ENSG00000173163.11",1,7,"VVVVVVMVV",0,8,0.885300207039338,110,116,133,136,145,151,164,167,"TTGATTA","CCTA","CAGATGC","CTGA",2.32276840173519,17,9,13,48,2.62653923097365,4.52791547730207,8.06911630545942,101,"ENSG00000079974.19"
"35758","ENSG00000236991.6_7242",7234,7242,9,"ENSG00000236991.6",1,8,"VVVVVVVMV",0,8,0.884057971014493,59,65,76,79,116,122,133,136,"ATGCTGT","CTGT","ATGTATA","CTGA",2.42360914240812,11,37,11,68,1.97401018550812,4.53285111705723,8.0690830011152,101,"ENSG00000079974.19"
"44289","ENSG00000280561.1_4657",4649,4657,9,"ENSG00000280561.1",1,8,"VVVVVVVMV",0,8,0.884057971014493,59,65,76,79,116,122,133,136,"ATGCTGT","CTGT","ATGTATA","CTGA",2.42360914240812,11,37,11,68,1.97401018550812,4.53285111705723,8.0690830011152,101,"ENSG00000079974.19"
"10303","ENSG00000130413.16_36581",36573,36581,9,"ENSG00000130413.16",1,2,"VMVVVVVVV",0,8,0.884057971014493,105,111,133,136,141,147,157,160,"GTGATGA","TTCA","ATGCTGA","TTGA",2.37880263786311,22,5,10,46,2.27257857298657,4.53281570635183,8.0690475904098,101,"ENSG00000079974.19"
"20930","ENSG00000165995.24_51580",51572,51580,9,"ENSG00000165995.24",1,1,"MVVVVVVVV",0,8,0.90600414078675,108,114,133,136,182,188,218,221,"GTGATGT","CTAA","TTGAGGC","CTGA",2.56116788006241,19,46,30,104,0.705636176771844,4.44502217763032,8.06903874077731,101,"ENSG00000079974.19"
"19964","ENSG00000164080.14_92457",92449,92457,9,"ENSG00000164080.14",0,NA,"VVVVVUVVV",1,8,0.922153209109731,47,53,64,67,73,79,133,136,"TTGATGT","CTGA","AGGAAGG","CTGG",2.33432683963074,11,6,54,80,1.95951595388783,4.38042372118986,8.06903655762878,101,"ENSG00000079974.19"
"42347","ENSG00000261738.8_92841",92833,92841,9,"ENSG00000261738.8",1,1,"MVVVUVVVV",1,7,0.795859213250517,61,67,107,110,116,122,133,136,"ATGATGA","CTGA","GTGCTGT","TTGA",2.63564792471042,40,6,11,66,1.97098933799229,4.88549387568211,8.06893072868418,101,"ENSG00000079974.19"
"38245","ENSG00000249837.1_92262",92254,92262,9,"ENSG00000249837.1",1,2,"VMVVVVVVV",0,8,0.884057971014493,115,121,133,136,180,186,198,201,"GTAATGA","GTGT","GTGCTCA","CTGA",2.42535064435792,12,44,12,77,1.96143912402861,4.53261085493702,8.06884273899499,101,"ENSG00000079974.19"
"20489","ENSG00000164951.16_30246",30238,30246,9,"ENSG00000164951.16",1,3,"VVMVVVVVV",0,8,0.882815734989648,73,79,101,104,112,118,133,136,"TTGATGA","CTTA","GTGGTGG","GTGA",2.401362241818,22,8,15,54,2.14083903270864,4.53748016120717,8.06874310116576,101,"ENSG00000079974.19"
"36854","ENSG00000243276.6_551772",551764,551772,9,"ENSG00000243276.6",1,2,"VMVVVVUVV",1,7,0.770186335403727,48,54,63,66,115,121,133,136,"ATGAGGA","CTGA","GTGCTGC","CTGA",2.72327665747964,9,49,12,79,1.79537859258844,4.98763907727984,8.06838441889475,101,"ENSG00000079974.19"
"24061","ENSG00000175048.17_37769",37761,37769,9,"ENSG00000175048.17",0,NA,"VVVVVUVVV",1,8,0.922153209109731,116,122,133,136,156,162,173,176,"AAGCTGG","CTCA","GTTATTA","CTGA",2.29198558287457,11,20,11,51,2.23906693182003,4.37974270441262,8.06835554085154,101,"ENSG00000079974.19"
"33399","ENSG00000229618.3_79259",79251,79259,9,"ENSG00000229618.3",1,8,"VVVVVVVMV",0,8,0.884057971014493,83,89,105,108,115,121,133,136,"ATAATGC","TTCA","ATGACCT","CTGA",2.29847059272316,16,7,12,44,2.80464300286273,4.53194507192094,8.06817695597891,101,"ENSG00000079974.19"
"2576","ENSG00000075884.14_593443",593435,593443,9,"ENSG00000075884.14",1,1,"MVVVVVVVV",0,8,0.90600414078675,115,121,133,136,165,171,181,184,"AAGGTGA","ATAA","TTGTTGA","CTGA",2.35722786164225,12,29,10,60,2.06137581640621,4.44405705683863,8.06807361998563,101,"ENSG00000079974.19"
"22393","ENSG00000170456.16_36162",36154,36162,9,"ENSG00000170456.16",1,7,"VVVVVVMVV",0,8,0.885300207039338,71,77,85,88,94,100,133,136,"ATGATCA","CTGA","AGGAGGA","TTGA",2.44745114907099,8,6,33,56,1.79085456091768,4.52679888868107,8.06799971683842,101,"ENSG00000079974.19"
"41756","ENSG00000259673.6_68703",68695,68703,9,"ENSG00000259673.6",1,7,"VVVVVVMVV",0,8,0.885300207039338,71,77,85,88,94,100,133,136,"ATGATCA","CTGA","AGGAGGA","TTGA",2.44745114907099,8,6,33,56,1.79085456091768,4.52679888868107,8.06799971683842,101,"ENSG00000079974.19"
"47183","ENSG00000287780.1_12772",12764,12772,9,"ENSG00000287780.1",1,7,"VVVVVVMVV",0,8,0.885300207039338,71,77,85,88,94,100,133,136,"ATGATCA","CTGA","AGGAGGA","TTGA",2.44745114907099,8,6,33,56,1.79085456091768,4.52679888868107,8.06799971683842,101,"ENSG00000079974.19"
"47441","ENSG00000288107.1_15995",15987,15995,9,"ENSG00000288107.1",1,7,"VVVVVVMVV",0,8,0.885300207039338,71,77,85,88,94,100,133,136,"ATGATCA","CTGA","AGGAGGA","TTGA",2.44745114907099,8,6,33,56,1.79085456091768,4.52679888868107,8.06799971683842,101,"ENSG00000079974.19"
"34585","ENSG00000233491.8_192543",192535,192543,9,"ENSG00000233491.8",1,1,"MVVVVUVVV",1,7,0.82815734989648,114,120,133,136,183,189,198,201,"AGGATGA","GAGA","CTGATGT","CTGA",2.55381752709027,13,47,9,78,1.9959216077967,4.75534294709963,8.06797234668555,101,"ENSG00000079974.19"
"19118","ENSG00000161638.11_20615",20607,20615,9,"ENSG00000161638.11",1,6,"VVVVVMVVV",0,8,0.902691511387163,52,58,100,103,113,119,133,136,"AGGATGT","TTTA","GTGAGGC","CTGA",2.40877510085992,42,10,14,75,1.77025956387183,4.45719005906783,8.06795610461648,101,"ENSG00000079974.19"
"15315","ENSG00000147724.12_129699",129691,129699,9,"ENSG00000147724.12",1,1,"MVVVVVVVV",0,8,0.90600414078675,89,95,133,136,139,145,155,158,"TTGATGG","GTCA","GTGTTCA","CTGA",2.41067184583449,38,3,10,60,1.70379397872536,4.44373490440549,8.06775146755249,101,"ENSG00000079974.19"
"24077","ENSG00000175097.9_1316",1308,1316,9,"ENSG00000175097.9",1,7,"VVVVVVMVV",0,8,0.885300207039338,81,87,101,104,113,119,133,136,"ATTATGA","CAGA","GGGAAAA","CTGT",2.29731278069833,14,9,14,46,2.78995296156916,4.52634287488951,8.06754370304686,101,"ENSG00000079974.19"
"29757","ENSG00000198677.13_46750",46742,46750,9,"ENSG00000198677.13",1,1,"MVVVVVVVV",0,8,0.90600414078675,75,81,93,96,116,122,133,136,"GTGATAA","TTGA","GTGAAAA","CTGG",2.32645135719452,12,20,11,52,2.26422927754441,4.44347624804364,8.06749281119064,101,"ENSG00000079974.19"
"35256","ENSG00000235493.2_121018",121010,121018,9,"ENSG00000235493.2",1,6,"VVVVVMVVV",0,8,0.902691511387163,116,122,133,136,146,152,167,170,"AAAATGT","GTAA","GTAATGA","CTGA",2.26960349452628,11,10,15,45,2.69613336614716,4.45670583241392,8.06747187796257,101,"ENSG00000079974.19"
"13383","ENSG00000141298.19_132235",132227,132235,9,"ENSG00000141298.19",1,6,"VVVVVMVVV",0,8,0.902691511387163,114,120,133,136,148,154,169,172,"TTGATGA","GTGT","GAGAAGA","ATGA",2.28705426122209,13,12,15,49,2.57976528803582,4.45669842404576,8.06746446959442,101,"ENSG00000079974.19"
"15794","ENSG00000149571.12_27359",27351,27359,9,"ENSG00000149571.12",0,NA,"VVVVVUVVV",1,8,0.922153209109731,89,95,133,136,150,156,177,180,"ATGGTGA","ATGT","ATGCTAA","CTGA",2.46428058663267,38,14,21,82,1.0861283961405,4.37866641008958,8.0672792465285,101,"ENSG00000079974.19"
"25911","ENSG00000183098.11_1125324",1125316,1125324,9,"ENSG00000183098.11",1,6,"VVVVVMVVV",0,8,0.902691511387163,104,110,133,136,142,148,159,162,"GAGATGT","GTGA","AGAAAGA","CTGA",2.33731586203677,23,6,11,49,2.24378980174033,4.45647388716303,8.06723993271169,101,"ENSG00000079974.19"
"39948","ENSG00000254530.2_383410",383402,383410,9,"ENSG00000254530.2",1,1,"MVUVVVVVV",1,7,0.789648033126294,115,121,133,136,149,155,164,167,"GTGATTA","CAGA","ATGATTC","CTGA",2.53938445654295,12,13,9,43,2.70531919494812,4.90863722630861,8.06722935881378,101,"ENSG00000079974.19"
"39572","ENSG00000253836.1_4150",4142,4150,9,"ENSG00000253836.1",0,NA,"VVVVVVUVV",1,8,0.886128364389234,108,114,133,136,142,148,187,190,"ATGATTA","GTTA","GTGCTTA","CTGA",2.47577057568062,19,6,39,73,1.58555726539781,4.52267360915048,8.06718706670742,101,"ENSG00000079974.19"
"10699","ENSG00000132405.19_82626",82618,82626,9,"ENSG00000132405.19",0,NA,"VVVVUVVVV",1,8,0.889855072463768,111,117,133,136,147,153,162,165,"CTGTTGG","CTGA","CTGATGT","ATGA",2.30300280242941,16,11,9,45,2.67763915973854,4.50774779398365,8.06716808383872,101,"ENSG00000079974.19"
"39530","ENSG00000253762.2_44979",44971,44979,9,"ENSG00000253762.2",1,8,"VVVVVVVMV",0,8,0.884057971014493,56,62,103,106,115,121,133,136,"ATGATGA","CAGA","ACGAGGG","CAGA",2.43211406723414,41,9,12,71,1.90962314877538,4.53092923258408,8.06716111664205,101,"ENSG00000079974.19"
"21455","ENSG00000167720.13_2257",2249,2257,9,"ENSG00000167720.13",1,1,"MVVVVVVVV",0,8,0.90600414078675,108,114,133,136,159,165,181,184,"TTCATGA","ATGA","GTCAGTA","CTGA",2.43949115755115,19,23,16,67,1.50845641437831,4.44293269951316,8.06694926266015,101,"ENSG00000079974.19"
"38093","ENSG00000249506.3_25358",25350,25358,9,"ENSG00000249506.3",1,1,"MVVVVVVVV",0,8,0.90600414078675,95,101,133,136,144,150,198,201,"GTGAGGA","ATGA","TTCAAGA","CTGA",2.51365097368344,32,8,48,97,1.01393352569049,4.44290167089502,8.06691823404202,101,"ENSG00000079974.19"
"10086","ENSG00000129158.11_149831",149823,149831,9,"ENSG00000129158.11",1,6,"UVVVVMVVV",1,7,0.805383022774327,78,84,95,98,110,116,133,136,"AGGATAA","CAGA","GTGATGT","CTGA",2.54126378382365,11,12,17,49,2.43946780781975,4.84530659166102,8.06683868275833,101,"ENSG00000079974.19"
"29140","ENSG00000197302.11_59889",59881,59889,9,"ENSG00000197302.11",1,1,"MVVVVVVVV",0,8,0.90600414078675,88,94,133,136,140,146,157,160,"AGGATGA","CAAA","ACGACTA","CTGA",2.3918546216003,39,4,11,63,1.82557376187791,4.44281780980332,8.06683437295031,101,"ENSG00000079974.19"
"47000","ENSG00000287474.1_24575",24567,24575,9,"ENSG00000287474.1",0,NA,"VVUVVVVVV",1,8,0.883643892339545,55,61,76,79,110,116,133,136,"ATGATGA","CTCA","TTGAACA","CAGA",2.4718824221034,15,31,17,72,1.64956107997508,4.53219430683277,8.06676987619095,101,"ENSG00000079974.19"
"10176","ENSG00000129675.16_26874",26866,26874,9,"ENSG00000129675.16",1,8,"VVVVVUVMV",1,7,0.806211180124224,111,117,133,136,148,154,168,171,"ATGAAGA","CAGA","GTCATAG","CTGA",2.53377538284328,16,12,14,51,2.47557781913843,4.84185342619007,8.06669814668696,101,"ENSG00000079974.19"
"6325","ENSG00000109390.13_22809",22801,22809,9,"ENSG00000109390.13",1,7,"VVVVVVMVV",0,8,0.885300207039338,89,95,108,111,113,119,133,136,"ATGATGG","ATGA","TTAATGT","CTTA",2.34748543825185,13,2,14,38,2.45203720221703,4.52548503097401,8.06668585913136,101,"ENSG00000079974.19"
"12138","ENSG00000137463.5_483",475,483,9,"ENSG00000137463.5",1,7,"VVVVVVMVV",0,8,0.885300207039338,89,95,108,111,113,119,133,136,"ATGATGG","ATGA","TTAATGT","CTTA",2.34748543825185,13,2,14,38,2.45203720221703,4.52548503097401,8.06668585913136,101,"ENSG00000079974.19"
"46968","ENSG00000287424.1_17985",17977,17985,9,"ENSG00000287424.1",1,8,"VVVVVVVMV",0,8,0.884057971014493,55,61,101,104,108,114,133,136,"AAGATGT","TTGA","CTGAAGG","CTGA",2.50595333844536,40,4,19,72,1.4144747308939,4.53020758013241,8.06643946419038,101,"ENSG00000079974.19"
"46081","ENSG00000286163.1_45907",45899,45907,9,"ENSG00000286163.1",1,2,"VMVVVVVVV",0,8,0.884057971014493,56,62,82,85,106,112,133,136,"ATCATGG","CTTA","ATGAGGA","CTGA",2.53976022919822,20,21,21,71,1.18905580578715,4.53019766677715,8.06642955083512,101,"ENSG00000079974.19"
"36412","ENSG00000240553.1_36492",36484,36492,9,"ENSG00000240553.1",0,NA,"VVVVVVUVV",1,8,0.886128364389234,114,120,133,136,146,152,160,163,"ATGACTA","GTCA","GAAATGA","CTGA",2.27699374068276,13,10,8,40,2.90710278039866,4.52176526290427,8.0662787204612,101,"ENSG00000079974.19"
"11184","ENSG00000134160.15_9973",9965,9973,9,"ENSG00000134160.15",1,2,"VMVVVVVVV",0,8,0.884057971014493,97,103,133,136,147,153,161,164,"GTGAGGG","CCGA","GTGACGG","CTGA",2.43919677998705,30,11,8,58,1.85878536250918,4.53002430727238,8.06625619133035,101,"ENSG00000079974.19"
"17786","ENSG00000155085.16_151917",151909,151917,9,"ENSG00000155085.16",1,1,"MVVVVVVVV",0,8,0.90600414078675,105,111,133,136,165,171,186,189,"AAGATTA","ATGA","GTGAAAA","CTGA",2.48299075939364,22,29,15,75,1.21542160605229,4.4421733338358,8.0661898969828,101,"ENSG00000079974.19"
"47093","ENSG00000287635.1_16508",16500,16508,9,"ENSG00000287635.1",1,2,"VMVVVVVVV",0,8,0.884057971014493,111,117,133,136,145,151,163,166,"TTGAGGA","GAGA","ATATTGG","CTGA",2.30536247358935,16,9,12,46,2.75065253458755,4.52993392296247,8.06616580702044,101,"ENSG00000079974.19"
"4102","ENSG00000095015.6_43466",43458,43466,9,"ENSG00000095015.6",1,6,"VVVVVMVVV",0,8,0.902691511387163,107,113,133,136,150,156,168,171,"CTGCTGA","GTGG","GTCATGG","CTGA",2.36251692377541,20,14,12,55,2.07125520811073,4.45534200832002,8.06610805386868,101,"ENSG00000079974.19"
"44118","ENSG00000278390.7_17173",17165,17173,9,"ENSG00000278390.7",1,8,"VVVVVUVMV",1,7,0.806211180124224,88,94,133,136,140,146,154,157,"ATGATGA","CTCC","GTGGAGA","CTGA",2.63172398775496,39,4,8,60,1.81994252829963,4.84119227833318,8.06603699883008,101,"ENSG00000079974.19"
"41245","ENSG00000258733.7_71636",71628,71636,9,"ENSG00000258733.7",0,NA,"UVVVVUVVV",2,7,0.824844720496894,110,116,133,136,145,151,167,170,"CTAATGG","CTGA","AAGAAGA","CTGA",2.49030802370825,17,9,16,51,2.46457668551793,4.76665754422657,8.06603642621415,101,"ENSG00000079974.19"
"15700","ENSG00000149256.16_36925",36917,36925,9,"ENSG00000149256.16",0,NA,"VVVVUVVVV",1,8,0.889855072463768,110,116,133,136,138,144,175,178,"ATGAGGA","TTGC","ATGAGGG","CTGA",2.49574139380545,17,2,31,59,1.38736696809709,4.50641073170002,8.0658310215551,101,"ENSG00000079974.19"
"38765","ENSG00000251003.9_126834",126826,126834,9,"ENSG00000251003.9",1,6,"VVVVVMVVV",0,8,0.902691511387163,78,84,105,108,116,122,133,136,"ATGAAGA","TTGA","GTGCATA","CTGT",2.31551518126408,21,8,11,49,2.38341259339507,4.45504511712224,8.06581116267089,101,"ENSG00000079974.19"
"1007","ENSG00000044115.21_270782",270774,270782,9,"ENSG00000044115.21",1,3,"VVMVVVVVV",0,8,0.882815734989648,101,107,133,136,154,160,173,176,"ATGCTGA","ATAA","TTGTTGA","CTGA",2.50683971767612,26,18,13,66,1.42547741109048,4.53443554889949,8.06569848885808,101,"ENSG00000079974.19"
"23103","ENSG00000172260.15_789997",789989,789997,9,"ENSG00000172260.15",1,1,"MVVVVVVVV",0,8,0.90600414078675,77,83,99,102,113,119,133,136,"CTGAGAA","CTGC","GAGAAGG","CTGA",2.28319825057648,16,11,14,50,2.54511071647796,4.44160809674696,8.06562465989396,101,"ENSG00000079974.19"
"44132","ENSG00000278540.5_313650",313642,313650,9,"ENSG00000278540.5",1,8,"VVVVVVVMV",0,8,0.884057971014493,111,117,133,136,141,147,158,161,"GTGAGGA","CTAT","AGGGTCA","CTGA",2.300683116903,16,5,11,41,2.77930076081277,4.5292970517082,8.06552893576617,101,"ENSG00000079974.19"
"12765","ENSG00000139044.12_8325",8317,8325,9,"ENSG00000139044.12",1,5,"VVVVMVVVV",0,8,0.886542443064182,54,60,93,96,105,111,133,136,"ATGAAGA","CTGA","TTGTTGA","GTGA",2.50531720364002,33,9,22,73,1.37510510937807,4.51930495007789,8.06547472233462,101,"ENSG00000079974.19"
"15238","ENSG00000147481.17_366864",366856,366864,9,"ENSG00000147481.17",1,5,"VVVVMVVVV",0,8,0.886542443064182,85,91,133,136,138,144,158,161,"ATGTTGA","CTGG","GTATTCA","CTGA",2.5019583191725,42,2,14,67,1.39724849231001,4.51924265503167,8.06541242728839,101,"ENSG00000079974.19"
"37247","ENSG00000246316.8_131453",131445,131453,9,"ENSG00000246316.8",0,NA,"UVVVVVVVV",1,8,0.902691511387163,113,119,133,136,143,149,158,161,"ATGCTTA","CATA","AAGGTAA","CTGA",2.22162844949786,14,7,9,39,3.0073188496743,4.45454379491501,8.06530984046367,101,"ENSG00000079974.19"
"37576","ENSG00000248491.6_88025",88017,88025,9,"ENSG00000248491.6",0,NA,"VVVVVUVVV",1,8,0.922153209109731,88,94,133,136,144,150,196,199,"ATGGTGA","CTTC","GTGGAGA","CTGA",2.47677244723545,39,8,46,102,0.994727245260851,4.37663589004097,8.06524872647989,101,"ENSG00000079974.19"
"14707","ENSG00000145743.18_335671",335663,335671,9,"ENSG00000145743.18",1,6,"VVVVVMVVV",0,8,0.902691511387163,76,82,99,102,110,116,133,136,"ATAATGA","CTAA","ATAATTA","CTAA",2.3067005076908,17,8,17,51,2.43972052476323,4.45443097734214,8.06519702289079,101,"ENSG00000079974.19"
"38228","ENSG00000249806.1_83663",83655,83663,9,"ENSG00000249806.1",1,1,"MVVVVVVVV",0,8,0.90600414078675,111,117,133,136,182,188,199,202,"GAGAAGA","ATGA","ATGTTTA","CTGA",2.39078272567184,16,46,11,82,1.825781171892,4.44108316909274,8.06509973223974,101,"ENSG00000079974.19"
"41207","ENSG00000258690.1_17140",17132,17140,9,"ENSG00000258690.1",1,1,"MVVVVVVVV",0,8,0.90600414078675,112,118,133,136,144,150,161,164,"ATAATGT","ATTA","TTGATGA","ATGA",2.23046569903019,15,8,11,43,2.89427592362447,4.4410118126231,8.0650283757701,101,"ENSG00000079974.19"
"18062","ENSG00000156103.16_202873",202865,202873,9,"ENSG00000156103.16",0,NA,"VVVVUVVVV",1,8,0.889855072463768,113,119,133,136,171,177,189,192,"TTAATTA","ATGA","CTGAGGA","CTGA",2.41206209872874,14,35,12,70,1.94183282751769,4.50556170476065,8.06498199461572,101,"ENSG00000079974.19"
"5027","ENSG00000102763.18_91826",91818,91826,9,"ENSG00000102763.18",0,NA,"VVVVVUVVV",1,8,0.922153209109731,104,110,133,136,142,148,190,193,"ATATTGA","CTGT","ATGCTGT","CTGA",2.43518700246649,23,6,42,80,1.27054422554166,4.37628106049622,8.06489389693515,101,"ENSG00000079974.19"
"23286","ENSG00000172469.17_18531",18523,18531,9,"ENSG00000172469.17",1,1,"MVVVVVVVV",0,8,0.90600414078675,112,118,133,136,145,151,168,171,"ATTATGC","ATGA","GTTATGA","CTAA",2.28063880740006,15,9,17,50,2.55843997602604,4.44067467300661,8.0646912361536,101,"ENSG00000079974.19"
"2808","ENSG00000078328.23_131909",131901,131909,9,"ENSG00000078328.23",1,5,"VVVVMVVVV",0,8,0.886542443064182,43,49,58,61,112,118,133,136,"GTGATGT","CTGA","ATGAAGG","CTGC",2.46298122903627,9,51,15,84,1.65401828556004,4.51847328645047,8.0646430587072,101,"ENSG00000079974.19"
"15132","ENSG00000147133.17_13826",13818,13826,9,"ENSG00000147133.17",1,2,"VMVVVVVVV",0,8,0.884057971014493,114,120,133,136,149,155,173,176,"ATGATTA","TTGA","GTGTTAA","CTGG",2.3681339183725,13,13,18,53,2.32599594502376,4.5283888502101,8.06462073426807,101,"ENSG00000079974.19"
"6230","ENSG00000108684.15_634089",634081,634089,9,"ENSG00000108684.15",0,NA,"VVVVVVUVV",1,8,0.886128364389234,109,115,133,136,140,146,164,167,"ACGATGT","CATA","ATGAAGG","CTGA",2.39083913203997,18,4,18,49,2.14137487588399,4.52007560570428,8.06458906326121,101,"ENSG00000079974.19"
"14664","ENSG00000145687.17_21638",21630,21638,9,"ENSG00000145687.17",0,NA,"UVVVVVVVV",1,8,0.902691511387163,95,101,133,136,149,155,211,214,"ATGATGA","CTTG","ATGAAAC","CTGA",2.56453273517573,32,13,56,110,0.718177975208937,4.45376571909511,8.06453176464377,101,"ENSG00000079974.19"
"11420","ENSG00000134882.16_153000",152992,153000,9,"ENSG00000134882.16",1,8,"VVVVVVVMV",0,8,0.884057971014493,103,109,133,136,163,169,181,184,"CTGATGG","CTTA","ATGAGCA","CTGA",2.52737741148283,24,27,12,72,1.26368985753857,4.52821815018936,8.06445003424733,101,"ENSG00000079974.19"
"14785","ENSG00000145888.11_20613",20605,20613,9,"ENSG00000145888.11",1,1,"MVVVVVVVV",0,8,0.90600414078675,107,113,133,136,143,149,188,191,"ATCTTGA","CAGA","AAGAAGA","CTGA",2.4369337017126,20,7,39,75,1.51527760169607,4.44037556994502,8.06439213309202,101,"ENSG00000079974.19"
"7224","ENSG00000113356.13_5362",5354,5362,9,"ENSG00000113356.13",1,1,"MVVVVVVVV",0,8,0.90600414078675,39,45,63,66,72,78,133,136,"ACGATGA","TTGA","TTGAAGA","CTTA",2.41655233218655,18,6,55,88,1.65088033781716,4.44030730476521,8.06432386791221,101,"ENSG00000079974.19"
"33905","ENSG00000231426.7_127464",127456,127464,9,"ENSG00000231426.7",1,8,"VVVVVVVMV",0,8,0.884057971014493,87,93,133,136,140,146,164,167,"ATGCTGA","CTGT","GTTCTCA","CTGA",2.49554392563878,40,4,18,71,1.4752519634258,4.52805286692108,8.06428475097905,101,"ENSG00000079974.19"
"9361","ENSG00000124215.17_14233",14225,14233,9,"ENSG00000124215.17",1,8,"VVVVVVVMV",0,8,0.884057971014493,78,84,98,101,115,121,133,136,"ATGAAGT","GTAA","ATTATAA","CTGA",2.33488344455393,14,14,12,49,2.54595498672809,4.52796115427191,8.06419303832988,101,"ENSG00000079974.19"
"484","ENSG00000013293.6_53292",53284,53292,9,"ENSG00000013293.6",1,8,"VVVVVVVMV",0,8,0.884057971014493,113,119,133,136,150,156,167,170,"AGGTTCA","CTGA","ATCAGGC","CTGA",2.33042483644548,14,14,11,48,2.57431153672816,4.52761927825784,8.06385116231581,101,"ENSG00000079974.19"
"30159","ENSG00000203867.8_96974",96966,96974,9,"ENSG00000203867.8",0,NA,"VVVVVUVVV",1,8,0.922153209109731,115,121,133,136,144,150,176,179,"GAGGTGA","CAGA","GAAATAA","CTGA",2.29164942440424,12,8,26,55,2.22317001845266,4.37520821195357,8.06382104839249,101,"ENSG00000079974.19"
"21464","ENSG00000167858.13_12515",12507,12515,9,"ENSG00000167858.13",1,8,"VVVVVVVMV",0,8,0.884057971014493,92,98,133,136,139,145,164,167,"CTGATGA","CTGG","ACCTTGA","CTGA",2.52379856979715,35,3,19,66,1.28476599733319,4.52752244899522,8.06375433305319,101,"ENSG00000079974.19"
"43668","ENSG00000273118.1_362982",362974,362982,9,"ENSG00000273118.1",1,1,"MVVVVVVVV",0,8,0.90600414078675,115,121,133,136,140,146,157,160,"GGGATTA","CAAA","GTGACTC","CTGA",2.22490324449984,12,4,11,36,2.92626049687161,4.43973719838431,8.06375376153131,101,"ENSG00000079974.19"
"18542","ENSG00000157625.16_90616",90608,90616,9,"ENSG00000157625.16",1,3,"VVMVVVVVV",0,8,0.882815734989648,112,118,133,136,170,176,190,193,"ATGATCT","CAGA","GTGGGCA","CTGA",2.4487380585571,15,34,14,72,1.80494380756703,4.53246604948692,8.06372898944551,101,"ENSG00000079974.19"
"8006","ENSG00000116396.15_72538",72530,72538,9,"ENSG00000116396.15",1,2,"VMVVVVVVV",0,8,0.884057971014493,105,111,133,136,144,150,185,188,"CTGATGA","GGGA","CTTAAGA","CTGA",2.50988337174553,22,8,35,74,1.37671676655114,4.52731814454701,8.06355002860498,101,"ENSG00000079974.19"
"25209","ENSG00000179915.25_704828",704820,704828,9,"ENSG00000179915.25",1,2,"VMVVVUVVV",1,7,0.806211180124223,98,104,133,136,146,152,162,165,"ATGATGA","CATA","CTGTTTA","CTGA",2.60970744680851,29,10,10,58,1.9567509034955,4.83870013722139,8.06354485771829,101,"ENSG00000079974.19"
"7996","ENSG00000116266.11_51573",51565,51573,9,"ENSG00000116266.11",1,2,"VMVVVVVVV",0,8,0.884057971014493,114,120,133,136,138,144,152,155,"ATTATGG","TTAA","ATGTTTT","CTGA",2.3027485073174,13,2,8,32,2.75757226228217,4.52730724443287,8.06353912849085,101,"ENSG00000079974.19"
"38336","ENSG00000250025.2_42176",42168,42176,9,"ENSG00000250025.2",1,6,"VVUVVMVVV",1,7,0.786335403726708,82,88,133,136,142,148,163,166,"ATGATGG","CTGA","ATGCTTT","CTGA",2.68070956674741,45,6,15,75,1.80113759495439,4.91813367665095,8.06347529155778,101,"ENSG00000079974.19"
"11357","ENSG00000134744.14_21690",21682,21690,9,"ENSG00000134744.14",1,1,"MVVVVVVVV",0,8,0.90600414078675,114,120,133,136,139,145,157,160,"GTGAGAA","TTCA","AAGAAGA","CTGA",2.2536024734571,13,3,12,37,2.73340942431075,4.43935647850619,8.06337304165319,101,"ENSG00000079974.19"
"40687","ENSG00000257322.7_30156",30148,30156,9,"ENSG00000257322.7",0,NA,"VVVVVUVVV",1,8,0.922153209109731,89,95,106,109,116,122,133,136,"ATGATGC","ATGA","AAGATGA","TTTA",2.17174438930266,11,7,11,38,3.0203974279366,4.37467333915525,8.06328617559417,101,"ENSG00000079974.19"
"18865","ENSG00000158985.14_99972",99964,99972,9,"ENSG00000158985.14",1,1,"MVVVVVVVV",0,8,0.90600414078675,95,101,133,136,165,171,186,189,"ATGAAGT","ATGA","GTGAAAA","CTGA",2.52815660272462,32,29,15,85,0.901826085985828,4.43905085937082,8.06306742251782,101,"ENSG00000079974.19"
"41159","ENSG00000258592.1_7477",7469,7477,9,"ENSG00000258592.1",1,1,"MVVVVVVVV",0,8,0.90600414078675,95,101,133,136,165,171,186,189,"ATGAAGT","ATGA","GTGAAAA","CTGA",2.52815660272462,32,29,15,85,0.901826085985828,4.43905085937082,8.06306742251782,101,"ENSG00000079974.19"
"47847","ENSG00000289487.1_100235",100227,100235,9,"ENSG00000289487.1",0,NA,"VVVVVUVVV",1,8,0.922153209109731,96,102,133,136,173,179,196,199,"TCCATGA","CTGA","GAGATGA","CTGA",2.5131490325011,31,37,17,94,0.743225314451855,4.37438804944813,8.06300088588705,101,"ENSG00000079974.19"
"44327","ENSG00000280878.1_22272",22264,22272,9,"ENSG00000280878.1",1,6,"VVVVVMVVV",0,8,0.902691511387163,112,118,133,136,152,158,173,176,"AGGATGG","TTCA","AGGACGA","CTGA",2.33903378294231,15,16,15,55,2.21524806923578,4.45220165554613,8.06296770109478,101,"ENSG00000079974.19"
"38966","ENSG00000251365.6_44280",44272,44280,9,"ENSG00000251365.6",1,8,"VVVVVVVMV",0,8,0.884057971014493,78,84,91,94,99,105,133,136,"TGGATGT","CTGA","ATGGAAA","CTGA",2.45809720049972,7,5,28,49,1.71892582170976,4.52656012292698,8.06279200698495,101,"ENSG00000079974.19"
"10921","ENSG00000133114.18_38408",38400,38408,9,"ENSG00000133114.18",1,8,"VVVVVVVMV",0,8,0.884057971014493,110,116,133,136,144,150,162,165,"TTGATGA","CTAA","ATCTAGA","CAGA",2.3103423375941,17,8,12,46,2.70380730046761,4.52652238777373,8.0627542718317,101,"ENSG00000079974.19"
"36554","ENSG00000241743.4_408901",408893,408901,9,"ENSG00000241743.4",0,NA,"VVVVUVVVV",1,8,0.889855072463768,109,115,133,136,162,168,176,179,"AAAATGA","CTGG","ATGTTAA","CTGA",2.43936801848013,18,26,8,61,1.75080917939281,4.50331565898176,8.06273594883683,101,"ENSG00000079974.19"
"10226","ENSG00000130021.15_420632",420624,420632,9,"ENSG00000130021.15",0,NA,"UVVVVVVVV",1,8,0.902691511387163,64,70,89,92,109,115,133,136,"ATGATTG","CTGG","GTGCACA","CTGA",2.42493331869566,19,17,18,63,1.64100398204007,4.45180652666946,8.06257257221811,101,"ENSG00000079974.19"
"31682","ENSG00000224404.2_13029",13021,13029,9,"ENSG00000224404.2",1,7,"VVVVVVMVV",0,8,0.885300207039338,114,120,133,136,150,156,193,196,"AGTATGA","CTTA","GTGCGGA","CTGA",2.46452336124346,13,14,37,73,1.65499868025382,4.52128860546922,8.06248943362657,101,"ENSG00000079974.19"
"33854","ENSG00000231304.2_4735",4727,4735,9,"ENSG00000231304.2",1,1,"MVVVVUVVV",1,7,0.82815734989648,38,44,76,79,86,92,133,136,"ATGATGG","CTGA","TTTTTGA","CTGA",2.69380078296363,32,7,41,89,1.04021807613674,4.74972249064023,8.06235189022615,101,"ENSG00000079974.19"
"25728","ENSG00000182648.15_82833",82825,82833,9,"ENSG00000182648.15",1,2,"VMVVVVVVV",0,8,0.884057971014493,74,80,96,99,116,122,133,136,"ATGATCA","GTGA","GTGAAAA","CTCA",2.37784684458324,16,17,11,53,2.25195535187037,4.52606691227299,8.06229879633096,101,"ENSG00000079974.19"
"11479","ENSG00000135074.16_78565",78557,78565,9,"ENSG00000135074.16",0,NA,"UVVVVVVVV",1,8,0.902691511387163,113,119,133,136,143,149,159,162,"ATGAGGT","CTGT","ATGGTAA","CTGT",2.22136960860322,14,7,10,40,2.99698625746431,4.45152924537144,8.0622952909201,101,"ENSG00000079974.19"
"516","ENSG00000015532.10_4528",4520,4528,9,"ENSG00000015532.10",1,8,"VVVVVVVMV",0,8,0.884057971014493,110,116,133,136,139,145,158,161,"GTGAACA","CTGC","TTGGGGA","CTGA",2.35677424144032,17,3,13,42,2.39241030607213,4.52605964558523,8.0622915296432,101,"ENSG00000079974.19"
"3842","ENSG00000089250.20_230086",230078,230086,9,"ENSG00000089250.20",1,8,"UVVVVVVMV",1,7,0.786749482401656,113,119,133,136,146,152,163,166,"CTGACGT","CTGG","GTGATGA","CTGA",2.52057397081567,14,10,11,44,2.85658025701803,4.91510168228063,8.06209961188725,101,"ENSG00000079974.19"
"9968","ENSG00000128595.17_27604",27596,27604,9,"ENSG00000128595.17",1,8,"VVVVVVVMV",0,8,0.884057971014493,116,122,133,136,156,162,192,195,"GAGATGG","TTGA","ATGAAGA","CTGA",2.50858368138533,11,20,30,70,1.3794235473866,4.52582868915554,8.06206057321351,101,"ENSG00000079974.19"
"1922","ENSG00000067715.15_43881",43873,43881,9,"ENSG00000067715.15",1,6,"VVVVVMVVV",0,8,0.902691511387163,110,116,133,136,176,182,231,234,"AAGATGA","TTGA","TTAATTA","CTGA",2.55592866221655,17,40,49,115,0.765561678783625,4.45127152339016,8.06203756893882,101,"ENSG00000079974.19"
"35786","ENSG00000237092.2_10954",10946,10954,9,"ENSG00000237092.2",0,NA,"UVVVUVVVV",2,7,0.792546583850932,60,66,84,87,105,111,133,136,"TTGAAGA","CTGA","CTGATGA","CTGA",2.71807617206126,18,18,22,67,1.44671175356755,4.89180489182733,8.06199122723106,101,"ENSG00000079974.19"
"4952","ENSG00000102466.16_422434",422426,422434,9,"ENSG00000102466.16",0,NA,"UVVVVVVVV",1,8,0.902691511387163,97,103,133,136,143,149,161,164,"AGCATGA","CTTA","GTATTGG","CTGA",2.37048994223871,30,7,12,58,2.00159217486045,4.45121461411296,8.06198065966161,101,"ENSG00000079974.19"
"30385","ENSG00000204767.4_5275",5267,5275,9,"ENSG00000204767.4",0,NA,"VVVVVVUVV",1,8,0.886128364389234,112,118,133,136,148,154,168,171,"GTCAGGA","CAAA","ATGTTGA","CTGA",2.32836041991803,15,12,14,50,2.54745203628129,4.51746370893371,8.06197716649064,101,"ENSG00000079974.19"
"7196","ENSG00000113273.17_171768",171760,171768,9,"ENSG00000113273.17",1,1,"MVVVVVVVV",0,8,0.90600414078675,112,118,133,136,141,147,158,161,"CAGATGT","ATTA","CTATTGA","CTGA",2.23378281258239,15,5,11,40,2.85983504323997,4.43793011511398,8.06194667826098,101,"ENSG00000079974.19"
"38404","ENSG00000250127.1_11525",11517,11525,9,"ENSG00000250127.1",1,1,"MVVUVVVVV",1,7,0.786749482401656,115,121,133,136,145,151,183,186,"ATGATGA","CTGG","ATTTTTA","CTGA",2.64258004092954,12,9,32,62,2.04107960363171,4.91456996912383,8.06156789873045,101,"ENSG00000079974.19"
"42850","ENSG00000267134.3_239542",239534,239542,9,"ENSG00000267134.3",1,7,"VVVVVVMVV",0,8,0.885300207039338,109,115,133,136,164,170,182,185,"ATGATGT","TTCA","GTTCAGA","CTGA",2.45755150452769,18,28,12,67,1.69776303084789,4.52035993192479,8.06156076008214,101,"ENSG00000079974.19"
"28612","ENSG00000196230.14_7990",7982,7990,9,"ENSG00000196230.14",1,8,"VVVVVVVMV",0,8,0.884057971014493,83,89,133,136,142,148,168,171,"AAGATGA","GCGA","GTGCTTA","CTGA",2.49009732321172,44,6,20,79,1.50056355511829,4.52530309413243,8.06153497819041,101,"ENSG00000079974.19"
"31028","ENSG00000215274.6_13633",13625,13633,9,"ENSG00000215274.6",1,1,"MVVVVVUVV",1,7,0.792132505175983,85,91,105,108,115,121,133,136,"CTGATGG","CTGC","CAGAGGA","CTGA",2.49484519215462,14,7,12,42,2.93936475710007,4.89291650953271,8.06144653023664,101,"ENSG00000079974.19"
"38055","ENSG00000249441.1_5113",5105,5113,9,"ENSG00000249441.1",1,7,"VVVVVVMVV",0,8,0.885300207039338,113,119,133,136,150,156,172,175,"ATGTTGC","CAGT","CTGAAGT","CTGA",2.36033512272608,14,14,16,53,2.34538451555173,4.52023800009806,8.06143882825541,101,"ENSG00000079974.19"
"18591","ENSG00000157778.9_552",544,552,9,"ENSG00000157778.9",1,6,"VVVVVMVVV",0,8,0.902691511387163,72,78,102,105,116,122,133,136,"CGGATGA","CTGA","GTTATGG","CTTA",2.36448454610725,24,11,11,55,2.0389176958624,4.45053700081102,8.06130304635968,101,"ENSG00000079974.19"
"522","ENSG00000016402.14_42960",42952,42960,9,"ENSG00000016402.14",1,8,"VVVVVVVMV",0,8,0.884057971014493,82,88,133,136,148,154,174,177,"CGGATGA","GTGA","TTAATGA","CTGA",2.5226191412334,45,12,20,86,1.28253808639177,4.52499975698694,8.06123164104491,101,"ENSG00000079974.19"
"1949","ENSG00000067992.17_51379",51371,51379,9,"ENSG00000067992.17",0,NA,"UVVVVVVVV",1,8,0.902691511387163,49,55,65,68,76,82,133,136,"GTGATGT","TTGA","CTGGTGA","CAGA",2.38400208310821,10,8,51,78,1.90786019095136,4.45030185291819,8.06106789846684,101,"ENSG00000079974.19"
"42976","ENSG00000267489.5_45605",45597,45605,9,"ENSG00000267489.5",1,8,"VVVVVUVMV",1,7,0.806211180124224,69,75,89,92,111,117,133,136,"AGGATGA","CTGG","CTGAAAA","CTGA",2.59489769909582,14,19,16,58,2.04514787186077,4.83611646645823,8.06096118695513,101,"ENSG00000079974.19"
"18446","ENSG00000157423.18_317915",317907,317915,9,"ENSG00000157423.18",1,5,"VVVVMVVVV",0,8,0.886542443064182,94,100,111,114,116,122,133,136,"AGGAAGA","CTGA","CTGACCA","GTGA",2.30476324018468,11,2,11,33,2.69406087293081,4.51478728520718,8.06095705746391,101,"ENSG00000079974.19"
"44026","ENSG00000276975.4_255116",255108,255116,9,"ENSG00000276975.4",1,5,"VVVVMVVVV",0,8,0.886542443064182,94,100,111,114,116,122,133,136,"AGGAAGA","CTGA","CTGACCA","GTGA",2.30476324018468,11,2,11,33,2.69406087293081,4.51478728520718,8.06095705746391,101,"ENSG00000079974.19"
"29818","ENSG00000198771.11_31970",31962,31970,9,"ENSG00000198771.11",0,NA,"VVVVVVUVV",1,8,0.886128364389234,87,93,106,109,116,122,133,136,"GTGAGGA","CTCA","GGGATTA","CTGT",2.25767523663762,13,7,11,40,3.01450882069823,4.51641926623725,8.06093272379418,101,"ENSG00000079974.19"
"31374","ENSG00000223609.11_5298",5290,5298,9,"ENSG00000223609.11",1,6,"VVVVVMVVV",0,8,0.902691511387163,111,117,133,136,153,159,180,183,"ATTATGA","CAAA","GTTAGCA","CTGA",2.41112443172447,16,17,21,63,1.72630402521381,4.45011672584424,8.06088277139289,101,"ENSG00000079974.19"
"1053","ENSG00000047230.15_21254",21246,21254,9,"ENSG00000047230.15",1,1,"MVVVVVVVV",0,8,0.90600414078675,92,98,133,136,147,153,170,173,"GTGAACA","ATGA","CTGCTGA","CTGA",2.43088398165613,35,11,17,72,1.54134415718548,4.43680934205658,8.06082590520358,101,"ENSG00000079974.19"
"41726","ENSG00000259616.2_308443",308435,308443,9,"ENSG00000259616.2",1,7,"VVVVVUMVV",1,7,0.807453416149068,108,114,133,136,146,152,184,187,"ATGAGGA","CTGA","GTGTTTC","CTGA",2.66373273856072,19,10,32,70,1.56542216476438,4.83091010545896,8.06072377005524,101,"ENSG00000079974.19"
"45410","ENSG00000285552.1_1688",1680,1688,9,"ENSG00000285552.1",1,8,"VVVVVVVMV",0,8,0.884057971014493,97,103,133,136,178,184,193,196,"ATCATGA","CTAA","ATCATGG","CTGA",2.55754571961686,30,42,9,90,1.04714632978399,4.52436278180743,8.0605946658654,101,"ENSG00000079974.19"
"19167","ENSG00000162390.18_66027",66019,66027,9,"ENSG00000162390.18",1,8,"VVVVVVVMV",0,8,0.884057971014493,115,121,133,136,140,146,162,165,"ATGGTCT","CTGG","CTGAAGG","CTGA",2.32149640877939,12,4,16,41,2.62061531072136,4.52431450897933,8.0605463930373,101,"ENSG00000079974.19"
"925","ENSG00000040731.10_49229",49221,49229,9,"ENSG00000040731.10",1,1,"MVVVVVVVV",0,8,0.90600414078675,79,85,105,108,111,117,133,136,"ATGATCA","CTGA","ATTTTTA","ATGA",2.36917532860767,20,3,16,48,1.95160527156045,4.43652686556956,8.06054342871656,101,"ENSG00000079974.19"
"16654","ENSG00000151967.18_48164",48156,48164,9,"ENSG00000151967.18",0,NA,"UVVVVVVVV",1,8,0.902691511387163,90,96,133,136,146,152,184,187,"ATTATGC","CTGT","ATGATTA","CTGA",2.52085374940043,37,10,32,88,0.99292154890441,4.44965330289349,8.06041934844215,101,"ENSG00000079974.19"
"44615","ENSG00000283154.3_925790",925782,925790,9,"ENSG00000283154.3",0,NA,"UVVVVVVVV",1,8,0.902691511387163,90,96,133,136,146,152,184,187,"ATTATGC","CTGT","ATGATTA","CTGA",2.52085374940043,37,10,32,88,0.99292154890441,4.44965330289349,8.06041934844215,101,"ENSG00000079974.19"
"24481","ENSG00000176571.13_21473",21465,21473,9,"ENSG00000176571.13",1,8,"VVVVVVVMV",0,8,0.884057971014493,114,120,133,136,141,147,156,159,"GTCATAA","TTAA","TTGAAAA","CTGA",2.26026396870327,13,5,9,36,3.02827255804952,4.52417475401784,8.06040663807581,101,"ENSG00000079974.19"
"27840","ENSG00000187398.12_389348",389340,389348,9,"ENSG00000187398.12",1,7,"VVVVVVMVV",0,8,0.885300207039338,82,88,133,136,137,143,152,155,"AAGATAA","CTGA","ATGTAGC","CTGA",2.51284266579565,45,1,9,64,1.32452029559083,4.51920118355712,8.06040201171447,101,"ENSG00000079974.19"
"41285","ENSG00000258772.1_1315",1307,1315,9,"ENSG00000258772.1",1,7,"VVVVVVMVV",0,8,0.885300207039338,84,90,133,136,139,145,157,160,"AGGAGGA","CAGA","ATGATCT","CTGA",2.46258893307311,43,3,12,67,1.65938357131778,4.51916078128463,8.06036160944198,101,"ENSG00000079974.19"
"41362","ENSG00000258918.1_37142",37134,37142,9,"ENSG00000258918.1",1,7,"VVVVVVMVV",0,8,0.885300207039338,84,90,133,136,139,145,157,160,"AGGAGGA","CAGA","ATGATCT","CTGA",2.46258893307311,43,3,12,67,1.65938357131778,4.51916078128463,8.06036160944198,101,"ENSG00000079974.19"
"41363","ENSG00000258918.1_8990",8982,8990,9,"ENSG00000258918.1",1,7,"VVVVVVMVV",0,8,0.885300207039338,84,90,133,136,139,145,157,160,"AGGAGGA","CAGA","ATGATCT","CTGA",2.46258893307311,43,3,12,67,1.65938357131778,4.51916078128463,8.06036160944198,101,"ENSG00000079974.19"
"1921","ENSG00000067715.15_425559",425551,425559,9,"ENSG00000067715.15",1,2,"VMVVVVVVV",0,8,0.884057971014493,35,41,51,54,83,89,133,136,"GTGATGA","CTGA","ATGCAGA","CTTA",2.56598502771095,10,29,44,92,0.98971612278869,4.52407074354875,8.06030262760672,101,"ENSG00000079974.19"
"25367","ENSG00000181143.15_32491",32483,32491,9,"ENSG00000181143.15",1,8,"VVVVVVVMV",0,8,0.884057971014493,100,106,133,136,147,153,166,169,"CTGAAGA","CTGT","GTGCCCA","CTGA",2.43590106338697,27,11,13,60,1.85684916508817,4.52404739691699,8.06027928097496,101,"ENSG00000079974.19"
"24856","ENSG00000178248.11_943",935,943,9,"ENSG00000178248.11",0,NA,"VVVVVUVVV",1,8,0.922153209109731,82,88,133,136,141,147,158,161,"ATGAAGA","TTGA","CTGTTTA","CTGT",2.33536315423705,45,5,11,70,1.91745051609383,4.37163455275188,8.0602473891908,101,"ENSG00000079974.19"
"21373","ENSG00000167306.21_65150",65142,65150,9,"ENSG00000167306.21",0,NA,"VVVUVUVVV",2,7,0.802898550724638,94,100,106,109,110,116,133,136,"GTGCTGA","CTGA","GTGCTCA","CTGA",2.65131058192985,6,1,17,33,1.71901064387363,4.84860363085149,8.06019783375004,101,"ENSG00000079974.19"
"40714","ENSG00000257452.1_73719",73711,73719,9,"ENSG00000257452.1",1,8,"VVVVVVVMV",0,8,0.884057971014493,77,83,91,94,102,108,133,136,"ATTAAGA","CGGA","ACGATGC","CTGA",2.4155514737363,8,8,25,50,1.99157386028167,4.52381258796426,8.06004447202223,101,"ENSG00000079974.19"
"13664","ENSG00000143147.15_21232",21224,21232,9,"ENSG00000143147.15",1,3,"VVMUVVVVV",1,7,0.763561076604555,114,120,133,136,138,144,157,160,"CTGATGT","TTGA","GTGCTGA","CTGA",2.62560503407182,13,2,13,37,2.51883054643972,5.00571602672964,8.05996033314786,101,"ENSG00000079974.19"
"46653","ENSG00000286985.2_13923",13915,13923,9,"ENSG00000286985.2",0,NA,"VVVUVVVVV",1,8,0.880745341614907,82,88,133,136,146,152,185,188,"ATGCTGA","CTGG","CTGAACA","CTGA",2.57599922449207,45,10,33,97,0.974457701031547,4.53694646607801,8.05992783253764,101,"ENSG00000079974.19"
"35457","ENSG00000236107.10_187391",187383,187391,9,"ENSG00000236107.10",1,3,"VVMVVVVVV",0,8,0.882815734989648,111,117,133,136,141,147,170,173,"ATGATAA","TTAA","AGGAATA","CTGA",2.39792662915837,16,5,23,53,2.12820866091602,4.52859654715961,8.05985948711821,101,"ENSG00000079974.19"
"20869","ENSG00000165914.15_239234",239226,239234,9,"ENSG00000165914.15",0,NA,"VVVVVVUVV",1,8,0.886128364389234,112,118,133,136,155,161,171,174,"CTGAGGA","GTGC","ATGCTGG","CTGA",2.3742992911404,15,19,10,53,2.23235938142168,4.51525533058943,8.05976878814636,101,"ENSG00000079974.19"
"14544","ENSG00000145362.21_118225",118217,118225,9,"ENSG00000145362.21",0,NA,"VVVUVVVVV",1,8,0.880745341614907,101,107,133,136,140,146,156,159,"CTGATGA","CTGG","GTGAGAA","ATGA",2.42618756593615,26,4,10,49,1.97253000279632,4.53677844392599,8.05975981038562,101,"ENSG00000079974.19"
"19396","ENSG00000162869.16_3900",3892,3900,9,"ENSG00000162869.16",1,8,"UVVVVVVMV",1,7,0.786749482401656,87,93,104,107,113,119,133,136,"CTGATGC","CTCA","GAGAAGA","CTGA",2.51818047263024,11,6,14,40,2.86308628654337,4.91273902601957,8.05973695562619,101,"ENSG00000079974.19"
"37373","ENSG00000247877.8_77415",77407,77415,9,"ENSG00000247877.8",1,6,"VVVVVMVVV",0,8,0.902691511387163,108,114,133,136,163,169,179,182,"ATAATCA","CTGT","GTTATTA","CTGA",2.41970654317869,19,27,10,65,1.66439958219502,4.4489441341799,8.05971017972855,101,"ENSG00000079974.19"
"10721","ENSG00000132549.20_51308",51300,51308,9,"ENSG00000132549.20",1,1,"MVVVVVVVV",0,8,0.90600414078675,82,88,133,136,145,151,199,202,"TTAATGA","ATGA","TTCATGA","CTGA",2.5181886579803,45,9,48,111,0.95475344249273,4.43566945725701,8.05968602040401,101,"ENSG00000079974.19"
"31084","ENSG00000215483.12_35306",35298,35306,9,"ENSG00000215483.12",1,8,"VVVVVUVMV",1,7,0.806211180124224,116,122,133,136,143,149,157,160,"GGGATGG","CTGA","GGAATCA","CTGA",2.43791186652425,11,7,8,35,3.08659389029706,4.83483491678135,8.05967963727825,101,"ENSG00000079974.19"
"47476","ENSG00000288542.1_110626",110618,110626,9,"ENSG00000288542.1",1,8,"VVVVVUVMV",1,7,0.806211180124224,116,122,133,136,143,149,157,160,"GGGATGG","CTGA","GGAATCA","CTGA",2.43791186652425,11,7,8,35,3.08659389029706,4.83483491678135,8.05967963727825,101,"ENSG00000079974.19"
"39777","ENSG00000254186.3_780860",780852,780860,9,"ENSG00000254186.3",1,8,"VVVVVVVMV",0,8,0.884057971014493,110,116,133,136,184,190,204,207,"GTGAGGA","GTAA","TTGAAGA","CTGA",2.469871058756,17,48,14,88,1.62772671187678,4.52338344256252,8.05961532662049,101,"ENSG00000079974.19"
"24991","ENSG00000179008.9_7980",7972,7980,9,"ENSG00000179008.9",1,8,"VVVVVVVMV",0,8,0.884057971014493,51,57,67,70,115,121,133,136,"GTTCTGA","CTGA","GAGGGGA","CTGA",2.43201967184192,10,45,12,76,1.87996315892485,4.52335690946775,8.05958879352572,101,"ENSG00000079974.19"
"40451","ENSG00000256292.2_8764",8756,8764,9,"ENSG00000256292.2",1,6,"VVVVUMVVV",1,7,0.792546583850932,86,92,107,110,116,122,133,136,"TTAATGA","CTGC","ATGCAGA","CTGA",2.49813297181854,15,6,11,41,2.90323199383234,4.88936295148899,8.05954928689272,101,"ENSG00000079974.19"
"40694","ENSG00000257335.8_183616",183608,183616,9,"ENSG00000257335.8",1,2,"VMVVVUVVV",1,7,0.806211180124223,112,118,133,136,140,146,156,159,"ATTCTGA","CTGA","GTACTGG","CTGA",2.4797532734746,15,4,10,38,2.80704417341016,4.83468316581021,8.05952788630711,101,"ENSG00000079974.19"
"29288","ENSG00000197585.10_53217",53209,53217,9,"ENSG00000197585.10",1,1,"MVVVVVUVV",1,7,0.792132505175983,76,82,101,104,115,121,133,136,"TTGATAA","CTGA","AAGATAA","CTGA",2.5789901581186,19,11,12,51,2.3704658835757,4.89093340109159,8.05946342179552,101,"ENSG00000079974.19"
"35636","ENSG00000236532.6_38372",38364,38372,9,"ENSG00000236532.6",0,NA,"UVVUVVVVV",2,7,0.78343685300207,79,85,100,103,109,115,133,136,"ATGGTGC","CTGC","ATGATGA","CTGA",2.57574507580679,15,6,18,48,2.53118672654907,4.92570514131526,8.05945255332354,101,"ENSG00000079974.19"
"184","ENSG00000006125.18_45727",45719,45727,9,"ENSG00000006125.18",0,NA,"VVVVVUVVV",1,8,0.922153209109731,72,78,102,105,113,119,133,136,"TTGATGA","CTTA","ATAAGGC","CTTA",2.31102078428905,24,8,14,55,2.07603986842676,4.3707112742551,8.05932411069402,101,"ENSG00000079974.19"
"31837","ENSG00000224957.7_258500",258492,258500,9,"ENSG00000224957.7",1,8,"VVVVVVVMV",0,8,0.884057971014493,65,71,86,89,112,118,133,136,"ATGAGGA","CTGT","GTGAGGA","CTCA",2.42883166017364,15,23,15,62,1.89964916043021,4.52296505706363,8.0591969411216,101,"ENSG00000079974.19"
"37623","ENSG00000248550.4_270647",270639,270647,9,"ENSG00000248550.4",0,NA,"UVVVVVVVV",1,8,0.902691511387163,116,122,133,136,143,149,163,166,"AAAATCA","CCAA","GTGATTA","CTGA",2.23850338098635,11,7,14,41,2.87032262606336,4.44841962482643,8.05918567037508,101,"ENSG00000079974.19"
"43749","ENSG00000273398.6_84664",84656,84664,9,"ENSG00000273398.6",1,1,"MVUVVVVVV",1,7,0.789648033126294,40,46,63,66,116,122,133,136,"AGGATGA","CTGA","GGTATGA","CTGA",2.67909130681493,17,50,11,87,1.7416318790419,4.90056014778536,8.05915228029053,101,"ENSG00000079974.19"
"7132","ENSG00000112902.12_482843",482835,482843,9,"ENSG00000112902.12",1,1,"MVVVVVVVV",0,8,0.90600414078675,80,86,102,105,116,122,133,136,"GAGATAA","CTGA","CTGAAGT","CTCA",2.26183324369964,16,11,11,47,2.66153838573431,4.43510666926631,8.05912323241331,101,"ENSG00000079974.19"
"10648","ENSG00000132170.24_96542",96534,96542,9,"ENSG00000132170.24",0,NA,"VVVVVUVVV",1,8,0.922153209109731,110,116,133,136,147,153,161,164,"AGGATTA","GGGA","ATACTTA","CTGA",2.23583567152237,17,11,8,45,2.57626513899442,4.37045907061923,8.05907190705815,101,"ENSG00000079974.19"
"19814","ENSG00000163746.13_24043",24035,24043,9,"ENSG00000163746.13",1,2,"VMVVVVVVV",0,8,0.884057971014493,80,86,98,101,109,115,133,136,"AAAATAA","CAGA","ATGAAAA","CTGA",2.31985572482958,12,8,18,47,2.62562570194296,4.52283263353504,8.05906451759301,101,"ENSG00000079974.19"
"23596","ENSG00000173406.16_1260984",1260976,1260984,9,"ENSG00000173406.16",1,8,"VVVUVVVMV",1,7,0.764803312629399,47,53,68,71,116,122,133,136,"ATGATGA","CTGG","GTGTAGT","CTGA",2.71521517606468,15,45,11,80,1.89786819953682,4.99982567665866,8.05903892717626,101,"ENSG00000079974.19"
"7341","ENSG00000113597.18_36643",36635,36643,9,"ENSG00000113597.18",0,NA,"UVVVVVVVV",1,8,0.902691511387163,19,25,38,41,89,95,133,136,"ATGATGA","CTTA","GTGTTGT","ATGA",2.51479777146626,13,48,38,108,1.02729028277376,4.44815218980388,8.05891823535253,101,"ENSG00000079974.19"
"4027","ENSG00000092148.14_83957",83949,83957,9,"ENSG00000092148.14",0,NA,"VVUVVVVVV",1,8,0.883643892339545,23,29,39,42,82,88,133,136,"ATGTAGA","CTGA","CTAATGA","CTGA",2.57448674636175,10,40,45,104,0.934125427537037,4.5243426008205,8.05891817017868,101,"ENSG00000079974.19"
"21472","ENSG00000167889.13_68238",68230,68238,9,"ENSG00000167889.13",0,NA,"UVVVVVVVV",1,8,0.902691511387163,116,122,133,136,177,183,200,203,"ATAATAA","CTTT","CTGATGA","CTGA",2.41711157534854,11,41,17,78,1.67845269192567,4.44813246522899,8.05889851077764,101,"ENSG00000079974.19"
"26316","ENSG00000183831.7_59668",59660,59668,9,"ENSG00000183831.7",1,5,"VVVVMVVVV",0,8,0.886542443064182,105,111,133,136,151,157,167,170,"GTGAAAA","ATGA","AAGATGA","CTGA",2.42398834660682,22,15,10,56,1.89083282208511,4.51268878319931,8.05885855545604,101,"ENSG00000079974.19"
"45648","ENSG00000285777.1_59654",59646,59654,9,"ENSG00000285777.1",1,5,"VVVVMVVVV",0,8,0.886542443064182,105,111,133,136,151,157,167,170,"GTGAAAA","ATGA","AAGATGA","CTGA",2.42398834660682,22,15,10,56,1.89083282208511,4.51268878319931,8.05885855545604,101,"ENSG00000079974.19"
"261","ENSG00000007129.18_4510",4502,4510,9,"ENSG00000007129.18",1,7,"VVVVVVMVV",0,8,0.885300207039338,113,119,133,136,146,152,165,168,"TTGATTA","GTCA","AAGAAAA","CTGA",2.29275463875444,14,10,13,46,2.78535128930058,4.51759555358255,8.0587963817399,101,"ENSG00000079974.19"
"43071","ENSG00000268027.5_8836",8828,8836,9,"ENSG00000268027.5",1,7,"VVVVVVMVV",0,8,0.885300207039338,113,119,133,136,146,152,165,168,"TTGATTA","GTCA","AAGAAAA","CTGA",2.29275463875444,14,10,13,46,2.78535128930058,4.51759555358255,8.0587963817399,101,"ENSG00000079974.19"
"44574","ENSG00000283072.3_51147",51139,51147,9,"ENSG00000283072.3",1,1,"MVVVVVVVV",0,8,0.90600414078675,91,97,133,136,165,171,186,189,"ATGAAGT","ATGA","GTGAAAA","CTGA",2.52815660272462,36,29,15,89,0.884534380642264,4.43472793303493,8.05874449618193,101,"ENSG00000079974.19"
"44613","ENSG00000283154.3_753482",753474,753482,9,"ENSG00000283154.3",1,1,"MVVVVVVVV",0,8,0.90600414078675,91,97,133,136,165,171,186,189,"ATGAAGT","ATGA","GTGAAAA","CTGA",2.52815660272462,36,29,15,89,0.884534380642264,4.43472793303493,8.05874449618193,101,"ENSG00000079974.19"
"33106","ENSG00000228697.6_53232",53224,53232,9,"ENSG00000228697.6",0,NA,"VVVUVVVVV",1,8,0.880745341614907,43,49,61,64,73,79,133,136,"ATGATTT","ATGA","GTATTGT","CTGA",2.42862765643535,12,9,54,84,1.95165924832839,4.53562757280768,8.05860893926731,101,"ENSG00000079974.19"
"35990","ENSG00000237636.3_18855",18847,18855,9,"ENSG00000237636.3",1,3,"VVMVVUVVV",1,7,0.804968944099379,89,95,133,136,142,148,161,164,"CTGATGA","CTGT","CTGGTTA","CTGA",2.61732975743034,38,6,13,66,1.90589165275231,4.83868917557198,8.05856495196949,101,"ENSG00000079974.19"
"13627","ENSG00000142687.19_78879",78871,78879,9,"ENSG00000142687.19",0,NA,"UVVVVVVVV",1,8,0.902691511387163,61,67,79,82,94,100,133,136,"AGAATGT","CTGA","GTCTTGC","CTGA",2.39237766789372,12,12,33,66,1.84191951762865,4.44777599256337,8.05854203811202,101,"ENSG00000079974.19"
"947","ENSG00000041515.16_285610",285602,285610,9,"ENSG00000041515.16",1,1,"MVVVVVVVV",0,8,0.90600414078675,90,96,133,136,165,171,186,189,"ATGAAGT","ATGA","GTGAAAA","CTGA",2.52815660272462,37,29,15,90,0.88271924969423,4.43427415029792,8.05829071344492,101,"ENSG00000079974.19"
"1926","ENSG00000067798.16_136088",136080,136088,9,"ENSG00000067798.16",1,1,"MVVVVVVVV",0,8,0.90600414078675,90,96,133,136,165,171,186,189,"ATGAAGT","ATGA","GTGAAAA","CTGA",2.52815660272462,37,29,15,90,0.88271924969423,4.43427415029792,8.05829071344492,101,"ENSG00000079974.19"
"5333","ENSG00000104325.7_45101",45093,45101,9,"ENSG00000104325.7",1,1,"MVVVVVVVV",0,8,0.90600414078675,90,96,133,136,165,171,186,189,"ATGAAGT","ATGA","GTGAAAA","CTGA",2.52815660272462,37,29,15,90,0.88271924969423,4.43427415029792,8.05829071344492,101,"ENSG00000079974.19"
"7714","ENSG00000115423.19_147108",147100,147108,9,"ENSG00000115423.19",1,1,"MVVVVVVVV",0,8,0.90600414078675,90,96,133,136,165,171,186,189,"ATGAAGT","ATGA","GTGAAAA","CTGA",2.52815660272462,37,29,15,90,0.88271924969423,4.43427415029792,8.05829071344492,101,"ENSG00000079974.19"
"9040","ENSG00000122420.10_7602",7594,7602,9,"ENSG00000122420.10",1,1,"MVVVVVVVV",0,8,0.90600414078675,90,96,133,136,165,171,186,189,"ATGAAGT","ATGA","GTGAAAA","CTGA",2.52815660272462,37,29,15,90,0.88271924969423,4.43427415029792,8.05829071344492,101,"ENSG00000079974.19"
"11552","ENSG00000135315.12_95103",95095,95103,9,"ENSG00000135315.12",1,1,"MVVVVVVVV",0,8,0.90600414078675,90,96,133,136,165,171,186,189,"ATGAAGT","ATGA","GTGAAAA","CTGA",2.52815660272462,37,29,15,90,0.88271924969423,4.43427415029792,8.05829071344492,101,"ENSG00000079974.19"
"12155","ENSG00000137491.15_20168",20160,20168,9,"ENSG00000137491.15",1,1,"MVVVVVVVV",0,8,0.90600414078675,90,96,133,136,165,171,186,189,"ATGAAGT","ATGA","GTGAAAA","CTGA",2.52815660272462,37,29,15,90,0.88271924969423,4.43427415029792,8.05829071344492,101,"ENSG00000079974.19"
"14096","ENSG00000144407.10_401874",401866,401874,9,"ENSG00000144407.10",1,1,"MVVVVVVVV",0,8,0.90600414078675,90,96,133,136,165,171,186,189,"ATGAAGT","ATGA","GTGAAAA","CTGA",2.52815660272462,37,29,15,90,0.88271924969423,4.43427415029792,8.05829071344492,101,"ENSG00000079974.19"
"16310","ENSG00000151322.20_155069",155061,155069,9,"ENSG00000151322.20",1,1,"MVVVVVVVV",0,8,0.90600414078675,90,96,133,136,165,171,186,189,"ATGAAGT","ATGA","GTGAAAA","CTGA",2.52815660272462,37,29,15,90,0.88271924969423,4.43427415029792,8.05829071344492,101,"ENSG00000079974.19"
"16996","ENSG00000152944.9_18952",18944,18952,9,"ENSG00000152944.9",1,1,"MVVVVVVVV",0,8,0.90600414078675,90,96,133,136,165,171,186,189,"ATGAAGT","ATGA","GTGAAAA","CTGA",2.52815660272462,37,29,15,90,0.88271924969423,4.43427415029792,8.05829071344492,101,"ENSG00000079974.19"
"18109","ENSG00000156136.10_20687",20679,20687,9,"ENSG00000156136.10",1,1,"MVVVVVVVV",0,8,0.90600414078675,90,96,133,136,165,171,186,189,"ATGAAGT","ATGA","GTGAAAA","CTGA",2.52815660272462,37,29,15,90,0.88271924969423,4.43427415029792,8.05829071344492,101,"ENSG00000079974.19"
"20513","ENSG00000164989.17_436851",436843,436851,9,"ENSG00000164989.17",1,1,"MVVVVVVVV",0,8,0.90600414078675,90,96,133,136,165,171,186,189,"ATGAAGT","ATGA","GTGAAAA","CTGA",2.52815660272462,37,29,15,90,0.88271924969423,4.43427415029792,8.05829071344492,101,"ENSG00000079974.19"
"21662","ENSG00000168702.18_1160796",1160788,1160796,9,"ENSG00000168702.18",1,1,"MVVVVVVVV",0,8,0.90600414078675,90,96,133,136,165,171,186,189,"ATGAAGT","ATGA","GTGAAAA","CTGA",2.52815660272462,37,29,15,90,0.88271924969423,4.43427415029792,8.05829071344492,101,"ENSG00000079974.19"
"23688","ENSG00000173542.9_110899",110891,110899,9,"ENSG00000173542.9",1,1,"MVVVVVVVV",0,8,0.90600414078675,90,96,133,136,165,171,186,189,"ATGAAGT","ATGA","GTGAAAA","CTGA",2.52815660272462,37,29,15,90,0.88271924969423,4.43427415029792,8.05829071344492,101,"ENSG00000079974.19"
"25101","ENSG00000179399.15_883592",883584,883592,9,"ENSG00000179399.15",1,1,"MVVVVVVVV",0,8,0.90600414078675,90,96,133,136,165,171,186,189,"ATGAAGT","ATGA","GTGAAAA","CTGA",2.52815660272462,37,29,15,90,0.88271924969423,4.43427415029792,8.05829071344492,101,"ENSG00000079974.19"
"25236","ENSG00000180116.15_121225",121217,121225,9,"ENSG00000180116.15",1,1,"MVVVVVVVV",0,8,0.90600414078675,90,96,133,136,165,171,186,189,"ATGAAGT","ATGA","GTGAAAA","CTGA",2.52815660272462,37,29,15,90,0.88271924969423,4.43427415029792,8.05829071344492,101,"ENSG00000079974.19"
"26480","ENSG00000184305.16_1336426",1336418,1336426,9,"ENSG00000184305.16",1,1,"MVVVVVVVV",0,8,0.90600414078675,90,96,133,136,165,171,186,189,"ATGAAGT","ATGA","GTGAAAA","CTGA",2.52815660272462,37,29,15,90,0.88271924969423,4.43427415029792,8.05829071344492,101,"ENSG00000079974.19"
"26490","ENSG00000184305.16_365836",365828,365836,9,"ENSG00000184305.16",1,1,"MVVVVVVVV",0,8,0.90600414078675,90,96,133,136,165,171,186,189,"ATGAAGT","ATGA","GTGAAAA","CTGA",2.52815660272462,37,29,15,90,0.88271924969423,4.43427415029792,8.05829071344492,101,"ENSG00000079974.19"
"32156","ENSG00000226159.2_21143",21135,21143,9,"ENSG00000226159.2",1,1,"MVVVVVVVV",0,8,0.90600414078675,90,96,133,136,165,171,186,189,"ATGAAGT","ATGA","GTGAAAA","CTGA",2.52815660272462,37,29,15,90,0.88271924969423,4.43427415029792,8.05829071344492,101,"ENSG00000079974.19"
"33187","ENSG00000228980.4_129654",129646,129654,9,"ENSG00000228980.4",1,1,"MVVVVVVVV",0,8,0.90600414078675,90,96,133,136,165,171,186,189,"ATGAAGT","ATGA","GTGAAAA","CTGA",2.52815660272462,37,29,15,90,0.88271924969423,4.43427415029792,8.05829071344492,101,"ENSG00000079974.19"
"34909","ENSG00000234377.8_40315",40307,40315,9,"ENSG00000234377.8",1,1,"MVVVVVVVV",0,8,0.90600414078675,90,96,133,136,165,171,186,189,"ATGAAGT","ATGA","GTGAAAA","CTGA",2.52815660272462,37,29,15,90,0.88271924969423,4.43427415029792,8.05829071344492,101,"ENSG00000079974.19"
"34918","ENSG00000234377.8_607822",607814,607822,9,"ENSG00000234377.8",1,1,"MVVVVVVVV",0,8,0.90600414078675,90,96,133,136,165,171,186,189,"ATGAAGT","ATGA","GTGAAAA","CTGA",2.52815660272462,37,29,15,90,0.88271924969423,4.43427415029792,8.05829071344492,101,"ENSG00000079974.19"
"35211","ENSG00000235350.1_1703",1695,1703,9,"ENSG00000235350.1",1,1,"MVVVVVVVV",0,8,0.90600414078675,90,96,133,136,165,171,186,189,"ATGAAGT","ATGA","GTGAAAA","CTGA",2.52815660272462,37,29,15,90,0.88271924969423,4.43427415029792,8.05829071344492,101,"ENSG00000079974.19"
"35232","ENSG00000235437.10_96087",96079,96087,9,"ENSG00000235437.10",1,1,"MVVVVVVVV",0,8,0.90600414078675,90,96,133,136,165,171,186,189,"ATGAAGT","ATGA","GTGAAAA","CTGA",2.52815660272462,37,29,15,90,0.88271924969423,4.43427415029792,8.05829071344492,101,"ENSG00000079974.19"
"35884","ENSG00000237413.5_81887",81879,81887,9,"ENSG00000237413.5",1,1,"MVVVVVVVV",0,8,0.90600414078675,90,96,133,136,165,171,186,189,"ATGAAGT","ATGA","GTGAAAA","CTGA",2.52815660272462,37,29,15,90,0.88271924969423,4.43427415029792,8.05829071344492,101,"ENSG00000079974.19"
"38296","ENSG00000249899.6_14973",14965,14973,9,"ENSG00000249899.6",1,1,"MVVVVVVVV",0,8,0.90600414078675,90,96,133,136,165,171,186,189,"ATGAAGT","ATGA","GTGAAAA","CTGA",2.52815660272462,37,29,15,90,0.88271924969423,4.43427415029792,8.05829071344492,101,"ENSG00000079974.19"
"40103","ENSG00000254987.1_75762",75754,75762,9,"ENSG00000254987.1",1,1,"MVVVVVVVV",0,8,0.90600414078675,90,96,133,136,165,171,186,189,"ATGAAGT","ATGA","GTGAAAA","CTGA",2.52815660272462,37,29,15,90,0.88271924969423,4.43427415029792,8.05829071344492,101,"ENSG00000079974.19"
"40601","ENSG00000257095.1_7446",7438,7446,9,"ENSG00000257095.1",1,1,"MVVVVVVVV",0,8,0.90600414078675,90,96,133,136,165,171,186,189,"ATGAAGT","ATGA","GTGAAAA","CTGA",2.52815660272462,37,29,15,90,0.88271924969423,4.43427415029792,8.05829071344492,101,"ENSG00000079974.19"
"41912","ENSG00000259986.2_43796",43788,43796,9,"ENSG00000259986.2",1,1,"MVVVVVVVV",0,8,0.90600414078675,90,96,133,136,165,171,186,189,"ATGAAGT","ATGA","GTGAAAA","CTGA",2.52815660272462,37,29,15,90,0.88271924969423,4.43427415029792,8.05829071344492,101,"ENSG00000079974.19"
"44834","ENSG00000283692.2_387380",387372,387380,9,"ENSG00000283692.2",1,1,"MVVVVVVVV",0,8,0.90600414078675,90,96,133,136,165,171,186,189,"ATGAAGT","ATGA","GTGAAAA","CTGA",2.52815660272462,37,29,15,90,0.88271924969423,4.43427415029792,8.05829071344492,101,"ENSG00000079974.19"
"46504","ENSG00000286749.1_212816",212808,212816,9,"ENSG00000286749.1",1,1,"MVVVVVVVV",0,8,0.90600414078675,90,96,133,136,165,171,186,189,"ATGAAGT","ATGA","GTGAAAA","CTGA",2.52815660272462,37,29,15,90,0.88271924969423,4.43427415029792,8.05829071344492,101,"ENSG00000079974.19"
"4035","ENSG00000092345.14_67764",67756,67764,9,"ENSG00000092345.14",1,3,"VVMVVVVVV",0,8,0.882815734989648,87,93,104,107,109,115,133,136,"TTGATGA","CTTA","ATGCTGT","TTGA",2.39080480938557,11,2,18,40,2.16921713251291,4.52697896543751,8.05824190539611,101,"ENSG00000079974.19"
"38585","ENSG00000250519.7_22652",22644,22652,9,"ENSG00000250519.7",0,NA,"VVVVVUVVV",1,8,0.922153209109731,63,69,86,89,91,97,133,136,"ATGGTGA","CTGG","GTGAAGA","CAGA",2.42311566069968,17,2,36,64,1.32431281147438,4.36960430403473,8.05821714047365,101,"ENSG00000079974.19"
"14826","ENSG00000145934.17_566074",566066,566074,9,"ENSG00000145934.17",0,NA,"VVVUVVVVV",1,8,0.880745341614907,113,119,133,136,146,152,166,169,"GTTATGC","GAGA","CTGAGAA","CTGA",2.31063716650739,14,10,14,47,2.73623958476761,4.53512184037089,8.05810320683051,101,"ENSG00000079974.19"
"43660","ENSG00000273079.7_71197",71189,71197,9,"ENSG00000273079.7",1,2,"VMVVVVVVV",0,8,0.884057971014493,114,120,133,136,152,158,171,174,"GAGATGA","ATGA","ATGATCA","CTAA",2.3524660046573,13,16,13,51,2.40385960744087,4.52174157628905,8.05797346034702,101,"ENSG00000079974.19"
"20765","ENSG00000165591.7_181858",181850,181858,9,"ENSG00000165591.7",1,1,"MVVVVVVVV",0,8,0.90600414078675,89,95,133,136,165,171,186,189,"ATGAAGT","ATGA","GTGAAAA","CTGA",2.52815660272462,38,29,15,91,0.881429187361973,4.43395163471486,8.05796819786186,101,"ENSG00000079974.19"
"33174","ENSG00000228956.9_363950",363942,363950,9,"ENSG00000228956.9",1,2,"VMVVVVVVV",0,8,0.884057971014493,92,98,133,136,144,150,159,162,"AAGATGA","CAAA","GAGATAT","CTGA",2.41394163451301,35,8,9,61,1.99385260403745,4.52169920853104,8.05793109258901,101,"ENSG00000079974.19"
"26532","ENSG00000184371.14_7231",7223,7231,9,"ENSG00000184371.14",0,NA,"VVVVUUVVV",2,7,0.812008281573499,81,87,106,109,115,121,133,136,"CTGAAGA","ATGA","ATGACAA","CTGA",2.50749234725532,19,6,12,46,2.52282050316678,4.80985903788389,8.05789216417789,101,"ENSG00000079974.19"
"33553","ENSG00000230289.1_5095",5087,5095,9,"ENSG00000230289.1",1,8,"VVVVVUVMV",1,7,0.806211180124224,71,77,91,94,106,112,133,136,"ATGAGGA","CTGT","GGGCTGA","CTGA",2.57129666982615,14,12,21,56,2.19005758191631,4.83300884518933,8.05785356568623,101,"ENSG00000079974.19"
"16023","ENSG00000150637.9_23062",23054,23062,9,"ENSG00000150637.9",1,7,"VVVVVUMVV",1,7,0.807453416149068,88,94,133,136,141,147,158,161,"ATGGTGA","CTAA","AGGATGA","CTGA",2.60890446191597,39,5,11,64,1.91927462198574,4.82799275868971,8.05780642328599,101,"ENSG00000079974.19"
"40983","ENSG00000258231.5_188106",188098,188106,9,"ENSG00000258231.5",0,NA,"UVVVVVVVV",1,8,0.902691511387163,88,94,133,136,146,152,203,206,"ATGAGGA","CTGT","ATGCATA","CTGA",2.5328676157721,39,10,51,109,0.902311757917121,4.44702396576611,8.05779001131477,101,"ENSG00000079974.19"
"37246","ENSG00000246316.8_13028",13020,13028,9,"ENSG00000246316.8",0,NA,"VVUVVVVVV",1,8,0.883643892339545,113,119,133,136,186,192,207,210,"ATGATAA","CTGA","CTGCTGT","CTCA",2.44664866073983,14,50,15,88,1.78185919760285,4.52321256730043,8.05778813665861,101,"ENSG00000079974.19"
"15511","ENSG00000148541.13_39678",39670,39678,9,"ENSG00000148541.13",1,1,"MVVVVVUVV",1,7,0.792132505175983,109,115,133,136,179,185,193,196,"CTGATGT","CTGA","GTGCAGA","CTGA",2.68597293482615,18,43,8,78,1.6504906425012,4.88924421866888,8.05777423937281,101,"ENSG00000079974.19"
"16991","ENSG00000152936.11_210409",210401,210409,9,"ENSG00000152936.11",1,8,"VVVVVVVMV",0,8,0.884057971014493,8,14,27,30,73,79,133,136,"AAGATCA","CTGA","GTCAAGA","CTGA",2.56281262516928,13,43,54,119,1.00063356495966,4.52151276652204,8.05774465058001,101,"ENSG00000079974.19"
"41626","ENSG00000259374.2_912",904,912,9,"ENSG00000259374.2",1,8,"VVVVVVVMV",0,8,0.884057971014493,91,97,133,136,151,157,170,173,"ATGTTGA","CAGT","GTGGTGT","CTGA",2.49101452963828,36,15,13,73,1.47905419628974,4.5214544318029,8.05768631586088,101,"ENSG00000079974.19"
"9481","ENSG00000124788.19_460513",460505,460513,9,"ENSG00000124788.19",0,NA,"VVUVVVVVV",1,8,0.883643892339545,82,88,133,136,147,153,183,186,"ATGATCA","CTTA","ATGCTTA","CTGA",2.5694822699581,45,11,30,95,0.962010727272346,4.52297313174826,8.05754870110643,101,"ENSG00000079974.19"
"11751","ENSG00000135972.9_39974",39966,39974,9,"ENSG00000135972.9",1,8,"VVVVVVVMV",0,8,0.884057971014493,84,90,133,136,139,145,155,158,"GTAATGA","CTGC","ATTAAAA","CTGA",2.45756680137852,43,3,10,65,1.70129094689785,4.52126740568866,8.05749928974663,101,"ENSG00000079974.19"
"12547","ENSG00000138639.18_394581",394573,394581,9,"ENSG00000138639.18",1,7,"VVUVVVMVV",1,7,0.768944099378882,115,121,133,136,152,158,168,171,"ATGATCT","CTGA","GTGTTAA","CTGA",2.61529073842721,12,16,10,47,2.49154367973466,4.98170381731234,8.05748021482787,101,"ENSG00000079974.19"
"13141","ENSG00000140386.13_412086",412078,412086,9,"ENSG00000140386.13",1,2,"VMVVVVVVV",0,8,0.884057971014493,99,105,133,136,151,157,174,177,"ATTAGGA","TTGA","TTGAAGA","CTGA",2.51329690069144,28,15,17,69,1.32942450212031,4.52118429334915,8.05741617740712,101,"ENSG00000079974.19"
"35379","ENSG00000235885.8_219120",219112,219120,9,"ENSG00000235885.8",1,1,"MVVVVVVVV",0,8,0.90600414078675,115,121,133,136,140,146,161,164,"ATGATTA","TGGA","CTCATGA","CTTA",2.2567384904486,12,4,15,40,2.68813347869659,4.43326418708847,8.05728075023547,101,"ENSG00000079974.19"
"35696","ENSG00000236780.7_91748",91740,91748,9,"ENSG00000236780.7",1,1,"MVVVVVVVV",0,8,0.90600414078675,115,121,133,136,140,146,161,164,"ATGATTA","TGGA","CTCATGA","CTTA",2.2567384904486,12,4,15,40,2.68813347869659,4.43326418708847,8.05728075023547,101,"ENSG00000079974.19"
"24542","ENSG00000176771.18_833844",833836,833844,9,"ENSG00000176771.18",1,5,"VVVVMVVVV",0,8,0.886542443064182,83,89,133,136,141,147,191,194,"ATGAAGA","CCAA","TTGATGA","CTGA",2.56545983638317,44,5,44,102,0.940945574522316,4.51100278760254,8.05717255985926,101,"ENSG00000079974.19"
"1869","ENSG00000066855.16_121827",121819,121827,9,"ENSG00000066855.16",0,NA,"VVVVVUVVV",1,8,0.922153209109731,88,94,105,108,113,119,133,136,"ATGATGC","GGGA","GTTAGAA","CTGG",2.19773205758734,11,5,14,39,2.82242244801047,4.36849237464818,8.0571052110871,101,"ENSG00000079974.19"
"33034","ENSG00000228566.2_240249",240241,240249,9,"ENSG00000228566.2",1,8,"VVVVVVVMV",0,8,0.884057971014493,113,119,133,136,152,158,179,182,"GTGGTGC","ATGA","ATGTGGA","CTGA",2.42560094411965,14,16,21,60,1.91281586387973,4.52087220616935,8.05710409022732,101,"ENSG00000079974.19"
"726","ENSG00000028277.22_76757",76749,76757,9,"ENSG00000028277.22",1,8,"VVVVVVVMV",0,8,0.884057971014493,70,76,95,98,105,111,133,136,"ATGGTAA","CAGA","AAGATAA","CTGA",2.41481837670164,19,7,22,57,1.98441370621092,4.52080072105546,8.05703260511343,101,"ENSG00000079974.19"
"4150","ENSG00000095787.25_51268",51260,51268,9,"ENSG00000095787.25",1,6,"VVVVVMVVV",0,8,0.902691511387163,111,117,133,136,146,152,175,178,"ATTAGGA","ATGT","GTGATAT","CTGA",2.35354273162876,16,10,23,58,2.0947778938448,4.44626569284247,8.05703173839112,101,"ENSG00000079974.19"
"10571","ENSG00000131626.19_10525",10517,10525,9,"ENSG00000131626.19",0,NA,"VVVVVUVVV",1,8,0.922153209109731,113,119,133,136,137,143,154,157,"ATGAAAA","CTGG","GTGATGC","CAGA",2.25999595357194,14,1,11,35,2.40702554606848,4.36841630913703,8.05702914557595,101,"ENSG00000079974.19"
"16032","ENSG00000150667.8_75554",75546,75554,9,"ENSG00000150667.8",1,8,"VVVVVVVMV",0,8,0.884057971014493,116,122,133,136,182,188,201,204,"AAGATGA","ATGG","ATGGAGC","CTGA",2.42806560281798,11,46,13,79,1.89602581918196,4.52078245949212,8.05701434355009,101,"ENSG00000079974.19"
"22555","ENSG00000170820.12_173521",173513,173521,9,"ENSG00000170820.12",1,8,"VVVVVVVMV",0,8,0.884057971014493,62,68,78,81,87,93,133,136,"ATTTTGA","TTGA","TTGATCC","CTGA",2.423891764698,10,6,40,65,1.92355055958277,4.5207072477257,8.05693913178367,101,"ENSG00000079974.19"
"44226","ENSG00000279847.3_2130",2122,2130,9,"ENSG00000279847.3",0,NA,"VVVVUVVVV",1,8,0.889855072463768,103,109,133,136,143,149,199,202,"ATTATGA","ATGT","TTGATTA","CTGA",2.51540120928426,24,7,50,90,1.22048503487751,4.49745660752648,8.05687689738155,101,"ENSG00000079974.19"
"15860","ENSG00000149972.12_475457",475449,475457,9,"ENSG00000149972.12",1,3,"VVMVVVVVV",0,8,0.882815734989648,86,92,104,107,113,119,133,136,"ATGATTT","CAGA","AGGATGA","TTGA",2.28343255100675,12,6,14,41,2.87948946421436,4.52559328439817,8.05685622435677,101,"ENSG00000079974.19"
"4748","ENSG00000101846.9_590420",590412,590420,9,"ENSG00000101846.9",1,5,"VVVVMVVVV",0,8,0.886542443064182,110,116,133,136,138,144,153,156,"ATAATCT","CTCA","GTGAGGC","CTGA",2.3526971523304,17,2,9,37,2.35770501516269,4.51058817434134,8.05675794659807,101,"ENSG00000079974.19"
"6072","ENSG00000107902.14_130669",130661,130669,9,"ENSG00000107902.14",1,8,"VVVVVVUMV",1,7,0.770186335403727,63,69,83,86,95,101,133,136,"ATGATGA","CTGG","ATGAGTC","CTGA",2.68480977065927,14,9,32,64,2.00482910595128,4.9758902275866,8.05663556920151,101,"ENSG00000079974.19"
"23976","ENSG00000174607.11_71862",71854,71862,9,"ENSG00000174607.11",1,2,"VMVVVVVVV",0,8,0.884057971014493,68,74,87,90,98,104,133,136,"ATGATTA","CAGA","TTGATAA","CTTA",2.39255966049223,13,8,29,59,2.1311853990133,4.52039578390704,8.05662766796502,101,"ENSG00000079974.19"
"41728","ENSG00000259628.1_64562",64554,64562,9,"ENSG00000259628.1",1,6,"VVVVVMVVV",0,8,0.902691511387163,100,106,133,136,156,162,176,179,"ATTATGA","TTGC","CTGTGGA","CTGA",2.47969409650815,27,20,14,70,1.25203546343511,4.44583236003904,8.05659840558769,101,"ENSG00000079974.19"
"23814","ENSG00000174306.22_93430",93422,93430,9,"ENSG00000174306.22",1,1,"MVVVVVVVV",0,8,0.90600414078675,65,71,88,91,108,114,133,136,"ATGATCT","CTGA","TTGATGC","TTGA",2.3957866361106,17,17,19,62,1.75837757865375,4.43257212151444,8.05658868466144,101,"ENSG00000079974.19"
"41784","ENSG00000259719.6_22161",22153,22161,9,"ENSG00000259719.6",1,5,"VVVVMVVVV",0,8,0.886542443064182,69,75,86,89,103,109,133,136,"AGGGTGA","CAGA","GTGAGTG","CTGA",2.41949195907017,11,14,24,58,1.91139939542426,4.51033644730635,8.05650621956308,101,"ENSG00000079974.19"
"17979","ENSG00000155966.14_42995",42987,42995,9,"ENSG00000155966.14",0,NA,"VVVVVUVVV",1,8,0.922153209109731,87,93,107,110,115,121,133,136,"GTGATTT","ATGA","ATGCTGT","CAGA",2.18775336947448,14,5,12,40,2.88653824664236,4.36789017745139,8.05650301389032,101,"ENSG00000079974.19"
"33784","ENSG00000231171.4_200783",200775,200783,9,"ENSG00000231171.4",1,1,"MVVVVVVVV",0,8,0.90600414078675,85,91,133,136,148,154,162,165,"ATGATTT","CTGA","TTGATAA","ATGA",2.39746954554867,42,12,8,71,1.74667752434633,4.43245195700104,8.05646852014804,101,"ENSG00000079974.19"
"20408","ENSG00000164796.18_574217",574209,574217,9,"ENSG00000164796.18",1,6,"VVVVVMVVV",0,8,0.902691511387163,111,117,133,136,147,153,179,182,"ATAATAA","CAAA","TTGAAGA","CTGA",2.38101704840608,16,11,26,62,1.90931333192623,4.44569008032502,8.05645612587368,101,"ENSG00000079974.19"
"17562","ENSG00000154447.15_170180",170172,170180,9,"ENSG00000154447.15",1,1,"MVVVVVVVV",0,8,0.90600414078675,97,103,133,136,141,147,169,172,"GTGGTGA","ATTA","CTGATCA","CTGA",2.45205061284561,30,5,22,66,1.38260992937689,4.43240350375357,8.05642006690057,101,"ENSG00000079974.19"
"30253","ENSG00000204334.8_31966",31958,31966,9,"ENSG00000204334.8",1,8,"VVVVVUVMV",1,7,0.806211180124224,94,100,133,136,138,144,157,160,"GTGATGA","ATGA","GAGCTGA","CTGA",2.67973242431191,33,2,13,57,1.46125204440878,4.83153371828871,8.0563784387856,101,"ENSG00000079974.19"
"38453","ENSG00000250198.5_45094",45086,45094,9,"ENSG00000250198.5",1,1,"MVVVVVVVV",0,8,0.90600414078675,112,118,133,136,142,148,156,159,"ACCATGA","CAGA","ATGTTGT","ATGA",2.21941291509778,15,6,8,38,2.93326392823231,4.43233750722105,8.05635407036804,101,"ENSG00000079974.19"
"935","ENSG00000040933.16_43746",43738,43746,9,"ENSG00000040933.16",1,1,"MVVVVVVVV",0,8,0.90600414078675,109,115,133,136,142,148,163,166,"ATGGTGG","CTTG","ATGAGTT","CTGA",2.28901995837281,18,6,15,48,2.46909348389097,4.43230663492743,8.05632319807443,101,"ENSG00000079974.19"
"42882","ENSG00000267270.8_2356",2348,2356,9,"ENSG00000267270.8",1,8,"VVVVVVVMV",0,8,0.884057971014493,115,121,133,136,143,149,168,171,"TTGTTGA","TTAA","ATGTAGC","CTGA",2.32529745446497,12,7,19,47,2.57820166525888,4.52004617375634,8.05627805781431,101,"ENSG00000079974.19"
"5774","ENSG00000106617.15_19893",19885,19893,9,"ENSG00000106617.15",1,8,"VVVVVVVMV",0,8,0.884057971014493,70,76,89,92,106,112,133,136,"GTGATCT","CTGG","GTCCTGA","CTGA",2.40017096150785,13,14,21,57,2.07871059647307,4.51996258496468,8.05619446902265,101,"ENSG00000079974.19"
"25271","ENSG00000180287.17_372917",372909,372917,9,"ENSG00000180287.17",1,1,"MVVVVVVVV",0,8,0.90600414078675,108,114,133,136,148,154,165,168,"AAGCTGA","TTAA","TTGAGTA","CTGA",2.30996451611024,19,12,11,51,2.32893815951228,4.43217540006181,8.05619196320881,101,"ENSG00000079974.19"
"39353","ENSG00000253503.6_31131",31123,31131,9,"ENSG00000253503.6",1,2,"VMVVVVVVV",0,8,0.884057971014493,112,118,133,136,149,155,165,168,"ATGAAGC","AAGA","GGGAGGT","CTGA",2.32101808295674,15,13,10,47,2.60638116151698,4.51995876197382,8.05619064603179,101,"ENSG00000079974.19"
"17251","ENSG00000153707.19_552608",552600,552608,9,"ENSG00000153707.19",0,NA,"VVVVVUVVV",1,8,0.922153209109731,104,110,133,136,158,164,178,181,"GTAATGA","TTGT","TTGTGGA","CTGA",2.41829843805274,23,22,14,68,1.34789331213027,4.36747072478713,8.05608356122606,101,"ENSG00000079974.19"
"1062","ENSG00000047346.13_1092",1084,1092,9,"ENSG00000047346.13",0,NA,"VVVVUVVVV",1,8,0.889855072463768,99,105,133,136,147,153,164,167,"ATTATGA","CTGA","TTTTTGA","CAGA",2.4131596208001,28,11,11,59,1.89882213233414,4.49663823441704,8.05605852427211,101,"ENSG00000079974.19"
"22139","ENSG00000169862.21_656221",656213,656221,9,"ENSG00000169862.21",1,2,"VMVVVVVVV",0,8,0.884057971014493,109,115,133,136,141,147,156,159,"CTGATAT","CTGC","ATGTTCT","CTGA",2.31864559364997,18,5,9,41,2.62060803478981,4.51956133144741,8.05579321550537,101,"ENSG00000079974.19"
"5690","ENSG00000106299.8_19526",19518,19526,9,"ENSG00000106299.8",1,8,"VVVVVVVMV",0,8,0.884057971014493,95,101,133,136,144,150,194,197,"ATTATGT","CTGA","CAGGTGA","CTGA",2.55885876614088,32,8,44,93,1.0191676774897,4.51955652960722,8.05578841366519,101,"ENSG00000079974.19"
"927","ENSG00000040731.10_60203",60195,60203,9,"ENSG00000040731.10",1,1,"MVVVVVVVV",0,8,0.90600414078675,72,78,92,95,111,117,133,136,"ATGATGA","CAGA","ATGATGT","ATGT",2.32735417341175,14,16,16,55,2.2110983432234,4.43169820815876,8.05571477130576,101,"ENSG00000079974.19"
"36403","ENSG00000240499.7_4090",4082,4090,9,"ENSG00000240499.7",0,NA,"UVVVVVVVV",1,8,0.902691511387163,114,120,133,136,141,147,187,190,"ATGAAAA","CTAA","GGGAAGG","CTGA",2.37483880884229,13,5,40,67,1.94752596293282,4.44494617213702,8.05571221768567,101,"ENSG00000079974.19"
"29587","ENSG00000198369.10_37135",37127,37135,9,"ENSG00000198369.10",1,1,"MVVVVUVVV",1,7,0.82815734989648,108,114,133,136,143,149,163,166,"GTGATGC","ATGG","GTGAGGG","CTGA",2.47837292319411,19,7,14,49,2.44938442174101,4.7429676440921,8.05559704367802,101,"ENSG00000079974.19"
"26849","ENSG00000185053.14_1133444",1133436,1133444,9,"ENSG00000185053.14",0,NA,"UVVVVVVVV",1,8,0.902691511387163,101,107,133,136,150,156,180,183,"TTGAAGA","ATGA","GTGCTCA","CTGA",2.50635300881667,26,14,24,73,1.07023328405435,4.44481333570803,8.05557938125669,101,"ENSG00000079974.19"
"38950","ENSG00000251326.2_3352",3344,3352,9,"ENSG00000251326.2",0,NA,"UVVUVVVVV",2,7,0.78343685300207,104,110,133,136,147,153,166,169,"ATGATGA","ATTA","GTGGGGA","CTGA",2.64899642289348,23,11,13,56,2.02723363849298,4.92180244777905,8.05554985978733,101,"ENSG00000079974.19"
"36544","ENSG00000241743.4_159125",159117,159125,9,"ENSG00000241743.4",1,8,"VVVVVVVMV",0,8,0.884057971014493,116,122,133,136,150,156,211,214,"ACGATGA","TTGT","TTGAGTA","CTGA",2.47179966113538,11,14,55,89,1.59832664460225,4.51924776304287,8.05547964710084,101,"ENSG00000079974.19"
"46259","ENSG00000286385.1_189676",189668,189676,9,"ENSG00000286385.1",1,1,"MVVVVUVVV",1,7,0.82815734989648,99,105,111,114,115,121,133,136,"GTGATGA","GTGG","ATGTTTG","CTGA",2.50310169079366,6,1,12,28,2.28402815152962,4.74284318920517,8.05547258879109,101,"ENSG00000079974.19"
"41838","ENSG00000259841.6_1379",1371,1379,9,"ENSG00000259841.6",1,6,"VVVVVMVVV",0,8,0.902691511387163,102,108,133,136,183,189,206,209,"ATTATGA","CTCA","GTGACTC","CTGA",2.53610381896528,25,47,17,98,0.87113252368823,4.44462282919752,8.05538887474618,101,"ENSG00000079974.19"
"21469","ENSG00000167889.13_11225",11217,11225,9,"ENSG00000167889.13",0,NA,"VVVVVUVVV",1,8,0.922153209109731,113,119,133,136,150,156,173,176,"CTGTGGA","GTGG","CTGATGT","CTGA",2.27737767593547,14,14,17,54,2.2843951899087,4.36672825736962,8.05534109380855,101,"ENSG00000079974.19"
"27145","ENSG00000185634.12_123702",123694,123702,9,"ENSG00000185634.12",1,1,"MVVVVVVVV",0,8,0.90600414078675,50,56,68,71,113,119,133,136,"TTGATTT","CTGT","ATGCTGT","CTGA",2.37731826569867,12,42,14,77,1.87641926009988,4.43130192452275,8.05531848766975,101,"ENSG00000079974.19"
"16485","ENSG00000151690.15_81163",81155,81163,9,"ENSG00000151690.15",0,NA,"VVUVVVUVV",2,7,0.769772256728778,86,92,104,107,113,119,133,136,"ATGAAGA","TTGA","ATGAGTC","CTGA",2.55381151331041,12,6,14,41,2.87948946421436,4.97622488823761,8.05531391515273,101,"ENSG00000079974.19"
"7015","ENSG00000112530.12_171150",171142,171150,9,"ENSG00000112530.12",1,8,"VVVVUVVMV",1,7,0.773913043478261,64,70,104,107,113,119,133,136,"ATAATGA","CTGA","TTGCTGT","CTGA",2.69569411728242,34,6,14,63,1.86726281924797,4.95963923361603,8.05529140752907,101,"ENSG00000079974.19"
"12662","ENSG00000138764.15_187764",187756,187764,9,"ENSG00000138764.15",0,NA,"VVUVVVVVV",1,8,0.883643892339545,108,114,133,136,144,150,204,207,"CTAATGA","CTAA","ATGGTCA","CTGA",2.47776580296768,19,8,54,90,1.5644201782253,4.52071471616912,8.0552902855273,101,"ENSG00000079974.19"
"37523","ENSG00000248371.5_74330",74322,74330,9,"ENSG00000248371.5",1,8,"VVVVVVVMV",0,8,0.884057971014493,78,84,96,99,114,120,133,136,"ATAATGT","CTGA","TTGCTGT","CTCA",2.34024702710196,12,15,13,49,2.47430530169348,4.51898803725997,8.05521992131794,101,"ENSG00000079974.19"
"45916","ENSG00000286046.1_224603",224595,224603,9,"ENSG00000286046.1",1,6,"VVVVVMVVV",0,8,0.902691511387163,69,75,92,95,104,110,133,136,"TGGATGT","TTGG","GTGATAA","CTGA",2.35703231364792,17,9,23,58,2.06424737200562,4.4444490324146,8.05521507796325,101,"ENSG00000079974.19"
"34533","ENSG00000233290.4_86683",86675,86683,9,"ENSG00000233290.4",1,8,"VVVVVVVMV",0,8,0.884057971014493,84,90,133,136,141,147,163,166,"ATTATGA","GTGG","CTGCTGG","CTGA",2.45781127423031,43,5,16,73,1.69045842758229,4.51896673061275,8.05519861467072,101,"ENSG00000079974.19"
"25515","ENSG00000182050.14_490255",490247,490255,9,"ENSG00000182050.14",1,3,"VVMVVVVVV",0,8,0.882815734989648,116,122,133,136,142,148,164,167,"TACATGA","CAAA","GTGATGC","CTGA",2.30417622557902,11,6,16,42,2.73454992187137,4.52393118976621,8.0551941297248,101,"ENSG00000079974.19"
"4965","ENSG00000102468.11_46753",46745,46753,9,"ENSG00000102468.11",1,6,"VVVVVMVVV",0,8,0.902691511387163,67,73,86,89,100,106,133,136,"GTGATAA","CTCA","GTGAGGA","CTTA",2.36150694067001,13,11,27,60,2.03425866018871,4.44440956616386,8.05517561171251,101,"ENSG00000079974.19"
"39766","ENSG00000254186.3_461761",461753,461761,9,"ENSG00000254186.3",0,NA,"VVVVVVUVV",1,8,0.886128364389234,108,114,133,136,141,147,159,162,"AAAATGA","TTGG","CTGAGGC","CTGA",2.33550349610419,19,5,12,45,2.47238119257838,4.51060112498491,8.05511458254185,101,"ENSG00000079974.19"
"18790","ENSG00000158486.15_51893",51885,51893,9,"ENSG00000158486.15",1,7,"VVVVVVMVV",0,8,0.885300207039338,98,104,133,136,147,153,205,208,"ATGAGGA","ATGA","GTGCGGT","CTGA",2.57405349423504,29,11,52,101,0.89527988110135,4.51390912733374,8.05510995549109,101,"ENSG00000079974.19"
"27040","ENSG00000185477.5_11483",11475,11483,9,"ENSG00000185477.5",1,8,"VVVVVVVMV",0,8,0.884057971014493,74,80,91,94,106,112,133,136,"AGGATGA","CTGT","GTGAAAA","GTGA",2.38108694657457,11,12,21,53,2.20111816010627,4.51875778431752,8.05498966837549,101,"ENSG00000079974.19"
"18948","ENSG00000159459.12_150573",150565,150573,9,"ENSG00000159459.12",1,5,"UVVVMVVVV",1,7,0.789233954451346,113,119,133,136,140,146,168,171,"ATGATGA","GTAA","GTAATTA","CTGA",2.60725030020634,14,4,22,49,2.21045555887487,4.89803105672928,8.05496687453466,101,"ENSG00000079974.19"
"45118","ENSG00000285051.2_268215",268207,268215,9,"ENSG00000285051.2",1,1,"MVVVVVVVV",0,8,0.90600414078675,112,118,133,136,149,155,172,175,"ATGAGGA","TTTA","ATGAAGA","ATGA",2.31326396062401,15,13,17,54,2.3013306921513,4.43077260741118,8.05478917055818,101,"ENSG00000079974.19"
"45201","ENSG00000285218.1_297986",297978,297986,9,"ENSG00000285218.1",1,1,"MVVVVVVVV",0,8,0.90600414078675,112,118,133,136,149,155,172,175,"ATGAGGA","TTTA","ATGAAGA","ATGA",2.31326396062401,15,13,17,54,2.3013306921513,4.43077260741118,8.05478917055818,101,"ENSG00000079974.19"
"12660","ENSG00000138760.11_7835",7827,7835,9,"ENSG00000138760.11",1,5,"VVVVMVVVV",0,8,0.886542443064182,83,89,133,136,147,153,162,165,"CTGATTA","GTGA","GTATTGG","CTGA",2.42996884273448,44,11,9,73,1.83404635997611,4.50845966121816,8.05462943347488,101,"ENSG00000079974.19"
"4024","ENSG00000092108.22_70092",70084,70092,9,"ENSG00000092108.22",1,6,"UVVVVMVVV",1,7,0.805383022774327,113,119,133,136,144,150,158,161,"ATGATGA","CTGT","CAGATAA","ATGA",2.45353400848551,14,8,8,39,2.97548754499619,4.8330952337249,8.05462732482221,101,"ENSG00000079974.19"
"36132","ENSG00000237978.6_202424",202416,202424,9,"ENSG00000237978.6",1,1,"MVVVVVUVV",1,7,0.792132505175983,70,76,87,90,114,120,133,136,"ATGATGA","CTGA","TTTATGA","CTTA",2.62554295366795,11,24,13,57,2.04060477451987,4.88605611640989,8.05458613711382,101,"ENSG00000079974.19"
"36386","ENSG00000240405.7_352434",352426,352434,9,"ENSG00000240405.7",1,5,"VVVVMVVVV",0,8,0.886542443064182,80,86,98,101,104,110,133,136,"ATGATTT","CAGA","AAAAAGA","CTGA",2.39567313980984,12,3,23,47,2.06249854527208,4.50841320266775,8.05458297492448,101,"ENSG00000079974.19"
"8186","ENSG00000117139.18_8711",8703,8711,9,"ENSG00000117139.18",1,3,"VVMVVVVVV",0,8,0.882815734989648,74,80,95,98,110,116,133,136,"ATAATGA","TTGA","ATGGTAA","GTGA",2.35796738448177,15,12,17,53,2.37310739038926,4.52322248840026,8.05448542835885,101,"ENSG00000079974.19"
"21382","ENSG00000167323.13_65144",65136,65144,9,"ENSG00000167323.13",1,6,"VVVVVMVVV",0,8,0.902691511387163,68,74,89,92,113,119,133,136,"GTGATGA","CTAA","ATGGTAC","GTGA",2.36334518259809,15,21,14,59,2.01918804781801,4.44370564961798,8.05447169516663,101,"ENSG00000079974.19"
"43603","ENSG00000272701.3_1843",1835,1843,9,"ENSG00000272701.3",0,NA,"VVVVVUVVV",1,8,0.922153209109731,90,96,102,105,109,115,133,136,"ATGATAA","CAGA","GTGCAAA","CTGC",2.31348763144887,6,4,18,37,2.04011713633172,4.36584200316438,8.05445483960331,101,"ENSG00000079974.19"
"10612","ENSG00000131848.10_32102",32094,32102,9,"ENSG00000131848.10",1,1,"MVVVVVVVV",0,8,0.90600414078675,73,79,90,93,97,103,133,136,"AAGATGA","ATGA","GAGAAGA","ATGA",2.36735090937879,11,4,30,54,1.93924525075729,4.43039616165397,8.05441272480097,101,"ENSG00000079974.19"
"7012","ENSG00000112530.12_120761",120753,120761,9,"ENSG00000112530.12",0,NA,"VVVVUVUVV",2,7,0.775983436853002,89,95,133,136,143,149,159,162,"ATGTTGA","CTGA","TTAAGGA","CTGA",2.66976679175647,38,7,10,64,2.00292035814552,4.9503414091305,8.0542751565425,101,"ENSG00000079974.19"
"42739","ENSG00000266202.1_28682",28674,28682,9,"ENSG00000266202.1",1,8,"VVVVVVVMV",0,8,0.884057971014493,113,119,133,136,145,151,187,190,"ATTATGA","CATA","GTACAGA","CTGA",2.41702126645031,14,9,36,68,1.95857970165577,4.51801370283113,8.0542455868891,101,"ENSG00000079974.19"
"10515","ENSG00000131374.15_925560",925552,925560,9,"ENSG00000131374.15",1,8,"VVVVVVVMV",0,8,0.884057971014493,81,87,97,100,116,122,133,136,"ATGGTGC","CTTA","GACATTA","CTGA",2.35109824108095,10,16,11,46,2.39783884146822,4.51795677883531,8.05418866289328,101,"ENSG00000079974.19"
"2507","ENSG00000075391.18_250099",250091,250099,9,"ENSG00000075391.18",0,NA,"VVVUVVVVV",1,8,0.880745341614907,110,116,133,136,140,146,156,159,"ATTTTCA","CTGC","GTAATGA","CTGA",2.32484147283897,17,4,10,40,2.6258528981385,4.53119901259958,8.0541803790592,101,"ENSG00000079974.19"
"28396","ENSG00000189056.15_119399",119391,119399,9,"ENSG00000189056.15",1,8,"VVVVVVVMV",0,8,0.884057971014493,115,121,133,136,147,153,167,170,"ATCATCA","TTCA","GTCCTGA","CTGA",2.30414761545866,12,11,14,46,2.71072431024414,4.51792710332548,8.05415898738345,101,"ENSG00000079974.19"
"35165","ENSG00000235166.8_166600",166592,166600,9,"ENSG00000235166.8",0,NA,"VVUVVVVVV",1,8,0.883643892339545,109,115,133,136,144,150,161,164,"ATGAATA","GTCA","ATGGTGT","CTGA",2.31528391644427,18,8,11,46,2.64288057764558,4.51952667181851,8.05410224117669,101,"ENSG00000079974.19"
"42723","ENSG00000266049.1_22845",22837,22845,9,"ENSG00000266049.1",1,7,"VVVVVVMVV",0,8,0.885300207039338,115,121,133,136,164,170,180,183,"TTGATGC","TTCA","TTGAAAA","CTGA",2.39670701722105,12,28,10,59,2.07345971481691,4.51287662407264,8.05407745222999,101,"ENSG00000079974.19"
"1764","ENSG00000065923.10_110442",110434,110442,9,"ENSG00000065923.10",1,1,"MVVVVVVVV",0,8,0.90600414078675,107,113,133,136,177,183,192,195,"ATGATGA","GTAA","ATGATTA","TTGA",2.43377660329514,20,41,9,79,1.49502630079316,4.43005091402353,8.05406747717052,101,"ENSG00000079974.19"
"48031","ENSG00000290199.1_45574",45566,45574,9,"ENSG00000290199.1",0,NA,"VVVVUVVVV",1,8,0.889855072463768,113,119,133,136,167,173,184,187,"ATGTTTA","AGGA","ATGAGGA","CTGA",2.39791787685765,14,31,11,65,1.99211097515687,4.49455753855197,8.05397782840704,101,"ENSG00000079974.19"
"36247","ENSG00000239311.1_24546",24538,24546,9,"ENSG00000239311.1",1,1,"MVVVVVVVV",0,8,0.90600414078675,110,116,133,136,140,146,157,160,"ACTATGA","CAAA","ATGACTG","CTGA",2.26756927856496,17,4,11,41,2.60270341598938,4.42995798493895,8.05397454808594,101,"ENSG00000079974.19"
"35873","ENSG00000237372.5_44411",44403,44411,9,"ENSG00000237372.5",1,8,"VVVVVUVMV",1,7,0.806211180124224,69,75,92,95,112,118,133,136,"ATGATGA","CTGA","CTGACTA","CTAA",2.59739985521236,17,17,15,58,2.00019332353086,4.82904808956998,8.05389281006687,101,"ENSG00000079974.19"
"46550","ENSG00000286802.1_12858",12850,12858,9,"ENSG00000286802.1",1,8,"VVVVVVVMV",0,8,0.884057971014493,112,118,133,136,138,144,156,159,"AAAATGA","CCAA","GTGGGGA","CTGA",2.34266299446363,15,2,12,38,2.45259901227958,4.51758807717594,8.05381996123391,101,"ENSG00000079974.19"
"3933","ENSG00000091129.22_64446",64438,64446,9,"ENSG00000091129.22",1,1,"MVVVVVVVV",0,8,0.90600414078675,92,98,133,136,165,171,186,189,"ATGAAGT","ATGA","GTGAATA","CTGA",2.52477822434624,35,29,15,88,0.887065692343355,4.42973013032957,8.05374669347657,101,"ENSG00000079974.19"
"40675","ENSG00000257277.2_43017",43009,43017,9,"ENSG00000257277.2",1,8,"UVVVVVVMV",1,7,0.786749482401656,115,121,133,136,140,146,165,168,"ATGATGA","CTGT","GTGAAGA","CTGG",2.58070582315732,12,4,19,44,2.42189389354475,4.90664984531506,8.05364777492169,101,"ENSG00000079974.19"
"3060","ENSG00000080603.17_13039",13031,13039,9,"ENSG00000080603.17",0,NA,"UVVVVUVVV",2,7,0.824844720496894,116,122,133,136,161,167,206,209,"ATGATAA","ATGA","GTGATGT","CTGA",2.68397834498558,11,25,39,84,1.12366216940672,4.75421278399432,8.05359166598189,101,"ENSG00000079974.19"
"44432","ENSG00000282034.2_7181",7173,7181,9,"ENSG00000282034.2",0,NA,"UVVVVUVVV",2,7,0.824844720496894,116,122,133,136,161,167,206,209,"ATGATAA","ATGA","GTGATGT","CTGA",2.68397834498558,11,25,39,84,1.12366216940672,4.75421278399432,8.05359166598189,101,"ENSG00000079974.19"
"7463","ENSG00000114346.14_15896",15888,15896,9,"ENSG00000114346.14",0,NA,"VVVVUVVVV",1,8,0.889855072463768,44,50,90,93,104,110,133,136,"ATGATGT","CTGA","GTGGTGG","CTGG",2.51716994649907,40,11,23,83,1.19526505147988,4.4940995070351,8.05351979689017,101,"ENSG00000079974.19"
"8426","ENSG00000118873.17_37106",37098,37106,9,"ENSG00000118873.17",1,5,"VVVVMVVVV",0,8,0.886542443064182,108,114,133,136,161,167,176,179,"ATCATGA","CTTT","GAGATAA","CTGA",2.44946932344597,19,25,9,62,1.69934025179525,4.50728393535876,8.05345370761549,101,"ENSG00000079974.19"
"41885","ENSG00000259905.7_550498",550490,550498,9,"ENSG00000259905.7",1,3,"VVMVVVVVV",0,8,0.882815734989648,110,116,133,136,148,154,184,187,"ATGATTA","ATAA","TTGAAAA","CTGA",2.46602708297014,17,12,30,68,1.64744465396352,4.52190630177444,8.05316924173303,101,"ENSG00000079974.19"
"46005","ENSG00000286110.1_94265",94257,94265,9,"ENSG00000286110.1",1,3,"VVMVVVVVV",0,8,0.882815734989648,110,116,133,136,148,154,184,187,"ATGATTA","ATAA","TTGAAAA","CTGA",2.46602708297014,17,12,30,68,1.64744465396352,4.52190630177444,8.05316924173303,101,"ENSG00000079974.19"
"12336","ENSG00000137872.17_335633",335625,335633,9,"ENSG00000137872.17",1,6,"VVUVVMVVV",1,7,0.786335403726708,114,120,133,136,143,149,162,165,"ATGAACA","CTCA","GTGATGG","CTGA",2.50485709720824,13,7,13,42,2.93215203790703,4.90779983815715,8.05314145306398,101,"ENSG00000079974.19"
"31532","ENSG00000224043.9_167492",167484,167492,9,"ENSG00000224043.9",1,1,"MVVVVVVVV",0,8,0.90600414078675,87,93,133,136,174,180,195,198,"AAGATGA","TAGA","GTGAAAA","CTGA",2.53295706342753,40,38,15,102,0.829662947935612,4.42901084269645,8.05302740584345,101,"ENSG00000079974.19"
"22147","ENSG00000169871.13_3103",3095,3103,9,"ENSG00000169871.13",1,8,"VVVVVVVMV",0,8,0.884057971014493,50,56,65,68,77,83,133,136,"AGGATGA","CTGA","GTGGAGT","CAGA",2.44160940527053,9,9,50,77,1.78926643172225,4.51666561671478,8.05289750077275,101,"ENSG00000079974.19"
"12331","ENSG00000137872.17_242900",242892,242900,9,"ENSG00000137872.17",1,1,"MVVVVVVVV",0,8,0.90600414078675,53,59,68,71,82,88,133,136,"ATAATGA","CTGA","ATGGTAG","ATGA",2.40551554585385,9,11,45,74,1.67869445342473,4.42886618977926,8.05288275292626,101,"ENSG00000079974.19"
"31050","ENSG00000215386.15_390647",390639,390647,9,"ENSG00000215386.15",0,NA,"UVVVVVVVV",1,8,0.902691511387163,85,91,133,136,155,161,170,173,"ATAATGA","CTAT","CTGAAGG","CTGA",2.46694904320333,42,19,9,79,1.32207710344216,4.44210101453277,8.05286706008142,101,"ENSG00000079974.19"
"36416","ENSG00000240563.2_15384",15376,15384,9,"ENSG00000240563.2",1,8,"VVVUVVVMV",1,7,0.764803312629399,115,121,133,136,147,153,162,165,"AAGAAGA","CTGA","GTAAAGA","CTGA",2.56746922027885,12,11,9,41,2.85804558259554,4.99362676278031,8.0528400132979,101,"ENSG00000079974.19"
"15520","ENSG00000148655.15_1020639",1020631,1020639,9,"ENSG00000148655.15",0,NA,"VVVVUVVVV",1,8,0.889855072463768,113,119,133,136,144,150,164,167,"ATAATAT","CTGG","GTCAGGG","CTGA",2.27183818050878,14,8,14,45,2.8279150943933,4.49337574111296,8.05279603096803,101,"ENSG00000079974.19"
"19280","ENSG00000162641.20_95839",95831,95839,9,"ENSG00000162641.20",1,1,"MVVVVVVVV",0,8,0.90600414078675,112,118,133,136,143,149,168,171,"AAGGAGA","TTGA","TTGAGCA","CTGA",2.28440938137961,15,7,19,50,2.48551652562052,4.42872810037115,8.05274466351815,101,"ENSG00000079974.19"
"39361","ENSG00000253515.2_66776",66768,66776,9,"ENSG00000253515.2",1,2,"VMVVVVVVV",0,8,0.884057971014493,68,74,82,85,114,120,133,136,"GAGATGT","TTGA","ATGAACA","CTGA",2.45315216924511,8,29,13,59,1.71149405557084,4.51646046263456,8.05269234669253,101,"ENSG00000079974.19"
"9079","ENSG00000122557.11_32872",32864,32872,9,"ENSG00000122557.11",1,1,"MVVVVVVVV",0,8,0.90600414078675,90,96,133,136,165,171,186,189,"ATGAAGT","ATGA","GTGAGAA","CTGA",2.52477822434624,37,29,15,90,0.88271924969423,4.42864351966729,8.05266008281429,101,"ENSG00000079974.19"
"38334","ENSG00000250017.1_1823",1815,1823,9,"ENSG00000250017.1",1,3,"VVMVVVVVV",0,8,0.882815734989648,116,122,133,136,143,149,167,170,"ACCATGT","ATGA","ATCATAA","CTGA",2.32027338208337,11,7,18,45,2.61688134685066,4.52134264018495,8.05260558014354,101,"ENSG00000079974.19"
"40995","ENSG00000258294.5_14247",14239,14247,9,"ENSG00000258294.5",1,2,"VMVVVVVVV",0,8,0.884057971014493,114,120,133,136,142,148,156,159,"ACAATGA","AGGA","ATTTTGC","CTGA",2.25043687874592,13,6,8,36,3.06214521483788,4.51626443495267,8.05249631901064,101,"ENSG00000079974.19"
"17330","ENSG00000153930.13_312268",312260,312268,9,"ENSG00000153930.13",1,1,"MVVVVVVVV",0,8,0.90600414078675,114,120,133,136,145,151,166,169,"ATGAAGA","CAGT","GTGGTTA","ATGA",2.24195466159906,13,9,15,46,2.76741358991009,4.42844450014262,8.05246106328961,101,"ENSG00000079974.19"
"106","ENSG00000005102.14_17847",17839,17847,9,"ENSG00000005102.14",1,5,"VVVVMVVVV",0,8,0.886542443064182,102,108,133,136,138,144,153,156,"ATGAGGC","CTCA","GTAATGC","CTGA",2.4484987363774,25,2,9,45,1.70164054851988,4.50624136442564,8.05241113668236,101,"ENSG00000079974.19"
"40887","ENSG00000258036.2_2261",2253,2261,9,"ENSG00000258036.2",1,8,"UVVVVVVMV",1,7,0.786749482401656,114,120,133,136,146,152,164,167,"GTGATGG","ATGA","GAGATAT","CTGA",2.51415820727554,13,10,12,44,2.86058706384062,4.90541044475271,8.05240837435934,101,"ENSG00000079974.19"
"23489","ENSG00000173068.19_303204",303196,303204,9,"ENSG00000173068.19",0,NA,"VVVVVVUVV",1,8,0.886128364389234,116,122,133,136,148,154,166,169,"AGGATCA","CTTT","ATTAAGA","CTGA",2.29845169722765,11,12,12,44,2.70740943193863,4.50760518669742,8.05211864425435,101,"ENSG00000079974.19"
"8643","ENSG00000120029.13_138756",138748,138756,9,"ENSG00000120029.13",1,1,"MVVVVVVVV",0,8,0.90600414078675,102,108,133,136,141,147,158,161,"ATAATGA","ATGA","CTGATAC","CTGG",2.34334595403782,25,5,11,50,2.08975769953248,4.42801601494616,8.05203257809316,101,"ENSG00000079974.19"
"27223","ENSG00000185760.18_212075",212067,212075,9,"ENSG00000185760.18",0,NA,"VVVVVVUVV",1,8,0.886128364389234,101,107,133,136,148,154,166,169,"ATGATGG","ATGA","TTGTTGA","CTCA",2.42576125871517,26,12,12,59,1.8574804877893,4.50730555313927,8.05181901069621,101,"ENSG00000079974.19"
"46272","ENSG00000286417.1_20974",20966,20974,9,"ENSG00000286417.1",1,1,"MVVVVVVVV",0,8,0.90600414078675,85,91,133,136,165,171,186,189,"ATGAAGT","ATGA","GTGAGAA","CTGA",2.52477822434624,42,29,15,95,0.879140135790658,4.4277487411914,8.0517653043384,101,"ENSG00000079974.19"
"11988","ENSG00000136828.19_192375",192367,192375,9,"ENSG00000136828.19",1,1,"MVVVVVUVV",1,7,0.792132505175983,72,78,91,94,100,106,133,136,"ATGATGA","TAGA","GAGAAGT","CTGA",2.60247131126746,13,6,27,55,2.18302980688195,4.88320963716626,8.05173965787019,101,"ENSG00000079974.19"
"41695","ENSG00000259560.2_330836",330828,330836,9,"ENSG00000259560.2",0,NA,"VVVVVVUVV",1,8,0.886128364389234,67,73,86,89,98,104,133,136,"ATGATCA","CAGA","TTGATAA","CTCA",2.39003215645957,13,9,29,60,2.09512994249798,4.50716941305711,8.05168287061404,101,"ENSG00000079974.19"
"38794","ENSG00000251027.2_176540",176532,176540,9,"ENSG00000251027.2",1,7,"VVVVVVMVV",0,8,0.885300207039338,110,116,133,136,142,148,162,165,"AAGATGA","TTGC","ATGAAGA","GTGA",2.31410516995306,17,6,14,46,2.61427567441327,4.51041086852508,8.05161169668243,101,"ENSG00000079974.19"
"19261","ENSG00000162631.20_104343",104335,104343,9,"ENSG00000162631.20",0,NA,"UVVVVVVVV",1,8,0.902691511387163,112,118,133,136,163,169,179,182,"ATTCTGA","TTGA","ATCATTT","CTGA",2.36490902136893,15,27,10,61,1.99702938301739,4.44077238136923,8.05153842691789,101,"ENSG00000079974.19"
"41698","ENSG00000259564.2_62886",62878,62886,9,"ENSG00000259564.2",1,1,"MVVVVVVVV",0,8,0.90600414078675,85,91,133,136,165,171,186,189,"ATGATAT","ATGA","GTGAAAA","CTGA",2.52462802121439,42,29,15,95,0.879140135790658,4.42749840263831,8.05151496578531,101,"ENSG00000079974.19"
"7944","ENSG00000116117.19_937334",937326,937334,9,"ENSG00000116117.19",0,NA,"UVVVVUVVV",2,7,0.824844720496894,114,120,133,136,150,156,180,183,"AGAATGA","CTGA","CTGATTT","CTGA",2.56144082950276,13,14,24,60,1.93221300727217,4.7521213009893,8.05150018297688,101,"ENSG00000079974.19"
"39558","ENSG00000253807.6_272595",272587,272595,9,"ENSG00000253807.6",0,NA,"VVVUVVVVV",1,8,0.880745341614907,66,72,87,90,108,114,133,136,"ATGGTGA","GTGA","GTGAGGA","ATGA",2.43845906624764,15,18,19,61,1.85750138415157,4.52847378978395,8.05145515624358,101,"ENSG00000079974.19"
"1293","ENSG00000052795.13_30811",30803,30811,9,"ENSG00000052795.13",1,2,"VMVVVVVVV",0,8,0.884057971014493,93,99,133,136,150,156,164,167,"ATGATTA","TTCA","TTGTAGA","CTGA",2.46685635012841,34,14,8,65,1.61505644115903,4.51519136050377,8.05142324456174,101,"ENSG00000079974.19"
"8628","ENSG00000119912.18_8398",8390,8398,9,"ENSG00000119912.18",1,1,"MVVVUVVVV",1,7,0.795859213250517,42,48,57,60,109,115,133,136,"TTGATGA","CTGA","ATGACTG","CTGA",2.69975824448302,9,49,18,85,1.47340507144718,4.86794834200015,8.05138519500222,101,"ENSG00000079974.19"
"20099","ENSG00000164300.17_111858",111850,111858,9,"ENSG00000164300.17",1,1,"MVVVVVVVV",0,8,0.90600414078675,107,113,133,136,148,154,162,165,"AAGATAC","ATGA","ATGCTGC","CTGA",2.32077793347668,20,12,8,49,2.23756330269318,4.42735404813444,8.05137061128143,101,"ENSG00000079974.19"
"43056","ENSG00000267772.1_8781",8773,8781,9,"ENSG00000267772.1",1,2,"VMVVVUVVV",1,7,0.806211180124223,114,120,133,136,169,175,196,199,"ATGATCT","CTGA","ATGAGGA","CTGA",2.67314546815694,13,33,21,76,1.48511367015075,4.82652086446592,8.05136558496281,101,"ENSG00000079974.19"
"13673","ENSG00000143153.14_53580",53572,53580,9,"ENSG00000143153.14",1,8,"VVVVVVVMV",0,8,0.884057971014493,83,89,133,136,143,149,178,181,"GTGATAA","CATA","ATGATGA","CTGA",2.5366449480006,44,7,29,89,1.14933974499794,4.51507651625048,8.05130840030846,101,"ENSG00000079974.19"
"34440","ENSG00000233047.7_90857",90849,90857,9,"ENSG00000233047.7",1,8,"VVVVVVVMV",0,8,0.884057971014493,63,69,80,83,107,113,133,136,"GTGAAGA","CTGA","ATGGTGA","ATGA",2.46334494370618,11,24,20,64,1.63788263775179,4.51504556561492,8.05127744967289,101,"ENSG00000079974.19"
"30412","ENSG00000204929.13_631819",631811,631819,9,"ENSG00000204929.13",1,1,"MVVVVVVVV",0,8,0.90600414078675,100,106,133,136,147,153,172,175,"ATGCTGT","GTGA","GGGAGGG","CTGA",2.42936803020706,27,11,19,66,1.51302270327473,4.42720239283045,8.05121895597745,101,"ENSG00000079974.19"
"31526","ENSG00000223993.2_26352",26344,26352,9,"ENSG00000223993.2",1,8,"UVVVVVVMV",1,7,0.786749482401656,116,122,133,136,141,147,166,169,"CTGATGA","CAGA","AAGACTA","CTGA",2.56897328142994,11,5,19,44,2.49023833375704,4.90418171915582,8.05117964876245,101,"ENSG00000079974.19"
"43293","ENSG00000270816.6_10584",10576,10584,9,"ENSG00000270816.6",1,8,"VVVVVVVMV",0,8,0.884057971014493,114,120,133,136,143,149,169,172,"GTCAAGA","GTGA","GAGAGAA","CTGA",2.33198484294428,13,7,20,49,2.51321678215748,4.51494560044651,8.05117748450448,101,"ENSG00000079974.19"
"556","ENSG00000018510.18_860",852,860,9,"ENSG00000018510.18",0,NA,"VVVVUVVVV",1,8,0.889855072463768,113,119,133,136,166,172,181,184,"CCGATGA","ATAA","GTGGTGG","CTGA",2.39300958549736,14,30,9,62,2.0135576275009,4.4917387160375,8.05115900589257,101,"ENSG00000079974.19"
"1370","ENSG00000054523.20_114438",114430,114438,9,"ENSG00000054523.20",1,1,"MVVVVVVVV",0,8,0.90600414078675,57,63,82,85,102,108,133,136,"ATGATTA","CTGA","GTTAAGA","CTTA",2.46451774576775,19,17,25,70,1.27802093903476,4.42703481103827,8.05105137418527,101,"ENSG00000079974.19"
"8680","ENSG00000120251.22_73769",73761,73769,9,"ENSG00000120251.22",1,6,"VVVVVMVVV",0,8,0.902691511387163,81,87,99,102,113,119,133,136,"ATGTATA","ATGT","GTGAGGA","CTGA",2.25752865783373,12,11,14,46,2.71072431024414,4.44022884061725,8.0509948861659,101,"ENSG00000079974.19"
"34787","ENSG00000234147.4_207651",207643,207651,9,"ENSG00000234147.4",1,8,"VVVVVVVMV",0,8,0.884057971014493,99,105,133,136,138,144,153,156,"GTGAAGG","ATGA","CTGCTGA","CTGA",2.4682869456646,28,2,9,48,1.60367379732598,4.51473002543915,8.05096190949712,101,"ENSG00000079974.19"
"4124","ENSG00000095587.9_3503",3495,3503,9,"ENSG00000095587.9",1,1,"MVVVVVVVV",0,8,0.90600414078675,115,121,133,136,149,155,172,175,"TTGATGC","ATGA","GTGACGG","CTGT",2.29726880173934,12,13,17,51,2.39239884315455,4.42688104702087,8.05089761016787,101,"ENSG00000079974.19"
"5977","ENSG00000107518.18_833868",833860,833868,9,"ENSG00000107518.18",1,7,"VVVVVVMVV",0,8,0.885300207039338,67,73,86,89,98,104,133,136,"ATGATTA","CAGA","TTGATAA","CTCA",2.39144358906366,13,9,29,60,2.09512994249798,4.5095218007306,8.05072262888795,101,"ENSG00000079974.19"
"8370","ENSG00000118473.23_89982",89974,89982,9,"ENSG00000118473.23",0,NA,"UVVVVVVVV",1,8,0.902691511387163,115,121,133,136,151,157,194,197,"TTGAAGA","TTCA","GAGATGA","CTGA",2.42534962198177,12,15,37,73,1.59056171441225,4.43988979857268,8.05065584412134,101,"ENSG00000079974.19"
"38854","ENSG00000251170.6_155526",155518,155526,9,"ENSG00000251170.6",1,2,"UMVVVVVVV",1,7,0.786749482401656,77,83,99,102,111,117,133,136,"AAGATGA","GTGA","GTGGACA","CTGA",2.56002478744065,16,9,16,50,2.5477663471737,4.90364956586118,8.0506474954678,101,"ENSG00000079974.19"
"804","ENSG00000034152.19_1486",1478,1486,9,"ENSG00000034152.19",0,NA,"VVVUVVVVV",1,8,0.880745341614907,87,93,103,106,113,119,133,136,"CTGTGGA","GTGG","GTGGTGA","CTGA",2.29300267593547,10,7,14,40,2.82377627591641,4.52761519553822,8.05059656199785,101,"ENSG00000079974.19"
"11892","ENSG00000136280.17_39480",39472,39480,9,"ENSG00000136280.17",1,6,"VVVVVMVVV",0,8,0.902691511387163,111,117,133,136,144,150,205,208,"ATGAATA","ATGA","GAGAATA","CTGA",2.39007969156858,16,8,55,88,1.82525135478566,4.43977899131071,8.05054503685937,101,"ENSG00000079974.19"
"10900","ENSG00000133083.15_227944",227936,227944,9,"ENSG00000133083.15",1,1,"MVVVVVVVV",0,8,0.90600414078675,104,110,133,136,143,149,188,191,"AGGAAGA","ATGA","GAGAGGA","CTGA",2.46119282790534,23,7,39,78,1.2979368867532,4.4264722681972,8.0504888313442,101,"ENSG00000079974.19"
"13911","ENSG00000143919.15_402775",402767,402775,9,"ENSG00000143919.15",1,3,"VVMVVVVVV",0,8,0.882815734989648,109,115,133,136,149,155,164,167,"ATGTTTA","ATGT","TTGTTGA","CTGA",2.35745397349872,18,13,9,49,2.36032871908099,4.51917213560145,8.05043507556004,101,"ENSG00000079974.19"
"1392","ENSG00000054965.11_57559",57551,57559,9,"ENSG00000054965.11",1,5,"VVVVMUVVV",1,7,0.808695652173913,60,66,82,85,113,119,133,136,"ATGATGA","CTGA","ATGATTT","ATGA",2.62198359073359,16,28,14,67,1.78260242176204,4.81562325666316,8.05040586535881,101,"ENSG00000079974.19"
"41772","ENSG00000259692.6_96546",96538,96546,9,"ENSG00000259692.6",1,7,"VVVVVVMVV",0,8,0.885300207039338,114,120,133,136,144,150,196,199,"GTGATGG","AGGA","ATGGAAA","CTGA",2.40728739325125,13,8,46,76,1.98818609070155,4.50919217809414,8.05039300625149,101,"ENSG00000079974.19"
"27207","ENSG00000185737.13_753732",753724,753732,9,"ENSG00000185737.13",1,8,"VVVVVVVMV",0,8,0.884057971014493,105,111,133,136,142,148,159,162,"ATGGTCA","CAGA","ATTCAGA","CTGA",2.36217009283202,22,6,11,48,2.30844722933211,4.51406196205306,8.05029384611104,101,"ENSG00000079974.19"
"40435","ENSG00000256195.3_27335",27327,27335,9,"ENSG00000256195.3",0,NA,"UVVVVVVVV",1,8,0.902691511387163,107,113,133,136,144,150,200,203,"AATATGA","TTGA","GTAATCA","CTGA",2.44178977915565,20,8,50,87,1.47946424708582,4.43951569369754,8.05028173924619,101,"ENSG00000079974.19"
"3898","ENSG00000090487.11_24178",24170,24178,9,"ENSG00000090487.11",0,NA,"UVVVVVVVV",1,8,0.902691511387163,114,120,133,136,146,152,161,164,"ATGATAA","CTTT","GTGATCT","CTTA",2.22618338470705,13,10,9,41,2.91662707420267,4.43946240972908,8.05022845527774,101,"ENSG00000079974.19"
"28771","ENSG00000196482.18_129428",129420,129428,9,"ENSG00000196482.18",1,8,"VVVVVVVMV",0,8,0.884057971014493,114,120,133,136,155,161,179,182,"ATAATGT","CTGC","ATGTTCC","CTGA",2.41520683599676,13,19,18,59,1.95440127400443,4.51394504516238,8.05017692922035,101,"ENSG00000079974.19"
"18082","ENSG00000156110.15_495346",495338,495346,9,"ENSG00000156110.15",1,8,"VVVVVVVMV",0,8,0.884057971014493,116,122,133,136,145,151,162,165,"ATAGTGA","ATGG","GTTAAAA","CTGA",2.26661243520082,11,9,11,40,2.94427865833799,4.51375705658587,8.04998894064384,101,"ENSG00000079974.19"
"6570","ENSG00000110723.12_61251",61243,61251,9,"ENSG00000110723.12",1,2,"VMVVVVVVV",0,8,0.884057971014493,61,67,104,107,116,122,133,136,"ATGATGA","CTGT","GTTACAA","CAGA",2.41712594863995,37,9,11,66,1.94061037428869,4.51369584130542,8.0499277253634,101,"ENSG00000079974.19"
"12537","ENSG00000138593.9_51728",51720,51728,9,"ENSG00000138593.9",0,NA,"UVVVVVVVV",1,8,0.902691511387163,45,51,64,67,74,80,133,136,"GAGATGA","GTGA","ATGAGGA","CTGT",2.36394417808596,13,7,53,82,1.99679912616064,4.43910674501676,8.04987279056541,101,"ENSG00000079974.19"
"10307","ENSG00000130414.13_58460",58452,58460,9,"ENSG00000130414.13",0,NA,"VVUVVVVVV",1,8,0.883643892339545,115,121,133,136,152,158,171,174,"ATGAGGC","AAGA","ATAACGA","CTGA",2.34776735339868,12,16,13,50,2.40868406116155,4.51511660428818,8.04969217364636,101,"ENSG00000079974.19"
"12339","ENSG00000137872.17_428377",428369,428377,9,"ENSG00000137872.17",0,NA,"VVVVUVVVV",1,8,0.889855072463768,116,122,133,136,143,149,158,161,"GTGAGGT","CTTA","ATGATGC","CTAA",2.23275811937214,11,7,9,36,3.07598718949591,4.49026032966088,8.04968061951595,101,"ENSG00000079974.19"
"4640","ENSG00000101445.10_94014",94006,94014,9,"ENSG00000101445.10",1,1,"MVVVVVVVV",0,8,0.90600414078675,115,121,133,136,150,156,212,215,"ATGGAGA","CTAA","GTTTTGA","CTGA",2.41185076787259,12,14,56,91,1.62351135276158,4.42562911797805,8.04964568112505,101,"ENSG00000079974.19"
"26985","ENSG00000185352.9_548118",548110,548118,9,"ENSG00000185352.9",0,NA,"UVVVVVVVV",1,8,0.902691511387163,50,56,101,104,110,116,133,136,"ATGATGA","CAGA","ATAATTC","CTGT",2.41102936646194,45,6,17,77,1.68166641329087,4.43879888075928,8.04956492630794,101,"ENSG00000079974.19"
"40396","ENSG00000255910.2_5584",5576,5584,9,"ENSG00000255910.2",1,7,"VVVVVVMVV",0,8,0.885300207039338,67,73,86,89,98,104,133,136,"ATGATAA","CAGA","TTGATAA","CTCA",2.39073787276161,13,9,29,60,2.09512994249798,4.50834560689385,8.0495464350512,101,"ENSG00000079974.19"
"18643","ENSG00000157985.20_48827",48819,48827,9,"ENSG00000157985.20",0,NA,"VVUVVVVVV",1,8,0.883643892339545,67,73,88,91,97,103,133,136,"ATGGTGC","CTGC","GTGTTTC","CTGA",2.40598156229328,15,6,30,60,2.01985826741474,4.51493383734248,8.04950940670066,101,"ENSG00000079974.19"
"1568","ENSG00000061455.11_59635",59627,59635,9,"ENSG00000061455.11",1,8,"VVVVVVVMV",0,8,0.884057971014493,113,119,133,136,148,154,174,177,"AGGATGT","ATAA","ATGATTC","CTGA",2.37103313877895,14,12,20,55,2.24618883759209,4.51326910736293,8.0495009914209,101,"ENSG00000079974.19"
"3185","ENSG00000082068.9_85238",85230,85238,9,"ENSG00000082068.9",0,NA,"UVVVVVVVV",1,8,0.902691511387163,109,115,133,136,186,192,212,215,"ATGAGGA","AAGA","GGGTTGA","CTGA",2.48562581436493,18,50,20,97,1.18366097915743,4.43862493539758,8.04939098094624,101,"ENSG00000079974.19"
"16793","ENSG00000152270.9_208026",208018,208026,9,"ENSG00000152270.9",1,8,"VVVVVVVMV",0,8,0.884057971014493,103,109,133,136,149,155,165,168,"CTGAGGA","CTGG","GTCCTGT","CTGA",2.42106171376328,24,13,10,56,1.91214662614554,4.51313951280851,8.04937139686649,101,"ENSG00000079974.19"
"13940","ENSG00000143995.20_47119",47111,47119,9,"ENSG00000143995.20",1,1,"MVVVVVVVV",0,8,0.90600414078675,102,108,133,136,158,164,172,175,"ATAATGC","TTGA","GTGCAAA","CTGA",2.45185964745373,25,22,8,64,1.35541995230121,4.42528773383152,8.04930429697852,101,"ENSG00000079974.19"
"42657","ENSG00000265533.1_180004",179996,180004,9,"ENSG00000265533.1",1,1,"MVVVVUVVV",1,7,0.82815734989648,44,50,61,64,115,121,133,136,"GTGCTGA","GTGA","GTGGTGT","CTGA",2.5519644820753,11,51,12,83,1.93352024828362,4.73665419886307,8.04928359844899,101,"ENSG00000079974.19"
"40439","ENSG00000256223.6_8272",8264,8272,9,"ENSG00000256223.6",1,1,"MVVVVVVVV",0,8,0.90600414078675,111,117,133,136,173,179,190,193,"TTAATGT","ATGA","CTGCTAA","CTGA",2.37953090177667,16,37,11,73,1.83712310719107,4.42516561309222,8.04918217623922,101,"ENSG00000079974.19"
"40524","ENSG00000256825.4_7863",7855,7863,9,"ENSG00000256825.4",1,1,"MVVVVVVVV",0,8,0.90600414078675,111,117,133,136,173,179,190,193,"TTAATGT","ATGA","CTGCTAA","CTGA",2.37953090177667,16,37,11,73,1.83712310719107,4.42516561309222,8.04918217623922,101,"ENSG00000079974.19"
"30245","ENSG00000204296.13_2053",2045,2053,9,"ENSG00000204296.13",1,2,"VMVVVVUVV",1,7,0.770186335403727,110,116,133,136,141,147,159,162,"ATGAAGA","CGGA","GGGATGC","CTGA",2.58247751895937,17,5,12,43,2.65690039645844,4.96835429738022,8.04909963899513,101,"ENSG00000079974.19"
"40392","ENSG00000255886.1_43534",43526,43534,9,"ENSG00000255886.1",1,8,"VVVVVUVMV",1,7,0.806211180124224,83,89,133,136,147,153,167,170,"AGGATGA","CGGA","TTGTTGA","CTGA",2.63852116846632,44,11,14,78,1.70679895999255,4.82423502077534,8.04907974127223,101,"ENSG00000079974.19"
"45604","ENSG00000285735.2_10960",10952,10960,9,"ENSG00000285735.2",1,2,"VMVVVVUVV",1,7,0.770186335403727,87,93,106,109,112,118,133,136,"ATGGTGG","ATGA","ATGATGA","CTGA",2.59891270860114,13,3,15,40,2.54671263256553,4.96819933914328,8.04894468075818,101,"ENSG00000079974.19"
"38004","ENSG00000249332.2_29277",29269,29277,9,"ENSG00000249332.2",1,8,"VVVVUVVMV",1,7,0.773913043478261,83,89,101,104,110,116,133,136,"ATGATGA","CTGA","TTTTTGA","ATGA",2.56835183397683,12,6,17,44,2.69027341612019,4.95315474399144,8.04880691790448,101,"ENSG00000079974.19"
"11015","ENSG00000133454.16_20265",20257,20265,9,"ENSG00000133454.16",1,6,"VVVVVMVVV",0,8,0.902691511387163,83,89,133,136,152,158,166,169,"TTGATAA","CTGG","CTCATGG","CTGA",2.44243168553463,44,16,8,77,1.4691338673912,4.43800294273884,8.0487689882875,101,"ENSG00000079974.19"
"28678","ENSG00000196352.18_26504",26496,26504,9,"ENSG00000196352.18",0,NA,"UVVVVVUVV",2,7,0.788819875776397,91,97,107,110,115,121,133,136,"CTGATGT","TTGA","ATGTTAT","CTGA",2.49933814217993,10,5,12,36,2.9113933483765,4.89341190739401,8.0486914104996,101,"ENSG00000079974.19"
"39067","ENSG00000251574.8_537704",537696,537704,9,"ENSG00000251574.8",1,7,"VVVVVVMVV",0,8,0.885300207039338,112,118,133,136,153,159,167,170,"ATGATGA","ATAA","TTGACAA","CTAA",2.35663120013675,15,17,8,49,2.31895289154377,4.50745688978053,8.04865771793788,101,"ENSG00000079974.19"
"32189","ENSG00000226317.3_158192",158184,158192,9,"ENSG00000226317.3",1,6,"VVVVVMVVV",0,8,0.902691511387163,103,109,133,136,147,153,162,165,"ATGATGT","CAGA","GTGCCAA","GTGA",2.35493073187993,24,11,9,53,2.0518942865626,4.43785812477387,8.04862417032253,101,"ENSG00000079974.19"
"15030","ENSG00000146776.15_143586",143578,143586,9,"ENSG00000146776.15",1,1,"MVUVVVVVV",1,7,0.789648033126294,115,121,133,136,144,150,173,176,"CTGATGA","GTGA","GGGTTGC","CTGA",2.58212580739144,12,8,23,52,2.34576786956996,4.88998497971156,8.04857711221674,101,"ENSG00000079974.19"
"11789","ENSG00000136052.10_67823",67815,67823,9,"ENSG00000136052.10",0,NA,"VVVVVUVVV",1,8,0.922153209109731,37,43,67,70,116,122,133,136,"ATGATGA","CTGG","GAGAAGG","CAGA",2.43508124749325,24,46,11,90,1.20593321293703,4.35995204905634,8.04856488549526,101,"ENSG00000079974.19"
"22760","ENSG00000171365.17_80320",80312,80320,9,"ENSG00000171365.17",0,NA,"VVVVVVUVV",1,8,0.886128364389234,80,86,102,105,112,118,133,136,"ATGATCA","ATGA","ATGAGCT","CTTA",2.30374801478392,16,7,15,47,2.65775615213065,4.50401906267253,8.04853252022946,101,"ENSG00000079974.19"
"21751","ENSG00000168843.14_594987",594979,594987,9,"ENSG00000168843.14",0,NA,"VVVVVUVVV",1,8,0.922153209109731,73,79,95,98,110,116,133,136,"GTAATGA","ATAA","GTGAAGA","ATGA",2.27072950536178,16,12,17,54,2.30144443589389,4.35991028457644,8.04852312101536,101,"ENSG00000079974.19"
"39429","ENSG00000253577.2_6963",6955,6963,9,"ENSG00000253577.2",0,NA,"VVVVVUVVV",1,8,0.922153209109731,114,120,133,136,144,150,166,169,"ATTATGC","TAGA","ATGAAGA","CTAA",2.20420828191212,13,8,16,46,2.74489991475503,4.35990544854229,8.04851828498121,101,"ENSG00000079974.19"
"33880","ENSG00000231356.1_750",742,750,9,"ENSG00000231356.1",1,2,"VMVVVVVVV",0,8,0.884057971014493,99,105,133,136,142,148,198,201,"ATGATCA","CAGA","ATGTACA","CTGA",2.54769986881478,28,6,50,93,1.0642743956656,4.51223504694103,8.04846693099901,101,"ENSG00000079974.19"
"5969","ENSG00000107518.18_122450",122442,122450,9,"ENSG00000107518.18",1,6,"VVVVVMVVV",0,8,0.902691511387163,86,92,133,136,158,164,176,179,"ATGATGA","TTGC","TTGATGA","ATGA",2.4881983270594,41,22,12,84,1.16262225696767,4.43765277600759,8.04841882155624,101,"ENSG00000079974.19"
"3138","ENSG00000081665.14_6324",6316,6324,9,"ENSG00000081665.14",1,8,"VVVVUVVMV",1,7,0.773913043478261,95,101,109,112,115,121,133,136,"AGGGTGA","CTGA","ATGTAGA","CTGA",2.57464261191325,8,3,12,32,2.6466277482812,4.95272795692572,8.04838013083877,101,"ENSG00000079974.19"
"43000","ENSG00000267581.1_6289",6281,6289,9,"ENSG00000267581.1",1,8,"VVVVUVVMV",1,7,0.773913043478261,95,101,109,112,115,121,133,136,"AGGGTGA","CTGA","ATGTAGA","CTGA",2.57464261191325,8,3,12,32,2.6466277482812,4.95272795692572,8.04838013083877,101,"ENSG00000079974.19"
"40121","ENSG00000255041.1_125846",125838,125846,9,"ENSG00000255041.1",0,NA,"VVVVVUVVV",1,8,0.922153209109731,104,110,133,136,139,145,153,156,"GTGGTGA","GTGC","ATCTTGG","CTGA",2.32074680825879,23,3,8,43,1.96642307340068,4.35951711544816,8.04812995188708,101,"ENSG00000079974.19"
"28466","ENSG00000189229.12_124520",124512,124520,9,"ENSG00000189229.12",0,NA,"UVVVVVVVV",1,8,0.902691511387163,113,119,133,136,141,147,160,163,"AGGATAC","CTGG","ATAAACA","CTGA",2.23660898960298,14,5,13,41,2.83865348206628,4.43734501985488,8.04811106540353,101,"ENSG00000079974.19"
"34592","ENSG00000233539.5_1259",1251,1259,9,"ENSG00000233539.5",1,1,"MVVVVVVVV",0,8,0.90600414078675,102,108,133,136,139,145,162,165,"AAGAGGA","GTGA","TTCAAGA","CTGA",2.41885887735272,25,3,17,54,1.57033290059405,4.42401468740305,8.04803125055005,101,"ENSG00000079974.19"
"8067","ENSG00000116701.16_24169",24161,24169,9,"ENSG00000116701.16",1,8,"VVVVVVVMV",0,8,0.884057971014493,81,87,104,107,116,122,133,136,"GAGATGG","CTGA","ATGAGGG","CAGA",2.30275346437904,17,9,11,46,2.6954680462079,4.5117894521837,8.04802133624167,101,"ENSG00000079974.19"
"4358","ENSG00000100320.24_251017",251009,251017,9,"ENSG00000100320.24",0,NA,"VVVVUVVVV",1,8,0.889855072463768,115,121,133,136,178,184,194,197,"GTGATGA","GAGA","GAGATGA","ATGA",2.39238837153841,12,42,10,73,2.00502100007192,4.488569202582,8.04798949243707,101,"ENSG00000079974.19"
"3112","ENSG00000081148.12_77022",77014,77022,9,"ENSG00000081148.12",1,6,"VVVVVMVVV",0,8,0.902691511387163,82,88,100,103,107,113,133,136,"ATGATGT","CTGT","ATAAAAA","CTGG",2.30817982371045,12,4,20,45,2.36034815670815,4.43705341202779,8.04781945757645,101,"ENSG00000079974.19"
"15861","ENSG00000149972.12_492030",492022,492030,9,"ENSG00000149972.12",1,7,"VVVVVVMVV",0,8,0.885300207039338,110,116,133,136,147,153,202,205,"GTGAGGA","GAGA","GTGAGGC","CTGA",2.46496522206824,17,11,49,86,1.59318024171425,4.5065704305423,8.04777125869965,101,"ENSG00000079974.19"
"44619","ENSG00000283156.2_14068",14060,14068,9,"ENSG00000283156.2",1,1,"MVVVVVVVV",0,8,0.90600414078675,113,119,133,136,140,146,199,202,"ATTATGT","GTGG","ATGAAAA","CTGA",2.38376500451317,14,4,53,80,1.80283853231731,4.42365130726794,8.04766787041494,101,"ENSG00000079974.19"
"23815","ENSG00000174325.6_19785",19777,19785,9,"ENSG00000174325.6",1,2,"UMVVVVVVV",1,7,0.786749482401656,113,119,133,136,148,154,167,170,"ATGATGA","TTTA","ATAACAA","CTGA",2.54275033403241,14,12,13,48,2.65071350396686,4.90059559937906,8.04759352898568,101,"ENSG00000079974.19"
"31352","ENSG00000223523.1_69126",69118,69126,9,"ENSG00000223523.1",1,2,"UMVVVVVVV",1,7,0.786749482401656,113,119,133,136,148,154,167,170,"ATGATGA","TTTA","ATAACAA","CTGA",2.54275033403241,14,12,13,48,2.65071350396686,4.90059559937906,8.04759352898568,101,"ENSG00000079974.19"
"24691","ENSG00000177570.15_163485",163477,163485,9,"ENSG00000177570.15",0,NA,"UVUVVVVVV",2,7,0.786335403726708,116,122,133,136,145,151,193,196,"CTGATGA","CAGA","GTAATGG","CTGA",2.65047665980831,11,9,42,71,1.93907381333352,4.9022295530139,8.04757116792074,101,"ENSG00000079974.19"
"24","ENSG00000001626.18_341833",341825,341833,9,"ENSG00000001626.18",0,NA,"VVVVVUVVV",1,8,0.922153209109731,58,64,74,77,85,91,133,136,"AAGATGA","GTGA","ATTATAA","TTGA",2.32742946890783,10,8,42,69,1.91962434317208,4.35895520063941,8.04756803707833,101,"ENSG00000079974.19"
"7350","ENSG00000113638.14_237899",237891,237899,9,"ENSG00000113638.14",1,5,"VVVVMVVVV",0,8,0.886542443064182,111,117,133,136,158,164,200,203,"ATTATGA","TTGC","ATGATTA","CTGA",2.53797112353518,16,22,36,83,1.08558366551308,4.50134778893691,8.04751756119364,101,"ENSG00000079974.19"
"6473","ENSG00000110077.15_1614",1606,1614,9,"ENSG00000110077.15",1,2,"VMVVVUVVV",1,7,0.806211180124223,110,116,133,136,142,148,176,179,"AAGATGA","TTGA","CTGAGAA","CTGA",2.60660433789223,17,6,28,60,1.91329633294702,4.82266464639047,8.04750936688736,101,"ENSG00000079974.19"
"8228","ENSG00000117523.18_6752",6744,6752,9,"ENSG00000117523.18",1,8,"VVVVVVVMV",0,8,0.884057971014493,96,102,133,136,148,154,167,170,"TTGAAGA","AAGA","ATGCTGA","CTGA",2.44917532894656,31,12,13,65,1.71703487635674,4.51121760066678,8.04744948472475,101,"ENSG00000079974.19"
"10223","ENSG00000130021.15_224613",224605,224613,9,"ENSG00000130021.15",1,8,"VVVVVUVMV",1,7,0.806211180124224,87,93,103,106,111,117,133,136,"TTGATGG","GAGA","ATGAGGA","CTGA",2.49717038285712,10,5,16,40,2.6424134007867,4.82255398829188,8.04739870878877,101,"ENSG00000079974.19"
"11602","ENSG00000135503.13_44310",44302,44310,9,"ENSG00000135503.13",1,1,"MVVVVVVVV",0,8,0.90600414078675,54,60,71,74,83,89,133,136,"CTGCTGG","CTGG","CTGTGGA","CTGA",2.36385637416115,11,9,44,73,1.93444351154183,4.42337150148737,8.04738806463437,101,"ENSG00000079974.19"
"37951","ENSG00000249252.5_362662",362654,362662,9,"ENSG00000249252.5",0,NA,"UVVVVVVVV",1,8,0.902691511387163,111,117,133,136,150,156,167,170,"AGGTTGC","ATGA","ATTCTGA","CTGA",2.29488458246865,16,14,11,50,2.44723331944775,4.43661596730969,8.04738201285835,101,"ENSG00000079974.19"
"28817","ENSG00000196553.15_83544",83536,83544,9,"ENSG00000196553.15",1,8,"VVVVVVVMV",0,8,0.884057971014493,92,98,133,136,154,160,173,176,"ATCATCA","CTGA","ATGAGTT","CTGA",2.5115701114841,35,18,13,75,1.30053680957541,4.51108438820069,8.04731627225866,101,"ENSG00000079974.19"
"4043","ENSG00000092439.16_4005",3997,4005,9,"ENSG00000092439.16",1,1,"MVVVVVVVV",0,8,0.90600414078675,89,95,102,105,115,121,133,136,"ATGGGGA","CTGA","GTGAATC","CTTA",2.27477632165132,7,10,12,38,2.5278450979318,4.42325514390182,8.04727170704882,101,"ENSG00000079974.19"
"47539","ENSG00000288645.1_3925",3917,3925,9,"ENSG00000288645.1",1,1,"MVVVVVVVV",0,8,0.90600414078675,89,95,102,105,115,121,133,136,"ATGGGGA","CTGA","GTGAATC","CTTA",2.27477632165132,7,10,12,38,2.5278450979318,4.42325514390182,8.04727170704882,101,"ENSG00000079974.19"
"12993","ENSG00000139793.21_69487",69479,69487,9,"ENSG00000139793.21",1,8,"VVVVVVVMV",0,8,0.884057971014493,113,119,133,136,146,152,185,188,"CAGATGC","CTAA","GAGATGA","CTGA",2.41591519309528,14,10,33,66,1.9380219264766,4.51103080344461,8.04726268750258,101,"ENSG00000079974.19"
"43772","ENSG00000273540.5_35111",35103,35111,9,"ENSG00000273540.5",1,1,"MVVVVVUVV",1,7,0.792132505175983,30,36,56,59,108,114,133,136,"CTGATGA","CTGA","ATGATAG","CTGA",2.76719825859734,20,49,19,97,1.06677498712093,4.87869084444247,8.0472208651464,101,"ENSG00000079974.19"
"47398","ENSG00000288088.1_130810",130802,130810,9,"ENSG00000288088.1",0,NA,"UVVVVVVVV",1,8,0.902691511387163,84,90,133,136,139,145,158,161,"ATGAGAA","CTCA","GTCATGG","CTGA",2.41871411097924,43,3,13,68,1.62045256763259,4.43630332687355,8.0470693724222,101,"ENSG00000079974.19"
"35610","ENSG00000236451.3_31834",31826,31834,9,"ENSG00000236451.3",0,NA,"UVVVVVVVV",1,8,0.902691511387163,113,119,133,136,148,154,171,174,"AAGGTTA","CTCA","GTGCAGA","CTGA",2.29751806489787,14,12,17,52,2.42764947298967,4.43610914307721,8.04687518862586,101,"ENSG00000079974.19"
"27514","ENSG00000186409.19_97721",97713,97721,9,"ENSG00000186409.19",1,5,"VVVVMVVVV",0,8,0.886542443064182,83,89,103,106,111,117,133,136,"AAGACTA","TTGA","CTGAATA","CTGA",2.30102917910606,14,5,16,44,2.66258055471462,4.50069377052209,8.04686354277882,101,"ENSG00000079974.19"
"11143","ENSG00000134030.14_99751",99743,99751,9,"ENSG00000134030.14",0,NA,"VVVVVVUVV",1,8,0.886128364389234,115,121,133,136,146,152,162,165,"GTGAAGT","CATA","TTCTTGA","CTGA",2.26300225979369,12,10,10,41,2.92251211305717,4.50229846125378,8.04681191881071,101,"ENSG00000079974.19"
"18412","ENSG00000157224.16_31462",31454,31462,9,"ENSG00000157224.16",0,NA,"VVVVVUVVV",1,8,0.922153209109731,114,120,133,136,142,148,165,168,"ATGCCGT","CACA","ATGATTT","CTGA",2.21244879592632,13,6,17,45,2.68306757253824,4.35818155301175,8.04679438945068,101,"ENSG00000079974.19"
"43727","ENSG00000273299.1_11749",11741,11749,9,"ENSG00000273299.1",0,NA,"VVVVVUVVV",1,8,0.922153209109731,114,120,133,136,142,148,165,168,"ATGCCGT","CACA","ATGATTT","CTGA",2.21244879592632,13,6,17,45,2.68306757253824,4.35818155301175,8.04679438945068,101,"ENSG00000079974.19"
"48440","ENSG00000291108.1_36649",36641,36649,9,"ENSG00000291108.1",0,NA,"UVVVVVVVV",1,8,0.902691511387163,80,86,107,110,114,120,133,136,"ATGATGA","CTGA","TTGGTGG","CTTC",2.33614864864865,21,4,13,47,2.16946464497368,4.4359472423245,8.04671328787316,101,"ENSG00000079974.19"
"17206","ENSG00000153707.19_1042832",1042824,1042832,9,"ENSG00000153707.19",0,NA,"UVVVVVVVV",1,8,0.902691511387163,94,100,133,136,145,151,167,170,"ATGATGA","TTGG","ATGAAGT","CTGC",2.40261513245321,33,9,16,67,1.72601060553534,4.43586120547252,8.04662725102117,101,"ENSG00000079974.19"
"14577","ENSG00000145391.14_106483",106475,106483,9,"ENSG00000145391.14",1,3,"UVMVVUVVV",2,6,0.707660455486542,47,53,66,69,79,85,133,136,"ATGATGA","CAGA","GTGAGGA","CTGA",2.84484934715692,13,10,48,80,1.89767027103119,5.21583314635266,8.04647496829883,101,"ENSG00000079974.19"
"39571","ENSG00000253824.2_50482",50474,50482,9,"ENSG00000253824.2",0,NA,"UVVVVUVVV",2,7,0.824844720496894,93,99,133,136,145,151,165,168,"CTGATGT","CTGG","TTGTTGA","CTGA",2.57306311089082,34,9,14,66,1.8340480167107,4.74695052232904,8.04632940431662,101,"ENSG00000079974.19"
"33378","ENSG00000229578.3_14444",14436,14444,9,"ENSG00000229578.3",1,2,"VMVVVVVVV",0,8,0.884057971014493,111,117,133,136,146,152,200,203,"AAGCTGA","CTGC","ATGAAAA","CTGA",2.44504838361354,16,10,48,83,1.73995696196154,4.51006987984629,8.04630176390426,101,"ENSG00000079974.19"
"19678","ENSG00000163602.12_52665",52657,52665,9,"ENSG00000163602.12",1,1,"MVVVVVVVV",0,8,0.90600414078675,115,121,133,136,145,151,201,204,"GTGGTGT","ACGA","CTGATAA","CTGA",2.36036404951821,12,9,50,80,1.95317313845169,4.42223336714327,8.04624993029027,101,"ENSG00000079974.19"
"46865","ENSG00000287292.1_292016",292008,292016,9,"ENSG00000287292.1",1,2,"VMVVVVVVV",0,8,0.884057971014493,72,78,98,101,112,118,133,136,"ATGATCA","GTGA","TTGTTGA","CTAA",2.38460360133999,20,11,15,55,2.14258642665929,4.50998594223148,8.04621782628945,101,"ENSG00000079974.19"
"45","ENSG00000002746.15_344570",344562,344570,9,"ENSG00000002746.15",1,6,"VVVVVMVVV",0,8,0.902691511387163,107,113,133,136,185,191,205,208,"ATGATGC","TTGT","TTAATTA","CTGA",2.45680378576107,20,49,14,92,1.36283107860357,4.43538074591934,8.04614679146799,101,"ENSG00000079974.19"
"37881","ENSG00000249026.2_526",518,526,9,"ENSG00000249026.2",1,6,"VVVVVMVVV",0,8,0.902691511387163,85,91,133,136,145,151,187,190,"TTGAGGA","CTAA","GTGAATA","CTGA",2.5118103560776,42,9,36,96,0.995459102402974,4.4352153690634,8.04598141461206,101,"ENSG00000079974.19"
"47851","ENSG00000289497.2_23424",23416,23424,9,"ENSG00000289497.2",1,6,"VVVVVMVVV",0,8,0.902691511387163,85,91,133,136,145,151,187,190,"TTGAGGA","CTAA","GTGAATA","CTGA",2.5118103560776,42,9,36,96,0.995459102402974,4.4352153690634,8.04598141461206,101,"ENSG00000079974.19"
"11744","ENSG00000135951.16_5216",5208,5216,9,"ENSG00000135951.16",1,1,"MVVVVVVVV",0,8,0.90600414078675,109,115,133,136,163,169,185,188,"AGGATGT","ATGA","GTAATCC","CTGA",2.42626106304238,18,27,16,70,1.51248718212278,4.42189023393467,8.04590679708166,101,"ENSG00000079974.19"
"17893","ENSG00000155761.14_110762",110754,110762,9,"ENSG00000155761.14",1,2,"VMVVUVVVV",1,7,0.773913043478261,85,91,101,104,113,119,133,136,"TAGATGA","CTGA","ATGACTT","CTGA",2.55634196961605,10,9,14,42,2.75865799256749,4.95023444750196,8.045886621415,101,"ENSG00000079974.19"
"34372","ENSG00000232860.10_4775",4767,4775,9,"ENSG00000232860.10",1,5,"VVVVMVVVV",0,8,0.886542443064182,112,118,133,136,146,152,164,167,"GCCATGA","CTAA","ATATTTA","CTGA",2.28433128914899,15,10,12,46,2.76986761191382,4.49968571822677,8.0458554904835,101,"ENSG00000079974.19"
"6704","ENSG00000111602.12_31224",31216,31224,9,"ENSG00000111602.12",0,NA,"VVVUVVVVV",1,8,0.880745341614907,111,117,133,136,170,176,223,226,"ATGAGGA","CCGA","AAGAAGA","CTGA",2.58367013919665,16,34,47,106,0.866879029795795,4.52283665611003,8.04581802256966,101,"ENSG00000079974.19"
"2744","ENSG00000078018.22_17649",17641,17649,9,"ENSG00000078018.22",0,NA,"VVUVVVUVV",2,7,0.769772256728778,115,121,133,136,142,148,175,178,"ATGATGA","GGGA","GTGATTT","CTGA",2.65189119422927,12,6,27,54,2.18761328221936,4.96672197760363,8.04581100451874,101,"ENSG00000079974.19"
"16273","ENSG00000151276.24_315173",315165,315173,9,"ENSG00000151276.24",1,7,"UVVVVVMVV",1,7,0.787991718426501,104,110,133,136,146,152,163,166,"ATGATGT","CTAA","TTGTTGT","CTGA",2.61270215737077,23,10,11,53,2.15715684371455,4.89379280654659,8.0457596802526,101,"ENSG00000079974.19"
"5303","ENSG00000104313.20_315443",315435,315443,9,"ENSG00000104313.20",1,2,"VMVVVVVVV",0,8,0.884057971014493,85,91,101,104,116,122,133,136,"ATAATGA","CTTA","TTTAGGA","CAGA",2.3024622072815,10,12,11,42,2.68834735019944,4.5095238496857,8.04575573374367,101,"ENSG00000079974.19"
"24476","ENSG00000176542.10_39001",38993,39001,9,"ENSG00000176542.10",1,7,"VVVVVVMVV",0,8,0.885300207039338,93,99,133,136,153,159,170,173,"AAGATGA","CTGT","GGCTTGA","CTGA",2.48880981856063,34,17,11,71,1.42603071870174,4.50452404394315,8.04572487210051,101,"ENSG00000079974.19"
"30784","ENSG00000213468.7_22997",22989,22997,9,"ENSG00000213468.7",0,NA,"VVVVVVUVV",1,8,0.886128364389234,115,121,133,136,162,168,180,183,"CTTTTGA","CTAA","ATGATAA","CTGA",2.39133135113758,12,26,12,59,2.06252025792554,4.50118231637735,8.04569577393429,101,"ENSG00000079974.19"
"46371","ENSG00000286523.1_22828",22820,22828,9,"ENSG00000286523.1",1,1,"MVVVVVVVV",0,8,0.90600414078675,82,88,133,136,165,171,186,189,"TTAATGA","ATGA","ATGAAAA","CTGA",2.52114473906138,45,29,15,98,0.878696675365736,4.42158206727707,8.04559863042406,101,"ENSG00000079974.19"
"12574","ENSG00000138653.10_9657",9649,9657,9,"ENSG00000138653.10",1,1,"MVVVVVVVV",0,8,0.90600414078675,114,120,133,136,149,155,166,169,"AGGCTGA","ATAA","GTTTTGC","CTGA",2.25096480827483,13,13,11,46,2.67966633841436,4.42152459839498,8.04554116154198,101,"ENSG00000079974.19"
"27109","ENSG00000185565.12_501630",501622,501630,9,"ENSG00000185565.12",1,6,"UVVVVMVVV",1,7,0.805383022774327,63,69,107,110,115,121,133,136,"ATGATGA","CTGA","GTTAGGA","CTGT",2.61052123552124,38,5,12,64,1.89247234732357,4.82398681269962,8.04551890379693,101,"ENSG00000079974.19"
"43561","ENSG00000272368.2_45291",45283,45291,9,"ENSG00000272368.2",1,6,"VVVVVMVVV",0,8,0.902691511387163,114,120,133,136,173,179,189,192,"AATATGA","CTGC","ATAAACA","CTGA",2.35948356023335,13,37,10,69,2.00903211378403,4.43473062883493,8.04549667438358,101,"ENSG00000079974.19"
"23891","ENSG00000174469.23_927437",927429,927437,9,"ENSG00000174469.23",1,2,"VMVVVUVVV",1,7,0.806211180124223,48,54,61,64,77,83,133,136,"ATAATGA","CTGA","CTGATCC","CTGA",2.69611641457972,7,13,50,79,1.30833355340882,4.82061074598507,8.04545546648196,101,"ENSG00000079974.19"
"40469","ENSG00000256394.3_3566",3558,3566,9,"ENSG00000256394.3",1,8,"VVVUVVVMV",1,7,0.764803312629399,60,66,106,109,115,121,133,136,"ATGATGA","CTGT","GTGCGGC","CTGA",2.70021595829246,40,6,12,67,1.94327781325734,4.98617938380177,8.04539263431937,101,"ENSG00000079974.19"
"22642","ENSG00000171044.11_259783",259775,259783,9,"ENSG00000171044.11",1,2,"VMVVVVVVV",0,8,0.884057971014493,111,117,133,136,140,146,202,205,"AAGATGG","CTCA","GGGATAA","CTGA",2.45400558850122,16,4,56,85,1.67618988694369,4.50905678590463,8.0452886699626,101,"ENSG00000079974.19"
"18941","ENSG00000159398.16_79878",79870,79878,9,"ENSG00000159398.16",0,NA,"VVVVUVVVV",1,8,0.889855072463768,74,80,95,98,104,110,133,136,"GTGAAGA","CTGA","GGGAAGC","GTGA",2.35369846687221,15,6,23,53,2.25213989393559,4.48586575160424,8.04528604145931,101,"ENSG00000079974.19"
"230","ENSG00000006740.18_28044",28036,28044,9,"ENSG00000006740.18",1,2,"VMVVVUVVV",1,7,0.806211180124223,116,122,133,136,162,168,178,181,"GAGATGA","CTGA","TAAATGA","CTGA",2.58038728566251,11,26,10,56,2.07911204100255,4.82042348635483,8.04526820685172,101,"ENSG00000079974.19"
"11140","ENSG00000134030.14_23659",23651,23659,9,"ENSG00000134030.14",0,NA,"VVVVVUVVV",1,8,0.922153209109731,104,110,133,136,184,190,200,203,"CTTATGC","CTGT","ATGATCA","CTGA",2.42276484583561,23,48,10,90,1.27436808537398,4.35653343106952,8.04514626750844,101,"ENSG00000079974.19"
"2470","ENSG00000075151.24_251329",251321,251329,9,"ENSG00000075151.24",1,8,"VVVVVVVMV",0,8,0.884057971014493,70,76,106,109,113,119,133,136,"ATGATAA","CTGA","ATTAGGA","CAGA",2.44242568776686,30,4,14,57,1.75266806592081,4.50887649609163,8.0451083801496,101,"ENSG00000079974.19"
"13005","ENSG00000139865.17_323196",323188,323196,9,"ENSG00000139865.17",1,8,"VVVVVVVMV",0,8,0.884057971014493,110,116,133,136,143,149,200,203,"ATGAGGA","CTTT","CTGCTGC","CTGA",2.44172909380207,17,7,51,84,1.75693063527505,4.50878114848888,8.04501303254685,101,"ENSG00000079974.19"
"15849","ENSG00000149972.12_183814",183806,183814,9,"ENSG00000149972.12",1,8,"VVVVVUVMV",1,7,0.806211180124224,114,120,133,136,143,149,157,160,"GTGAGGT","CTGC","ATGAATA","CTGA",2.43390712591265,13,7,8,37,3.05461656648853,4.82016601814322,8.04501073864011,101,"ENSG00000079974.19"
"36199","ENSG00000238276.7_25214",25206,25214,9,"ENSG00000238276.7",1,7,"VVVVVVMVV",0,8,0.885300207039338,84,90,104,107,115,121,133,136,"AAAATGC","CTGT","AAAATGA","CTGA",2.2641285829849,14,8,12,43,2.92097912702687,4.50379242006489,8.04499324822224,101,"ENSG00000079974.19"
"36297","ENSG00000239704.12_14747",14739,14747,9,"ENSG00000239704.12",1,2,"VMVVVVVVV",0,8,0.884057971014493,104,110,133,136,169,175,185,188,"ATGATCA","GCGA","TTGGTGA","CTGA",2.50992830892573,23,33,10,75,1.30217038415905,4.50875644424931,8.04498832830728,101,"ENSG00000079974.19"
"41411","ENSG00000259024.7_102580",102572,102580,9,"ENSG00000259024.7",1,2,"VMVVVVVVV",0,8,0.884057971014493,104,110,133,136,169,175,185,188,"ATGATCA","GCGA","TTGGTGA","CTGA",2.50992830892573,23,33,10,75,1.30217038415905,4.50875644424931,8.04498832830728,101,"ENSG00000079974.19"
"20281","ENSG00000164597.15_1551",1543,1551,9,"ENSG00000164597.15",1,7,"VVVVVVMVV",0,8,0.885300207039338,103,109,133,136,140,146,201,204,"ATGATAA","ATGA","TTTCTGA","CTGA",2.54377564228288,24,4,55,92,1.05651421774746,4.50375462490833,8.04495545306568,101,"ENSG00000079974.19"
"10778","ENSG00000132837.15_203418",203410,203418,9,"ENSG00000132837.15",1,8,"VVVVVVVMV",0,8,0.884057971014493,71,77,96,99,107,113,133,136,"AGAAGGA","CTGA","GTGAAAC","CTGA",2.3932478923878,19,8,20,56,2.07988202569179,4.50871699373595,8.04494887779392,101,"ENSG00000079974.19"
"39052","ENSG00000251567.5_255767",255759,255767,9,"ENSG00000251567.5",1,2,"VMVVVVVVV",0,8,0.884057971014493,112,118,133,136,148,154,166,169,"TTGAGGA","TTGC","GTCTTGG","CTGA",2.30994220585603,15,12,12,48,2.6352298265801,4.50871113307175,8.04494301712972,101,"ENSG00000079974.19"
"10484","ENSG00000131370.16_56575",56567,56575,9,"ENSG00000131370.16",0,NA,"VVVVVUVVV",1,8,0.922153209109731,116,122,133,136,146,152,168,171,"GCCAAGA","CTGG","TTGCAGA","CTGA",2.21836258732562,11,10,16,46,2.63565755816795,4.35618536841802,8.04479820485694,101,"ENSG00000079974.19"
"20494","ENSG00000164970.15_24163",24155,24163,9,"ENSG00000164970.15",1,8,"VVVVVVVMV",0,8,0.884057971014493,116,122,133,136,159,165,176,179,"AAAATGA","TTGA","ATAAATA","CTGA",2.38506872544492,11,23,11,54,2.13375658766859,4.50855368932535,8.04478557338332,101,"ENSG00000079974.19"
"318","ENSG00000008196.13_20827",20819,20827,9,"ENSG00000008196.13",0,NA,"UVVVVVUVV",2,7,0.788819875776397,102,108,133,136,146,152,162,165,"CTGCTGT","CTGA","ATGATGA","CTGA",2.62319279406435,25,10,10,54,2.07002668363077,4.88949466101495,8.04477416412054,101,"ENSG00000079974.19"
"48429","ENSG00000291097.1_11636",11628,11636,9,"ENSG00000291097.1",0,NA,"VVVVVVUVV",1,8,0.886128364389234,74,80,92,95,110,116,133,136,"AAGATGT","CTGA","GAGAAGA","CCGA",2.36235164460509,12,15,17,53,2.25175894151834,4.50019247638806,8.04470593394499,101,"ENSG00000079974.19"
"46986","ENSG00000287452.2_2151",2143,2151,9,"ENSG00000287452.2",0,NA,"UVVVUVVVV",2,7,0.792546583850932,111,117,133,136,141,147,162,165,"TTGATGT","CTGT","GAGAAGA","CTGA",2.53580968981509,16,5,15,45,2.59247467372287,4.87446815145587,8.0446544868596,101,"ENSG00000079974.19"
"44830","ENSG00000283692.2_241702",241694,241702,9,"ENSG00000283692.2",1,1,"MVVVVVVVV",0,8,0.90600414078675,105,111,133,136,141,147,183,186,"ATAATGG","AAGA","GTGATTA","CTGA",2.4554758138881,22,5,36,72,1.3126035102769,4.42061056738272,8.04462713052972,101,"ENSG00000079974.19"
"38091","ENSG00000249494.6_10192",10184,10192,9,"ENSG00000249494.6",1,1,"MVVVVVVVV",0,8,0.90600414078675,72,78,92,95,109,115,133,136,"ATAATGA","CTGG","TTGCTGC","TTGA",2.31893897481428,14,14,18,55,2.2227923270347,4.4205963731158,8.0446129362628,101,"ENSG00000079974.19"
"8545","ENSG00000119509.13_176471",176463,176471,9,"ENSG00000119509.13",0,NA,"VVUVVVUVV",2,7,0.769772256728778,115,121,133,136,152,158,167,170,"ATGAGGA","CTTA","GTGATTT","CTGA",2.60553340577988,12,16,9,46,2.49153733158579,4.96544000919625,8.04452903611136,101,"ENSG00000079974.19"
"14254","ENSG00000144642.22_283996",283988,283996,9,"ENSG00000144642.22",1,2,"VMVVVVVVV",0,8,0.884057971014493,71,77,103,106,115,121,133,136,"CTGATGA","CAGA","AGGAAGA","CTCA",2.3986366501558,26,9,12,56,2.04223890616466,4.50828747680084,8.04451936085881,101,"ENSG00000079974.19"
"44797","ENSG00000283563.1_509609",509601,509609,9,"ENSG00000283563.1",1,2,"VMVVVVVVV",0,8,0.884057971014493,71,77,103,106,115,121,133,136,"CTGATGA","CAGA","AGGAAGA","CTCA",2.3986366501558,26,9,12,56,2.04223890616466,4.50828747680084,8.04451936085881,101,"ENSG00000079974.19"
"33303","ENSG00000229272.2_135976",135968,135976,9,"ENSG00000229272.2",1,1,"MVVVUVVVV",1,7,0.795859213250517,81,87,109,112,115,121,133,136,"GTGATGA","CTTA","ATGTTAG","CTGA",2.61661774126215,22,3,12,46,2.00007990726766,4.86104954558717,8.04448639858924,101,"ENSG00000079974.19"
"43012","ENSG00000267586.7_389343",389335,389343,9,"ENSG00000267586.7",1,1,"MVVVVVVVV",0,8,0.90600414078675,115,121,133,136,141,147,171,174,"AAGATGA","GAGA","GTGCTGA","CTGG",2.31534710757054,12,5,24,50,2.24619869107756,4.42046151872029,8.04447808186729,101,"ENSG00000079974.19"
"27085","ENSG00000185532.20_682526",682518,682526,9,"ENSG00000185532.20",1,2,"VMVVVUVVV",1,7,0.806211180124223,45,51,65,68,80,86,133,136,"ATGATAA","CAGA","GTGAGGG","CTGA",2.63159815268439,14,12,47,82,1.73454444834387,4.81963303322662,8.04447775372352,101,"ENSG00000079974.19"
"12145","ENSG00000137473.19_220949",220941,220949,9,"ENSG00000137473.19",1,2,"VMVVVVVVV",0,8,0.884057971014493,97,103,133,136,147,153,166,169,"AAGGTGA","CAGA","ATTAAGA","CTGA",2.43524451252341,30,11,13,63,1.79776154613285,4.5081812407389,8.04441312479688,101,"ENSG00000079974.19"
"32873","ENSG00000228204.2_53353",53345,53353,9,"ENSG00000228204.2",1,1,"MVVVVVUVV",1,7,0.792132505175983,72,78,92,95,113,119,133,136,"GTGATGA","GAGA","GTGGTAA","CTGA",2.59430680783185,14,18,14,55,2.20805483040527,4.87585838732107,8.044388408025,101,"ENSG00000079974.19"
"39963","ENSG00000254532.2_256655",256647,256655,9,"ENSG00000254532.2",1,1,"MVVVVVVVV",0,8,0.90600414078675,74,80,96,99,113,119,133,136,"AAGATGA","GTGA","GAGAAAA","ATGA",2.30236310790397,16,14,14,53,2.33221137617902,4.42032469055138,8.04434125369837,101,"ENSG00000079974.19"
"7484","ENSG00000114439.19_161480",161472,161480,9,"ENSG00000114439.19",1,5,"VVVVMVVVV",0,8,0.886542443064182,115,121,133,136,145,151,180,183,"TTTCTGA","CTGT","ATGCTGA","CTGA",2.38395044922305,12,9,29,59,2.09966542519814,4.49816710500462,8.04433687726135,101,"ENSG00000079974.19"
"19489","ENSG00000163116.10_343596",343588,343596,9,"ENSG00000163116.10",1,1,"MVVVVVVVV",0,8,0.90600414078675,67,73,85,88,97,103,133,136,"GTGATGG","ATGA","GAGAAGA","ATGA",2.34053368990102,12,9,30,60,2.07730810959138,4.42021651056621,8.04423307371321,101,"ENSG00000079974.19"
"25909","ENSG00000183098.11_1040970",1040962,1040970,9,"ENSG00000183098.11",1,8,"VVVVVVVMV",0,8,0.884057971014493,83,89,101,104,113,119,133,136,"GTGATGA","TTGT","GTGCTTT","CTTA",2.28015740957341,12,9,14,44,2.83078849053812,4.50795947192355,8.04419135598152,101,"ENSG00000079974.19"
"23161","ENSG00000172264.19_530986",530978,530986,9,"ENSG00000172264.19",1,1,"MVVVVVVVV",0,8,0.90600414078675,116,122,133,136,153,159,179,182,"AGGATGG","CACA","ATGATCT","CTGA",2.36418346328598,11,17,20,57,1.919320070133,4.42013578967656,8.04415235282355,101,"ENSG00000079974.19"
"21360","ENSG00000167291.16_57162",57154,57162,9,"ENSG00000167291.16",1,8,"VVVVVVVMV",0,8,0.884057971014493,114,120,133,136,142,148,156,159,"ACGCTGA","CAGT","ATCACGT","CTGA",2.24540230882537,13,6,8,36,3.06214521483788,4.50787348508509,8.04410536914306,101,"ENSG00000079974.19"
"36742","ENSG00000242808.12_561433",561425,561433,9,"ENSG00000242808.12",0,NA,"VVVVVUVVV",1,8,0.922153209109731,114,120,133,136,140,146,188,191,"ATCATTA","TTAA","ATGAGAA","CTGA",2.33615261096233,13,4,42,68,1.84706166740264,4.35535310178787,8.0439659382268,101,"ENSG00000079974.19"
"38359","ENSG00000250048.2_61354",61346,61354,9,"ENSG00000250048.2",0,NA,"UVVVUVVVV",2,7,0.792546583850932,64,70,87,90,111,117,133,136,"CTGATGT","CTGA","CTGAAAA","CTGA",2.6614796915829,17,21,16,63,1.75187939181211,4.87376933392453,8.04395566932826,101,"ENSG00000079974.19"
"28665","ENSG00000196301.3_2262",2254,2262,9,"ENSG00000196301.3",0,NA,"VVVVUUVVV",2,7,0.812008281573499,115,121,133,136,141,147,166,169,"AGGATGA","GAGA","GTCAGGA","CTGA",2.50060806763082,12,5,19,45,2.5129201868511,4.7959101594308,8.0439432857248,101,"ENSG00000079974.19"
"18901","ENSG00000159216.19_445919",445911,445919,9,"ENSG00000159216.19",1,6,"VVVVVMVVV",0,8,0.902691511387163,115,121,133,136,147,153,163,166,"GTTAAGA","CTTT","CTGGTGC","CTGA",2.23199247380169,12,11,10,42,2.85263932279037,4.43314728703374,8.04391333258239,101,"ENSG00000079974.19"
"13373","ENSG00000141255.13_47118",47110,47118,9,"ENSG00000141255.13",0,NA,"VVVVUVVVV",1,8,0.889855072463768,83,89,105,108,112,118,133,136,"ATGAGGG","CTGT","GTGAGGA","TTGA",2.31544132344615,16,4,15,44,2.50144838041652,4.48443096751438,8.04385125736945,101,"ENSG00000079974.19"
"10091","ENSG00000129158.11_94044",94036,94044,9,"ENSG00000129158.11",1,6,"UVVVVMVVV",1,7,0.805383022774327,90,96,133,136,151,157,168,171,"ATGATGA","CTGC","ATTTAGA","CTGA",2.66180223167473,37,15,11,72,1.54388143076807,4.82230741048323,8.04383950158054,101,"ENSG00000079974.19"
"38356","ENSG00000250043.1_24257",24249,24257,9,"ENSG00000250043.1",1,1,"MVVVVVVVV",0,8,0.90600414078675,110,116,133,136,140,146,157,160,"AATATGG","CGAA","ATGATGG","CTGA",2.26147796782912,17,4,11,41,2.60270341598938,4.41980580037921,8.04382236352621,101,"ENSG00000079974.19"
"37346","ENSG00000247498.11_48003",47995,48003,9,"ENSG00000247498.11",1,7,"VVVVVVMVV",0,8,0.885300207039338,114,120,133,136,142,148,164,167,"GTTTTGA","GTAA","GTGAAAA","CTGA",2.28955339105301,13,6,16,44,2.74664955069004,4.50258470609419,8.04378553425154,101,"ENSG00000079974.19"
"19545","ENSG00000163249.13_28939",28931,28939,9,"ENSG00000163249.13",1,1,"MVVVVVVVV",0,8,0.90600414078675,116,122,133,136,146,152,162,165,"ATGCTGA","GTCA","CTGAAGG","CGGA",2.2158855251164,11,10,10,40,2.90610893538618,4.41966977570722,8.04368633885422,101,"ENSG00000079974.19"
"40862","ENSG00000257986.3_352670",352662,352670,9,"ENSG00000257986.3",1,7,"UVVVVVMVV",1,7,0.787991718426501,86,92,103,106,114,120,133,136,"CTGTTGA","CAGA","TTGAAGG","CTGA",2.49929750561884,11,8,13,41,2.90473314802163,4.89167912970347,8.04364600340947,101,"ENSG00000079974.19"
"27677","ENSG00000187118.14_51870",51862,51870,9,"ENSG00000187118.14",1,2,"VMVVUVVVV",1,7,0.773913043478261,89,95,106,109,116,122,133,136,"ATGATGA","TTGA","ATGATTT","GTGA",2.51573610503718,11,7,11,38,3.0203974279366,4.94799286537946,8.0436450392925,101,"ENSG00000079974.19"
"742","ENSG00000030419.17_67730",67722,67730,9,"ENSG00000030419.17",0,NA,"VVUVVVVVV",1,8,0.883643892339545,103,109,133,136,138,144,152,155,"ATGATAA","TTCA","ATAATGC","CTGA",2.4450357689615,24,2,8,43,1.73578345126629,4.5090054777524,8.04358104711058,101,"ENSG00000079974.19"
"26129","ENSG00000183475.13_26979",26971,26979,9,"ENSG00000183475.13",1,8,"VVVVVVVMV",0,8,0.884057971014493,84,90,97,100,114,120,133,136,"TTGATGT","CTGA","ATCATTA","ATGA",2.37945232225622,7,14,13,43,2.16605672498635,4.50726805167362,8.04349993573159,101,"ENSG00000079974.19"
"6387","ENSG00000109670.17_183807",183799,183807,9,"ENSG00000109670.17",1,8,"VVVVVVVMV",0,8,0.884057971014493,85,91,133,136,141,147,163,166,"ATCATGA","TTAA","AAGATAA","CTGA",2.45072511615983,42,5,16,72,1.69066594180959,4.50720834571879,8.04344022977676,101,"ENSG00000079974.19"
"4068","ENSG00000092964.18_7278",7270,7278,9,"ENSG00000092964.18",1,8,"VVVVVUVMV",1,7,0.806211180124224,82,88,104,107,110,116,133,136,"ATGCAGA","CTGA","CTGAGGG","CTGA",2.55477765168132,16,3,17,45,2.24241190716345,4.81856572959306,8.04341045008996,101,"ENSG00000079974.19"
"1875","ENSG00000066933.16_71210",71202,71210,9,"ENSG00000066933.16",1,1,"MVVVVVVVV",0,8,0.90600414078675,113,119,133,136,145,151,163,166,"ATAAGGT","ATAA","TTGAAGG","CTGA",2.21944301213148,14,9,12,44,2.88123422355851,4.41938024277542,8.04339680592242,101,"ENSG00000079974.19"
"6975","ENSG00000112394.18_135754",135746,135754,9,"ENSG00000112394.18",1,7,"VVVVVVMVV",0,8,0.885300207039338,52,58,71,74,115,121,133,136,"GTGAAGA","CTGA","CTGAAAA","CTTA",2.40736038772163,13,41,12,75,1.95970242656672,4.50219291951106,8.04339374766841,101,"ENSG00000079974.19"
"2593","ENSG00000076356.7_158274",158266,158274,9,"ENSG00000076356.7",1,7,"VVVVVVMVV",0,8,0.885300207039338,87,93,133,136,140,146,160,163,"GTGAGGA","ATCA","GTGAATA","CTGA",2.44472137841232,40,4,14,67,1.71053094737324,4.50216836753052,8.04336919568787,101,"ENSG00000079974.19"
"24752","ENSG00000177807.10_10008",10000,10008,9,"ENSG00000177807.10",0,NA,"UVVVVVVVV",1,8,0.902691511387163,112,118,133,136,165,171,187,190,"ATAAGGA","GAGA","ATGGTGA","CTGA",2.40011591395632,15,29,16,69,1.72928173280805,4.43251362312922,8.04327966867787,101,"ENSG00000079974.19"
"1391","ENSG00000054965.11_181915",181907,181915,9,"ENSG00000054965.11",1,8,"VVVVVUVMV",1,7,0.806211180124224,47,53,91,94,110,116,133,136,"GTGATGC","CTGA","GTGAAAA","CTGA",2.71263428875241,38,16,17,80,1.189273270711,4.81837546559843,8.04322018609532,101,"ENSG00000079974.19"
"35854","ENSG00000237356.7_341697",341689,341697,9,"ENSG00000237356.7",1,7,"VVVVVVMVV",0,8,0.885300207039338,94,100,133,136,183,189,204,207,"ATGATGT","GTTA","ATGTTGA","CTGA",2.5758407300799,33,47,15,104,0.835785332230425,4.50201421652411,8.04321504468146,101,"ENSG00000079974.19"
"35408","ENSG00000235958.5_6880",6872,6880,9,"ENSG00000235958.5",1,8,"VVVVVVUMV",1,7,0.770186335403727,105,111,133,136,146,152,162,165,"ATGATGG","CTGG","GTGAGCA","CTGA",2.64212406713641,22,10,10,51,2.2356869146,4.96246184054402,8.04320718215893,101,"ENSG00000079974.19"
"16141","ENSG00000150907.10_82739",82731,82739,9,"ENSG00000150907.10",1,6,"VVVVVMVVV",0,8,0.902691511387163,47,53,64,67,110,116,133,136,"AGGAAGA","CTGA","GTGAGGA","CAGA",2.40798476528121,11,43,17,80,1.67641363928022,4.43241135195541,8.04317739750406,101,"ENSG00000079974.19"
"47477","ENSG00000288542.1_27225",27217,27225,9,"ENSG00000288542.1",1,6,"VVVVVMVVV",0,8,0.902691511387163,47,53,64,67,110,116,133,136,"AGGAAGA","CTGA","GTGAGGA","CAGA",2.40798476528121,11,43,17,80,1.67641363928022,4.43241135195541,8.04317739750406,101,"ENSG00000079974.19"
"35229","ENSG00000235437.10_197015",197007,197015,9,"ENSG00000235437.10",1,1,"MVVVVVUVV",1,7,0.792132505175983,77,83,99,102,114,120,133,136,"ATGAGGA","GTGA","AAAATGA","CTGA",2.54622785492239,16,12,13,50,2.52363528668645,4.87462191320893,8.04315193391286,101,"ENSG00000079974.19"
"29417","ENSG00000197959.15_485461",485453,485461,9,"ENSG00000197959.15",1,1,"MVVVVVVVV",0,8,0.90600414078675,66,72,85,88,97,103,133,136,"GTGATGG","ATGA","GAGAAGA","ATGA",2.34053368990102,13,9,30,61,2.0727745457934,4.41908311961671,8.04309968276371,101,"ENSG00000079974.19"
"40760","ENSG00000257545.5_72811",72803,72811,9,"ENSG00000257545.5",1,7,"VVVVVVMVV",0,8,0.885300207039338,112,118,133,136,145,151,160,163,"ATGATTA","CTAA","GTAAACA","CAGA",2.26966023656222,15,9,9,42,2.87609901230305,4.5017918140128,8.04299264217015,101,"ENSG00000079974.19"
"16781","ENSG00000152223.16_54878",54870,54878,9,"ENSG00000152223.16",0,NA,"VVVVVUVVV",1,8,0.922153209109731,85,91,133,136,142,148,178,181,"ATGTTCA","CAGA","CTGAAGC","CTGA",2.44592949840909,42,6,30,87,1.1111454663754,4.354335530609,8.04294836704792,101,"ENSG00000079974.19"
"5296","ENSG00000104313.20_122265",122257,122265,9,"ENSG00000104313.20",1,7,"VVUVVVMVV",1,7,0.768944099378882,42,48,60,63,114,120,133,136,"ATGATCA","CTGA","AAGAGGA","CTGA",2.69229308922543,12,51,13,85,1.91994630186007,4.96714172417407,8.04291812168959,101,"ENSG00000079974.19"
"8779","ENSG00000120658.14_91211",91203,91211,9,"ENSG00000120658.14",0,NA,"UVVVVVVVV",1,8,0.902691511387163,90,96,133,136,142,148,192,195,"ATGAGGA","AAGA","ATGAGGC","CTGA",2.50969676031088,37,6,44,96,0.997223872069085,4.43213390186874,8.04289994741739,101,"ENSG00000079974.19"
"26840","ENSG00000185052.13_407221",407213,407221,9,"ENSG00000185052.13",0,NA,"UVVVVVVVV",1,8,0.902691511387163,103,109,133,136,151,157,171,174,"ATTATGA","ATGT","ATGGCAA","CTGA",2.41278296604102,24,15,14,62,1.64317605283275,4.43209895660988,8.04286500215854,101,"ENSG00000079974.19"
"41608","ENSG00000259345.7_524427",524419,524427,9,"ENSG00000259345.7",1,1,"MVVVVVVVV",0,8,0.90600414078675,112,118,133,136,148,154,168,171,"AGGAGGA","CCAA","GTGGCTA","CTGA",2.26918892715355,15,12,14,50,2.54745203628129,4.41884455432624,8.04286111747324,101,"ENSG00000079974.19"
"63","ENSG00000003393.16_69061",69053,69061,9,"ENSG00000003393.16",1,1,"MVVVVVVVV",0,8,0.90600414078675,88,94,103,106,113,119,133,136,"GTGAAGA","TTGA","ATCAAGT","GTGA",2.23843191746924,9,7,14,39,2.75241366960942,4.41882327985108,8.04283984299808,101,"ENSG00000079974.19"
"14480","ENSG00000145087.13_426707",426699,426707,9,"ENSG00000145087.13",1,7,"VVVVVVMVV",0,8,0.885300207039338,94,100,133,136,149,155,211,214,"ATGATCA","CTCA","ATGAAGG","CTGA",2.5942249804408,33,13,56,111,0.711699496357856,4.50163317482413,8.04283400298148,101,"ENSG00000079974.19"
"47984","ENSG00000289899.1_41816",41808,41816,9,"ENSG00000289899.1",1,1,"MVVVVVVVV",0,8,0.90600414078675,89,95,133,136,162,168,180,183,"GGGATGA","ATGA","ATGCGCA","CTGA",2.49142508247819,38,26,12,85,1.0654281788957,4.41873218218757,8.04274874533457,101,"ENSG00000079974.19"
"15553","ENSG00000148655.15_968518",968510,968518,9,"ENSG00000148655.15",0,NA,"VVVVUVVVV",1,8,0.889855072463768,115,121,133,136,187,193,227,230,"TTGATGA","ATGT","GTAAGGA","CTGA",2.53031185034169,12,51,34,106,1.06446717036129,4.48330320982647,8.04272349968155,101,"ENSG00000079974.19"
"18525","ENSG00000157570.12_88406",88398,88406,9,"ENSG00000157570.12",0,NA,"UVVVVVVVV",1,8,0.902691511387163,107,113,133,136,141,147,198,201,"AAGATAA","ATGC","ATGATGA","CTGA",2.44560754503659,20,5,51,85,1.42377005526778,4.43195508887793,8.04272113442658,101,"ENSG00000079974.19"
"15497","ENSG00000148498.17_476122",476114,476122,9,"ENSG00000148498.17",1,1,"MVVVVVVVV",0,8,0.90600414078675,115,121,133,136,144,150,168,171,"TAGAAGA","TTGG","GTGCAGA","CTGA",2.25737879412628,12,8,18,47,2.62562570194296,4.4187044156962,8.0427209788432,101,"ENSG00000079974.19"
"28699","ENSG00000196353.13_686205",686197,686205,9,"ENSG00000196353.13",1,6,"VVVVVMVVV",0,8,0.902691511387163,109,115,133,136,146,152,162,165,"ATGTTTA","TTAA","GTGTCAA","CTGA",2.27405792100067,18,10,10,47,2.56731219017298,4.43192458254436,8.04269062809301,101,"ENSG00000079974.19"
"33991","ENSG00000231689.3_36017",36009,36017,9,"ENSG00000231689.3",1,1,"MVVVVVVVV",0,8,0.90600414078675,111,117,133,136,159,165,175,178,"TTGATAA","CAGT","TTGACCA","CTGA",2.34956222032473,16,23,10,58,2.01094528239038,4.41867335447215,8.04268991761915,101,"ENSG00000079974.19"
"21750","ENSG00000168843.14_586758",586750,586758,9,"ENSG00000168843.14",0,NA,"UVVVVVVVV",1,8,0.902691511387163,53,59,76,79,93,99,133,136,"ATCATGT","CTTA","TAGAGGA","CTGA",2.44294358192285,17,14,34,74,1.44137802028526,4.43191714160941,8.04268318715806,101,"ENSG00000079974.19"
"36805","ENSG00000243081.2_11264",11256,11264,9,"ENSG00000243081.2",0,NA,"VVVUVVVVV",1,8,0.880745341614907,41,47,66,69,78,84,133,136,"CTGATGC","ATGA","ATGTACA","CTGA",2.48222812087297,19,9,49,86,1.5305079887724,4.51967386531472,8.04265523177435,101,"ENSG00000079974.19"
"26305","ENSG00000183826.18_100145",100137,100145,9,"ENSG00000183826.18",1,8,"VVVVVVVMV",0,8,0.884057971014493,99,105,133,136,141,147,158,161,"CTGATAA","CTAA","ATCAACA","CTGA",2.40454684256408,28,5,11,53,1.99537299314042,4.50642131922524,8.04265320328321,101,"ENSG00000079974.19"
"9867","ENSG00000127948.16_28416",28408,28416,9,"ENSG00000127948.16",1,2,"VMVVVVUVV",1,7,0.770186335403727,69,75,87,90,96,102,133,136,"ATGAAGA","CTGG","GTGATGC","CTGA",2.66343175229157,12,6,31,58,2.09110507583487,4.96182918944467,8.04257453105958,101,"ENSG00000079974.19"
"5757","ENSG00000106571.15_108580",108572,108580,9,"ENSG00000106571.15",1,1,"MVVVVVVVV",0,8,0.90600414078675,105,111,133,136,143,149,171,174,"ATTATGT","CAGT","ATGAAAA","CTGA",2.38939704456323,22,7,22,60,1.74458986263098,4.41847587326312,8.04249243641012,101,"ENSG00000079974.19"
"27423","ENSG00000186132.15_58903",58895,58903,9,"ENSG00000186132.15",0,NA,"VVUVVVVVV",1,8,0.883643892339545,114,120,133,136,185,191,239,242,"GTGATGT","CTCA","GTTTTGA","CTGA",2.55464526310879,13,49,48,119,1.00063189874922,4.50790007986862,8.0424756492268,101,"ENSG00000079974.19"
"32436","ENSG00000226995.9_25771",25763,25771,9,"ENSG00000226995.9",0,NA,"UVVVVVVVV",1,8,0.902691511387163,113,119,133,136,149,155,171,174,"AAGTTGC","CTGT","CTGATCT","CTGA",2.29647828448598,14,13,16,52,2.41686210039474,4.43167933257532,8.04244537812397,101,"ENSG00000079974.19"
"13466","ENSG00000141503.17_61683",61675,61683,9,"ENSG00000141503.17",1,1,"MVVVVVVVV",0,8,0.90600414078675,87,93,105,108,114,120,133,136,"ATTATGA","CTGA","GGGATGG","ATGG",2.21054741037539,12,6,13,40,2.93620699704671,4.41829743322067,8.04231399636766,101,"ENSG00000079974.19"
"47767","ENSG00000289228.2_75673",75665,75673,9,"ENSG00000289228.2",0,NA,"VVUVVVVVV",1,8,0.883643892339545,114,120,133,136,141,147,155,158,"TTGCTAA","ATGC","TTGCTGA","CTGA",2.24880597767883,13,5,8,35,3.03887925885067,4.50772977751072,8.0423053468689,101,"ENSG00000079974.19"
"22093","ENSG00000169826.8_4674",4666,4674,9,"ENSG00000169826.8",1,2,"VMVVVUVVV",1,7,0.806211180124223,116,122,133,136,177,183,193,196,"ATGAAGA","ATGA","TTGTGGA","CTGA",2.59333462919852,11,41,10,71,1.98078321785632,4.81742018646161,8.0422649069585,101,"ENSG00000079974.19"
"46631","ENSG00000286944.1_4591",4583,4591,9,"ENSG00000286944.1",0,NA,"VVVVVUVVV",1,8,0.922153209109731,84,90,133,136,140,146,198,201,"ATGAAGA","GTTA","ATGAGGG","CTGA",2.48619479224016,43,4,52,108,0.83984141834615,4.35361834165347,8.04223117809239,101,"ENSG00000079974.19"
"9469","ENSG00000124788.19_138830",138822,138830,9,"ENSG00000124788.19",1,1,"MVVVVVVVV",0,8,0.90600414078675,112,118,133,136,140,146,175,178,"AAGATGG","ATCA","ATGCAGA","CTGA",2.36643783066203,15,4,29,57,1.89618419413322,4.41810909963669,8.04212566278369,101,"ENSG00000079974.19"
"48207","ENSG00000290603.1_39254",39246,39254,9,"ENSG00000290603.1",1,8,"VVVVVVVMV",0,8,0.884057971014493,115,121,133,136,146,152,207,210,"GTGGTGA","ATGT","GGGAAGA","CTGA",2.41865847148648,12,10,55,86,1.89907930515915,4.50586727876725,8.04209916282522,101,"ENSG00000079974.19"
"31176","ENSG00000218305.5_1569",1561,1569,9,"ENSG00000218305.5",1,2,"VMVVVVVVV",0,8,0.884057971014493,108,114,133,136,143,149,163,166,"ATGGTTT","GTGA","CTGAAGG","CTGA",2.33604926816697,19,7,14,49,2.44938442174101,4.5057615523802,8.04199343643817,101,"ENSG00000079974.19"
"608","ENSG00000021645.20_1241757",1241749,1241757,9,"ENSG00000021645.20",0,NA,"UVVVVVVVV",1,8,0.902691511387163,59,65,84,87,116,122,133,136,"GTGATGG","CTGA","GTGAAAT","CTGG",2.41507055970932,19,29,11,68,1.62388358831124,4.43108849659335,8.041854542142,101,"ENSG00000079974.19"
"28727","ENSG00000196376.11_311227",311219,311227,9,"ENSG00000196376.11",1,1,"MVVVVVVVV",0,8,0.90600414078675,102,108,133,136,147,153,172,175,"AAGATGT","CTGA","TTGAAGA","CAGA",2.41329879711474,25,11,19,64,1.58211788336878,4.41769413270009,8.04171069584709,101,"ENSG00000079974.19"
"22104","ENSG00000169851.16_412167",412159,412167,9,"ENSG00000169851.16",1,1,"MVVVVVVVV",0,8,0.90600414078675,116,122,133,136,144,150,161,164,"CTAATGA","CATA","ATGATAA","ATGA",2.20176246747592,11,8,11,39,2.99201626321764,4.41760817826427,8.04162474141127,101,"ENSG00000079974.19"
"7978","ENSG00000116183.11_90047",90039,90047,9,"ENSG00000116183.11",1,7,"VVVVVVMVV",0,8,0.885300207039338,114,120,133,136,173,179,191,194,"GGGATCA","TTGA","GGGAAGA","CTGA",2.40517478554525,13,37,12,71,1.96712500590911,4.50040589405269,8.04160672221004,101,"ENSG00000079974.19"
"22479","ENSG00000170624.14_398765",398757,398765,9,"ENSG00000170624.14",0,NA,"VVUVVVVVV",1,8,0.883643892339545,110,116,133,136,161,167,179,182,"ATCATGT","CTTC","ATGAAGA","CTGA",2.42864784062461,17,25,12,63,1.83693634407316,4.50698048705931,8.04155605641748,101,"ENSG00000079974.19"
"41242","ENSG00000258733.7_224926",224918,224926,9,"ENSG00000258733.7",1,1,"MVVVVVVVV",0,8,0.90600414078675,88,94,133,136,153,159,174,177,"TTGATAA","CTAA","ATAAGGA","CTGA",2.46337372034165,39,17,15,80,1.24732411201304,4.41745389523934,8.04147045838634,101,"ENSG00000079974.19"
"26529","ENSG00000184349.14_54131",54123,54131,9,"ENSG00000184349.14",1,1,"MVVVVVVVV",0,8,0.90600414078675,116,122,133,136,180,186,194,197,"TTGTTGA","TTGG","GTAGTGA","CTGA",2.35672028452281,11,44,8,72,1.9581567577994,4.4174063303212,8.0414228934682,101,"ENSG00000079974.19"
"15342","ENSG00000147905.18_128152",128144,128152,9,"ENSG00000147905.18",1,2,"UMVVVVVVV",1,7,0.786749482401656,91,97,133,136,144,150,161,164,"ATGATGA","ATTA","TAGATGA","CTGA",2.63970588235294,36,8,11,64,1.9784766988863,4.89412897864314,8.04112690824977,101,"ENSG00000079974.19"
"39886","ENSG00000254394.2_623227",623219,623227,9,"ENSG00000254394.2",1,1,"MVVVVUVVV",1,7,0.82815734989648,114,120,133,136,147,153,197,200,"GTGATGT","CTGT","CTGCTGT","CTGA",2.56112189775345,13,11,44,77,1.83979223264071,4.72848455441592,8.04111395400184,101,"ENSG00000079974.19"
"4626","ENSG00000101349.17_193665",193657,193665,9,"ENSG00000101349.17",1,8,"VVVVVVVMV",0,8,0.884057971014493,83,89,102,105,113,119,133,136,"ATGATGA","CAGA","ATGCAGA","ATTA",2.273541432099,13,8,14,44,2.86230846435328,4.50481283625333,8.0410447203113,101,"ENSG00000079974.19"
"28662","ENSG00000196295.13_36694",36686,36694,9,"ENSG00000196295.13",1,2,"VMVVVVVVV",0,8,0.884057971014493,12,18,27,30,77,83,133,136,"ATGATGG","ATGA","GGGAGAA","CTGA",2.57667221431363,9,47,50,115,0.840476941275732,4.50457292584164,8.04080480989961,101,"ENSG00000079974.19"
"11760","ENSG00000135976.21_31953",31945,31953,9,"ENSG00000135976.21",1,5,"VVVVMVVVV",0,8,0.886542443064182,114,120,133,136,147,153,166,169,"GAAATGA","ATAA","ATGAGAA","CTGA",2.28362355868014,13,11,13,46,2.75395732407148,4.49452859548478,8.04069836774151,101,"ENSG00000079974.19"
"38016","ENSG00000249345.8_48854",48846,48854,9,"ENSG00000249345.8",1,2,"VMVVVVUVV",1,7,0.770186335403727,81,87,98,101,112,118,133,136,"AGAATGA","CTGA","GTGCTAA","CTGA",2.58128880247573,11,11,15,46,2.63110971553104,4.95992543300898,8.04067077462388,101,"ENSG00000079974.19"
"10511","ENSG00000131374.15_722182",722174,722182,9,"ENSG00000131374.15",0,NA,"VVUVVVVVV",1,8,0.883643892339545,19,25,42,45,72,78,133,136,"ATCATGC","CTGA","GGGATAA","CTGA",2.57711112885998,17,27,55,108,0.843397537443102,4.50603459912741,8.04061016848559,101,"ENSG00000079974.19"
"23595","ENSG00000173406.16_1225405",1225397,1225405,9,"ENSG00000173406.16",1,8,"VVVVVVVMV",0,8,0.884057971014493,115,121,133,136,145,151,159,162,"GTGGTGC","ATGG","GTGAGTC","CTGA",2.25399179586,12,9,8,38,2.99071377040895,4.50433143570224,8.04056331976021,101,"ENSG00000079974.19"
"14049","ENSG00000144290.17_456583",456575,456583,9,"ENSG00000144290.17",1,8,"VVVVVVVMV",0,8,0.884057971014493,116,122,133,136,177,183,193,196,"ATGAGTA","GTGA","GTGACCT","CTGA",2.40547291729245,11,41,10,71,1.98078321785632,4.50431733328483,8.0405492173428,101,"ENSG00000079974.19"
"27951","ENSG00000187715.13_900",892,900,9,"ENSG00000187715.13",1,6,"VVVVVMVVV",0,8,0.902691511387163,86,92,102,105,116,122,133,136,"CTAATGA","CGGA","TTGAAAA","CTGT",2.24314752710644,10,11,11,41,2.76434709247797,4.42966598496356,8.04043203051221,101,"ENSG00000079974.19"
"37779","ENSG00000248858.7_114231",114223,114231,9,"ENSG00000248858.7",1,8,"VVVVVVVMV",0,8,0.884057971014493,98,104,133,136,138,144,153,156,"ATGAAGG","ATGA","CTGCTAA","CTGA",2.46492257432431,29,2,9,49,1.58364168116353,4.50411471083139,8.04034659488936,101,"ENSG00000079974.19"
"9456","ENSG00000124767.7_10198",10190,10198,9,"ENSG00000124767.7",1,2,"VMVVVVVVV",0,8,0.884057971014493,72,78,95,98,111,117,133,136,"ATGAAGA","CAGA","ATGAATA","TTGA",2.37128141566181,17,13,16,55,2.20770838002646,4.5040627877763,8.04029467183427,101,"ENSG00000079974.19"
"25296","ENSG00000180530.11_100631",100623,100631,9,"ENSG00000180530.11",1,1,"MVVVVVVVV",0,8,0.90600414078675,114,120,133,136,149,155,165,168,"TGGCTGA","AGGA","GTGACCA","CTGA",2.24536394678078,13,13,10,45,2.69577346056746,4.41621660977651,8.0402331729235,101,"ENSG00000079974.19"
"35294","ENSG00000235609.7_49125",49117,49125,9,"ENSG00000235609.7",1,1,"MVVVVVVVV",0,8,0.90600414078675,114,120,133,136,149,155,165,168,"TGGCTGA","AGGA","GTGACCA","CTGA",2.24536394678078,13,13,10,45,2.69577346056746,4.41621660977651,8.0402331729235,101,"ENSG00000079974.19"
"27805","ENSG00000187391.22_522136",522128,522136,9,"ENSG00000187391.22",0,NA,"VVUVVUVVV",2,7,0.805797101449275,112,118,133,136,141,147,162,165,"ATCATGT","CTGT","ATGCAGA","CTGA",2.49021022434751,15,5,15,44,2.666730280727,4.81703294409426,8.04022134989136,101,"ENSG00000079974.19"
"3610","ENSG00000086827.9_25488",25480,25488,9,"ENSG00000086827.9",0,NA,"VVVUVVVVV",1,8,0.880745341614907,115,121,133,136,150,156,168,171,"ATGAAGA","CAGA","TTTAAGA","CTTA",2.32274739056528,12,14,12,47,2.58378750295285,4.51719252668035,8.04017389313998,101,"ENSG00000079974.19"
"24928","ENSG00000178662.16_215503",215495,215503,9,"ENSG00000178662.16",0,NA,"UVVVVVVVV",1,8,0.902691511387163,94,100,110,113,116,122,133,136,"GTGATCA","ATGA","GTCAAAA","CAGA",2.23547266604699,10,3,11,33,2.81420863607881,4.42933993576468,8.04010598131334,101,"ENSG00000079974.19"
"15146","ENSG00000147202.19_341689",341681,341689,9,"ENSG00000147202.19",0,NA,"VVVVVUVVV",1,8,0.922153209109731,89,95,133,136,143,149,161,164,"TTGTTGA","CAAA","ATGGAAA","CTGA",2.31666335102486,38,7,12,66,1.96101275684839,4.35135877425353,8.03997161069245,101,"ENSG00000079974.19"
"24239","ENSG00000175497.17_923590",923582,923590,9,"ENSG00000175497.17",1,7,"VVVVVVMVV",0,8,0.885300207039338,99,105,133,136,184,190,204,207,"GGGATGA","GTGA","ATGAGTA","CTGA",2.55650484857094,28,48,14,99,0.950754180175817,4.49852995932886,8.03973078748621,101,"ENSG00000079974.19"
"21572","ENSG00000168386.19_44879",44871,44879,9,"ENSG00000168386.19",0,NA,"VVVVVVUVV",1,8,0.886128364389234,114,120,133,136,160,166,176,179,"TTAATGT","GTGA","CTGGTGC","CTGA",2.37577620840996,13,24,10,56,2.14228997892255,4.49519950874724,8.03971296630418,101,"ENSG00000079974.19"
"17671","ENSG00000154727.11_23741",23733,23741,9,"ENSG00000154727.11",1,5,"VVVVMVVVV",0,8,0.886542443064182,113,119,133,136,139,145,169,172,"ATAATGA","ATAA","ATTAACA","CTGA",2.39918221896358,14,3,24,50,1.97935818168017,4.493476577026,8.03964634928273,101,"ENSG00000079974.19"
"18243","ENSG00000156650.14_80181",80173,80181,9,"ENSG00000156650.14",0,NA,"VVUVVVVVV",1,8,0.883643892339545,110,116,133,136,147,153,181,184,"ATGATGA","TAGA","GTGAAGC","TTGA",2.43828815489681,17,11,28,65,1.76459858546657,4.50496323786132,8.0395388072195,101,"ENSG00000079974.19"
"18329","ENSG00000157077.16_99663",99655,99663,9,"ENSG00000157077.16",1,2,"VMVVVVVVV",0,8,0.884057971014493,106,112,133,136,143,149,186,189,"TTAATGA","TTGA","CAGAAGA","CTGA",2.48500000155165,21,7,37,74,1.4463798326319,4.50326162741073,8.0394935114687,101,"ENSG00000079974.19"
"441","ENSG00000011465.18_6671",6663,6671,9,"ENSG00000011465.18",1,1,"MVVVVVVVV",0,8,0.90600414078675,83,89,133,136,142,148,203,206,"CTGATGA","ATAA","TTGTTCA","CTGA",2.5015140629812,44,6,55,114,0.98494052894685,4.41542523720538,8.03944180035238,101,"ENSG00000079974.19"
"20333","ENSG00000164675.11_68671",68663,68671,9,"ENSG00000164675.11",1,1,"MVVVVVVVV",0,8,0.90600414078675,104,110,133,136,151,157,176,179,"ATGATAC","CAGA","GTGCATA","CTGA",2.43884104306949,23,15,19,66,1.40210955510027,4.41526246055755,8.03927902370454,101,"ENSG00000079974.19"
"31635","ENSG00000224228.2_240157",240149,240157,9,"ENSG00000224228.2",1,8,"VVVVVVVMV",0,8,0.884057971014493,108,114,133,136,172,178,186,189,"AGGATGT","CTGC","CTGCTAA","CTGA",2.46574929579955,19,36,8,72,1.57335556706028,4.50292105143098,8.03915293548895,101,"ENSG00000079974.19"
"2487","ENSG00000075223.14_174013",174005,174013,9,"ENSG00000075223.14",1,8,"UVVVVVVMV",1,7,0.786749482401656,116,122,133,136,146,152,161,164,"GTGATGT","CTTA","ATAAAAA","CTGA",2.4978079580315,11,10,9,39,2.91644152759617,4.89212364528487,8.03912157489149,101,"ENSG00000079974.19"
"42363","ENSG00000261777.6_7233",7225,7233,9,"ENSG00000261777.6",0,NA,"VVVUVVVVV",1,8,0.880745341614907,101,107,133,136,146,152,171,174,"ATGAGGA","GTCA","ATGTTAA","CTGA",2.46843001640803,26,10,19,64,1.60707015152819,4.51581756522876,8.03879893168839,101,"ENSG00000079974.19"
"11675","ENSG00000135749.19_312068",312060,312068,9,"ENSG00000135749.19",0,NA,"VVVVVVUVV",1,8,0.886128364389234,89,95,133,136,143,149,161,164,"GTGATCA","AGGA","AGGATGT","CTGA",2.40240132113467,38,7,12,66,1.96101275684839,4.49425539110322,8.03876884866015,101,"ENSG00000079974.19"
"5853","ENSG00000107077.19_229475",229467,229475,9,"ENSG00000107077.19",1,2,"VMVVVUVVV",1,7,0.806211180124223,113,119,133,136,142,148,157,160,"ATCATGG","ATGT","ATGAAGA","CTGA",2.43738141108098,14,6,9,38,3.00615666399917,4.81384151780142,8.03868623829831,101,"ENSG00000079974.19"
"31842","ENSG00000224972.1_47668",47660,47668,9,"ENSG00000224972.1",1,2,"VMVVVUVVV",1,7,0.806211180124223,113,119,133,136,142,148,157,160,"ATCATGG","ATGT","ATGAAGA","CTGA",2.43738141108098,14,6,9,38,3.00615666399917,4.81384151780142,8.03868623829831,101,"ENSG00000079974.19"
"7368","ENSG00000113719.17_56330",56322,56330,9,"ENSG00000113719.17",0,NA,"UVVVVVVVV",1,8,0.902691511387163,109,115,133,136,187,193,203,206,"ATGATTA","TTAA","CCAATGA","CTGA",2.40665599410906,18,51,10,88,1.66700627077008,4.42784489120762,8.03861093675627,101,"ENSG00000079974.19"
"12430","ENSG00000138162.19_72230",72222,72230,9,"ENSG00000138162.19",0,NA,"VVVVVVUVV",1,8,0.886128364389234,113,119,133,136,149,155,168,171,"ATGCTGA","CTAA","CTGCCGA","CAGA",2.30962827667361,14,13,13,49,2.57837416635746,4.49397400271205,8.03848746026899,101,"ENSG00000079974.19"
"33525","ENSG00000230131.6_168991",168983,168991,9,"ENSG00000230131.6",1,5,"VVVVMVVVV",0,8,0.886542443064182,56,62,81,84,100,106,133,136,"ATGATGA","ATGA","CTGGAGA","GTGA",2.50500584254691,19,16,27,71,1.26905835661647,4.4922743267323,8.03844409898903,101,"ENSG00000079974.19"
"34623","ENSG00000233635.2_107143",107135,107143,9,"ENSG00000233635.2",1,1,"MVVVVVVVV",0,8,0.90600414078675,115,121,133,136,140,146,157,160,"GGGATTA","CAAA","ATGACTG","CTGA",2.20970054179714,12,4,11,36,2.92626049687161,4.41439936054647,8.03841592369347,101,"ENSG00000079974.19"
"18070","ENSG00000156103.16_91240",91232,91240,9,"ENSG00000156103.16",0,NA,"VVVVVVUVV",1,8,0.886128364389234,70,76,91,94,113,119,133,136,"GAGATGA","CTGA","GTGAGAG","TTGA",2.38073115631889,15,19,14,57,2.10356811137972,4.49377728837641,8.03829074593334,101,"ENSG00000079974.19"
"46751","ENSG00000287137.1_24846",24838,24846,9,"ENSG00000287137.1",1,8,"UVVVVVVMV",1,7,0.786749482401656,113,119,133,136,149,155,171,174,"ATTATGA","CTAA","TTGGAGA","CTGA",2.57218724672972,14,13,16,52,2.41686210039474,4.89119426964821,8.03819219925484,101,"ENSG00000079974.19"
"33353","ENSG00000229443.2_62910",62902,62910,9,"ENSG00000229443.2",1,2,"VMVVVVVVV",0,8,0.884057971014493,112,118,133,136,152,158,170,173,"TTGTTTA","ATGA","GTAAAGA","CTGA",2.34770571914874,15,16,12,52,2.35646305272445,4.50195862842901,8.03819051248698,101,"ENSG00000079974.19"
"31721","ENSG00000224556.2_7606",7598,7606,9,"ENSG00000224556.2",1,3,"VVMVVVVVV",0,8,0.882815734989648,81,87,98,101,109,115,133,136,"ATAATGT","TTGA","CTGATGT","TTGA",2.31390422287273,11,8,18,46,2.60161669597259,4.50691121211437,8.03817415207296,101,"ENSG00000079974.19"
"13626","ENSG00000142687.19_158081",158073,158081,9,"ENSG00000142687.19",1,1,"MVVVVVVVV",0,8,0.90600414078675,52,58,69,72,77,83,133,136,"AGGATGG","CTGA","GTGATCC","CTAA",2.3621838368828,11,5,50,75,1.90867907393099,4.41414282995409,8.03815939310109,101,"ENSG00000079974.19"
"32499","ENSG00000227088.2_559458",559450,559458,9,"ENSG00000227088.2",1,1,"MVVVVVVVV",0,8,0.90600414078675,115,121,133,136,143,149,192,195,"ACAATGA","CAGT","ATGTGGA","CTGA",2.34678197227499,12,7,43,71,2.01129740178583,4.41412763757144,8.03814420071844,101,"ENSG00000079974.19"
"2421","ENSG00000074416.16_75806",75798,75806,9,"ENSG00000074416.16",1,1,"MVVVVVVVV",0,8,0.90600414078675,115,121,133,136,145,151,173,176,"TTAATGT","GGGA","GTGTCGA","CTGA",2.29466552952081,12,9,22,52,2.3586165794513,4.41409669406418,8.03811325721117,101,"ENSG00000079974.19"
"6890","ENSG00000112200.17_65074",65066,65074,9,"ENSG00000112200.17",1,2,"VMVVVVVVV",0,8,0.884057971014493,79,85,99,102,111,117,133,136,"TTGGTGA","CTGC","GTGGTGA","CTTA",2.29988446465375,14,9,16,48,2.67484456445411,4.50185191553645,8.03808379959442,101,"ENSG00000079974.19"
"32115","ENSG00000226022.1_115322",115314,115322,9,"ENSG00000226022.1",1,1,"MVVVVVVVV",0,8,0.90600414078675,101,107,133,136,142,148,157,160,"ATGTTGT","ATAA","ATAATTA","CTGA",2.33088092101778,26,6,9,50,2.11678986997175,4.41399900252257,8.03801556566957,101,"ENSG00000079974.19"
"41529","ENSG00000259199.2_17424",17416,17424,9,"ENSG00000259199.2",1,6,"VVVVVMVVV",0,8,0.902691511387163,85,91,107,110,113,119,133,136,"ATGATCA","GTGA","ATGGGTA","ATGA",2.29221098550988,16,3,14,42,2.42754250017988,4.42723726756143,8.03800331311009,101,"ENSG00000079974.19"
"10999","ENSG00000133424.22_505402",505394,505402,9,"ENSG00000133424.22",0,NA,"VVVVVVUVV",1,8,0.886128364389234,116,122,133,136,137,143,152,155,"CTGGTGT","CTCA","ATAAATA","CTGA",2.29511153654525,11,1,9,30,2.67246561923797,4.49330229905157,8.0378157566085,101,"ENSG00000079974.19"
"38313","ENSG00000249937.9_167335",167327,167335,9,"ENSG00000249937.9",0,NA,"VVVVVUVVV",1,8,0.922153209109731,80,86,101,104,115,121,133,136,"AGGTTGA","TTGA","TTGAGGC","GTGA",2.20369893333832,15,11,12,47,2.70540742960106,4.34918341296412,8.03779624940305,101,"ENSG00000079974.19"
"15854","ENSG00000149972.12_410395",410387,410395,9,"ENSG00000149972.12",1,8,"VVVVVVVMV",0,8,0.884057971014493,92,98,133,136,147,153,161,164,"CTGAAGA","CATA","CTGTTGA","CTGA",2.4273182275787,35,11,8,63,1.82384354856706,4.50149126643959,8.03772315049756,101,"ENSG00000079974.19"
"20797","ENSG00000165675.19_238506",238498,238506,9,"ENSG00000165675.19",1,8,"UVVVVVVMV",1,7,0.786749482401656,113,119,133,136,148,154,170,173,"ATGGTGA","TTGA","GACATGA","CTGA",2.56111245839806,14,12,16,51,2.48875095851114,4.89070850362454,8.03770643323117,101,"ENSG00000079974.19"
"48241","ENSG00000290729.1_17058",17050,17058,9,"ENSG00000290729.1",1,1,"MVVVVVVVV",0,8,0.90600414078675,83,89,133,136,144,150,192,195,"CTGATGC","CTGT","AGGATGT","CTGA",2.49805237754516,44,8,42,103,1.00076360828874,4.41361153131413,8.03762809446112,101,"ENSG00000079974.19"
"42352","ENSG00000261742.6_2544",2536,2544,9,"ENSG00000261742.6",1,1,"MVVVVVVVV",0,8,0.90600414078675,106,112,133,136,160,166,176,179,"GTGATGT","ATGG","GTGGTCT","CTGA",2.41465133065944,21,24,10,64,1.55645360067857,4.41353228460205,8.03754884774905,101,"ENSG00000079974.19"
"17411","ENSG00000154124.6_17199",17191,17199,9,"ENSG00000154124.6",1,6,"VVVVVMVVV",0,8,0.902691511387163,74,80,101,104,114,120,133,136,"ATGATAA","TTGA","CAGATGT","CTTA",2.321940750333,21,10,13,53,2.22730030358685,4.42672632645171,8.03749237200037,101,"ENSG00000079974.19"
"22759","ENSG00000171365.17_78177",78169,78177,9,"ENSG00000171365.17",1,5,"VVVVMVVVV",0,8,0.886542443064182,80,86,98,101,104,110,133,136,"AACATGA","CTAA","GTGCCAA","CTGA",2.38541322853368,12,3,23,47,2.06249854527208,4.49131335054082,8.03748312279755,101,"ENSG00000079974.19"
"24347","ENSG00000175894.18_87649",87641,87649,9,"ENSG00000175894.18",1,8,"VVVVVVVMV",0,8,0.884057971014493,97,103,133,136,140,146,189,192,"GTGATGA","TTTA","ATGTTTA","CTGA",2.56680727294026,30,4,43,86,0.892534694879135,4.50114579528689,8.03737767934486,101,"ENSG00000079974.19"
"25891","ENSG00000183049.14_349461",349453,349461,9,"ENSG00000183049.14",1,1,"MVVVVVVVV",0,8,0.90600414078675,115,121,133,136,170,176,184,187,"ATAAGGA","ATCA","CTAATGA","CTGA",2.34735517840851,12,34,8,63,2.0043779667073,4.41335312235767,8.03736968550467,101,"ENSG00000079974.19"
"27631","ENSG00000186918.14_19486",19478,19486,9,"ENSG00000186918.14",1,8,"UVVVVVVMV",1,7,0.786749482401656,114,120,133,136,143,149,182,185,"ATGATGA","GTGG","CTGAGAA","CTGA",2.62347042756148,13,7,33,62,2.07151149453477,4.89032858623616,8.03732651584278,101,"ENSG00000079974.19"
"30845","ENSG00000214050.8_107063",107055,107063,9,"ENSG00000214050.8",1,8,"UVVVVVVMV",1,7,0.786749482401656,114,120,133,136,143,149,182,185,"ATGATGA","GTGG","CTGAGAA","CTGA",2.62347042756148,13,7,33,62,2.07151149453477,4.89032858623616,8.03732651584278,101,"ENSG00000079974.19"
"11928","ENSG00000136536.15_24292",24284,24292,9,"ENSG00000136536.15",1,1,"MVVVVVVVV",0,8,0.90600414078675,114,120,133,136,138,144,153,156,"ATTATGA","ATAA","ATGAAAA","CTGC",2.23872180549284,13,2,9,33,2.72772849389642,4.41313513262884,8.03715169577584,101,"ENSG00000079974.19"
"11312","ENSG00000134532.20_164771",164763,164771,9,"ENSG00000134532.20",1,8,"VVVVVVVMV",0,8,0.884057971014493,86,92,133,136,185,191,204,207,"ATGAAGA","TTAA","GTGATGT","CTGA",2.56235048093887,41,49,13,112,0.921288436308913,4.50090624397534,8.03713812803331,101,"ENSG00000079974.19"
"27319","ENSG00000185942.13_618783",618775,618783,9,"ENSG00000185942.13",1,6,"VVVVVMVVV",0,8,0.902691511387163,115,121,133,136,181,187,197,200,"GAGATCA","CTCA","GTAATTA","CTGA",2.35535550934656,12,45,10,76,2.00272740745237,4.42627436744069,8.03704041298934,101,"ENSG00000079974.19"
"11384","ENSG00000134775.16_272364",272356,272364,9,"ENSG00000134775.16",1,7,"VVVVVUMVV",1,7,0.807453416149068,115,121,133,136,145,151,168,171,"TTGATGA","GAGA","GAGAAAA","CTGA",2.48664662692052,12,9,17,47,2.6511251156644,4.80719232378364,8.03700598837991,101,"ENSG00000079974.19"
"34055","ENSG00000231829.4_1678",1670,1678,9,"ENSG00000231829.4",1,1,"MVVVVVVVV",0,8,0.90600414078675,116,122,133,136,182,188,199,202,"AAAAAGA","ATGA","CTGTTGA","CTGA",2.35338274188424,11,46,11,77,1.96266818198945,4.41297161530444,8.03698817845143,101,"ENSG00000079974.19"
"7433","ENSG00000114127.11_17472",17464,17472,9,"ENSG00000114127.11",1,8,"UVVVVVVMV",1,7,0.786749482401656,114,120,133,136,144,150,162,165,"AAGAGGA","CTGA","ATCAAAA","CTGA",2.49033335558565,13,8,12,42,2.95772979160902,4.889988040545,8.03698597015163,101,"ENSG00000079974.19"
"36912","ENSG00000243620.2_21075",21067,21075,9,"ENSG00000243620.2",0,NA,"UVVVVVVVV",1,8,0.902691511387163,112,118,133,136,160,166,180,183,"ATTATGG","TTAA","ATGGGGA","CTGA",2.36651539920929,15,24,14,62,1.9275043473159,4.42606841884446,8.03683446439311,101,"ENSG00000079974.19"
"20529","ENSG00000165029.17_33662",33654,33662,9,"ENSG00000165029.17",1,6,"VVVVVMVVV",0,8,0.902691511387163,100,106,133,136,149,155,203,206,"TTGATGA","CTCA","ATAGTAA","CTGA",2.53538946002271,27,13,48,97,0.800717164223254,4.42582839109366,8.03659443664232,101,"ENSG00000079974.19"
"35326","ENSG00000235726.7_73644",73636,73644,9,"ENSG00000235726.7",1,1,"MVVVVVVVV",0,8,0.90600414078675,75,81,92,95,104,110,133,136,"ATGAGGA","CAGA","ATGCAAA","CTCA",2.30488396795702,11,9,23,52,2.2843601990788,4.41256332969807,8.03657989284507,101,"ENSG00000079974.19"
"28460","ENSG00000189221.11_23660",23652,23660,9,"ENSG00000189221.11",1,7,"VVVVVVMVV",0,8,0.885300207039338,115,121,133,136,149,155,184,187,"AAGATTA","CTTA","GGGTTGA","CTGA",2.42072067093847,12,13,29,63,1.84324415907016,4.49534549133166,8.03654631948901,101,"ENSG00000079974.19"
"23051","ENSG00000172137.19_23635",23627,23635,9,"ENSG00000172137.19",0,NA,"VVUVVVVVV",1,8,0.883643892339545,115,121,133,136,186,192,215,218,"ATGATGT","GGGA","ATAATAA","CTGA",2.49718614072835,12,50,23,94,1.35973902292709,4.50191165694569,8.03648722630386,101,"ENSG00000079974.19"
"19627","ENSG00000163527.10_75667",75659,75667,9,"ENSG00000163527.10",1,5,"VVUVMVVVV",1,7,0.770186335403727,85,91,101,104,111,117,133,136,"GTGTTGA","GTGA","AAGATGA","CTGA",2.56913979297194,10,7,16,42,2.69523991124441,4.95570963276434,8.03645497437925,101,"ENSG00000079974.19"
"21812","ENSG00000169064.13_143192",143184,143192,9,"ENSG00000169064.13",1,8,"VVVVVVVMV",0,8,0.884057971014493,82,88,133,136,156,162,174,177,"TTGTTGA","CAGA","GTGGTGT","CTGA",2.51462776177478,45,20,12,86,1.23635545435745,4.500135133214,8.03636701727197,101,"ENSG00000079974.19"
"41819","ENSG00000259786.7_265289",265281,265289,9,"ENSG00000259786.7",1,8,"UVVVVVVMV",1,7,0.786749482401656,116,122,133,136,139,145,155,158,"ATGATGA","ATCA","ACAGTGA","CTGA",2.50101953878159,11,3,10,33,2.88390446837489,4.88934201506303,8.03633994466966,101,"ENSG00000079974.19"
"6916","ENSG00000112246.10_71997",71989,71997,9,"ENSG00000112246.10",1,3,"VVMVVUVVV",1,7,0.804968944099379,89,95,104,107,111,117,133,136,"ATGATGA","GTGA","ATGAAGC","CTGG",2.51594106230761,9,4,16,38,2.4923773304413,4.81632943645635,8.03620521285386,101,"ENSG00000079974.19"
"21954","ENSG00000169375.17_64362",64354,64362,9,"ENSG00000169375.17",0,NA,"VVVVUUVVV",2,7,0.812008281573499,115,121,133,136,159,165,176,179,"TTGCTGA","CAGA","TTGAGGA","CTGA",2.54897272114841,12,23,11,55,2.15906080900719,4.78805307083248,8.03608619712648,101,"ENSG00000079974.19"
"31128","ENSG00000215869.4_84059",84051,84059,9,"ENSG00000215869.4",1,3,"VVMVVVVVV",0,8,0.882815734989648,108,114,133,136,148,154,168,171,"ATGATGA","TTAA","TTGAAAA","CTGT",2.37077000509807,19,12,14,54,2.21412747889105,4.50481521155288,8.03607815151148,101,"ENSG00000079974.19"
"15097","ENSG00000147044.23_349859",349851,349859,9,"ENSG00000147044.23",1,1,"MVVVVVVVV",0,8,0.90600414078675,108,114,133,136,153,159,185,188,"AAGATTA","CAGA","ATGGAGA","CTGA",2.46101597249786,19,17,26,71,1.24131970418648,4.41202321354305,8.03603977669004,101,"ENSG00000079974.19"
"26257","ENSG00000183722.9_70998",70990,70998,9,"ENSG00000183722.9",1,1,"MVVVVVVVV",0,8,0.90600414078675,114,120,133,136,144,150,158,161,"ATGGTAC","CTGA","TTTATGA","ATGA",2.19387456471745,13,8,8,38,3.0222337442241,4.41201604391845,8.03603260706545,101,"ENSG00000079974.19"
"27734","ENSG00000187240.17_291030",291022,291030,9,"ENSG00000187240.17",0,NA,"UVVVVVUVV",2,7,0.788819875776397,110,116,133,136,143,149,173,176,"ATGATGA","TAGA","TAGAAGA","CTGA",2.61809631126746,17,7,24,57,2.06879430624794,4.88069242867442,8.03597193178001,101,"ENSG00000079974.19"
"24017","ENSG00000174891.14_203370",203362,203370,9,"ENSG00000174891.14",1,3,"VVMVVVVVV",0,8,0.882815734989648,99,105,133,136,144,150,172,175,"ATGAAGA","GTTA","CTGAAGT","CTGA",2.48197181926718,28,8,22,67,1.47220544388417,4.50467105974968,8.03593399970828,101,"ENSG00000079974.19"
"41888","ENSG00000259905.7_626068",626060,626068,9,"ENSG00000259905.7",1,1,"MVVVVVVVV",0,8,0.90600414078675,113,119,133,136,148,154,167,170,"ATTAAGA","ATGT","ATAGAGA","CTGA",2.24951305578143,14,12,13,48,2.65071350396686,4.4118668022941,8.03588336544109,101,"ENSG00000079974.19"
"45997","ENSG00000286110.1_169835",169827,169835,9,"ENSG00000286110.1",1,1,"MVVVVVVVV",0,8,0.90600414078675,113,119,133,136,148,154,167,170,"ATTAAGA","ATGT","ATAGAGA","CTGA",2.24951305578143,14,12,13,48,2.65071350396686,4.4118668022941,8.03588336544109,101,"ENSG00000079974.19"
"17511","ENSG00000154263.18_5211",5203,5211,9,"ENSG00000154263.18",1,1,"MVVVVVVVV",0,8,0.90600414078675,106,112,133,136,160,166,177,180,"ATGGGGA","CTGC","CTGTCGA","CTGA",2.41576532938783,21,24,11,65,1.54225760663789,4.41183995063918,8.03585651378618,101,"ENSG00000079974.19"
"32684","ENSG00000227564.3_54849",54841,54849,9,"ENSG00000227564.3",1,1,"MVVVVVVVV",0,8,0.90600414078675,65,71,104,107,111,117,133,136,"ATGATGG","CTGA","AGGCTAA","TTGA",2.40503992389027,33,4,16,62,1.61317430128838,4.41169344847254,8.03571001161954,101,"ENSG00000079974.19"
"24956","ENSG00000178878.13_3397",3389,3397,9,"ENSG00000178878.13",1,1,"MVVVVUVVV",1,7,0.82815734989648,115,121,133,136,187,193,205,208,"AGGATGA","ATGA","GAGTTGG","CTGA",2.54000327870547,12,51,12,84,1.958877246195,4.7230581093912,8.03568750897712,101,"ENSG00000079974.19"
"37391","ENSG00000248079.4_149066",149058,149066,9,"ENSG00000248079.4",1,8,"UVVVVVVMV",1,7,0.786749482401656,90,96,133,136,151,157,175,178,"ATGGTGA","CTGA","GGGATGA","CTGA",2.75408171050373,37,15,18,79,1.19419648560871,4.88868530557506,8.03568323518168,101,"ENSG00000079974.19"
"14770","ENSG00000145832.16_387567",387559,387567,9,"ENSG00000145832.16",1,1,"MVVVVUVVV",1,7,0.82815734989648,108,114,133,136,148,154,168,171,"AAGATGA","AGGA","ATGAAAA","CTGA",2.50167218029659,19,12,14,54,2.21412747889105,4.72298550355041,8.03561490313633,101,"ENSG00000079974.19"
"24393","ENSG00000176124.15_789620",789612,789620,9,"ENSG00000176124.15",0,NA,"UVVVVVVVV",1,8,0.902691511387163,95,101,133,136,157,163,174,177,"ATGATGA","TTCA","GTGAGGA","CAGA",2.46768006188962,32,21,11,73,1.2475624913064,4.42469072597597,8.03545677152462,101,"ENSG00000079974.19"
"45581","ENSG00000285713.1_636036",636028,636036,9,"ENSG00000285713.1",1,6,"VVVVVMVVV",0,8,0.902691511387163,115,121,133,136,144,150,158,161,"CGGGTGA","TTTA","GTGCAGC","CTGA",2.19793579913759,12,8,8,37,3.04579407461945,4.42467485055085,8.03544089609951,101,"ENSG00000079974.19"
"45666","ENSG00000285783.1_408815",408807,408815,9,"ENSG00000285783.1",1,6,"VVVVVMVVV",0,8,0.902691511387163,115,121,133,136,144,150,158,161,"CGGGTGA","TTTA","GTGCAGC","CTGA",2.19793579913759,12,8,8,37,3.04579407461945,4.42467485055085,8.03544089609951,101,"ENSG00000079974.19"
"8281","ENSG00000117859.19_176233",176225,176233,9,"ENSG00000117859.19",1,5,"VVVVMVVVV",0,8,0.886542443064182,72,78,90,93,100,106,133,136,"CTGATGC","ATGA","GTGATGC","CTAA",2.36298946257181,12,7,27,55,2.20375066540696,4.48925343730476,8.03542320956149,101,"ENSG00000079974.19"
"17240","ENSG00000153707.19_2284277",2284269,2284277,9,"ENSG00000153707.19",1,1,"MVVVVVVVV",0,8,0.90600414078675,99,105,133,136,182,188,198,201,"ATGAAGA","ATGA","ACTTTGA","CTGA",2.48480422379311,28,46,10,93,1.08010839539424,4.41136747183708,8.03538403498408,101,"ENSG00000079974.19"
"17234","ENSG00000153707.19_2009772",2009764,2009772,9,"ENSG00000153707.19",0,NA,"UVVUVVVVV",2,7,0.78343685300207,114,120,133,136,137,143,152,155,"CTGATGT","ATGA","ATGATTT","CTGA",2.55448625806804,13,1,9,32,2.57651761548694,4.9016065006518,8.03535391266008,101,"ENSG00000079974.19"
"23861","ENSG00000174469.23_168016",168008,168016,9,"ENSG00000174469.23",1,2,"VMVVVVVVV",0,8,0.884057971014493,115,121,133,136,161,167,221,224,"ATCATGA","ATGA","ATAAAAA","CTGA",2.53069575090597,12,25,54,100,1.12504511404314,4.49908753002074,8.03531941407871,101,"ENSG00000079974.19"
"40053","ENSG00000254789.4_2898",2890,2898,9,"ENSG00000254789.4",0,NA,"VVVVVUVVV",1,8,0.922153209109731,102,108,133,136,145,151,159,162,"GTGATGA","ATGT","TGGAGGA","ATGA",2.2924725138785,25,9,8,51,2.10296421973054,4.34652857806347,8.03514141450239,101,"ENSG00000079974.19"
"23730","ENSG00000173705.9_67904",67896,67904,9,"ENSG00000173705.9",0,NA,"UVVVVVVVV",1,8,0.902691511387163,113,119,133,136,183,189,201,204,"GTTATCA","ATGA","GTGTGGT","CTGA",2.36599473858454,14,47,12,82,1.92365064242424,4.42423722491363,8.03500327046229,101,"ENSG00000079974.19"
"40023","ENSG00000254731.1_4169",4161,4169,9,"ENSG00000254731.1",1,2,"VMVVVVVVV",0,8,0.884057971014493,81,87,97,100,109,115,133,136,"GTGATAA","TTAA","ATCTTTA","CTGA",2.32274370320136,10,9,18,46,2.51006585300547,4.49875596858696,8.03498785264493,101,"ENSG00000079974.19"
"30913","ENSG00000214694.13_84807",84799,84807,9,"ENSG00000214694.13",1,8,"VVVVVVVMV",0,8,0.884057971014493,111,117,133,136,149,155,172,175,"CAGATGG","GTGA","TTGTTAA","CTGA",2.36477382900162,16,13,17,55,2.22969745339171,4.49871407835063,8.0349459624086,101,"ENSG00000079974.19"
"41617","ENSG00000259356.1_2800",2792,2800,9,"ENSG00000259356.1",1,8,"VVVVVVVMV",0,8,0.884057971014493,92,98,107,110,114,120,133,136,"ATGGTGA","CTGC","GACATGA","CTGG",2.29046164488116,9,4,13,35,2.72479624215583,4.49863513534089,8.03486701939886,101,"ENSG00000079974.19"
"10541","ENSG00000131503.21_51365",51357,51365,9,"ENSG00000131503.21",1,1,"MVVVVVVVV",0,8,0.90600414078675,95,101,133,136,165,171,186,189,"ATGAAGC","ATGA","GTGAAAA","CTGA",2.5112194114755,32,29,15,85,0.901826085985828,4.41082220728896,8.03483877043596,101,"ENSG00000079974.19"
"36604","ENSG00000242104.5_10825",10817,10825,9,"ENSG00000242104.5",1,1,"MVVVVVVVV",0,8,0.90600414078675,95,101,133,136,165,171,186,189,"ATGAAGC","ATGA","GTGAAAA","CTGA",2.5112194114755,32,29,15,85,0.901826085985828,4.41082220728896,8.03483877043596,101,"ENSG00000079974.19"
"40109","ENSG00000254996.5_51271",51263,51271,9,"ENSG00000254996.5",1,1,"MVVVVVVVV",0,8,0.90600414078675,95,101,133,136,165,171,186,189,"ATGAAGC","ATGA","GTGAAAA","CTGA",2.5112194114755,32,29,15,85,0.901826085985828,4.41082220728896,8.03483877043596,101,"ENSG00000079974.19"
"12432","ENSG00000138175.9_10101",10093,10101,9,"ENSG00000138175.9",1,2,"VMVVVUVVV",1,7,0.806211180124223,105,111,133,136,143,149,158,161,"ATTATGA","CAGA","ATAAAGG","CTGA",2.53518681544737,22,7,9,47,2.33841717154883,4.80991565196616,8.03476037246305,101,"ENSG00000079974.19"
"11781","ENSG00000136040.9_52582",52574,52582,9,"ENSG00000136040.9",1,3,"VVMVVVVVV",0,8,0.882815734989648,57,63,77,80,90,96,133,136,"AAGATGA","CTGA","CAGGTGA","CTAA",2.41724371548053,14,10,37,70,1.89867613546224,4.50340855966644,8.03467149962503,101,"ENSG00000079974.19"
"15846","ENSG00000149972.12_1294911",1294903,1294911,9,"ENSG00000149972.12",0,NA,"VVVVVUVVV",1,8,0.922153209109731,101,107,133,136,148,154,207,210,"TTTATGG","CTGA","GTGAAAT","CTGA",2.47241000925061,26,12,53,100,0.900705714042023,4.34585977726151,8.03447261370044,101,"ENSG00000079974.19"
"1020","ENSG00000044459.15_341478",341470,341478,9,"ENSG00000044459.15",1,7,"VVVVVVMVV",0,8,0.885300207039338,110,116,133,136,173,179,197,200,"GTGAGGA","GAGA","GTCATGA","CTGA",2.48523549233852,17,37,18,81,1.40454225806832,4.49319471841461,8.03439554657196,101,"ENSG00000079974.19"
"16500","ENSG00000151694.15_22788",22780,22788,9,"ENSG00000151694.15",0,NA,"VVVVUUVVV",2,7,0.812008281573499,112,118,133,136,156,162,173,176,"ATGAAGA","CTGT","CAGATAA","CTGA",2.54581429127611,15,20,11,55,2.17330300215538,4.78634956933237,8.03438269562636,101,"ENSG00000079974.19"
"28394","ENSG00000189050.16_462",454,462,9,"ENSG00000189050.16",0,NA,"VVVVVVUVV",1,8,0.886128364389234,76,82,100,103,110,116,133,136,"TTGACGA","CGGG","GTGAAAG","CTGA",2.33922833131312,18,7,17,51,2.36443557425484,4.48982277908557,8.03433623664251,101,"ENSG00000079974.19"
"42837","ENSG00000267104.2_54676",54668,54676,9,"ENSG00000267104.2",0,NA,"VVVVVVUVV",1,8,0.886128364389234,76,82,100,103,110,116,133,136,"TTGACGA","CGGG","GTGAAAG","CTGA",2.33922833131312,18,7,17,51,2.36443557425484,4.48982277908557,8.03433623664251,101,"ENSG00000079974.19"
"10243","ENSG00000130052.14_9464",9456,9464,9,"ENSG00000130052.14",1,6,"VVVVVMVVV",0,8,0.902691511387163,97,103,111,114,115,121,133,136,"ATTATGA","ATGA","GTTAATA","CTTA",2.29588023168678,8,1,12,30,2.38822135680402,4.4235223920123,8.03428843756096,101,"ENSG00000079974.19"
"35955","ENSG00000237505.8_628753",628745,628753,9,"ENSG00000237505.8",1,2,"VMVVVVVVV",0,8,0.884057971014493,114,120,133,136,154,160,170,173,"ATGAAGA","ATGA","GTCATTA","TTGA",2.34342512147651,13,18,10,50,2.36912592960672,4.49799001819586,8.03422190225383,101,"ENSG00000079974.19"
"11904","ENSG00000136478.9_1630",1622,1630,9,"ENSG00000136478.9",0,NA,"VVUVVVVVV",1,8,0.883643892339545,110,116,133,136,182,188,198,201,"ATGTTTA","CTGT","GTGGTAA","CTGA",2.43615348809467,17,46,10,82,1.75708092710102,4.49952604526637,8.03410161462455,101,"ENSG00000079974.19"
"41253","ENSG00000258744.3_49875",49867,49875,9,"ENSG00000258744.3",1,1,"MVVVVVVVV",0,8,0.90600414078675,89,95,133,136,165,171,186,189,"ATGAAGT","ATGA","GTGACAA","CTGA",2.51379849461651,38,29,15,91,0.881429187361973,4.41002145453468,8.03403801768168,101,"ENSG00000079974.19"
"24338","ENSG00000175868.14_110671",110663,110671,9,"ENSG00000175868.14",1,1,"MVVVVVVVV",0,8,0.90600414078675,110,116,133,136,140,146,157,160,"AATATGA","CGAA","ATGACTG","CTGA",2.25559948216279,17,4,11,41,2.60270341598938,4.41000832426866,8.03402488741566,101,"ENSG00000079974.19"
"24309","ENSG00000175779.5_29559",29551,29559,9,"ENSG00000175779.5",1,2,"VMVVVVVVV",0,8,0.884057971014493,100,106,133,136,146,152,175,178,"ATGAAGA","CTGT","ATAATTC","CTGA",2.49471631830314,27,10,23,69,1.35956409119899,4.49775155330498,8.03398343736295,101,"ENSG00000079974.19"
"20859","ENSG00000165895.19_68124",68116,68124,9,"ENSG00000165895.19",1,8,"VVVVVVVMV",0,8,0.884057971014493,110,116,133,136,175,181,191,194,"GTTATGA","GTAA","CTCATGA","CTGA",2.43397578848573,17,39,10,75,1.76400963945692,4.49762872400711,8.03386060806508,101,"ENSG00000079974.19"
"31152","ENSG00000217004.1_470",462,470,9,"ENSG00000217004.1",1,6,"VVVVVMVVV",0,8,0.902691511387163,108,114,133,136,149,155,163,166,"GAGATGT","AAGA","CTGCTGG","CTGA",2.31598747012797,19,13,8,49,2.25233891800453,4.42306384638108,8.03382989192973,101,"ENSG00000079974.19"
"26113","ENSG00000183421.12_18915",18907,18915,9,"ENSG00000183421.12",0,NA,"VVVVVUVVV",1,8,0.922153209109731,114,120,133,136,155,161,182,185,"AGAATGT","CAGA","CTGCTGG","CTGA",2.34026755559118,13,19,21,62,1.77864623547881,4.34510748485501,8.03372032129393,101,"ENSG00000079974.19"
"27059","ENSG00000185532.20_1137277",1137269,1137277,9,"ENSG00000185532.20",0,NA,"VVVUVVVVV",1,8,0.880745341614907,47,53,75,78,90,96,133,136,"GAGATGA","GTGA","CTGGGGA","CTGA",2.53551753715932,22,12,37,80,1.13948572365452,4.51073399284583,8.03371535930545,101,"ENSG00000079974.19"
"18495","ENSG00000157540.22_115191",115183,115191,9,"ENSG00000157540.22",1,2,"VMVVVVVVV",0,8,0.884057971014493,112,118,133,136,151,157,213,216,"ATGATTA","GAGA","GTTACGA","CTGA",2.47890371507784,15,15,56,95,1.46388014253157,4.49747622742929,8.03370811148726,101,"ENSG00000079974.19"
"12969","ENSG00000139734.19_144763",144755,144763,9,"ENSG00000139734.19",0,NA,"VVVVVUVVV",1,8,0.922153209109731,99,105,133,136,153,159,168,171,"ATGATGA","ATGG","GTCAAGA","CTGC",2.3813274375305,28,17,9,63,1.50470753973588,4.34505594748481,8.03366878392373,101,"ENSG00000079974.19"
"10126","ENSG00000129493.15_59393",59385,59393,9,"ENSG00000129493.15",1,7,"VVVVVVMVV",0,8,0.885300207039338,96,102,133,136,146,152,166,169,"TGGATGA","CAAA","CTGATTA","CTGA",2.42522773094818,31,10,14,64,1.80162282865194,4.49245192540996,8.03365275356731,101,"ENSG00000079974.19"
"30079","ENSG00000203546.7_96284",96276,96284,9,"ENSG00000203546.7",1,7,"VVVVVVMVV",0,8,0.885300207039338,96,102,133,136,146,152,166,169,"TGGATGA","CAAA","CTGATTA","CTGA",2.42522773094818,31,10,14,64,1.80162282865194,4.49245192540996,8.03365275356731,101,"ENSG00000079974.19"
"34964","ENSG00000234477.1_36159",36151,36159,9,"ENSG00000234477.1",0,NA,"VVVVUVVVV",1,8,0.889855072463768,80,86,96,99,107,113,133,136,"ATGATTA","ATGA","ATTCTGA","GTGA",2.32075428329535,10,8,20,47,2.42512071430717,4.47420398406904,8.03362427392412,101,"ENSG00000079974.19"
"29951","ENSG00000198929.13_160330",160322,160330,9,"ENSG00000198929.13",1,1,"MVVVVVVVV",0,8,0.90600414078675,116,122,133,136,148,154,172,175,"AAGATGG","CTTT","GAGAAGC","CTGA",2.28910721468936,11,12,18,50,2.37747971982741,4.40954862110579,8.03356518425279,101,"ENSG00000079974.19"
"18601","ENSG00000157827.20_186862",186854,186862,9,"ENSG00000157827.20",1,2,"VMVVUVVVV",1,7,0.773913043478261,88,94,108,111,115,121,133,136,"ATAATGA","CTGA","GTGATCA","GTGA",2.5420683933442,14,4,12,39,2.80452374081856,4.9379115907783,8.03356376469134,101,"ENSG00000079974.19"
"29959","ENSG00000198933.10_9830",9822,9830,9,"ENSG00000198933.10",0,NA,"VVVVVUVVV",1,8,0.922153209109731,44,50,64,67,77,83,133,136,"GTGCAGA","CTGA","GTGATGG","CTTA",2.32726605777064,14,10,50,83,1.86455882966614,4.34491647036761,8.03352930680653,101,"ENSG00000079974.19"
"23246","ENSG00000172379.22_143997",143989,143997,9,"ENSG00000172379.22",1,8,"VVVVVUVMV",1,7,0.806211180124224,68,74,98,101,111,117,133,136,"ATGATAA","CTTA","GTGATAT","CTGA",2.60397177004393,24,10,16,59,1.87472678237756,4.80863464566761,8.0334793661645,101,"ENSG00000079974.19"
"6205","ENSG00000108669.17_56789",56781,56789,9,"ENSG00000108669.17",1,2,"VMVVVVVVV",0,8,0.884057971014493,24,30,40,43,88,94,133,136,"ATGATGA","CTGT","CTGAAGA","GTGA",2.55630307219207,10,45,39,103,0.946907403555382,4.49723197120897,8.03346385526694,101,"ENSG00000079974.19"
"44353","ENSG00000281131.1_4958",4950,4958,9,"ENSG00000281131.1",0,NA,"VVUVVVVVV",1,8,0.883643892339545,113,119,133,136,177,183,231,234,"ATGAGGA","TTTA","ATGAGGA","CTGA",2.55318915367421,14,41,48,112,0.973861498687597,4.49878063079558,8.03335620015375,101,"ENSG00000079974.19"
"32514","ENSG00000227110.7_273293",273285,273293,9,"ENSG00000227110.7",1,7,"VVVVVUMVV",1,7,0.807453416149068,15,21,66,69,116,122,133,136,"ATGATTA","CTGA","GTGGAGA","CTGA",2.73382276507277,45,47,11,112,0.987798072505569,4.80332079324767,8.03313445784394,101,"ENSG00000079974.19"
"26398","ENSG00000184178.17_147727",147719,147727,9,"ENSG00000184178.17",1,1,"MVVVVVVVV",0,8,0.90600414078675,90,96,133,136,164,170,185,188,"ATGAAGC","ATGA","GTGAAAA","CTGA",2.5112194114755,37,28,15,89,0.894798364167929,4.40906527683448,8.03308183998148,101,"ENSG00000079974.19"
"29229","ENSG00000197535.16_52043",52035,52043,9,"ENSG00000197535.16",1,1,"MVVVVVVVV",0,8,0.90600414078675,90,96,133,136,164,170,185,188,"ATGAAGC","ATGA","GTGAAAA","CTGA",2.5112194114755,37,28,15,89,0.894798364167929,4.40906527683448,8.03308183998148,101,"ENSG00000079974.19"
"32959","ENSG00000228340.8_521216",521208,521216,9,"ENSG00000228340.8",1,2,"VMVVVVVVV",0,8,0.884057971014493,87,93,133,136,156,162,172,175,"ATGATGG","TAGA","ATCATGG","CTGA",2.50615385098785,40,20,10,79,1.27945036921727,4.49678567728406,8.03301756134203,101,"ENSG00000079974.19"
"2244","ENSG00000072134.16_67735",67727,67735,9,"ENSG00000072134.16",1,6,"VVUVVMVVV",1,7,0.786335403726708,16,22,37,40,79,85,133,136,"CTGATGA","CTGA","GTGTGGA","CTGA",2.79422528562437,15,39,48,111,0.922456225376702,4.88765619905146,8.03299781395829,101,"ENSG00000079974.19"
"36434","ENSG00000240875.6_53275",53267,53275,9,"ENSG00000240875.6",1,2,"VMUVVVVVV",1,7,0.767701863354037,112,118,133,136,143,149,177,180,"AAGATGA","CTGG","GTGATAA","CTGA",2.66470430660312,15,7,28,59,2.08396764552947,4.9621657557209,8.03297320913705,101,"ENSG00000079974.19"
"10094","ENSG00000129159.9_115682",115674,115682,9,"ENSG00000129159.9",1,2,"VMUVVVVVV",1,7,0.767701863354037,114,120,133,136,146,152,163,166,"ATAATGA","CAGA","GGGTTGT","CTGA",2.54349954552042,13,10,11,43,2.89199271304926,4.96216408746302,8.03297154087916,101,"ENSG00000079974.19"
"29316","ENSG00000197658.9_29960",29952,29960,9,"ENSG00000197658.9",1,1,"MVVVVVVVV",0,8,0.90600414078675,82,88,133,136,182,188,199,202,"TTAATGA","GTGA","ATGTTTA","CTGA",2.4971197754244,45,46,11,111,0.988212267561057,4.40891935926427,8.03293592241126,101,"ENSG00000079974.19"
"17601","ENSG00000154639.19_29702",29694,29702,9,"ENSG00000154639.19",1,1,"MVVVUVVVV",1,7,0.795859213250517,71,77,98,101,111,117,133,136,"ATAATGT","CTGA","TTGAATA","CTGA",2.59968838810582,21,10,16,56,2.06654599426426,4.84945047874243,8.0328873317445,101,"ENSG00000079974.19"
"26431","ENSG00000184226.15_484251",484243,484251,9,"ENSG00000184226.15",0,NA,"VVUVVVVVV",1,8,0.883643892339545,114,120,133,136,148,154,168,171,"ATGGTGT","CTGA","CTCATTA","CTAA",2.30361772843138,13,12,14,48,2.63466801651755,4.49802988484835,8.03260545420653,101,"ENSG00000079974.19"
"15281","ENSG00000147548.17_40183",40175,40183,9,"ENSG00000147548.17",1,2,"VMVVVVVVV",0,8,0.884057971014493,112,118,133,136,153,159,174,177,"AAAATGA","TTAA","TTGATGG","CTGA",2.374604314695,15,17,15,56,2.15470348981367,4.49634973027841,8.03258161433638,101,"ENSG00000079974.19"
"5474","ENSG00000104972.16_7080",7072,7080,9,"ENSG00000104972.16",1,3,"VVMVVVUVV",1,7,0.768944099378882,73,79,95,98,101,107,133,136,"GTGATGA","CTGA","GACATGG","CTGA",2.70775626323218,16,3,26,54,1.77519946175934,4.9567269708268,8.03250336834233,101,"ENSG00000079974.19"
"41175","ENSG00000258631.3_72664",72656,72664,9,"ENSG00000258631.3",1,2,"UMVVVVVVV",1,7,0.786749482401656,116,122,133,136,160,166,187,190,"ATTATGA","ATGA","GTGAGGA","CTGA",2.69398592666748,11,24,21,65,1.58178443325678,4.88542265275999,8.03242058236661,101,"ENSG00000079974.19"
"27583","ENSG00000186566.13_97462",97454,97462,9,"ENSG00000186566.13",1,8,"VVVVVVVMV",0,8,0.884057971014493,107,113,133,136,146,152,173,176,"AGGATGA","CTTC","ATGAGTT","CTGA",2.42036312462774,20,10,21,60,1.84885178995253,4.49615148853436,8.03238337259233,101,"ENSG00000079974.19"
"28087","ENSG00000188107.15_590067",590059,590067,9,"ENSG00000188107.15",1,2,"VMVVVVVVV",0,8,0.884057971014493,112,118,133,136,167,173,212,215,"GTAATGA","GTGA","GAGAAGA","CTGA",2.55114819957897,15,31,39,94,0.976928754004266,4.49614585446602,8.03237773852399,101,"ENSG00000079974.19"
"8334","ENSG00000118271.12_21542",21534,21542,9,"ENSG00000118271.12",1,6,"VVVVVMVVV",0,8,0.902691511387163,75,81,94,97,110,116,133,136,"ATTGTGA","CTGA","ATGTTCA","CTGC",2.29480527918028,13,13,17,52,2.38767349220293,4.4215938383512,8.03235988389985,101,"ENSG00000079974.19"
"25116","ENSG00000179532.13_58082",58074,58082,9,"ENSG00000179532.13",1,2,"VMVVVVVVV",0,8,0.884057971014493,68,74,82,85,115,121,133,136,"ATGAGGA","CTGA","AGGATTA","TTGA",2.43662728489277,8,30,12,59,1.74021463788834,4.49609913429336,8.03233101835133,101,"ENSG00000079974.19"
"24362","ENSG00000176049.16_156500",156492,156500,9,"ENSG00000176049.16",0,NA,"VVVVVUVVV",1,8,0.922153209109731,97,103,133,136,142,148,164,167,"GTGATGA","AGGA","ATGAACA","CTAA",2.3383357898243,30,6,16,61,1.78586986130364,4.34369378169974,8.03230661813867,101,"ENSG00000079974.19"
"7249","ENSG00000113391.19_84724",84716,84724,9,"ENSG00000113391.19",1,2,"VMVVVVVVV",0,8,0.884057971014493,103,109,133,136,144,150,192,195,"CTGATTA","CAAA","GTGATGA","CTGA",2.51488231142845,24,8,42,83,1.21838950605156,4.49606789556031,8.03229977961828,101,"ENSG00000079974.19"
"46257","ENSG00000286385.1_137263",137255,137263,9,"ENSG00000286385.1",1,1,"MVVVVVVVV",0,8,0.90600414078675,83,89,133,136,147,153,166,169,"GTGAAGA","GGGA","CTAATAA","CTGA",2.38176606071538,44,11,13,77,1.75456267268591,4.40825076936378,8.03226733251077,101,"ENSG00000079974.19"
"29156","ENSG00000197329.12_949",941,949,9,"ENSG00000197329.12",0,NA,"VVVVVVUVV",1,8,0.886128364389234,115,121,133,136,139,145,176,179,"CTGAGGT","CTCA","TTGATGG","CTGA",2.42140107811575,12,3,31,55,1.808229900221,4.4877259385815,8.03223939613843,101,"ENSG00000079974.19"
"28287","ENSG00000188641.14_176906",176898,176906,9,"ENSG00000188641.14",0,NA,"VVVVUVVVV",1,8,0.889855072463768,116,122,133,136,147,153,171,174,"AACATGA","CTGA","GTCAGGA","CTTA",2.31660640376237,11,11,18,49,2.44715686390202,4.47279988891278,8.03222017876785,101,"ENSG00000079974.19"
"44551","ENSG00000282987.1_206433",206425,206433,9,"ENSG00000282987.1",0,NA,"VVUVVVVVV",1,8,0.883643892339545,104,110,133,136,151,157,166,169,"ATGATAA","ATTA","GTGGTTT","CTGA",2.42476549869123,23,15,9,56,1.82546618608346,4.49764237767291,8.03221794703109,101,"ENSG00000079974.19"
"21423","ENSG00000167522.17_57470",57462,57470,9,"ENSG00000167522.17",1,3,"VVMVVVVVV",0,8,0.882815734989648,77,83,106,109,114,120,133,136,"ATGGTGA","CTGA","ATCAAAA","CAGA",2.38188697112149,23,5,13,50,2.12435866656067,4.50090128517598,8.03216422513458,101,"ENSG00000079974.19"
"35662","ENSG00000236653.3_31450",31442,31450,9,"ENSG00000236653.3",1,8,"VVVVVVVMV",0,8,0.884057971014493,114,120,133,136,142,148,170,173,"AAGATGA","CCAA","ATGATGA","CTCA",2.33938562428545,13,6,22,50,2.38778799128283,4.49592303829646,8.03215492235443,101,"ENSG00000079974.19"
"27091","ENSG00000185565.12_1011139",1011131,1011139,9,"ENSG00000185565.12",1,1,"MVVVVVVVV",0,8,0.90600414078675,54,60,75,78,109,115,133,136,"ATGAGAA","CTGA","GTGAAGA","TTGA",2.40665311744727,15,31,18,73,1.58801099090179,4.40809127680423,8.03210783995123,101,"ENSG00000079974.19"
"7456","ENSG00000114316.13_12866",12858,12866,9,"ENSG00000114316.13",0,NA,"VVVUVVVVV",1,8,0.880745341614907,98,104,133,136,142,148,165,168,"ATCATGT","GTGA","GTGCTCT","CTGA",2.44444884187617,29,6,17,61,1.73998392444945,4.50907738423932,8.03205875069895,101,"ENSG00000079974.19"
"41749","ENSG00000259669.6_1335",1327,1335,9,"ENSG00000259669.6",1,8,"VVVVVVVMV",0,8,0.884057971014493,48,54,81,84,93,99,133,136,"ATGATGG","CTGA","TTGATTA","CTGG",2.52994943161228,27,9,34,79,1.11684071391622,4.49579256449952,8.03202444855749,101,"ENSG00000079974.19"
"36178","ENSG00000238156.1_2501",2493,2501,9,"ENSG00000238156.1",1,3,"UVMVVVVVV",1,7,0.785507246376811,113,119,133,136,149,155,174,177,"CTGATGT","CTGA","GTTAGAA","CTGA",2.5989796915829,14,13,19,55,2.23336522368198,4.88997412522533,8.03200311073258,101,"ENSG00000079974.19"
"28467","ENSG00000189229.12_168304",168296,168304,9,"ENSG00000189229.12",0,NA,"UVVVVVVVV",1,8,0.902691511387163,116,122,133,136,148,154,198,201,"TTGAAGT","CTGT","ATGTGGA","CTGA",2.39027626604199,11,12,44,76,1.74972679131141,4.4212254745645,8.03199152011315,101,"ENSG00000079974.19"
"38732","ENSG00000250938.8_491940",491932,491940,9,"ENSG00000250938.8",0,NA,"VVVUVVVVV",1,8,0.880745341614907,78,84,93,96,103,109,133,136,"ATGATGG","CTGG","GTGTTGC","CTGC",2.38271287022521,9,7,24,49,2.15127091645627,4.50900584615609,8.03198721261572,101,"ENSG00000079974.19"
"2814","ENSG00000078328.23_1565171",1565163,1565171,9,"ENSG00000078328.23",0,NA,"VVVVVVUVV",1,8,0.886128364389234,91,97,133,136,146,152,165,168,"ATGCTGT","CTGT","TTCATCA","CTGA",2.41896387213785,36,10,13,68,1.82341759195751,4.48746085155246,8.0319743091094,101,"ENSG00000079974.19"
"39455","ENSG00000253619.1_103010",103002,103010,9,"ENSG00000253619.1",1,8,"VVVVVVVMV",0,8,0.884057971014493,111,117,133,136,146,152,165,168,"TTGAAGA","ATGA","CTGATGG","CTGC",2.29888437947304,16,10,13,48,2.65706975281283,4.4957414039916,8.03197328804957,101,"ENSG00000079974.19"
"38369","ENSG00000250049.7_45444",45436,45444,9,"ENSG00000250049.7",1,1,"MVVVVVVVV",0,8,0.90600414078675,48,54,80,83,91,97,133,136,"GTGGTGA","CAGA","GTTATTT","CTGA",2.47011637494688,26,8,36,79,1.16437569668888,4.40795454908369,8.03197111223069,101,"ENSG00000079974.19"
"32200","ENSG00000226320.6_308197",308189,308197,9,"ENSG00000226320.6",1,1,"MVVVVVVVV",0,8,0.90600414078675,116,122,133,136,142,148,157,160,"GTGCCCA","CTGC","TTCAAGA","CTGA",2.18137960059269,11,6,9,35,3.08888184458108,4.40785312879976,8.03186969194676,101,"ENSG00000079974.19"
"35614","ENSG00000236452.1_61925",61917,61925,9,"ENSG00000236452.1",1,1,"MVVVVVVVV",0,8,0.90600414078675,116,122,133,136,142,148,157,160,"GTGCCCA","CTGC","TTCAAGA","CTGA",2.18137960059269,11,6,9,35,3.08888184458108,4.40785312879976,8.03186969194676,101,"ENSG00000079974.19"
"44521","ENSG00000282890.1_63476",63468,63476,9,"ENSG00000282890.1",1,2,"VMVVVVVVV",0,8,0.884057971014493,110,116,133,136,143,149,158,161,"ATGATGA","TTAA","AATAGGA","ATGA",2.28172560355367,17,7,9,42,2.77102650663001,4.49563263258029,8.03186451663826,101,"ENSG00000079974.19"
"43924","ENSG00000275443.2_130452",130444,130452,9,"ENSG00000275443.2",1,8,"UVVVVVVMV",1,7,0.786749482401656,70,76,89,92,106,112,133,136,"TTGATGG","CTGT","TTGATGA","CTGA",2.61911282357694,13,14,21,57,2.07871059647307,4.88486568841317,8.03186361801979,101,"ENSG00000079974.19"
"40403","ENSG00000255929.6_63013",63005,63013,9,"ENSG00000255929.6",1,1,"MVUVVVVVV",1,7,0.789648033126294,115,121,133,136,140,146,156,159,"ATGATGG","CAGG","AGGCTGA","CTGA",2.47852746834738,12,4,10,35,2.9695409736259,4.87326435731878,8.03185648982396,101,"ENSG00000079974.19"
"42756","ENSG00000266450.1_51719",51711,51719,9,"ENSG00000266450.1",1,2,"VMVVVVVVV",0,8,0.884057971014493,72,78,88,91,99,105,133,136,"TTGATGA","CAGA","ATAATGT","CAGA",2.38525069009553,10,8,28,55,2.0804959162991,4.49554179590066,8.03177367995863,101,"ENSG00000079974.19"
"42772","ENSG00000266602.2_197874",197866,197874,9,"ENSG00000266602.2",1,2,"VMVVVVVVV",0,8,0.884057971014493,72,78,88,91,99,105,133,136,"TTGATGA","CAGA","ATAATGT","CAGA",2.38525069009553,10,8,28,55,2.0804959162991,4.49554179590066,8.03177367995863,101,"ENSG00000079974.19"
"13803","ENSG00000143498.18_24684",24676,24684,9,"ENSG00000143498.18",1,1,"MVVVVVUVV",1,7,0.792132505175983,85,91,98,101,115,121,133,136,"AGGATGA","CAGA","GTGAATT","CTGA",2.58644065397185,7,14,12,42,2.21002010876154,4.8632394504768,8.03176947118073,101,"ENSG00000079974.19"
"38564","ENSG00000250437.1_25884",25876,25884,9,"ENSG00000250437.1",1,5,"VVVUMVVVV",1,7,0.767287784679089,112,118,133,136,144,150,160,163,"TTGATCA","CTGG","CTGAGGA","CTGA",2.54054353680015,15,8,10,42,2.91350402497271,4.96261523424342,8.03176637295978,101,"ENSG00000079974.19"
"6659","ENSG00000111249.14_52765",52757,52765,9,"ENSG00000111249.14",1,2,"VMVVVVVVV",0,8,0.884057971014493,111,117,133,136,140,146,155,158,"GTGATGA","GAGA","GTGCCAA","CTCA",2.28714585223339,16,4,9,38,2.73410937113347,4.49543709650569,8.03166898056366,101,"ENSG00000079974.19"
"4738","ENSG00000101846.9_346540",346532,346540,9,"ENSG00000101846.9",1,1,"MVUVVVVVV",1,7,0.789648033126294,115,121,133,136,150,156,171,174,"TTGTTGA","CTGT","GTGATGC","CTGA",2.55749437291032,12,14,15,50,2.44081365521485,4.87269403532092,8.0312861678261,101,"ENSG00000079974.19"
"40248","ENSG00000255345.1_5027",5019,5027,9,"ENSG00000255345.1",0,NA,"VVVVUVVVV",1,8,0.889855072463768,111,117,133,136,152,158,177,180,"ATTCTGA","TTGA","TGGATTA","CTGA",2.39784821055812,16,16,19,60,1.90178924435281,4.47186099535174,8.03128128520681,101,"ENSG00000079974.19"
"25493","ENSG00000181852.18_14556",14548,14556,9,"ENSG00000181852.18",1,6,"VVVVVMVVV",0,8,0.902691511387163,87,93,102,105,111,117,133,136,"AGGATGC","CAGA","GTGAGTA","CTGT",2.26053923933764,9,6,16,40,2.61171463301261,4.42049405714921,8.03126010269787,101,"ENSG00000079974.19"
"33121","ENSG00000228740.3_425",417,425,9,"ENSG00000228740.3",1,1,"MVVVVVVVV",0,8,0.90600414078675,101,107,133,136,139,145,160,163,"CTGAGGA","CTGG","ATACTAA","CTGA",2.39656847052003,26,3,15,53,1.65172665175957,4.40721244713995,8.03122901028695,101,"ENSG00000079974.19"
"32781","ENSG00000227885.4_44587",44579,44587,9,"ENSG00000227885.4",1,3,"VVMVVVVVV",0,8,0.882815734989648,113,119,133,136,150,156,210,213,"AAGCTGA","GTGA","GTGATAG","CTGA",2.46177167370589,14,14,54,91,1.5876492769199,4.49986510873978,8.03112804869838,101,"ENSG00000079974.19"
"18285","ENSG00000156876.10_13931",13923,13931,9,"ENSG00000156876.10",1,8,"VVVVVVVMV",0,8,0.884057971014493,116,122,133,136,141,147,158,161,"ATGAAAA","TTGC","AAGAACA","CTGA",2.24771728024235,11,5,11,36,2.9946049370839,4.49484670134155,8.03107858539953,101,"ENSG00000079974.19"
"11803","ENSG00000136122.18_5153",5145,5153,9,"ENSG00000136122.18",1,2,"VMVVUVVVV",1,7,0.773913043478261,63,69,82,85,113,119,133,136,"ATGATGG","TTGA","GTGAGGG","CTGA",2.67017274707417,13,28,14,64,1.94031635829718,4.93536700136458,8.03101917527762,101,"ENSG00000079974.19"
"23319","ENSG00000172572.7_287541",287533,287541,9,"ENSG00000172572.7",1,2,"VMVVVVVVV",0,8,0.884057971014493,89,95,108,111,116,122,133,136,"GTCATGA","CTAA","ATAATTA","ATGA",2.2508835465556,13,5,11,38,2.9726827964902,4.49464327671522,8.03087516077319,101,"ENSG00000079974.19"
"36373","ENSG00000240395.1_400",392,400,9,"ENSG00000240395.1",0,NA,"VVVVVUVVV",1,8,0.922153209109731,86,92,103,106,110,116,133,136,"ATGAAGG","GTGA","GCGATAA","TTGA",2.2251941840464,11,4,17,41,2.53435147947551,4.34224484327955,8.03085767971847,101,"ENSG00000079974.19"
"17013","ENSG00000152953.13_232291",232283,232291,9,"ENSG00000152953.13",0,NA,"UVVVVVVVV",1,8,0.902691511387163,39,45,59,62,112,118,133,136,"GGGATGA","CTGA","ATAATGG","CTGG",2.38473608356062,14,50,15,88,1.78185919760285,4.42002493866842,8.03079098421707,101,"ENSG00000079974.19"
"5261","ENSG00000104177.19_16056",16048,16056,9,"ENSG00000104177.19",1,6,"VVVVVMVVV",0,8,0.902691511387163,109,115,133,136,186,192,223,226,"GTGATAT","CTAA","ATGATGA","CTGA",2.53583898288719,18,50,31,108,0.774465053149335,4.42001456809931,8.03078061364796,101,"ENSG00000079974.19"
"14058","ENSG00000144331.20_11417",11409,11417,9,"ENSG00000144331.20",1,1,"MVVVVVVVV",0,8,0.90600414078675,93,99,133,136,138,144,153,156,"TTGAGGA","AGGA","GTGAGAA","CTGA",2.41356254631539,34,2,9,54,1.53605812968424,4.40661877628005,8.03063533942705,101,"ENSG00000079974.19"
"19764","ENSG00000163638.13_146415",146407,146415,9,"ENSG00000163638.13",1,1,"MVVVVVVVV",0,8,0.90600414078675,115,121,133,136,145,151,165,168,"GCAAGGA","TTAA","GTGAAGA","CTGA",2.21934970846562,12,9,14,44,2.83078849053812,4.40661330341056,8.03062986655756,101,"ENSG00000079974.19"
"11994","ENSG00000136828.19_79722",79714,79722,9,"ENSG00000136828.19",1,1,"MVVVVVVVV",0,8,0.90600414078675,73,79,90,93,102,108,133,136,"AAGATGA","ATGA","GAGAAGT","ATGA",2.31414144991933,11,9,25,54,2.19851634966736,4.40653150394906,8.03054806709605,101,"ENSG00000079974.19"
"43376","ENSG00000271758.2_156255",156247,156255,9,"ENSG00000271758.2",1,6,"VVVVVMVVV",0,8,0.902691511387163,96,102,108,111,114,120,133,136,"ATGATGA","GGGA","ATACTGC","CAGA",2.28898699538757,6,3,13,31,2.41914009540899,4.41976334949821,8.03052939504686,101,"ENSG00000079974.19"
"21337","ENSG00000167191.12_24645",24637,24645,9,"ENSG00000167191.12",1,8,"VVVVVVVMV",0,8,0.884057971014493,111,117,133,136,137,143,164,167,"GAGGTGA","CAGA","ATGATGG","CTGA",2.45254469467451,16,1,21,47,1.62667598260177,4.49424348677463,8.0304753708326,101,"ENSG00000079974.19"
"11378","ENSG00000134775.16_164404",164396,164404,9,"ENSG00000134775.16",0,NA,"UVVVVUVVV",2,7,0.824844720496894,68,74,87,90,106,112,133,136,"GGGATGA","CTGT","TTTATGA","CTGA",2.54694528509633,13,16,21,59,1.94453887295792,4.73104352673336,8.03042240872094,101,"ENSG00000079974.19"
"28217","ENSG00000188517.17_196713",196705,196713,9,"ENSG00000188517.17",0,NA,"VVVVVUVVV",1,8,0.922153209109731,112,118,133,136,153,159,170,173,"ATACTGA","CAGT","GTAATAG","CTGA",2.2565265792673,15,17,11,52,2.32366327493513,4.34179345084596,8.03040628728488,101,"ENSG00000079974.19"
"13836","ENSG00000143641.10_22851",22843,22851,9,"ENSG00000143641.10",1,3,"VVMVVVVVV",0,8,0.882815734989648,102,108,133,136,172,178,188,191,"ATGATGA","CAGA","GTGTTAA","CTAA",2.52121879696387,25,36,10,80,1.1881341502588,4.49906486583781,8.03032780579641,101,"ENSG00000079974.19"
"34655","ENSG00000233723.11_289043",289035,289043,9,"ENSG00000233723.11",0,NA,"VVVVVUVVV",1,8,0.922153209109731,87,93,133,136,141,147,162,165,"CTGAAGA","GTTA","AGGATCA","CTGA",2.34249778056723,40,5,15,69,1.74997469656612,4.34165664175358,8.0302694781925,101,"ENSG00000079974.19"
"46473","ENSG00000286735.1_26515",26507,26515,9,"ENSG00000286735.1",0,NA,"VVVVUVVVV",1,8,0.889855072463768,116,122,133,136,145,151,185,188,"AGGATCA","AAGA","GTGAGGT","CTGA",2.38415585022295,11,9,34,63,1.98892331912071,4.4708239134851,8.03024420334017,101,"ENSG00000079974.19"
"41145","ENSG00000258583.7_278619",278611,278619,9,"ENSG00000258583.7",1,1,"MVVVVVVVV",0,8,0.90600414078675,115,121,133,136,140,146,157,160,"GAGATTA","CAAA","ATGACTG","CTGA",2.20476052768282,12,4,11,36,2.92626049687161,4.40616600368926,8.03018256683626,101,"ENSG00000079974.19"
"36922","ENSG00000243620.2_54332",54324,54332,9,"ENSG00000243620.2",1,1,"MVVVVVVVV",0,8,0.90600414078675,90,96,133,136,165,171,186,189,"ATGAAGT","ATGA","ATGAAAA","CTGA",2.51126471083273,37,29,15,90,0.88271924969423,4.40612099714477,8.03013756029177,101,"ENSG00000079974.19"
"40711","ENSG00000257452.1_59718",59710,59718,9,"ENSG00000257452.1",1,1,"MVVVVVVVV",0,8,0.90600414078675,90,96,133,136,165,171,186,189,"ATGAAGT","ATGA","ATGAAAA","CTGA",2.51126471083273,37,29,15,90,0.88271924969423,4.40612099714477,8.03013756029177,101,"ENSG00000079974.19"
"43669","ENSG00000273118.1_436455",436447,436455,9,"ENSG00000273118.1",1,1,"MVVVVVVVV",0,8,0.90600414078675,90,96,133,136,165,171,186,189,"ATGAAGT","ATGA","ATGAAAA","CTGA",2.51126471083273,37,29,15,90,0.88271924969423,4.40612099714477,8.03013756029177,101,"ENSG00000079974.19"
"9332","ENSG00000124181.15_5838",5830,5838,9,"ENSG00000124181.15",1,6,"UVVVVMVVV",1,7,0.805383022774327,110,116,133,136,180,186,200,203,"TTGATGA","CTTA","GTGCTTA","CTGA",2.64071431710758,17,44,14,84,1.62960455239082,4.80859166661034,8.03012375770765,101,"ENSG00000079974.19"
"31125","ENSG00000215869.4_116994",116986,116994,9,"ENSG00000215869.4",0,NA,"UVVVVVVVV",1,8,0.902691511387163,104,110,133,136,153,159,171,174,"AAGATAA","CTAA","AAGATAA","CTGA",2.40271609288356,23,17,12,61,1.65916966126588,4.41931923678907,8.03008528233773,101,"ENSG00000079974.19"
"1611","ENSG00000064012.24_67954",67946,67954,9,"ENSG00000064012.24",1,1,"MVVVVVVVV",0,8,0.90600414078675,90,96,133,136,165,171,186,189,"ATGAAGC","ATGA","GTGAAAA","CTGA",2.5112194114755,37,29,15,90,0.88271924969423,4.40604549821606,8.03006206136306,101,"ENSG00000079974.19"
"3177","ENSG00000082068.9_144661",144653,144661,9,"ENSG00000082068.9",1,1,"MVVVVVVVV",0,8,0.90600414078675,90,96,133,136,165,171,186,189,"ATGAAGC","ATGA","GTGAAAA","CTGA",2.5112194114755,37,29,15,90,0.88271924969423,4.40604549821606,8.03006206136306,101,"ENSG00000079974.19"
"11202","ENSG00000134247.10_66273",66265,66273,9,"ENSG00000134247.10",1,1,"MVVVVVVVV",0,8,0.90600414078675,90,96,133,136,165,171,186,189,"ATGAAGC","ATGA","GTGAAAA","CTGA",2.5112194114755,37,29,15,90,0.88271924969423,4.40604549821606,8.03006206136306,101,"ENSG00000079974.19"
"12211","ENSG00000137672.13_189464",189456,189464,9,"ENSG00000137672.13",1,1,"MVVVVVVVV",0,8,0.90600414078675,90,96,133,136,165,171,186,189,"ATGAAGC","ATGA","GTGAAAA","CTGA",2.5112194114755,37,29,15,90,0.88271924969423,4.40604549821606,8.03006206136306,101,"ENSG00000079974.19"
"12697","ENSG00000138785.16_161602",161594,161602,9,"ENSG00000138785.16",1,1,"MVVVVVVVV",0,8,0.90600414078675,90,96,133,136,165,171,186,189,"ATGAAGC","ATGA","GTGAAAA","CTGA",2.5112194114755,37,29,15,90,0.88271924969423,4.40604549821606,8.03006206136306,101,"ENSG00000079974.19"
"13137","ENSG00000140386.13_297730",297722,297730,9,"ENSG00000140386.13",1,1,"MVVVVVVVV",0,8,0.90600414078675,90,96,133,136,165,171,186,189,"ATGAAGC","ATGA","GTGAAAA","CTGA",2.5112194114755,37,29,15,90,0.88271924969423,4.40604549821606,8.03006206136306,101,"ENSG00000079974.19"
"13144","ENSG00000140386.13_480131",480123,480131,9,"ENSG00000140386.13",1,1,"MVVVVVVVV",0,8,0.90600414078675,90,96,133,136,165,171,186,189,"ATGAAGC","ATGA","GTGAAAA","CTGA",2.5112194114755,37,29,15,90,0.88271924969423,4.40604549821606,8.03006206136306,101,"ENSG00000079974.19"
"16831","ENSG00000152402.11_221504",221496,221504,9,"ENSG00000152402.11",1,1,"MVVVVVVVV",0,8,0.90600414078675,90,96,133,136,165,171,186,189,"ATGAAGC","ATGA","GTGAAAA","CTGA",2.5112194114755,37,29,15,90,0.88271924969423,4.40604549821606,8.03006206136306,101,"ENSG00000079974.19"
"17850","ENSG00000155530.4_113220",113212,113220,9,"ENSG00000155530.4",1,1,"MVVVVVVVV",0,8,0.90600414078675,90,96,133,136,165,171,186,189,"ATGAAGC","ATGA","GTGAAAA","CTGA",2.5112194114755,37,29,15,90,0.88271924969423,4.40604549821606,8.03006206136306,101,"ENSG00000079974.19"
"20195","ENSG00000164418.22_226895",226887,226895,9,"ENSG00000164418.22",1,1,"MVVVVVVVV",0,8,0.90600414078675,90,96,133,136,165,171,186,189,"ATGAAGC","ATGA","GTGAAAA","CTGA",2.5112194114755,37,29,15,90,0.88271924969423,4.40604549821606,8.03006206136306,101,"ENSG00000079974.19"
"23943","ENSG00000174482.11_716245",716237,716245,9,"ENSG00000174482.11",1,1,"MVVVVVVVV",0,8,0.90600414078675,90,96,133,136,165,171,186,189,"ATGAAGC","ATGA","GTGAAAA","CTGA",2.5112194114755,37,29,15,90,0.88271924969423,4.40604549821606,8.03006206136306,101,"ENSG00000079974.19"
"24431","ENSG00000176273.15_35137",35129,35137,9,"ENSG00000176273.15",1,1,"MVVVVVVVV",0,8,0.90600414078675,90,96,133,136,165,171,186,189,"ATGAAGC","ATGA","GTGAAAA","CTGA",2.5112194114755,37,29,15,90,0.88271924969423,4.40604549821606,8.03006206136306,101,"ENSG00000079974.19"
"26455","ENSG00000184304.17_231828",231820,231828,9,"ENSG00000184304.17",1,1,"MVVVVVVVV",0,8,0.90600414078675,90,96,133,136,165,171,186,189,"ATGAAGC","ATGA","GTGAAAA","CTGA",2.5112194114755,37,29,15,90,0.88271924969423,4.40604549821606,8.03006206136306,101,"ENSG00000079974.19"
"31924","ENSG00000225258.1_102150",102142,102150,9,"ENSG00000225258.1",1,1,"MVVVVVVVV",0,8,0.90600414078675,90,96,133,136,165,171,186,189,"ATGAAGC","ATGA","GTGAAAA","CTGA",2.5112194114755,37,29,15,90,0.88271924969423,4.40604549821606,8.03006206136306,101,"ENSG00000079974.19"
"32238","ENSG00000226453.4_211663",211655,211663,9,"ENSG00000226453.4",1,1,"MVVVVVVVV",0,8,0.90600414078675,90,96,133,136,165,171,186,189,"ATGAAGC","ATGA","GTGAAAA","CTGA",2.5112194114755,37,29,15,90,0.88271924969423,4.40604549821606,8.03006206136306,101,"ENSG00000079974.19"
"35108","ENSG00000234948.2_352238",352230,352238,9,"ENSG00000234948.2",1,1,"MVVVVVVVV",0,8,0.90600414078675,90,96,133,136,165,171,186,189,"ATGAAGC","ATGA","GTGAAAA","CTGA",2.5112194114755,37,29,15,90,0.88271924969423,4.40604549821606,8.03006206136306,101,"ENSG00000079974.19"
"36694","ENSG00000242641.6_67457",67449,67457,9,"ENSG00000242641.6",1,1,"MVVVVVVVV",0,8,0.90600414078675,90,96,133,136,165,171,186,189,"ATGAAGC","ATGA","GTGAAAA","CTGA",2.5112194114755,37,29,15,90,0.88271924969423,4.40604549821606,8.03006206136306,101,"ENSG00000079974.19"
"37136","ENSG00000245573.9_159905",159897,159905,9,"ENSG00000245573.9",1,1,"MVVVVVVVV",0,8,0.90600414078675,90,96,133,136,165,171,186,189,"ATGAAGC","ATGA","GTGAAAA","CTGA",2.5112194114755,37,29,15,90,0.88271924969423,4.40604549821606,8.03006206136306,101,"ENSG00000079974.19"
"37861","ENSG00000248975.2_336973",336965,336973,9,"ENSG00000248975.2",1,1,"MVVVVVVVV",0,8,0.90600414078675,90,96,133,136,165,171,186,189,"ATGAAGC","ATGA","GTGAAAA","CTGA",2.5112194114755,37,29,15,90,0.88271924969423,4.40604549821606,8.03006206136306,101,"ENSG00000079974.19"
"38354","ENSG00000250039.4_49078",49070,49078,9,"ENSG00000250039.4",1,1,"MVVVVVVVV",0,8,0.90600414078675,90,96,133,136,165,171,186,189,"ATGAAGC","ATGA","GTGAAAA","CTGA",2.5112194114755,37,29,15,90,0.88271924969423,4.40604549821606,8.03006206136306,101,"ENSG00000079974.19"
"41380","ENSG00000258932.5_483071",483063,483071,9,"ENSG00000258932.5",1,1,"MVVVVVVVV",0,8,0.90600414078675,90,96,133,136,165,171,186,189,"ATGAAGC","ATGA","GTGAAAA","CTGA",2.5112194114755,37,29,15,90,0.88271924969423,4.40604549821606,8.03006206136306,101,"ENSG00000079974.19"
"41483","ENSG00000259093.2_34509",34501,34509,9,"ENSG00000259093.2",1,1,"MVVVVVVVV",0,8,0.90600414078675,90,96,133,136,165,171,186,189,"ATGAAGC","ATGA","GTGAAAA","CTGA",2.5112194114755,37,29,15,90,0.88271924969423,4.40604549821606,8.03006206136306,101,"ENSG00000079974.19"
"42177","ENSG00000260983.2_8361",8353,8361,9,"ENSG00000260983.2",1,1,"MVVVVVVVV",0,8,0.90600414078675,90,96,133,136,165,171,186,189,"ATGAAGC","ATGA","GTGAAAA","CTGA",2.5112194114755,37,29,15,90,0.88271924969423,4.40604549821606,8.03006206136306,101,"ENSG00000079974.19"
"43132","ENSG00000269086.3_20917",20909,20917,9,"ENSG00000269086.3",1,1,"MVVVVVVVV",0,8,0.90600414078675,90,96,133,136,165,171,186,189,"ATGAAGC","ATGA","GTGAAAA","CTGA",2.5112194114755,37,29,15,90,0.88271924969423,4.40604549821606,8.03006206136306,101,"ENSG00000079974.19"
"43398","ENSG00000271850.2_146433",146425,146433,9,"ENSG00000271850.2",1,1,"MVVVVVVVV",0,8,0.90600414078675,90,96,133,136,165,171,186,189,"ATGAAGC","ATGA","GTGAAAA","CTGA",2.5112194114755,37,29,15,90,0.88271924969423,4.40604549821606,8.03006206136306,101,"ENSG00000079974.19"
"44966","ENSG00000284634.1_163484",163476,163484,9,"ENSG00000284634.1",1,1,"MVVVVVVVV",0,8,0.90600414078675,90,96,133,136,165,171,186,189,"ATGAAGC","ATGA","GTGAAAA","CTGA",2.5112194114755,37,29,15,90,0.88271924969423,4.40604549821606,8.03006206136306,101,"ENSG00000079974.19"
"47763","ENSG00000289228.2_212062",212054,212062,9,"ENSG00000289228.2",1,1,"MVVVVVVVV",0,8,0.90600414078675,90,96,133,136,165,171,186,189,"ATGAAGC","ATGA","GTGAAAA","CTGA",2.5112194114755,37,29,15,90,0.88271924969423,4.40604549821606,8.03006206136306,101,"ENSG00000079974.19"
"48451","ENSG00000291118.1_46251",46243,46251,9,"ENSG00000291118.1",1,1,"MVVVVVVVV",0,8,0.90600414078675,90,96,133,136,165,171,186,189,"ATGAAGC","ATGA","GTGAAAA","CTGA",2.5112194114755,37,29,15,90,0.88271924969423,4.40604549821606,8.03006206136306,101,"ENSG00000079974.19"
"23699","ENSG00000173578.9_22823",22815,22823,9,"ENSG00000173578.9",1,8,"VVVVVVVMV",0,8,0.884057971014493,67,73,83,86,90,96,133,136,"ATGATAA","CAGT","GTGCTAG","CTGA",2.42725330016604,10,4,37,60,1.79360164463433,4.49382257810199,8.03005446215996,101,"ENSG00000079974.19"
"13857","ENSG00000143772.11_7457",7449,7457,9,"ENSG00000143772.11",1,7,"VVVVVUMVV",1,7,0.807453416149068,112,118,133,136,145,151,175,178,"TAGATGA","CAGA","GTTATGA","CTGA",2.55406293839459,15,9,24,57,2.17386681192099,4.80023826697123,8.03005193156751,101,"ENSG00000079974.19"
"11164","ENSG00000134121.10_74193",74185,74193,9,"ENSG00000134121.10",0,NA,"VVVVVUVVV",1,8,0.922153209109731,115,121,133,136,171,177,186,189,"AAGAGGA","TTGT","ATCATTA","CTGA",2.30205641312379,12,35,9,65,2.01863489697515,4.34141941278344,8.03003224922236,101,"ENSG00000079974.19"
"17255","ENSG00000153707.19_707390",707382,707390,9,"ENSG00000153707.19",1,2,"UMVVVVVVV",1,7,0.786749482401656,80,86,100,103,116,122,133,136,"ATGATAT","CTGA","GTCATTT","CTGA",2.53280388716168,14,13,11,47,2.6466001213307,4.88298984226882,8.02998777187544,101,"ENSG00000079974.19"
"32548","ENSG00000227160.3_62464",62456,62464,9,"ENSG00000227160.3",1,8,"VVVVVVVMV",0,8,0.884057971014493,115,121,133,136,139,145,162,165,"GTGCTTA","TTGA","GTAAAGC","CTGA",2.33278909489694,12,3,17,41,2.42281833002045,4.49368640733335,8.02991829139131,101,"ENSG00000079974.19"
"5210","ENSG00000103978.17_22599",22591,22599,9,"ENSG00000103978.17",1,1,"MVVVVVVVV",0,8,0.90600414078675,89,95,133,136,165,171,186,189,"ATGAAGC","ATGA","GTGAAAA","CTGA",2.5112194114755,38,29,15,91,0.881429187361973,4.405722982633,8.02973954577999,101,"ENSG00000079974.19"
"24730","ENSG00000177694.16_487601",487593,487601,9,"ENSG00000177694.16",1,1,"MVVVVVVVV",0,8,0.90600414078675,89,95,133,136,165,171,186,189,"ATGAAGC","ATGA","GTGAAAA","CTGA",2.5112194114755,38,29,15,91,0.881429187361973,4.405722982633,8.02973954577999,101,"ENSG00000079974.19"
"15237","ENSG00000147481.17_331347",331339,331347,9,"ENSG00000147481.17",0,NA,"UVVVVVVVV",1,8,0.902691511387163,82,88,101,104,115,121,133,136,"AAGACAA","CTGG","GTGGTAG","CTGA",2.23215653962301,13,11,12,45,2.79479972865154,4.41896083153457,8.02972687708322,101,"ENSG00000079974.19"
"24469","ENSG00000176463.14_7519",7511,7519,9,"ENSG00000176463.14",1,6,"VVVVVMUVV",1,7,0.788819875776397,95,101,107,110,111,117,133,136,"CTGATGA","CCGA","GGGAGGA","CTGA",2.65039579436841,6,1,16,32,1.82823935963824,4.8743861638569,8.02966566696249,101,"ENSG00000079974.19"
"42810","ENSG00000266941.1_1184",1176,1184,9,"ENSG00000266941.1",1,7,"UVVVVVMVV",1,7,0.787991718426501,87,93,107,110,112,118,133,136,"CTGATGC","CTGA","ATGGCAA","CTGA",2.57570804087432,14,2,15,40,2.33934647388753,4.87768335326242,8.02965022696843,101,"ENSG00000079974.19"
"39174","ENSG00000253197.5_73511",73503,73511,9,"ENSG00000253197.5",1,2,"UMVVVVVVV",1,7,0.786749482401656,74,80,88,91,114,120,133,136,"ATAATGA","CTGA","GGGAATA","CTGA",2.65599817133647,8,23,13,53,1.82350519502637,4.88253991765072,8.02953784725734,101,"ENSG00000079974.19"
"35729","ENSG00000236911.6_48620",48612,48620,9,"ENSG00000236911.6",1,8,"VVVVVUVMV",1,7,0.806211180124224,110,116,133,136,142,148,158,161,"ATGATGA","ATGA","GTGACCT","ATGA",2.46938204911062,17,6,10,42,2.7561906869595,4.80468442025757,8.02952914075446,101,"ENSG00000079974.19"
"34096","ENSG00000231901.1_8189",8181,8189,9,"ENSG00000231901.1",1,3,"VVMVVVVVV",0,8,0.882815734989648,114,120,133,136,151,157,193,196,"ATTATAA","GAGA","ATGATGA","CTGA",2.45992060220138,13,15,36,73,1.5935691462701,4.49825995690315,8.02952289686175,101,"ENSG00000079974.19"
"38729","ENSG00000250938.8_38174",38166,38174,9,"ENSG00000250938.8",1,2,"VMVVVUVVV",1,7,0.806211180124223,110,116,133,136,146,152,166,169,"ATGATGA","GTGA","ATGAGCA","CTGC",2.50399608161263,17,10,14,50,2.52532700015,4.80465855272522,8.02950327322212,101,"ENSG00000079974.19"
"35621","ENSG00000236467.8_22491",22483,22491,9,"ENSG00000236467.8",0,NA,"VVVUVVVVV",1,8,0.880745341614907,59,65,75,78,98,104,133,136,"ATGATGA","CTGG","ATGAAAA","CTGG",2.50195504092954,10,20,29,68,1.346275959381,4.50649405806115,8.02947542452078,101,"ENSG00000079974.19"
"26371","ENSG00000184005.11_376945",376937,376945,9,"ENSG00000184005.11",1,1,"MVVVVVVVV",0,8,0.90600414078675,112,118,133,136,141,147,187,190,"TTGAAGC","TTGA","TTGATTT","CTGA",2.36402210763798,15,5,40,69,1.86139302393864,4.40538510204796,8.02940166519496,101,"ENSG00000079974.19"
"16118","ENSG00000150760.13_237083",237075,237083,9,"ENSG00000150760.13",1,8,"UVVVVVVMV",1,7,0.786749482401656,86,92,133,136,142,148,160,163,"ATGAGGA","CTGA","GAGATTC","CTGA",2.63797260342559,41,6,12,68,1.94283691265418,4.88233023387285,8.02932816347948,101,"ENSG00000079974.19"
"40287","ENSG00000255471.1_12539",12531,12539,9,"ENSG00000255471.1",1,2,"VMVVVUVVV",1,7,0.806211180124223,81,87,103,106,109,115,133,136,"TAGATGA","GTGA","TTGAAGA","CTGA",2.55581343732907,16,3,18,46,2.17895036061787,4.80442665236959,8.02927137286648,101,"ENSG00000079974.19"
"31074","ENSG00000215424.10_7145",7137,7145,9,"ENSG00000215424.10",1,1,"MVVVVVVVV",0,8,0.90600414078675,115,121,133,136,160,166,175,178,"ATGGTAA","CTTA","GCTTTGA","CTGA",2.3213136156828,12,24,9,54,2.1455524974828,4.40524415050869,8.02926071365569,101,"ENSG00000079974.19"
"22732","ENSG00000171262.11_8778",8770,8778,9,"ENSG00000171262.11",0,NA,"VVVVVUVVV",1,8,0.922153209109731,115,121,133,136,146,152,186,189,"ATGTTGT","AGGA","GAGAGTA","CTGA",2.31006573395964,12,10,34,65,1.96191402202376,4.34058806210533,8.02920089854426,101,"ENSG00000079974.19"
"13471","ENSG00000141527.19_2385",2377,2385,9,"ENSG00000141527.19",0,NA,"VVVVVUVVV",1,8,0.922153209109731,101,107,133,136,146,152,171,174,"ATGCTGC","GAGA","CTGAGGG","CTGA",2.36327680773648,26,10,19,64,1.60707015152819,4.34056221744285,8.02917505388177,101,"ENSG00000079974.19"
"27845","ENSG00000187398.12_64911",64903,64911,9,"ENSG00000187398.12",1,8,"VVVVVVVMV",0,8,0.884057971014493,80,86,102,105,115,121,133,136,"ATGATAA","CTAA","TAGATGT","CTTA",2.29118545655361,16,10,12,47,2.696939157786,4.49287721703586,8.02910910109383,101,"ENSG00000079974.19"
"43929","ENSG00000275443.2_271209",271201,271209,9,"ENSG00000275443.2",0,NA,"VVUVVVVVV",1,8,0.883643892339545,48,54,70,73,78,84,133,136,"ATGTTGA","CTGA","GTGAGAG","TTGA",2.43083701376419,16,5,49,79,1.77241665630681,4.49449918701702,8.0290747563752,101,"ENSG00000079974.19"
"20971","ENSG00000166111.10_11708",11700,11708,9,"ENSG00000166111.10",0,NA,"VVUVVVVVV",1,8,0.883643892339545,105,111,133,136,142,148,162,165,"ATGCTCA","CTAA","ATGGGGG","CTGA",2.36778164582182,22,6,14,51,2.19266426575719,4.49446880947566,8.02904437883384,101,"ENSG00000079974.19"
"35251","ENSG00000235491.1_27417",27409,27417,9,"ENSG00000235491.1",1,1,"MVVVVVVVV",0,8,0.90600414078675,114,120,133,136,153,159,171,174,"TCAATGA","GTAA","ATGATAA","CTGA",2.28566777908253,13,17,12,51,2.38227935566718,4.40501613738768,8.02903270053468,101,"ENSG00000079974.19"
"18719","ENSG00000158290.19_11971",11963,11971,9,"ENSG00000158290.19",1,5,"VVVVMVVVV",0,8,0.886542443064182,112,118,133,136,150,156,170,173,"GTAATGT","TTAA","GTGTTTA","CTGA",2.32909544794186,15,14,14,52,2.40391929924378,4.48280557138072,8.02897534363744,101,"ENSG00000079974.19"
"10302","ENSG00000130413.16_34049",34041,34049,9,"ENSG00000130413.16",1,3,"VVMVVVVVV",0,8,0.882815734989648,84,90,133,136,145,151,159,162,"AAGATGA","CTCT","TTCTTGA","CTGA",2.40890049355979,43,9,8,69,1.931186758153,4.49763084547123,8.02889378542982,101,"ENSG00000079974.19"
"1416","ENSG00000055208.20_184084",184076,184084,9,"ENSG00000055208.20",1,8,"UVVVVVVMV",1,7,0.786749482401656,108,114,133,136,142,148,158,161,"CTGATGA","CTCA","ATACTGG","CTGA",2.54370785251541,19,6,10,44,2.56931418845727,4.88184163464001,8.02883956424663,101,"ENSG00000079974.19"
"3967","ENSG00000091436.17_174371",174363,174371,9,"ENSG00000091436.17",1,8,"VVVVVVVMV",0,8,0.884057971014493,82,88,133,136,143,149,157,160,"ATGAAGA","CTTT","ATGTCAA","CTGA",2.39851022876554,45,7,8,69,1.98035467239235,4.49260571604066,8.02883760009863,101,"ENSG00000079974.19"
"23927","ENSG00000174482.11_1223473",1223465,1223473,9,"ENSG00000174482.11",1,1,"MVVVVVVVV",0,8,0.90600414078675,112,118,133,136,141,147,163,166,"ACAATGT","CAGT","ATGAAGT","CTGA",2.25204313499028,15,5,16,45,2.60549078817484,4.40477792202751,8.02879448517451,101,"ENSG00000079974.19"
"21775","ENSG00000168939.13_86767",86759,86767,9,"ENSG00000168939.13",0,NA,"VVVVUVVVV",1,8,0.889855072463768,111,117,133,136,147,153,165,168,"AACAAGA","TTGA","TTGACAA","CTGA",2.28668239583726,16,11,12,48,2.63288850677677,4.46935945308963,8.0287797429447,101,"ENSG00000079974.19"
"23386","ENSG00000172901.21_53962",53954,53962,9,"ENSG00000172901.21",1,2,"UMVVVVVVV",1,7,0.786749482401656,97,103,133,136,162,168,180,183,"ATGATGA","CTTA","GTGTGGA","CTGA",2.7631689104624,30,26,12,77,1.10598825207056,4.88177858045498,8.0287765100616,101,"ENSG00000079974.19"
"41102","ENSG00000258548.6_25210",25202,25210,9,"ENSG00000258548.6",0,NA,"UVVVVVVVV",1,8,0.902691511387163,78,84,96,99,105,111,133,136,"ATGATGC","CTTA","GGGTTGC","CTTA",2.29181624100193,12,6,22,49,2.39275669173859,4.41788290793787,8.02864895348652,101,"ENSG00000079974.19"
"35191","ENSG00000235281.2_78619",78611,78619,9,"ENSG00000235281.2",1,8,"VVVVVVVMV",0,8,0.884057971014493,114,120,133,136,150,156,168,171,"CTGATGC","TTGA","GTGATTT","CTAA",2.30868594127831,13,14,12,48,2.57831834355075,4.4923894880182,8.02862137207617,101,"ENSG00000079974.19"
"27354","ENSG00000186047.11_321223",321215,321223,9,"ENSG00000186047.11",0,NA,"UVVVVVVVV",1,8,0.902691511387163,89,95,105,108,115,121,133,136,"AGGGTGA","ATTA","AAAATGC","CTGA",2.21012552129322,10,7,12,38,2.9371858392292,4.417838995296,8.02860504084466,101,"ENSG00000079974.19"
"29512","ENSG00000198108.4_104399",104391,104399,9,"ENSG00000198108.4",1,2,"VMVVVVVVV",0,8,0.884057971014493,115,121,133,136,139,145,154,157,"AAGGTGA","CAGA","TTGAAGA","GTGA",2.25923703182843,12,3,9,33,2.90790712619639,4.49237183459649,8.02860371865446,101,"ENSG00000079974.19"
"39955","ENSG00000254530.2_53900",53892,53900,9,"ENSG00000254530.2",0,NA,"UVVVUVVVV",2,7,0.792546583850932,108,114,133,136,154,160,170,173,"TTGATGT","ATGA","ATGAAGA","CTGA",2.62260367638614,19,18,10,56,1.94958236546587,4.8584017186767,8.02858805408043,101,"ENSG00000079974.19"
"488","ENSG00000013374.17_29504",29496,29504,9,"ENSG00000013374.17",0,NA,"UVVVVVVVV",1,8,0.902691511387163,91,97,133,136,180,186,197,200,"GGGATGT","CAGA","CTGATGT","CTGA",2.50140064748689,36,44,11,100,0.995175335282438,4.41779491296542,8.02856095851408,101,"ENSG00000079974.19"
"37819","ENSG00000248905.10_412078",412070,412078,9,"ENSG00000248905.10",1,8,"VVVVVVVMV",0,8,0.884057971014493,113,119,133,136,147,153,191,194,"TTGATTA","CTTA","GGGAGAA","CTGA",2.42098978488305,14,11,38,72,1.82922226145722,4.49228854016938,8.02852042422735,101,"ENSG00000079974.19"
"31567","ENSG00000224116.7_32622",32614,32622,9,"ENSG00000224116.7",1,2,"VMVVVVVVV",0,8,0.884057971014493,116,122,133,136,144,150,195,198,"ATAATAA","ATGC","GTGATTA","CTGA",2.40000509934814,11,8,45,73,1.96877241169088,4.49220160183628,8.02843348589425,101,"ENSG00000079974.19"
"43430","ENSG00000271860.9_847749",847741,847749,9,"ENSG00000271860.9",1,1,"MVVVVVVVV",0,8,0.90600414078675,116,122,133,136,162,168,182,185,"ATGACAA","AAGA","ATGCAGA","CTGA",2.35007166017546,11,26,14,60,1.95046381915096,4.40440205508017,8.02841861822717,101,"ENSG00000079974.19"
"16003","ENSG00000150625.17_80319",80311,80319,9,"ENSG00000150625.17",1,2,"VMVVVVVVV",0,8,0.884057971014493,112,118,133,136,137,143,151,154,"ATGTGGA","ATTA","ATGTGGA","CTGA",2.33173581807554,15,1,8,33,2.42358477214728,4.49212255649605,8.02835444055402,101,"ENSG00000079974.19"
"26283","ENSG00000183780.13_108913",108905,108913,9,"ENSG00000183780.13",1,8,"VVVVVVVMV",0,8,0.884057971014493,110,116,133,136,185,191,202,205,"AAGATAA","CTTA","GAGAGGA","CTGA",2.43395076544724,17,49,11,86,1.7418568032576,4.49204880989313,8.0282806939511,101,"ENSG00000079974.19"
"33025","ENSG00000228563.1_26131",26123,26131,9,"ENSG00000228563.1",1,1,"MVVVVVVVV",0,8,0.90600414078675,108,114,133,136,167,173,183,186,"AAAATGA","AGGA","CTGAGGA","CTGA",2.39964670298441,19,31,10,69,1.61926543080212,4.40422752934122,8.02824409248821,101,"ENSG00000079974.19"
"7745","ENSG00000115525.18_4685",4677,4685,9,"ENSG00000115525.18",0,NA,"VVVUVVVVV",1,8,0.880745341614907,114,120,133,136,146,152,164,167,"GTGGTGA","ATGA","AGGAAGA","CTGT",2.2740651000666,13,10,12,44,2.86058706384062,4.50525526607116,8.02823663253079,101,"ENSG00000079974.19"
"37588","ENSG00000248510.2_57728",57720,57728,9,"ENSG00000248510.2",1,3,"VVMVUVVVV",1,7,0.772670807453416,111,117,133,136,144,150,161,164,"ATTATGA","TTTA","ATGTTGA","CTGA",2.53967564016069,16,8,11,44,2.81900123054908,4.93754304123843,8.02822627105209,101,"ENSG00000079974.19"
"1762","ENSG00000065911.13_14724",14716,14724,9,"ENSG00000065911.13",1,3,"UVMVVVVVV",1,7,0.785507246376811,84,90,101,104,113,119,133,136,"TTGATAA","CTAA","ATTATGA","CTGA",2.51024872034165,11,9,14,43,2.80912572351533,4.88602929811491,8.02805828362216,101,"ENSG00000079974.19"
"2732","ENSG00000077942.19_17463",17455,17463,9,"ENSG00000077942.19",1,2,"VMVVVVUVV",1,7,0.770186335403727,80,86,99,102,108,114,133,136,"ATGATGA","CTGA","ATCATAA","CAGA",2.58473093629344,13,6,19,47,2.55748080673387,4.94725509550586,8.02800043712077,101,"ENSG00000079974.19"
"23173","ENSG00000172264.19_84173",84165,84173,9,"ENSG00000172264.19",1,1,"MVVVVVVVV",0,8,0.90600414078675,112,118,133,136,155,161,184,187,"GTTATGC","ATGA","CTGATCC","CTGA",2.4036641343388,15,19,23,66,1.59090915425101,4.40383417912742,8.02785074227442,101,"ENSG00000079974.19"
"2331","ENSG00000073282.14_223557",223549,223557,9,"ENSG00000073282.14",1,1,"MVVVVVVVV",0,8,0.90600414078675,113,119,133,136,144,150,158,161,"AAGAGGA","ATGA","ATAAGGA","TTGA",2.19593041434878,14,8,8,39,2.97548754499619,4.40375591016367,8.02777247331067,101,"ENSG00000079974.19"
"4637","ENSG00000101413.12_14649",14641,14649,9,"ENSG00000101413.12",1,2,"VMVVVVVVV",0,8,0.884057971014493,111,117,133,136,143,149,197,200,"CAGATGA","TTTA","TTGCTGA","CTGA",2.41864380424927,16,7,48,80,1.8417262100533,4.49150455959544,8.02773644365341,101,"ENSG00000079974.19"
"17314","ENSG00000153904.21_181117",181109,181117,9,"ENSG00000153904.21",1,8,"VVVVVVVMV",0,8,0.884057971014493,111,117,133,136,144,150,163,166,"ATTATGG","TTCA","ATCAGAA","CTGA",2.28271237685026,16,8,13,46,2.74777226283164,4.49146369379168,8.02769557784965,101,"ENSG00000079974.19"
"42496","ENSG00000263715.7_76304",76296,76304,9,"ENSG00000263715.7",1,6,"VVVVVMVVV",0,8,0.902691511387163,114,120,133,136,145,151,165,168,"ATAAAGA","ATGA","GTGTTAA","TTGA",2.22661923875893,13,9,14,45,2.82358264695618,4.41692772633726,8.02769377188591,101,"ENSG00000079974.19"
"24136","ENSG00000175216.15_40924",40916,40924,9,"ENSG00000175216.15",1,1,"MVVVVVVVV",0,8,0.90600414078675,111,117,133,136,180,186,195,198,"TTAATGA","ATTA","GTTTTGA","CTGA",2.36623932519946,16,44,9,78,1.83974785624959,4.40366917272816,8.02768573587516,101,"ENSG00000079974.19"
"2464","ENSG00000075142.14_3728",3720,3728,9,"ENSG00000075142.14",1,3,"VVMVVVVVV",0,8,0.882815734989648,107,113,133,136,154,160,170,173,"AAGATTA","ATGA","ATTATTA","CTGA",2.41837927290715,20,18,10,57,1.86309166353369,4.49640503739534,8.02766797735393,101,"ENSG00000079974.19"
"15334","ENSG00000147862.18_183120",183112,183120,9,"ENSG00000147862.18",1,8,"VVVVUVVMV",1,7,0.773913043478261,115,121,133,136,138,144,154,157,"AAGATGA","TGGA","ATGTTGA","CTGA",2.54914230765173,12,2,10,33,2.73361353275093,4.93197389594061,8.02762606985365,101,"ENSG00000079974.19"
"46412","ENSG00000286612.1_25896",25888,25896,9,"ENSG00000286612.1",1,1,"MVVUVVVVV",1,7,0.786749482401656,94,100,133,136,141,147,194,197,"ATGAGGA","CTGA","ATGAGGA","CTGA",2.78535436018234,33,5,47,94,0.953211042100751,4.88056002749576,8.02755795710238,101,"ENSG00000079974.19"
"27942","ENSG00000187699.10_208707",208699,208707,9,"ENSG00000187699.10",1,8,"VVVUVVVMV",1,7,0.764803312629399,115,121,133,136,144,150,158,161,"ATGAAGA","CTCA","GTGGTCC","CTGA",2.52413495392875,12,8,8,37,3.04579407461945,4.96834010853612,8.02755335905372,101,"ENSG00000079974.19"
"5367","ENSG00000104375.17_526198",526190,526198,9,"ENSG00000104375.17",0,NA,"VVVVVUVVV",1,8,0.922153209109731,93,99,133,136,145,151,188,191,"ATGACGG","CTGT","AAGAGGA","CTGA",2.45343638496472,34,9,37,89,0.999343803350854,4.33889659244558,8.02750942888451,101,"ENSG00000079974.19"
"9558","ENSG00000125414.19_3745",3737,3745,9,"ENSG00000125414.19",1,2,"VMVVVVVVV",0,8,0.884057971014493,90,96,133,136,145,151,166,169,"GTGTTTA","CTGT","CTGAGGA","CTGA",2.42896042700253,37,9,15,70,1.77194648576437,4.49125399977863,8.0274858838366,101,"ENSG00000079974.19"
"16931","ENSG00000152785.8_17555",17547,17555,9,"ENSG00000152785.8",1,5,"VVVVMVVVV",0,8,0.886542443064182,111,117,133,136,187,193,221,224,"AAGATGA","GTGA","ATGGTTT","CTGA",2.5367984360893,16,51,28,104,1.01315983087262,4.48128735120032,8.02745712345705,101,"ENSG00000079974.19"
"25584","ENSG00000182185.19_557936",557928,557936,9,"ENSG00000182185.19",1,8,"VVVVVVVMV",0,8,0.884057971014493,80,86,100,103,115,121,133,136,"ATAGTGA","CAGA","GTGAAGA","CTGC",2.29112614019403,14,12,12,47,2.69058290894004,4.49118929422506,8.02742117828303,101,"ENSG00000079974.19"
"42534","ENSG00000264015.2_131035",131027,131035,9,"ENSG00000264015.2",1,2,"UMVVVVVVV",1,7,0.786749482401656,108,114,133,136,148,154,164,167,"TTGATGA","ATGA","ATAAGAA","CTGA",2.57671751367085,19,12,10,50,2.34342757637708,4.88038608354569,8.02738401315231,101,"ENSG00000079974.19"
"29018","ENSG00000196951.13_28452",28444,28452,9,"ENSG00000196951.13",1,1,"MVVVVUVVV",1,7,0.82815734989648,97,103,133,136,171,177,191,194,"GTGATGA","CTGG","ATGCAGA","CTGA",2.68859643929686,30,35,14,88,0.93486674659496,4.7147107521435,8.02734015172942,101,"ENSG00000079974.19"
"13654","ENSG00000143061.18_81594",81586,81594,9,"ENSG00000143061.18",0,NA,"UVVVVUVVV",2,7,0.824844720496894,83,89,133,136,143,149,162,165,"ATCATGA","ATGA","GTGCCCA","CTGA",2.54885453468975,44,7,13,73,1.91944411394727,4.72795191963641,8.02733080162398,101,"ENSG00000079974.19"
"2392","ENSG00000074054.21_81449",81441,81449,9,"ENSG00000074054.21",1,6,"VVVVVMVVV",0,8,0.902691511387163,104,110,133,136,150,156,171,174,"CTGATGA","TTGA","TTGATTC","ATGA",2.3930031377658,23,14,15,61,1.71287950709287,4.41655843971622,8.02732448526487,101,"ENSG00000079974.19"
"1148","ENSG00000048052.24_904188",904180,904188,9,"ENSG00000048052.24",0,NA,"VVVUVVVVV",1,8,0.880745341614907,78,84,102,105,111,117,133,136,"TTGTTGC","TTGA","ATTATCA","CTGA",2.34106218803242,18,6,16,49,2.40988400447612,4.50424131450639,8.02722268096602,101,"ENSG00000079974.19"
"15304","ENSG00000147655.12_79362",79354,79362,9,"ENSG00000147655.12",0,NA,"UVVVVVVVV",1,8,0.902691511387163,109,115,133,136,141,147,183,186,"GTGGAGA","CTGG","TTGCTGA","CTGA",2.4035636449464,18,5,36,68,1.64191350252502,4.41641778387526,8.02718382942391,101,"ENSG00000079974.19"
"22170","ENSG00000169933.17_329147",329139,329147,9,"ENSG00000169933.17",0,NA,"UVVVVVVVV",1,8,0.902691511387163,49,55,96,99,108,114,133,136,"TTCAAGA","CTGA","GTGGATA","CTGA",2.42079914026588,41,9,19,78,1.52687238945453,4.4163833311401,8.02714937668876,101,"ENSG00000079974.19"
"24883","ENSG00000178568.15_1059877",1059869,1059877,9,"ENSG00000178568.15",0,NA,"UVVVVVVVV",1,8,0.902691511387163,116,122,133,136,170,176,194,197,"AGGATAA","ATTA","ATGAAGA","CTGA",2.40453248118183,11,34,18,72,1.63497149111314,4.41629700808134,8.02706305362999,101,"ENSG00000079974.19"
"26956","ENSG00000185345.24_550378",550370,550378,9,"ENSG00000185345.24",1,2,"VMVVVUVVV",1,7,0.806211180124223,115,121,133,136,145,151,173,176,"AAGGTGA","CTGA","TTGCTAA","CTGA",2.5274728680692,12,9,22,52,2.3586165794513,4.80210892497816,8.02695364547505,101,"ENSG00000079974.19"
"40535","ENSG00000256947.1_130516",130508,130516,9,"ENSG00000256947.1",1,6,"VVVVVMVVV",0,8,0.902691511387163,116,122,133,136,143,149,176,179,"CTGAGAA","AAGA","GTGTTGA","CTGA",2.32293436497624,11,7,27,54,2.17844644406837,4.41616888597749,8.02693493152614,101,"ENSG00000079974.19"
"7387","ENSG00000113805.9_87191",87183,87191,9,"ENSG00000113805.9",1,8,"VVVVUVVMV",1,7,0.773913043478261,75,81,91,94,110,116,133,136,"GTGATGT","CAGA","TTGAGGA","CTGA",2.64283298932061,10,16,17,52,2.10584599525678,4.93118314768187,8.02683532159492,101,"ENSG00000079974.19"
"10043","ENSG00000128918.15_195074",195066,195074,9,"ENSG00000128918.15",0,NA,"VVVVVUVVV",1,8,0.922153209109731,66,72,85,88,98,104,133,136,"TTGATTA","CTTA","ATGATGC","GTGA",2.29650257445834,13,10,29,61,2.04276169260408,4.33819471391492,8.02680755035384,101,"ENSG00000079974.19"
"6763","ENSG00000111817.19_50481",50473,50481,9,"ENSG00000111817.19",1,6,"VVVVVMVVV",0,8,0.902691511387163,111,117,133,136,151,157,169,172,"ATTGTGG","CTGT","CTGTTAA","CTGA",2.29705078491513,16,15,12,52,2.35006582937844,4.41593443220316,8.02670047775181,101,"ENSG00000079974.19"
"13494","ENSG00000141577.14_19285",19277,19285,9,"ENSG00000141577.14",1,5,"VVVVMUVVV",1,7,0.808695652173913,110,116,133,136,160,166,177,180,"ATGCTGC","CTGA","GTGCTGC","CTGA",2.59201342529898,17,24,11,61,1.88743575153369,4.79188131338172,8.02666392207737,101,"ENSG00000079974.19"
"38017","ENSG00000249345.8_82405",82397,82405,9,"ENSG00000249345.8",1,8,"VVVVVVVMV",0,8,0.884057971014493,99,105,133,136,144,150,179,182,"GTGAGGA","CAGG","GTGAGGA","CTGA",2.51221230879828,28,8,29,74,1.21359197424136,4.49041850822414,8.02665039228211,101,"ENSG00000079974.19"
"18580","ENSG00000157680.16_69429",69421,69429,9,"ENSG00000157680.16",1,7,"VVVVVUMVV",1,7,0.807453416149068,116,122,133,136,160,166,222,225,"TTGATGA","GTGA","ATGATGC","CTGA",2.70978714462847,11,24,56,100,1.12208656359273,4.7968335486123,8.02664721320857,101,"ENSG00000079974.19"
"46160","ENSG00000286234.1_39171",39163,39171,9,"ENSG00000286234.1",1,1,"MVVVVVVVV",0,8,0.90600414078675,104,110,133,136,149,155,166,169,"ATCATGT","GTGT","TTGTTGG","CTGA",2.34863439476323,23,13,11,56,1.95294265283586,4.40262632114768,8.02664288429468,101,"ENSG00000079974.19"
"47341","ENSG00000288016.3_5815",5807,5815,9,"ENSG00000288016.3",1,8,"VVUVVVVMV",1,7,0.767701863354037,62,68,77,80,89,95,133,136,"ATTATGA","CTGA","ATAAAGA","CTGA",2.70089490072288,9,9,38,65,1.8170424740318,4.95575211971275,8.0265595731289,101,"ENSG00000079974.19"
"31707","ENSG00000224509.4_55627",55619,55627,9,"ENSG00000224509.4",1,8,"VVVVVVVMV",0,8,0.884057971014493,107,113,133,136,145,151,166,169,"TTCATTA","ATGA","GTGCTTA","CTGA",2.35532405775905,20,9,15,53,2.25819927077292,4.49008991395831,8.02632179801628,101,"ENSG00000079974.19"
"11275","ENSG00000134444.15_98860",98852,98860,9,"ENSG00000134444.15",1,1,"MVVVVVVVV",0,8,0.90600414078675,84,90,133,136,147,153,202,205,"ATTATGC","CAGA","AAGATGA","CTGA",2.51557159772435,43,11,49,112,0.8387431930583,4.40230512780516,8.02632169095216,101,"ENSG00000079974.19"
"32342","ENSG00000226800.5_2528",2520,2528,9,"ENSG00000226800.5",0,NA,"VVVVVUVVV",1,8,0.922153209109731,112,118,133,136,171,177,226,229,"GTGTTGA","GTGA","ATAAAAA","CTGA",2.46272087405302,15,35,49,108,0.932526859952349,4.33766650507646,8.02627934151538,101,"ENSG00000079974.19"
"24408","ENSG00000176204.14_25947",25939,25947,9,"ENSG00000176204.14",1,2,"VMVVVVVVV",0,8,0.884057971014493,110,116,133,136,144,150,161,164,"TGGATGA","CTGT","TTGATAA","CTTA",2.28400035515025,17,8,11,45,2.73343017903204,4.49002480334176,8.02625668739973,101,"ENSG00000079974.19"
"46013","ENSG00000286121.1_22678",22670,22678,9,"ENSG00000286121.1",1,1,"MVVVVVVVV",0,8,0.90600414078675,112,118,133,136,146,152,173,176,"ATGGTAA","CACA","ATGGTTA","CTGA",2.30112526791701,15,10,21,55,2.26802767626181,4.40221569892713,8.02623226207413,101,"ENSG00000079974.19"
"13765","ENSG00000143375.15_10233",10225,10233,9,"ENSG00000143375.15",1,8,"VVVVVVVMV",0,8,0.884057971014493,109,115,133,136,138,144,154,157,"ATGAAGG","TTGG","CTGGAGA","CTGA",2.35852003990628,18,2,10,39,2.2363636083945,4.48995763527577,8.02618951933374,101,"ENSG00000079974.19"
"38723","ENSG00000250938.8_246087",246079,246087,9,"ENSG00000250938.8",1,2,"VMVVVVVVV",0,8,0.884057971014493,113,119,133,136,141,147,162,165,"ATGCTTA","TTAA","TTAAAGA","CTGA",2.28517652902294,14,5,15,43,2.72483913333804,4.48983733170608,8.02606921576405,101,"ENSG00000079974.19"
"24278","ENSG00000175662.18_75636",75628,75636,9,"ENSG00000175662.18",0,NA,"VVVVUVVVV",1,8,0.889855072463768,112,118,133,136,161,167,182,185,"AAAATAA","CTGA","TTGTGGA","CTGA",2.40237124253753,15,25,15,64,1.85045988121447,4.46656704119949,8.02598733105457,101,"ENSG00000079974.19"
"21693","ENSG00000168702.18_563546",563538,563546,9,"ENSG00000168702.18",1,1,"MVVVVVVVV",0,8,0.90600414078675,109,115,133,136,147,153,163,166,"ATTAGGA","TTGG","ATGGCAA","CTGA",2.26567423891828,18,11,10,48,2.50326153916375,4.40193911632141,8.0259556794684,101,"ENSG00000079974.19"
"755","ENSG00000032219.19_66532",66524,66532,9,"ENSG00000032219.19",1,7,"VVVVVUMVV",1,7,0.807453416149068,19,25,36,39,88,94,133,136,"ATGAGGA","CTGA","ATGAAAA","CTGA",2.72749963045261,11,49,39,108,1.00087254657324,4.79605085406433,8.0258645186606,101,"ENSG00000079974.19"
"14322","ENSG00000144677.15_62645",62637,62645,9,"ENSG00000144677.15",1,3,"UVMVVVVVV",1,7,0.785507246376811,76,82,96,99,112,118,133,136,"ATGGTGT","CTAA","GTGAGGA","CTGA",2.55892913814477,14,13,15,51,2.47562110031658,4.8837871719871,8.02581615749434,101,"ENSG00000079974.19"
"44747","ENSG00000283518.1_101141",101133,101141,9,"ENSG00000283518.1",0,NA,"VVVVUVVVV",1,8,0.889855072463768,110,116,133,136,144,150,164,167,"GTGATGC","CTCA","GAGATAA","CTGT",2.28758741548901,17,8,14,48,2.61482619096146,4.46635224022206,8.02577253007713,101,"ENSG00000079974.19"
"45365","ENSG00000285519.1_28056",28048,28056,9,"ENSG00000285519.1",1,8,"VVVVVUVMV",1,7,0.806211180124224,110,116,133,136,146,152,194,197,"ATGATGA","CAGC","ATGATCT","CTGA",2.63038468693976,17,10,42,78,1.66692550096493,4.80070585347416,8.02555057397105,101,"ENSG00000079974.19"
"29722","ENSG00000198626.18_685591",685583,685591,9,"ENSG00000198626.18",1,1,"MVVVVVVVV",0,8,0.90600414078675,81,87,105,108,114,120,133,136,"ATTATTA","CTGA","GGGAATA","TTGA",2.25490950942499,18,6,13,46,2.57340124586314,4.4015328271741,8.0255493903211,101,"ENSG00000079974.19"
"29798","ENSG00000198739.11_123305",123297,123305,9,"ENSG00000198739.11",1,8,"VVVVVVVMV",0,8,0.884057971014493,91,97,133,136,171,177,194,197,"ATGATGA","TTAA","ATGAACT","CTGA",2.58499539119846,36,35,17,97,0.723683089038638,4.48924642425709,8.02547830831506,101,"ENSG00000079974.19"
"39195","ENSG00000253288.2_269927",269919,269927,9,"ENSG00000253288.2",1,3,"VVMVVVVVV",0,8,0.882815734989648,114,120,133,136,142,148,156,159,"TTTATGT","CAGG","TTAAGGA","CTGA",2.23717815546711,13,6,8,36,3.06214521483788,4.49416656282132,8.02542950277991,101,"ENSG00000079974.19"
"5839","ENSG00000106991.14_16657",16649,16657,9,"ENSG00000106991.14",1,8,"VVVVVUVMV",1,7,0.806211180124224,113,119,133,136,143,149,197,200,"GTGATGA","CTGG","AGGCTGC","CTGA",2.58513360145902,14,7,48,78,1.96772129403731,4.80048632594102,8.02533104643792,101,"ENSG00000079974.19"
"9477","ENSG00000124788.19_338238",338230,338238,9,"ENSG00000124788.19",0,NA,"VVUVVUVVV",2,7,0.805797101449275,105,111,133,136,155,161,170,173,"ATCATGA","GTGA","ATCATGA","CTGA",2.63251538186359,22,19,9,59,1.65837025174122,4.80211819937461,8.02530660517171,101,"ENSG00000079974.19"
"7859","ENSG00000115902.11_30216",30208,30216,9,"ENSG00000115902.11",1,5,"UVVVMVVVV",1,7,0.789233954451346,79,85,93,96,103,109,133,136,"CTCATGA","CTGA","CTGTGGA","CTGA",2.61392460518034,8,7,24,48,2.04677423483544,4.86823456734276,8.02517038514814,101,"ENSG00000079974.19"
"31776","ENSG00000224812.4_106303",106295,106303,9,"ENSG00000224812.4",1,6,"VVVVVMVVV",0,8,0.902691511387163,110,116,133,136,169,175,194,197,"GTGCTGA","GGGA","GTGTGGA","CTGA",2.44467137075372,17,33,19,78,1.35947291847913,4.41432051420931,8.02508655975796,101,"ENSG00000079974.19"
"11689","ENSG00000135837.17_138840",138832,138840,9,"ENSG00000135837.17",0,NA,"VVVUUVVVV",2,7,0.770600414078675,113,119,133,136,147,153,162,165,"CTGATGA","CAGT","ATGAACA","CTGA",2.54410478026294,14,11,9,43,2.81000361935371,4.94267553860999,8.02507719492469,101,"ENSG00000079974.19"
"7596","ENSG00000115084.15_1085",1077,1085,9,"ENSG00000115084.15",1,2,"VMVVVVVVV",0,8,0.884057971014493,113,119,133,136,182,188,201,204,"AAGATGA","ATGT","ATGGTTG","CTGA",2.41053260126198,14,46,13,82,1.88513389314551,4.48883780872301,8.02506969278098,101,"ENSG00000079974.19"
"29839","ENSG00000198793.14_45835",45827,45835,9,"ENSG00000198793.14",1,2,"VMVVVVVVV",0,8,0.884057971014493,75,81,93,96,98,104,133,136,"ATGAGGG","CTGC","GTGCAGT","CTGA",2.44205534779367,12,2,29,52,1.67462665262463,4.48874890947894,8.02498079353691,101,"ENSG00000079974.19"
"32472","ENSG00000227043.3_65322",65314,65322,9,"ENSG00000227043.3",1,8,"VVVVVVVMV",0,8,0.884057971014493,111,117,133,136,143,149,157,160,"CTGATGG","ATGA","GTGAGAG","TTGA",2.26541366789166,16,7,8,40,2.85115871942076,4.48847912634129,8.02471101039927,101,"ENSG00000079974.19"
"13731","ENSG00000143324.14_33798",33790,33798,9,"ENSG00000143324.14",1,2,"VMVVVVVVV",0,8,0.884057971014493,113,119,133,136,139,145,158,161,"GTGATAC","GTTA","GTGTTTA","CTGA",2.29876333732017,14,3,13,39,2.62870264911643,4.48844789114606,8.02467977520403,101,"ENSG00000079974.19"
"46381","ENSG00000286540.1_108703",108695,108703,9,"ENSG00000286540.1",1,7,"VVVVVVMVV",0,8,0.885300207039338,111,117,133,136,137,143,160,163,"ATGATAC","CAGT","ATGATTA","CTGA",2.40890497433492,16,1,17,43,1.87360058849439,4.48324177101513,8.02444259917248,101,"ENSG00000079974.19"
"47669","ENSG00000288902.2_53059",53051,53059,9,"ENSG00000288902.2",1,8,"VVVVVVVMV",0,8,0.884057971014493,114,120,133,136,141,147,155,158,"GCGAGGA","TTGG","CTCATGG","CTGA",2.23708855637618,13,5,8,35,3.03887925885067,4.48820074200629,8.02443262606426,101,"ENSG00000079974.19"
"39268","ENSG00000253394.7_155544",155536,155544,9,"ENSG00000253394.7",1,1,"MVVVVVVVV",0,8,0.90600414078675,66,72,85,88,95,101,133,136,"GTGATTA","ATGA","GTGAGAA","ATGA",2.3273462125507,13,7,32,61,2.08595446593717,4.40039897073545,8.02441553388245,101,"ENSG00000079974.19"
"11392","ENSG00000134775.16_424546",424538,424546,9,"ENSG00000134775.16",1,8,"VVVVVUVMV",1,7,0.806211180124224,76,82,100,103,112,118,133,136,"GTGGTGA","GTGA","AAGATGT","CTGA",2.51451890090839,18,9,15,51,2.43450289211067,4.79949055787498,8.02433527837188,101,"ENSG00000079974.19"
"8344","ENSG00000118322.14_154349",154341,154349,9,"ENSG00000118322.14",1,7,"VVVVVVMVV",0,8,0.885300207039338,86,92,133,136,152,158,176,179,"CTTATGA","TTAA","GTGATGA","CTGA",2.52099395592409,41,16,18,84,1.12573766572262,4.48309100963746,8.02429183779481,101,"ENSG00000079974.19"
"27173","ENSG00000185716.12_50264",50256,50264,9,"ENSG00000185716.12",1,8,"VVUVVVVMV",1,7,0.767701863354037,116,122,133,136,150,156,166,169,"ATAATGT","CTGA","TTGGTGC","CTGA",2.58110730702474,11,14,10,44,2.60627218227297,4.95341355727614,8.02422101069229,101,"ENSG00000079974.19"
"31116","ENSG00000215805.3_1282",1274,1282,9,"ENSG00000215805.3",0,NA,"VVVVVVUVV",1,8,0.886128364389234,116,122,133,136,177,183,216,219,"ATGGTGG","CAGA","GGGATGA","CTGA",2.52921832711076,11,41,33,94,1.05682306807694,4.47956964553717,8.0240831030941,101,"ENSG00000079974.19"
"36496","ENSG00000241369.6_87506",87498,87506,9,"ENSG00000241369.6",1,2,"UMVVVVVVV",1,7,0.786749482401656,92,98,105,108,115,121,133,136,"ATGAACA","CTGA","ATTCTGA","CTGA",2.52099953031719,7,7,12,35,2.70144760059183,4.87702778400994,8.02402571361657,101,"ENSG00000079974.19"
"1215","ENSG00000049618.25_120949",120941,120949,9,"ENSG00000049618.25",1,8,"UVVVVVVMV",1,7,0.786749482401656,116,122,133,136,147,153,161,164,"AGGATGA","CAGG","ATGAAAA","CTGA",2.50098015436085,11,11,8,39,2.83485122318002,4.87701306306309,8.02401099266971,101,"ENSG00000079974.19"
"31872","ENSG00000225096.3_404829",404821,404829,9,"ENSG00000225096.3",0,NA,"VVUVVUVVV",2,7,0.805797101449275,111,117,133,136,143,149,160,163,"GTAATGA","TTAA","GTGAGGG","CTGA",2.45508428522657,16,7,11,43,2.83604865207137,4.80081930506213,8.02400771085923,101,"ENSG00000079974.19"
"38134","ENSG00000249662.6_27133",27125,27133,9,"ENSG00000249662.6",0,NA,"VVVVVVUVV",1,8,0.886128364389234,86,92,109,112,116,122,133,136,"ATGATAA","CTAA","AAGATCA","CTCA",2.2972484391791,17,4,11,41,2.60270341598938,4.47942325262917,8.02393671018611,101,"ENSG00000079974.19"
"32649","ENSG00000227480.2_45660",45652,45660,9,"ENSG00000227480.2",1,2,"UMVVVVVVV",1,7,0.786749482401656,77,83,95,98,110,116,133,136,"ATTTTGA","CTGA","ATGACAA","CTGA",2.55647250329016,12,12,17,50,2.46438680404,4.8768842064936,8.02388213610023,101,"ENSG00000079974.19"
"28054","ENSG00000188107.15_1049174",1049166,1049174,9,"ENSG00000188107.15",1,1,"MVVVVVVVV",0,8,0.90600414078675,90,96,133,136,165,171,186,189,"ATGAAGC","GTGA","GTGAAAA","CTGA",2.50746471810879,37,29,15,90,0.88271924969423,4.39978767593821,8.02380423908521,101,"ENSG00000079974.19"
"29884","ENSG00000198838.14_454887",454879,454887,9,"ENSG00000198838.14",1,2,"VMVVVVVVV",0,8,0.884057971014493,107,113,133,136,145,151,160,163,"GTTATTG","CTGT","ATGATGT","CTGA",2.32618661622986,20,9,9,47,2.44234172667085,4.48756312538415,8.02379500944212,101,"ENSG00000079974.19"
"30935","ENSG00000214814.7_251416",251408,251416,9,"ENSG00000214814.7",1,3,"VVMVVVVVV",0,8,0.882815734989648,86,92,100,103,112,118,133,136,"ATCATGC","CTGA","GTGAACT","TTGA",2.31706648600284,8,9,15,41,2.52296964375313,4.49251988760968,8.02378282756827,101,"ENSG00000079974.19"
"18614","ENSG00000157837.16_80744",80736,80744,9,"ENSG00000157837.16",0,NA,"UVVVUVVVV",2,7,0.792546583850932,108,114,133,136,140,146,154,157,"GAGATGA","AAGA","CTGATGA","CTGA",2.5479729290343,19,4,8,40,2.42787061583007,4.85358920234801,8.02377553775174,101,"ENSG00000079974.19"
"27653","ENSG00000187068.3_68109",68101,68109,9,"ENSG00000187068.3",1,7,"VVVVVVMVV",0,8,0.885300207039338,81,87,96,99,115,121,133,136,"ACGATGA","CTGG","GTGCTAA","CTGT",2.34645490707505,9,16,12,46,2.2870778845413,4.48252764959374,8.02372847775109,101,"ENSG00000079974.19"
"31186","ENSG00000218336.9_38814",38806,38814,9,"ENSG00000218336.9",0,NA,"UVVVVVVVV",1,8,0.902691511387163,101,107,133,136,152,158,168,171,"AGGATGA","CCTA","GTTATTT","CTGA",2.40442734764299,26,16,10,61,1.62218468570775,4.41292508416526,8.02369112971391,101,"ENSG00000079974.19"
"37472","ENSG00000248266.1_37949",37941,37949,9,"ENSG00000248266.1",0,NA,"UVVVVVVVV",1,8,0.902691511387163,101,107,133,136,152,158,168,171,"AGGATGA","CCTA","GTTATTT","CTGA",2.40442734764299,26,16,10,61,1.62218468570775,4.41292508416526,8.02369112971391,101,"ENSG00000079974.19"
"16717","ENSG00000152207.8_44273",44265,44273,9,"ENSG00000152207.8",1,1,"MVVVVVVVV",0,8,0.90600414078675,90,96,133,136,168,174,189,192,"ATGAAGC","ATGA","GTGAAAA","CTGA",2.5112194114755,37,32,15,93,0.856677279213788,4.39953500559595,8.02355156874295,101,"ENSG00000079974.19"
"27251","ENSG00000185774.16_634916",634908,634916,9,"ENSG00000185774.16",1,2,"VMVVVUVVV",1,7,0.806211180124223,105,111,133,136,149,155,167,170,"ATGATGT","GTGA","GTTCAGA","CTGA",2.58083060340128,22,13,12,56,1.98924353042757,4.79869522160903,8.02353994210593,101,"ENSG00000079974.19"
"39132","ENSG00000251680.6_343729",343721,343729,9,"ENSG00000251680.6",1,7,"UVVVVVMVV",1,7,0.787991718426501,112,118,133,136,149,155,196,199,"ATGATGT","CTGT","GTTATGA","CTGA",2.67980144533208,15,13,41,78,1.62042324538055,4.87144155356526,8.02340842727127,101,"ENSG00000079974.19"
"23839","ENSG00000174453.10_32576",32568,32576,9,"ENSG00000174453.10",1,8,"UVVVVVVMV",1,7,0.786749482401656,115,121,133,136,146,152,160,163,"ATGAAAA","ATGA","TTGATAA","CTGA",2.48734694823951,12,10,8,39,2.92332041146315,4.87640834993163,8.02340627953826,101,"ENSG00000079974.19"
"13915","ENSG00000143951.16_164905",164897,164905,9,"ENSG00000143951.16",0,NA,"VVVUVVVVV",1,8,0.880745341614907,113,119,133,136,144,150,167,170,"AGGTTTA","CTGT","CTCATGA","CTGA",2.3027447949096,14,8,17,48,2.64998840369942,4.50040509244085,8.02338645890048,101,"ENSG00000079974.19"
"19979","ENSG00000164100.9_81933",81925,81933,9,"ENSG00000164100.9",1,7,"VVVVVVMVV",0,8,0.885300207039338,84,90,133,136,145,151,173,176,"ATAATGA","TTGC","ATGCTGT","CTGA",2.48547304279742,43,9,22,83,1.35869012355661,4.48212760221819,8.02332843037554,101,"ENSG00000079974.19"
"36225","ENSG00000238755.3_542021",542013,542021,9,"ENSG00000238755.3",0,NA,"VVUVVVVVV",1,8,0.883643892339545,114,120,133,136,147,153,163,166,"TTAATGT","TAGA","ATCTTGA","CTGA",2.26678280872116,13,11,10,43,2.84307618458625,4.48874039401516,8.02331596337334,101,"ENSG00000079974.19"
"47973","ENSG00000289860.1_22486",22478,22486,9,"ENSG00000289860.1",1,5,"VVVVMVVVV",0,8,0.886542443064182,91,97,133,136,145,151,159,162,"TTGATGG","TTTA","ATCAGGA","CTGA",2.39576882093851,36,9,8,62,1.93679080785414,4.47714573686105,8.02331550911778,101,"ENSG00000079974.19"
"18431","ENSG00000157388.20_63636",63628,63636,9,"ENSG00000157388.20",1,1,"MVVVVVVVV",0,8,0.90600414078675,88,94,133,136,165,171,186,189,"ATGAAGC","GTGA","GTGAAAA","CTGA",2.50746471810879,39,29,15,92,0.880520043705561,4.39923787444105,8.02325443758804,101,"ENSG00000079974.19"
"25152","ENSG00000179818.17_139503",139495,139503,9,"ENSG00000179818.17",1,3,"VVMVVVVVV",0,8,0.882815734989648,114,120,133,136,141,147,157,160,"GTGATGT","TTGC","GTGAACA","CTCA",2.24428404451267,13,5,10,37,3.00590809002966,4.49195043002853,8.02321336998712,101,"ENSG00000079974.19"
"38095","ENSG00000249526.1_53586",53578,53586,9,"ENSG00000249526.1",1,8,"VVVVVVVMV",0,8,0.884057971014493,43,49,63,66,110,116,133,136,"TTGATGG","CAAA","GTGAAGG","CTGA",2.44247099088066,14,44,17,84,1.66476676512877,4.4869766760833,8.02320856014127,101,"ENSG00000079974.19"
"29404","ENSG00000197953.6_21709",21701,21709,9,"ENSG00000197953.6",1,8,"VVVVVVVMV",0,8,0.884057971014493,107,113,133,136,160,166,185,188,"TTGAAGA","TTGA","ATGGGGA","CTGA",2.51032651455019,20,24,19,72,1.21234991127876,4.48696500207,8.02319688612797,101,"ENSG00000079974.19"
"18663","ENSG00000158019.21_326212",326204,326212,9,"ENSG00000158019.21",1,7,"VVVVVVMVV",0,8,0.885300207039338,113,119,133,136,145,151,172,175,"ATCATGA","TTGA","TTGTTTA","CTTA",2.33293180490204,14,9,21,53,2.37494295172615,4.48195541276826,8.02315624092561,101,"ENSG00000079974.19"
"25106","ENSG00000179406.10_33618",33610,33618,9,"ENSG00000179406.10",1,8,"VVVVVVVMV",0,8,0.884057971014493,111,117,133,136,144,150,163,166,"TTGATAA","GTTA","AGGGTGT","CTGA",2.27997513088862,16,8,13,46,2.74777226283164,4.48690161718894,8.02313350124691,101,"ENSG00000079974.19"
"44965","ENSG00000284634.1_150781",150773,150781,9,"ENSG00000284634.1",0,NA,"UVVVVVVVV",1,8,0.902691511387163,35,41,59,62,74,80,133,136,"CAGATGA","CTCA","TTCATCA","CTGA",2.43238617224305,18,12,53,92,1.43343118844657,4.41233475085005,8.0231007963987,101,"ENSG00000079974.19"
"27440","ENSG00000186153.18_506372",506364,506372,9,"ENSG00000186153.18",1,8,"VVVVUVVMV",1,7,0.773913043478261,79,85,100,103,111,117,133,136,"ATGATGA","CTTT","ATGGAAA","CTGA",2.55797946334946,15,8,16,48,2.65648061531143,4.92741925941029,8.02307143332333,101,"ENSG00000079974.19"
"17110","ENSG00000153157.13_15774",15766,15774,9,"ENSG00000153157.13",0,NA,"VVVVVVUVV",1,8,0.886128364389234,92,98,107,110,116,122,133,136,"ATATTGT","CAGA","ATCCTTA","CTGA",2.24648358107326,9,6,11,35,2.93749081376803,4.47851200523078,8.02302546278771,101,"ENSG00000079974.19"
"43516","ENSG00000272162.1_154811",154803,154811,9,"ENSG00000272162.1",0,NA,"VVVVVVUVV",1,8,0.886128364389234,92,98,107,110,116,122,133,136,"ATATTGT","CAGA","ATCCTTA","CTGA",2.24648358107326,9,6,11,35,2.93749081376803,4.47851200523078,8.02302546278771,101,"ENSG00000079974.19"
"42918","ENSG00000267337.2_167534",167526,167534,9,"ENSG00000267337.2",1,3,"VVMVVVVVV",0,8,0.882815734989648,114,120,133,136,147,153,205,208,"TTGATGT","CACA","CTGAAGC","CTGA",2.42021280773276,13,11,52,85,1.83224861302956,4.49175016614532,8.02301310610391,101,"ENSG00000079974.19"
"3493","ENSG00000085276.19_153421",153413,153421,9,"ENSG00000085276.19",1,8,"VVVVVVVMV",0,8,0.884057971014493,116,122,133,136,169,175,186,189,"AGTATGA","AAGA","CTGGTGA","CTGA",2.393602256315,11,33,11,64,1.98971875998334,4.48676678385417,8.02299866791214,101,"ENSG00000079974.19"
"9616","ENSG00000125850.11_15437",15429,15437,9,"ENSG00000125850.11",0,NA,"VVVVVUVVV",1,8,0.922153209109731,84,90,133,136,173,179,194,197,"ATGTAGA","CTGG","CTGATAA","CTGA",2.47593503053453,43,37,15,104,0.831126476766588,4.33434000341586,8.02295283985479,101,"ENSG00000079974.19"
"45588","ENSG00000285713.1_832483",832475,832483,9,"ENSG00000285713.1",1,2,"UMVVVVVVV",1,7,0.786749482401656,50,56,64,67,116,122,133,136,"AAGATGA","TTGA","ATGATAA","CTGA",2.66783744600034,8,49,11,77,1.7179481977594,4.87588279277375,8.02288072238037,101,"ENSG00000079974.19"
"45674","ENSG00000285783.1_605262",605254,605262,9,"ENSG00000285783.1",1,2,"UMVVVVVVV",1,7,0.786749482401656,50,56,64,67,116,122,133,136,"AAGATGA","TTGA","ATGATAA","CTGA",2.66783744600034,8,49,11,77,1.7179481977594,4.87588279277375,8.02288072238037,101,"ENSG00000079974.19"
"37202","ENSG00000245857.4_34095",34087,34095,9,"ENSG00000245857.4",1,5,"VVVVMVVVV",0,8,0.886542443064182,87,93,102,105,115,121,133,136,"ATGCAGA","CTGA","TTGGTGC","CTAA",2.27717750689368,9,10,12,40,2.72565214616319,4.47670888136359,8.02287865362032,101,"ENSG00000079974.19"
"42509","ENSG00000263745.7_457352",457344,457352,9,"ENSG00000263745.7",1,1,"MVVVVVVVV",0,8,0.90600414078675,84,90,105,108,114,120,133,136,"ATGATGG","ATGA","ATGAAGA","TTGC",2.21557786103177,15,6,13,43,2.82479659184204,4.3988289163468,8.02284547949379,101,"ENSG00000079974.19"
"46848","ENSG00000287290.1_71733",71725,71733,9,"ENSG00000287290.1",1,2,"VMVVVVVVV",0,8,0.884057971014493,86,92,104,107,111,117,133,136,"GTTTTAA","CTGA","CTAATTA","CTGA",2.29886608556333,12,4,16,41,2.62061531072136,4.48659730361923,8.0228291876772,101,"ENSG00000079974.19"
"938","ENSG00000041353.10_118047",118039,118047,9,"ENSG00000041353.10",1,3,"VVMVVVVVV",0,8,0.882815734989648,111,117,133,136,144,150,160,163,"AAGAAGA","CCCA","CTCATTA","CTGA",2.26940607969772,16,8,10,43,2.8368911233464,4.49156624699947,8.02282918695806,101,"ENSG00000079974.19"
"13953","ENSG00000144036.16_524518",524510,524518,9,"ENSG00000144036.16",1,5,"VVVVMVVVV",0,8,0.886542443064182,48,54,87,90,111,117,133,136,"GAGATGG","CTGA","CTGAACA","CTGA",2.53390090646398,33,21,16,79,1.01385598970224,4.47663217486553,8.02280194712225,101,"ENSG00000079974.19"
"45392","ENSG00000285542.1_85279",85271,85279,9,"ENSG00000285542.1",0,NA,"VVUVVVVVV",1,8,0.883643892339545,87,93,133,136,144,150,185,188,"ATGATTA","GAGA","CTGATGC","CTGA",2.53675844480757,40,8,35,92,1.04117966968504,4.48822565876721,8.02280122812538,101,"ENSG00000079974.19"
"34094","ENSG00000231901.1_30801",30793,30801,9,"ENSG00000231901.1",1,8,"VVVVVVVMV",0,8,0.884057971014493,110,116,133,136,142,148,158,161,"AAAATGT","TTGA","TCCATGA","CTGA",2.27850556383589,17,6,10,42,2.7561906869595,4.48655694479969,8.02278882885766,101,"ENSG00000079974.19"
"29443","ENSG00000197992.7_5817",5809,5817,9,"ENSG00000197992.7",0,NA,"VVVVVVUVV",1,8,0.886128364389234,44,50,67,70,109,115,133,136,"ATGAAGA","CTGA","GTGGTAA","ATGA",2.47687246425779,17,39,18,83,1.40012903734014,4.47815303309801,8.02266649065495,101,"ENSG00000079974.19"
"14504","ENSG00000145241.11_59825",59817,59825,9,"ENSG00000145241.11",1,6,"UVVVVMVVV",1,7,0.805383022774327,114,120,133,136,146,152,164,167,"ATGATCA","GTAA","AGGAGGA","CTGA",2.45157041645879,13,10,12,44,2.86058706384062,4.80109746005815,8.02262955115545,101,"ENSG00000079974.19"
"23361","ENSG00000172765.19_214541",214533,214541,9,"ENSG00000172765.19",0,NA,"VVVVVVUVV",1,8,0.886128364389234,83,89,100,103,108,114,133,136,"CTGAGGG","CAGA","AGGAACA","CTGA",2.31333112727861,11,5,19,44,2.49023833375704,4.47811146223694,8.02262491979388,101,"ENSG00000079974.19"
"3881","ENSG00000090060.19_23462",23454,23462,9,"ENSG00000090060.19",1,2,"VMVVVVVVV",0,8,0.884057971014493,84,90,101,104,113,119,133,136,"ATGATAA","CTAA","GGGATAT","TTGA",2.27046272489338,11,9,14,43,2.80912572351533,4.4863859723678,8.02261785642577,101,"ENSG00000079974.19"
"4695","ENSG00000101665.10_7640",7632,7640,9,"ENSG00000101665.10",1,2,"VMVVVVVVV",0,8,0.884057971014493,84,90,133,136,148,154,176,179,"TTGAAGA","GTGA","GTGTTGG","CTGA",2.51568953166618,43,12,22,86,1.17397340594276,4.48630923759598,8.02254112165395,101,"ENSG00000079974.19"
"12877","ENSG00000139292.13_116627",116619,116627,9,"ENSG00000139292.13",1,2,"VMVVVVVVV",0,8,0.884057971014493,87,93,102,105,110,116,133,136,"ATTATTA","CTGA","CTGAAGC","GTGA",2.31698721212769,9,5,17,40,2.49845702884538,4.4862596107575,8.02249149481547,101,"ENSG00000079974.19"
"11415","ENSG00000134871.19_47327",47319,47327,9,"ENSG00000134871.19",1,1,"MVVVVVVVV",0,8,0.90600414078675,114,120,133,136,146,152,180,183,"GTGATTG","GTGT","TTGGTGA","CTGA",2.32873277781459,13,10,28,60,2.06832646038502,4.39830291145391,8.02231947460091,101,"ENSG00000079974.19"
"47153","ENSG00000287722.1_137095",137087,137095,9,"ENSG00000287722.1",1,6,"VVVVVMVVV",0,8,0.902691511387163,28,34,42,45,72,78,133,136,"TTGATGA","CTGA","ATGAAAA","CTGC",2.52396191243668,8,27,55,99,0.819488931739639,4.41147542032938,8.02224146587804,101,"ENSG00000079974.19"
"47001","ENSG00000287474.1_284547",284539,284547,9,"ENSG00000287474.1",1,6,"VVVVUMVVV",1,7,0.792546583850932,115,121,133,136,144,150,190,193,"AAGATGA","CCGA","GTGATTG","CTGA",2.61013599063383,12,8,40,69,2.00724430952782,4.85203772843834,8.02222406384207,101,"ENSG00000079974.19"
"41243","ENSG00000258733.7_247925",247917,247925,9,"ENSG00000258733.7",1,6,"VVVVVMVVV",0,8,0.902691511387163,108,114,133,136,142,148,157,160,"TTTATCA","TTGT","GTGAAGG","CTGA",2.26108821088838,19,6,9,43,2.57165407925597,4.41139387129463,8.02215991684329,101,"ENSG00000079974.19"
"35611","ENSG00000236451.3_63603",63595,63603,9,"ENSG00000236451.3",0,NA,"UVVVVVVVV",1,8,0.902691511387163,105,111,133,136,148,154,165,168,"ATGTTGA","CTGT","GTCAGGA","CTAA",2.33351436201804,22,12,11,54,2.08873531456253,4.41137443200404,8.02214047755269,101,"ENSG00000079974.19"
"13456","ENSG00000141449.16_2982",2974,2982,9,"ENSG00000141449.16",1,8,"UVVVVVVMV",1,7,0.786749482401656,114,120,133,136,144,150,158,161,"GCGATGA","TTGA","ATAGAGA","CTGA",2.47173861472375,13,8,8,38,3.0222337442241,4.87512279392895,8.02212072353557,101,"ENSG00000079974.19"
"12436","ENSG00000138185.20_44583",44575,44583,9,"ENSG00000138185.20",1,8,"VVVVVVVMV",0,8,0.884057971014493,114,120,133,136,137,143,161,164,"AAGCTGG","CTGA","ATGAACT","CTGA",2.39427666463217,13,1,18,41,1.98155685057965,4.48585032036519,8.02208220442316,101,"ENSG00000079974.19"
"39609","ENSG00000253901.1_48920",48912,48920,9,"ENSG00000253901.1",0,NA,"UVVVVVVVV",1,8,0.902691511387163,111,117,133,136,142,148,161,164,"GTTATGT","CTGC","CTGAGGA","CTTA",2.23428116066169,16,6,13,44,2.74952189876665,4.4111824091278,8.02194845467646,101,"ENSG00000079974.19"
"22856","ENSG00000171587.15_490181",490173,490181,9,"ENSG00000171587.15",1,1,"MVVVVVVVV",0,8,0.90600414078675,104,110,133,136,143,149,160,163,"GTCATAA","CAGC","ATAATGA","CTGA",2.29974110228241,23,7,11,50,2.25954195980958,4.39778732708974,8.02180389023674,101,"ENSG00000079974.19"
"20220","ENSG00000164466.13_15360",15352,15360,9,"ENSG00000164466.13",1,1,"MVVVVVVVV",0,8,0.90600414078675,111,117,133,136,174,180,188,191,"AGGAAGA","CTGT","GGGTTCA","CTGA",2.36426370619915,16,38,8,71,1.82907090850701,4.39770723745867,8.02172380060567,101,"ENSG00000079974.19"
"10245","ENSG00000130147.16_13571",13563,13571,9,"ENSG00000130147.16",0,NA,"VVVVVVUVV",1,8,0.886128364389234,106,112,133,136,138,144,153,156,"AAGGTGA","GGGA","ATGATGT","CTGA",2.39262419743361,21,2,9,41,1.95783211577235,4.47716502466577,8.0216784822227,101,"ENSG00000079974.19"
"38535","ENSG00000250349.3_993864",993856,993864,9,"ENSG00000250349.3",0,NA,"VVVVVUVVV",1,8,0.922153209109731,116,122,133,136,144,150,205,208,"CTGGTCA","ATGA","CTCATGG","CTGA",2.30548165183866,11,8,55,83,1.96213836468618,4.33300401090264,8.02161684734157,101,"ENSG00000079974.19"
"10083","ENSG00000129151.9_28622",28614,28622,9,"ENSG00000129151.9",1,1,"MVVVVVVVV",0,8,0.90600414078675,84,90,100,103,109,115,133,136,"CTGGTTA","CTGG","GTTTTGC","CTGA",2.25579088321148,10,6,18,43,2.55156039240884,4.39754157012135,8.02155813326835,101,"ENSG00000079974.19"
"16719","ENSG00000152208.13_1023856",1023848,1023856,9,"ENSG00000152208.13",1,8,"VVUVVVVMV",1,7,0.767701863354037,67,73,81,84,109,115,133,136,"ATGATGA","CTTA","GTGGTGG","CTGA",2.74669931586781,8,25,18,60,1.49105977593037,4.95059713709561,8.02140459051175,101,"ENSG00000079974.19"
"38574","ENSG00000250467.1_42298",42290,42298,9,"ENSG00000250467.1",1,6,"VVVVVMVVV",0,8,0.902691511387163,91,97,133,136,151,157,168,171,"ATTATTA","CTGT","TTGATCT","CTGA",2.41449443489892,36,15,11,71,1.54569656693168,4.41058153323112,8.02134757877977,101,"ENSG00000079974.19"
"28070","ENSG00000188107.15_1665309",1665301,1665309,9,"ENSG00000188107.15",1,1,"MVVVVVUVV",1,7,0.792132505175983,114,120,133,136,144,150,185,188,"ATGATGA","CCTA","TTGAACA","CTGA",2.60624820299022,13,8,35,65,2.03527447462572,4.85256562364014,8.02109564434407,101,"ENSG00000079974.19"
"10585","ENSG00000131725.14_7208",7200,7208,9,"ENSG00000131725.14",1,8,"VVVVVVVMV",0,8,0.884057971014493,108,114,133,136,141,147,159,162,"ATGATTC","CCTA","ATAATGT","CTGA",2.32003345304268,19,5,12,45,2.47238119257838,4.48481771988239,8.02104960394036,101,"ENSG00000079974.19"
"16216","ENSG00000151150.22_3706",3698,3706,9,"ENSG00000151150.22",1,8,"VVVVVUVMV",1,7,0.806211180124224,112,118,133,136,144,150,161,164,"GTGATGG","ATCA","GTTATGT","CTGA",2.44353942281523,15,8,11,43,2.89427592362447,4.79613468559817,8.02097940609506,101,"ENSG00000079974.19"
"14151","ENSG00000144455.14_537953",537945,537953,9,"ENSG00000144455.14",0,NA,"VVVUVVVVV",1,8,0.880745341614907,98,104,133,136,138,144,153,156,"ATGATGG","AAGA","CGAATGA","CTGA",2.46121750741649,29,2,9,49,1.58364168116353,4.49793959931837,8.02092096577799,101,"ENSG00000079974.19"
"18822","ENSG00000158623.14_41146",41138,41146,9,"ENSG00000158623.14",1,1,"MVVVVVVVV",0,8,0.90600414078675,114,120,133,136,187,193,227,230,"ATGAAGA","TTGC","ATGTTGC","CTGA",2.47912725849866,13,51,34,107,1.05993647159815,4.39686288206396,8.02087944521096,101,"ENSG00000079974.19"
"33175","ENSG00000228956.9_44491",44483,44491,9,"ENSG00000228956.9",1,1,"MVVVVVVVV",0,8,0.90600414078675,113,119,133,136,149,155,204,207,"ATGAGGC","ATGT","GTGAAGC","CTGA",2.38894477534503,14,13,49,85,1.66113788400922,4.39685909657735,8.02087565972435,101,"ENSG00000079974.19"
"8915","ENSG00000121446.20_24615",24607,24615,9,"ENSG00000121446.20",1,1,"MVVVVVVVV",0,8,0.90600414078675,91,97,133,136,148,154,172,175,"TTGATAA","TTCA","TTGAAGA","CTGA",2.42688860803911,36,12,18,75,1.40802361180481,4.39682024968305,8.02083681283004,101,"ENSG00000079974.19"
"4430","ENSG00000100578.18_32861",32853,32861,9,"ENSG00000100578.18",0,NA,"VVVVVVUVV",1,8,0.886128364389234,58,64,101,104,115,121,133,136,"ATGAAGG","CTTA","TTTATAA","CTGA",2.41616599938266,37,11,12,69,1.79742118219238,4.47629862785252,8.02081208540946,101,"ENSG00000079974.19"
"16960","ENSG00000152894.15_116186",116178,116186,9,"ENSG00000152894.15",1,8,"VVVUVVVMV",1,7,0.764803312629399,52,58,77,80,85,91,133,136,"CTGATGA","CTGA","TTGATTT","CTGA",2.74861717751626,19,5,42,75,1.52200399096726,4.96152962693558,8.02074287745318,101,"ENSG00000079974.19"
"38215","ENSG00000249797.2_212099",212091,212099,9,"ENSG00000249797.2",1,2,"VMVVVVVVV",0,8,0.884057971014493,85,91,103,106,111,117,133,136,"ATTGTGT","CTGG","GTGTTAT","CTGA",2.28449011216874,12,5,16,42,2.70755614894998,4.48437255751873,8.0206044415767,101,"ENSG00000079974.19"
"29590","ENSG00000198369.10_86194",86186,86194,9,"ENSG00000198369.10",1,1,"MVVVVUVVV",1,7,0.82815734989648,104,110,133,136,150,156,171,174,"ATGACGA","GTGA","GTGTGGG","CTGA",2.5677593546649,23,14,15,61,1.71287950709287,4.70781880121471,8.02044820080063,101,"ENSG00000079974.19"
"32046","ENSG00000225690.1_854",846,854,9,"ENSG00000225690.1",0,NA,"VVVVVVUVV",1,8,0.886128364389234,108,114,133,136,173,179,193,196,"TTGAGCA","CTGA","GTGGTGC","CTGA",2.46625704524214,19,37,14,79,1.46167129410216,4.47584623226243,8.02035968981937,101,"ENSG00000079974.19"
"33603","ENSG00000230448.5_658230",658222,658230,9,"ENSG00000230448.5",1,5,"VVVVMVVVV",0,8,0.886542443064182,114,120,133,136,184,190,213,216,"CTCATGC","CTGA","ATGGTTA","CTGA",2.48113371178165,13,48,23,93,1.35570923224218,4.47415016102996,8.02031993328669,101,"ENSG00000079974.19"
"23363","ENSG00000172766.19_23488",23480,23488,9,"ENSG00000172766.19",1,1,"MVVVVVVVV",0,8,0.90600414078675,95,101,133,136,140,146,186,189,"GTGATGT","TTTA","GTGAAGT","CTGA",2.50542992214204,32,4,40,85,0.881671591257902,4.39613443471787,8.02015099786487,101,"ENSG00000079974.19"
"14362","ENSG00000144746.7_15925",15917,15925,9,"ENSG00000144746.7",0,NA,"VVVUVUVVV",2,7,0.802898550724638,115,121,133,136,150,156,170,173,"ATGATGC","GTGT","ATGGAGA","CTGA",2.51073099206625,12,14,14,49,2.4955092537077,4.80842896687067,8.02002316976922,101,"ENSG00000079974.19"
"4229","ENSG00000099364.18_11754",11746,11754,9,"ENSG00000099364.18",0,NA,"VVVUVVVVV",1,8,0.880745341614907,101,107,133,136,149,155,173,176,"AGGAGGA","CAGA","GTGGTGT","CTGA",2.47863623037041,26,13,18,66,1.46380131909301,4.49701071372393,8.01999208018356,101,"ENSG00000079974.19"
"3062","ENSG00000080608.10_117635",117627,117635,9,"ENSG00000080608.10",1,7,"VVVVVVMVV",0,8,0.885300207039338,116,122,133,136,145,151,163,166,"GTGAAAA","AAGA","TTAAAGA","CTGA",2.25110120727725,11,9,12,41,2.90761341977754,4.47873870040648,8.01993952856383,101,"ENSG00000079974.19"
"2478","ENSG00000075213.11_302509",302501,302509,9,"ENSG00000075213.11",1,2,"VMVVVVVVV",0,8,0.884057971014493,113,119,133,136,138,144,159,162,"ATGAGGG","CCAA","TTGTGGA","CTGA",2.33921934924819,14,2,15,40,2.33934647388753,4.48353553388554,8.01976741794351,101,"ENSG00000079974.19"
"41738","ENSG00000259639.6_82858",82850,82858,9,"ENSG00000259639.6",0,NA,"UVVVVVVVV",1,8,0.902691511387163,115,121,133,136,141,147,180,183,"AAGATGG","ATTA","GTTATTA","CTGA",2.34422890396312,12,5,33,59,2.00751060953173,4.4089258256548,8.01969187120345,101,"ENSG00000079974.19"
"6319","ENSG00000109339.24_480758",480750,480758,9,"ENSG00000109339.24",1,1,"MVVVVVVVV",0,8,0.90600414078675,115,121,133,136,140,146,157,160,"GGGATTA","CGAA","ATGACTG","CTGA",2.19843646169702,12,4,11,36,2.92626049687161,4.39562589371293,8.01964245685993,101,"ENSG00000079974.19"
"19841","ENSG00000163803.13_125650",125642,125650,9,"ENSG00000163803.13",1,3,"VVMVVVVVV",0,8,0.882815734989648,116,122,133,136,142,148,156,159,"GGGAAGA","AGGA","GTCAAGC","CTGA",2.22719652035648,11,6,8,34,3.10547079730643,4.48836189992074,8.01962483987933,101,"ENSG00000079974.19"
"1134","ENSG00000048052.24_546645",546637,546645,9,"ENSG00000048052.24",1,1,"MVVVVUVVV",1,7,0.82815734989648,116,122,133,136,142,148,169,172,"ATCATGA","AAGA","GTGGAAA","CTGA",2.46084915211694,11,6,21,47,2.42168604320477,4.70683676432943,8.01946616391535,101,"ENSG00000079974.19"
"26846","ENSG00000185053.14_104917",104909,104917,9,"ENSG00000185053.14",1,1,"MVVVVVVVV",0,8,0.90600414078675,112,118,133,136,148,154,200,203,"GAGAAGA","CTGT","GGGAAGA","CTGA",2.38506982018187,15,12,46,82,1.68128585324766,4.3954378302817,8.0194543934287,101,"ENSG00000079974.19"
"16340","ENSG00000151348.16_147415",147407,147415,9,"ENSG00000151348.16",1,7,"VVVVVVMVV",0,8,0.885300207039338,111,117,133,136,166,172,225,228,"ATGATGT","CAAA","ATAATGA","CTGA",2.55341299101418,16,30,53,108,0.890244376542767,4.47824941249266,8.01945024065001,101,"ENSG00000079974.19"
"18116","ENSG00000156162.16_41304",41296,41304,9,"ENSG00000156162.16",1,8,"VVVVVVVMV",0,8,0.884057971014493,108,114,133,136,140,146,155,158,"CTGTTGA","AAGA","GGGCTGT","CTGA",2.32431420723911,19,4,9,41,2.43739490963409,4.4832057394737,8.01943762353167,101,"ENSG00000079974.19"
"1915","ENSG00000067715.15_257953",257945,257953,9,"ENSG00000067715.15",0,NA,"VVVVVVUVV",1,8,0.886128364389234,106,112,133,136,141,147,165,168,"CTGATAT","CTGC","GTGGTAA","CTGA",2.38832464770403,21,5,18,53,1.97748604430352,4.47491259058259,8.01942604813952,101,"ENSG00000079974.19"
"3039","ENSG00000080493.19_332515",332507,332515,9,"ENSG00000080493.19",1,2,"VMVVVUVVV",1,7,0.806211180124223,89,95,104,107,109,115,133,136,"GTGATGT","CTGG","CTGGAGA","CTGA",2.56809746687701,9,2,18,38,2.05738232990384,4.79450802727098,8.01935274776787,101,"ENSG00000079974.19"
"4053","ENSG00000092621.13_41243",41235,41243,9,"ENSG00000092621.13",1,7,"VVVVVVMVV",0,8,0.885300207039338,69,75,91,94,105,111,133,136,"TTAATGG","CTGC","GTTAAGA","CTGA",2.3747884845119,16,11,22,58,2.08056508593416,4.47812207900337,8.01932290716072,101,"ENSG00000079974.19"
"43078","ENSG00000268081.3_14498",14490,14498,9,"ENSG00000268081.3",1,2,"VMVVVVVVV",0,8,0.884057971014493,116,122,133,136,144,150,159,162,"AAGATGA","GTGC","CTGAAAA","ATGA",2.23401331255167,11,8,9,37,3.03891519075247,4.48308431860757,8.01931620266554,101,"ENSG00000079974.19"
"36262","ENSG00000239440.6_365276",365268,365276,9,"ENSG00000239440.6",1,2,"VMVVVVVVV",0,8,0.884057971014493,73,79,100,103,113,119,133,136,"AAGATGG","CTGA","GTGACAA","CTGG",2.36288450809666,21,10,14,54,2.17945409868633,4.48300437149936,8.01923625555733,101,"ENSG00000079974.19"
"17355","ENSG00000153956.17_16381",16373,16381,9,"ENSG00000153956.17",0,NA,"VVVVVUVVV",1,8,0.922153209109731,64,70,86,89,104,110,133,136,"TTGATAA","TTGT","TTCATGT","CTGA",2.33581456700809,16,15,23,63,1.75039632064279,4.33062335850751,8.01923619494644,101,"ENSG00000079974.19"
"44529","ENSG00000282933.4_17502",17494,17502,9,"ENSG00000282933.4",1,1,"MVVVVUVVV",1,7,0.82815734989648,95,101,111,114,116,122,133,136,"TTGTTGA","ATGA","GTACTGG","CTGA",2.42089308921111,10,2,11,32,2.68688258497362,4.70654246159525,8.01917186118117,101,"ENSG00000079974.19"
"34146","ENSG00000231971.6_27912",27904,27912,9,"ENSG00000231971.6",1,7,"VVVVVVMVV",0,8,0.885300207039338,116,122,133,136,154,160,213,216,"TTGATGG","CAGG","GTGATTA","CTGA",2.48445125337094,11,18,53,91,1.34879155549593,4.47794997782555,8.0191508059829,101,"ENSG00000079974.19"
"25416","ENSG00000181355.21_439513",439505,439513,9,"ENSG00000181355.21",1,1,"MVVVVVVVV",0,8,0.90600414078675,84,90,133,136,143,149,157,160,"TTCATGG","TTGA","CTTCTGA","CTGA",2.33996814895099,43,7,8,67,1.98059071349555,4.39509459329221,8.01911115643921,101,"ENSG00000079974.19"
"20714","ENSG00000165409.18_19856",19848,19856,9,"ENSG00000165409.18",1,6,"VVVVVMVVV",0,8,0.902691511387163,106,112,133,136,152,158,177,180,"AAGAGGA","ATGT","GTGAAGA","CTGA",2.42392750198486,21,16,19,65,1.47371232772393,4.40830725190576,8.01907329745441,101,"ENSG00000079974.19"
"8751","ENSG00000120594.17_35685",35677,35685,9,"ENSG00000120594.17",0,NA,"VVVUUVVVV",2,7,0.770600414078675,114,120,133,136,139,145,155,158,"ATGGTGA","GTGA","TTAATCA","CTGA",2.53775925929783,13,3,10,35,2.82812012749484,4.93662879737009,8.01903045368479,101,"ENSG00000079974.19"
"6784","ENSG00000111879.20_414",406,414,9,"ENSG00000111879.20",1,6,"VVVVVMVVV",0,8,0.902691511387163,116,122,133,136,146,152,161,164,"GCGTTGA","AAGA","GCGGTGG","CTGA",2.20746570736308,11,10,9,39,2.91644152759617,4.40821989417085,8.0189859397195,101,"ENSG00000079974.19"
"32945","ENSG00000228340.8_203708",203700,203708,9,"ENSG00000228340.8",1,1,"MVVVVUVVV",1,7,0.82815734989648,110,116,133,136,140,146,160,163,"ATGAGGA","AGGA","GTGGAGG","CTGA",2.45282457210265,17,4,14,44,2.47281007051852,4.70624347113404,8.01887287071996,101,"ENSG00000079974.19"
"1599","ENSG00000063438.20_43083",43075,43083,9,"ENSG00000063438.20",1,1,"MVUVVVVVV",1,7,0.789648033126294,114,120,133,136,146,152,160,163,"AGGATGA","GGGA","CTGGGGA","CTGA",2.48005344699015,13,10,8,40,2.90710278039866,4.86019810674991,8.01879023925509,101,"ENSG00000079974.19"
"47518","ENSG00000288622.1_93127",93119,93127,9,"ENSG00000288622.1",1,1,"MVUVVVVVV",1,7,0.789648033126294,114,120,133,136,146,152,160,163,"AGGATGA","GGGA","CTGGGGA","CTGA",2.48005344699015,13,10,8,40,2.90710278039866,4.86019810674991,8.01879023925509,101,"ENSG00000079974.19"
"45527","ENSG00000285683.2_52900",52892,52900,9,"ENSG00000285683.2",0,NA,"UVVVVVVVV",1,8,0.902691511387163,115,121,133,136,147,153,168,171,"ATAATTA","TTGA","TTGATAA","CTCA",2.24653194492133,12,11,15,47,2.65511872150141,4.40799958857757,8.01876563412622,101,"ENSG00000079974.19"
"90","ENSG00000004866.22_131244",131236,131244,9,"ENSG00000004866.22",0,NA,"VVVVUVVVV",1,8,0.889855072463768,102,108,133,136,145,151,177,180,"ATGCTGT","CTTA","GTTAGGA","CTGA",2.47178168917266,25,9,26,69,1.35868901372724,4.45930840205291,8.01872869190798,101,"ENSG00000079974.19"
"30859","ENSG00000214188.9_130583",130575,130583,9,"ENSG00000214188.9",0,NA,"VVVVUVVVV",1,8,0.889855072463768,102,108,133,136,145,151,177,180,"ATGCTGT","CTTA","GTTAGGA","CTGA",2.47178168917266,25,9,26,69,1.35868901372724,4.45930840205291,8.01872869190798,101,"ENSG00000079974.19"
"47519","ENSG00000288635.1_130091",130083,130091,9,"ENSG00000288635.1",0,NA,"VVVVUVVVV",1,8,0.889855072463768,102,108,133,136,145,151,177,180,"ATGCTGT","CTTA","GTTAGGA","CTGA",2.47178168917266,25,9,26,69,1.35868901372724,4.45930840205291,8.01872869190798,101,"ENSG00000079974.19"
"22824","ENSG00000171495.17_10105",10097,10105,9,"ENSG00000171495.17",1,2,"VMVVVVVVV",0,8,0.884057971014493,116,122,133,136,155,161,181,184,"AAAATGA","CAGA","TTTATGT","CTGA",2.41739745984265,11,19,20,59,1.81392715552061,4.48247755528456,8.01870943934253,101,"ENSG00000079974.19"
"14286","ENSG00000144645.16_241094",241086,241094,9,"ENSG00000144645.16",1,8,"VVVVVVVMV",0,8,0.884057971014493,114,120,133,136,146,152,172,175,"ATGATGG","CAGA","GTTTTGT","ATGA",2.32786345058387,13,10,20,52,2.41052112524927,4.48240269895209,8.01863458301007,101,"ENSG00000079974.19"
"42331","ENSG00000261645.7_88120",88112,88120,9,"ENSG00000261645.7",1,2,"VMVVVUVVV",1,7,0.806211180124223,112,118,133,136,150,156,174,177,"ATGGTGA","CTGT","ATATTGA","CTGA",2.55100374987727,15,14,18,56,2.16834432199952,4.793758996962,8.01860371745889,101,"ENSG00000079974.19"
"30550","ENSG00000205683.12_197879",197871,197879,9,"ENSG00000205683.12",1,3,"VVMVVVUVV",1,7,0.768944099378882,94,100,133,136,144,150,164,167,"GTGATGA","GTGA","CTGGGGA","CTGA",2.68442367689115,33,8,14,64,1.8748838501349,4.94276042401897,8.0185368215345,101,"ENSG00000079974.19"
"46505","ENSG00000286749.1_228674",228666,228674,9,"ENSG00000286749.1",1,3,"VVMVVVVVV",0,8,0.882815734989648,89,95,133,136,163,169,178,181,"ATGAAGA","CAGG","GTAATGA","CTGA",2.52897366701606,38,27,9,83,1.08925415849552,4.48726965131731,8.01853259127591,101,"ENSG00000079974.19"
"16774","ENSG00000152217.20_316747",316739,316747,9,"ENSG00000152217.20",1,8,"VVVVVVVMV",0,8,0.884057971014493,106,112,133,136,138,144,159,162,"ATAATGG","GTGA","ATGGGTA","CTGA",2.42612853012123,21,2,15,47,1.75490525467822,4.4822738638716,8.01850574792957,101,"ENSG00000079974.19"
"40303","ENSG00000255501.3_265628",265620,265628,9,"ENSG00000255501.3",1,6,"VVVVVMVVV",0,8,0.902691511387163,46,52,67,70,76,82,133,136,"AATATGA","CTAA","GTTACTA","CTGA",2.36035880970059,15,6,51,81,1.89521684440758,4.40773556060288,8.01850160615153,101,"ENSG00000079974.19"
"17329","ENSG00000153930.13_269835",269827,269835,9,"ENSG00000153930.13",0,NA,"UVVVVVVVV",1,8,0.902691511387163,110,116,133,136,142,148,180,183,"CTGAGGA","CTAT","CTGAGGT","CTGA",2.3702602474033,17,6,32,64,1.82915181879539,4.40772170037101,8.01848774591967,101,"ENSG00000079974.19"
"40981","ENSG00000258231.5_167229",167221,167229,9,"ENSG00000258231.5",1,3,"VVMVVVVVV",0,8,0.882815734989648,114,120,133,136,180,186,201,204,"TGGATGA","CTTT","ATGCTGA","CTGA",2.41993712275551,13,44,15,81,1.81595617134713,4.48721758076263,8.01848052072123,101,"ENSG00000079974.19"
"13851","ENSG00000143702.16_20768",20760,20768,9,"ENSG00000143702.16",1,1,"MVVVVVVVV",0,8,0.90600414078675,115,121,133,136,138,144,155,158,"ATGATGG","ATGG","ATAATTA","TTGA",2.23496774752116,12,2,11,34,2.67787429758514,4.39441482026488,8.01843138341188,101,"ENSG00000079974.19"
"41707","ENSG00000259579.1_53299",53291,53299,9,"ENSG00000259579.1",0,NA,"VVVVVUUVV",2,7,0.808281573498965,116,122,133,136,170,176,188,191,"ATCATGA","CTGG","GTCATGG","CTGA",2.57756652264767,11,34,12,66,1.95694524361724,4.7851805153171,8.01830680931296,101,"ENSG00000079974.19"
"17369","ENSG00000153982.11_51036",51028,51036,9,"ENSG00000153982.11",1,2,"VMVVVVVVV",0,8,0.884057971014493,105,111,133,136,157,163,171,174,"ATGATGA","CTAA","TTTAAGA","TTGA",2.45584229774428,22,21,8,60,1.55552811026772,4.48195252380741,8.01818440786538,101,"ENSG00000079974.19"
"3221","ENSG00000082438.18_175409",175401,175409,9,"ENSG00000082438.18",1,7,"VVVVVVMVV",0,8,0.885300207039338,110,116,133,136,147,153,203,206,"GTGAGGA","GAGA","GTGGTGG","CTGA",2.44722873558176,17,11,50,87,1.59255564868864,4.47685347147509,8.01805429963244,101,"ENSG00000079974.19"
"41295","ENSG00000258779.8_93180",93172,93180,9,"ENSG00000258779.8",1,7,"VVVVVVMVV",0,8,0.885300207039338,115,121,133,136,153,159,188,191,"ATGGGGA","CCGG","GTGATGA","CTGA",2.44950418792722,12,17,29,67,1.57723073004967,4.47681466239111,8.01801549054846,101,"ENSG00000079974.19"
"9878","ENSG00000127955.17_398887",398879,398887,9,"ENSG00000127955.17",1,6,"VVVVVMVVV",0,8,0.902691511387163,110,116,133,136,159,165,177,180,"AAGTTGA","CTTT","ATGATTA","CTGA",2.36135700726599,17,23,12,61,1.88612674312966,4.4071266978924,8.01789274344106,101,"ENSG00000079974.19"
"26546","ENSG00000184384.14_64387",64379,64387,9,"ENSG00000184384.14",1,3,"VVMVVVVVV",0,8,0.882815734989648,114,120,133,136,179,185,193,196,"GTGATCT","TTTA","GTGATGT","CTGA",2.39493584920531,13,43,8,73,1.9797380023119,4.48649424925348,8.01775718921208,101,"ENSG00000079974.19"
"30618","ENSG00000206072.13_41997",41989,41997,9,"ENSG00000206072.13",1,1,"MVVVVUVVV",1,7,0.82815734989648,110,116,133,136,140,146,157,160,"ATTATGA","CAAA","GTGACTG","CTGA",2.43266159388663,17,4,11,41,2.60270341598938,4.7051118438084,8.01774124339432,101,"ENSG00000079974.19"
"27940","ENSG00000187699.10_179607",179599,179607,9,"ENSG00000187699.10",1,1,"MVVVVVVVV",0,8,0.90600414078675,114,120,133,136,141,147,157,160,"TAGATGA","GTGA","ATTAAGT","CAGA",2.18530788713602,13,5,10,37,3.00590809002966,4.39365683440078,8.01767339754778,101,"ENSG00000079974.19"
"17772","ENSG00000155052.15_57340",57332,57340,9,"ENSG00000155052.15",1,6,"VVVVVMVVV",0,8,0.902691511387163,112,118,133,136,140,146,159,162,"GTGAAAA","TTGT","ATCATAA","CTGA",2.24050889171388,15,4,13,41,2.69053742222015,4.40681584174484,8.01758188729349,101,"ENSG00000079974.19"
"35305","ENSG00000235665.6_26534",26526,26534,9,"ENSG00000235665.6",1,2,"UMVVVVVVV",1,7,0.786749482401656,112,118,133,136,146,152,162,165,"ATTATGA","TGGA","GTGATCC","CTGA",2.49987240216049,15,10,10,44,2.8163612972043,4.87054432790189,8.01754225750852,101,"ENSG00000079974.19"
"35700","ENSG00000236790.7_236632",236624,236632,9,"ENSG00000236790.7",1,2,"UMVVVVVVV",1,7,0.786749482401656,112,118,133,136,146,152,162,165,"ATTATGA","TGGA","GTGATCC","CTGA",2.49987240216049,15,10,10,44,2.8163612972043,4.87054432790189,8.01754225750852,101,"ENSG00000079974.19"
"8963","ENSG00000121904.19_251211",251203,251211,9,"ENSG00000121904.19",1,8,"VVVVVVVMV",0,8,0.884057971014493,113,119,133,136,142,148,164,167,"GTTTTGA","GTTA","GTGAGCA","CTGA",2.28193671226533,14,6,16,45,2.71225618073006,4.48129189895807,8.01752378301604,101,"ENSG00000079974.19"
"19383","ENSG00000162849.16_376334",376326,376334,9,"ENSG00000162849.16",1,1,"MVVVVUVVV",1,7,0.82815734989648,115,121,133,136,144,150,174,177,"ATGATGT","CTTG","AGGATGG","CTGA",2.47781754653967,12,8,24,53,2.300770563016,4.70488855165344,8.01751795123936,101,"ENSG00000079974.19"
"48164","ENSG00000290551.1_479840",479832,479840,9,"ENSG00000290551.1",0,NA,"VVVVVUUVV",2,7,0.808281573498965,107,113,133,136,141,147,155,158,"ATCATGA","CTTA","ATCTGGA","CTGA",2.50769931109945,20,5,8,42,2.41938781257756,4.78434580497681,8.01747209897267,101,"ENSG00000079974.19"
"38398","ENSG00000250124.1_288",280,288,9,"ENSG00000250124.1",1,2,"UMVVVVVVV",1,7,0.786749482401656,116,122,133,136,141,147,155,158,"ATTATGA","TGGA","TTGCTTA","CTGA",2.45806496972806,11,5,8,33,3.09466359973071,4.87044084947944,8.01743877908607,101,"ENSG00000079974.19"
"38171","ENSG00000249738.10_452833",452825,452833,9,"ENSG00000249738.10",0,NA,"VVVUVVUVV",2,7,0.766873706004141,74,80,93,96,102,108,133,136,"ATGATAT","CTGA","GTGAGGG","CTGA",2.63204375202655,13,6,25,53,2.25263884457577,4.94989929785486,8.01739412187142,101,"ENSG00000079974.19"
"46188","ENSG00000286260.1_14570",14562,14570,9,"ENSG00000286260.1",1,8,"VVVVVVVMV",0,8,0.884057971014493,81,87,104,107,115,121,133,136,"ATAAAGA","CTGA","TTAAAGA","CTAA",2.2831179811541,17,8,12,46,2.70380730046761,4.48114846037375,8.01738034443172,101,"ENSG00000079974.19"
"19955","ENSG00000164061.5_2343",2335,2343,9,"ENSG00000164061.5",1,8,"VVVVVVVMV",0,8,0.884057971014493,66,72,99,102,116,122,133,136,"CTGATGC","CTGA","TTGATGG","CTGT",2.43200630342259,27,14,11,61,1.71120519043264,4.48114513664581,8.01737702070378,101,"ENSG00000079974.19"
"41576","ENSG00000259283.2_34966",34958,34966,9,"ENSG00000259283.2",0,NA,"UVVVVVVVV",1,8,0.902691511387163,114,120,133,136,181,187,201,204,"ATGATAC","AAGA","ATGTTTA","CTGA",2.36351990685192,13,45,14,81,1.86959497114287,4.40659858753891,8.01736463308757,101,"ENSG00000079974.19"
"18193","ENSG00000156475.19_170897",170889,170897,9,"ENSG00000156475.19",0,NA,"VVVVVVUVV",1,8,0.886128364389234,42,48,60,63,112,118,133,136,"TTGCTGA","CTCA","GTAAGTA","CTGA",2.41095391385551,12,49,15,85,1.81833304572327,4.47283978452334,8.01735324208027,101,"ENSG00000079974.19"
"23648","ENSG00000173473.11_97039",97031,97039,9,"ENSG00000173473.11",1,6,"VVVVVMVVV",0,8,0.902691511387163,92,98,133,136,143,149,183,186,"ATGGTGA","CTTC","GTGAAAA","CTGA",2.48310690669491,35,7,34,85,1.07223894878429,4.40657124835426,8.01733729390292,101,"ENSG00000079974.19"
"20391","ENSG00000164796.18_113859",113851,113859,9,"ENSG00000164796.18",1,7,"VVVVVVMVV",0,8,0.885300207039338,84,90,105,108,114,120,133,136,"ATGAGGG","CTGA","GGTAAGA","CTCA",2.26194351187184,15,6,13,43,2.82479659184204,4.47610500108024,8.01730582923759,101,"ENSG00000079974.19"
"9739","ENSG00000126838.10_26683",26675,26683,9,"ENSG00000126838.10",1,3,"VVMVVVVVV",0,8,0.882815734989648,86,92,102,105,115,121,133,136,"ATGATGC","CTGA","GTGAGTA","AAGA",2.27155876876347,10,10,12,41,2.79974786452966,4.48586824740487,8.01713118736346,101,"ENSG00000079974.19"
"18159","ENSG00000156299.15_420975",420967,420975,9,"ENSG00000156299.15",1,1,"MVVVVVVVV",0,8,0.90600414078675,112,118,133,136,141,147,163,166,"GGGCTGA","ATGT","AAGATGG","CTGA",2.24499265676562,15,5,16,45,2.60549078817484,4.3930271249864,8.0170436881334,101,"ENSG00000079974.19"
"720","ENSG00000028116.18_195457",195449,195457,9,"ENSG00000028116.18",1,8,"VVVVVVVMV",0,8,0.884057971014493,41,47,73,76,82,88,133,136,"ATGATGA","TTGA","ATGAAAA","CTGC",2.51974792936151,26,6,45,86,1.12478890739331,4.48077710911751,8.01700899317548,101,"ENSG00000079974.19"
"20946","ENSG00000166016.6_35917",35909,35917,9,"ENSG00000166016.6",1,7,"VVVVUVMVV",1,7,0.775155279503105,40,46,62,65,77,83,133,136,"ATGATGA","CAGA","TGGATGG","CTGA",2.70886961742719,16,12,50,87,1.60621241300488,4.9163357989632,8.01695691697562,101,"ENSG00000079974.19"
"23024","ENSG00000171988.20_122409",122401,122409,9,"ENSG00000171988.20",1,1,"MVVVVVVVV",0,8,0.90600414078675,111,117,133,136,157,163,178,181,"ATTCTGA","CTAG","GTAATGA","CTGA",2.35173376851908,16,21,15,61,1.89334233986059,4.39289186583029,8.01690842897729,101,"ENSG00000079974.19"
"1360","ENSG00000054392.13_178843",178835,178843,9,"ENSG00000054392.13",1,8,"VVVVVVVMV",0,8,0.884057971014493,115,121,133,136,139,145,163,166,"TATATGA","CAGA","TTGGTGT","CTGA",2.33519432560396,12,3,18,42,2.35450764382418,4.48061745362932,8.01684933768729,101,"ENSG00000079974.19"
"40423","ENSG00000256115.6_13308",13300,13308,9,"ENSG00000256115.6",1,1,"MVVVVVUVV",1,7,0.792132505175983,113,119,133,136,173,179,190,193,"ATGATGG","CTTA","GAGATGT","CTGA",2.61448658531792,14,37,11,71,1.96311819908652,4.84825719196817,8.0167872126721,101,"ENSG00000079974.19"
"8347","ENSG00000118363.13_9029",9021,9029,9,"ENSG00000118363.13",1,5,"VVVVMVVVV",0,8,0.886542443064182,80,86,98,101,107,113,133,136,"ATGGTAA","CTAA","GTGATGA","CTGT",2.30685017864035,12,6,20,47,2.50314091347921,4.47053552610373,8.01670529836045,101,"ENSG00000079974.19"
"34997","ENSG00000234663.7_269512",269504,269512,9,"ENSG00000234663.7",1,2,"VMVVVVVVV",0,8,0.884057971014493,107,113,133,136,138,144,169,172,"ATGATGA","CTTC","GTGATGA","CTGC",2.49495183711783,20,2,25,56,1.28865103735696,4.48041582120228,8.01664770526025,101,"ENSG00000079974.19"
"14238","ENSG00000144642.22_1205201",1205193,1205201,9,"ENSG00000144642.22",1,1,"MVVVVVVVV",0,8,0.90600414078675,114,120,133,136,177,183,198,201,"ATAATGG","GGGA","CTGGAGA","CTGA",2.36275433771856,13,41,15,78,1.81875017214173,4.39261143923304,8.01662800238004,101,"ENSG00000079974.19"
"14267","ENSG00000144642.22_806796",806788,806796,9,"ENSG00000144642.22",1,1,"MVVVVUVVV",1,7,0.82815734989648,50,56,68,71,110,116,133,136,"ATGCTGA","CAGT","GTGAAGA","CTGA",2.56632232684975,12,39,17,77,1.70681903835148,4.70390863767079,8.01653803725671,101,"ENSG00000079974.19"
"44771","ENSG00000283563.1_1032409",1032401,1032409,9,"ENSG00000283563.1",1,1,"MVVVVUVVV",1,7,0.82815734989648,50,56,68,71,110,116,133,136,"ATGCTGA","CAGT","GTGAAGA","CTGA",2.56632232684975,12,39,17,77,1.70681903835148,4.70390863767079,8.01653803725671,101,"ENSG00000079974.19"
"44229","ENSG00000279924.1_788",780,788,9,"ENSG00000279924.1",0,NA,"VVVVVUVVV",1,8,0.922153209109731,52,58,70,73,112,118,133,136,"ATGATGC","CTGA","GTGATGC","TTCA",2.32280756219976,12,39,15,75,1.826290220015,4.32791849200336,8.01653132844228,101,"ENSG00000079974.19"
"39247","ENSG00000253363.7_271510",271502,271510,9,"ENSG00000253363.7",1,3,"UVMVVVVVV",1,7,0.785507246376811,105,111,133,136,146,152,181,184,"ATGATAA","CTGA","ATGCAGA","CTGA",2.71706975147342,22,10,29,70,1.38420039992908,4.8744996857713,8.01652867127855,101,"ENSG00000079974.19"
"34671","ENSG00000233723.11_99545",99537,99545,9,"ENSG00000233723.11",1,1,"MVVVVVVVV",0,8,0.90600414078675,116,122,133,136,138,144,164,167,"GTATTCA","ATGA","GTGAAGA","CTGA",2.33039182798163,11,2,20,42,2.0338548930404,4.39245010322949,8.01646666637649,101,"ENSG00000079974.19"
"31887","ENSG00000225179.2_15922",15914,15922,9,"ENSG00000225179.2",1,8,"VVVVVUVMV",1,7,0.806211180124224,82,88,100,103,111,117,133,136,"GTCATGA","ATGA","GCCAAGA","CTGA",2.46226958170572,12,8,16,45,2.75134207376402,4.7916181546172,8.0164628751141,101,"ENSG00000079974.19"
"43448","ENSG00000271901.2_71731",71723,71731,9,"ENSG00000271901.2",1,8,"VVVVVUVMV",1,7,0.806211180124224,82,88,100,103,111,117,133,136,"GTCATGA","ATGA","GCCAAGA","CTGA",2.46226958170572,12,8,16,45,2.75134207376402,4.7916181546172,8.0164628751141,101,"ENSG00000079974.19"
"35507","ENSG00000236204.7_95980",95972,95980,9,"ENSG00000236204.7",1,1,"MVVVVVUVV",1,7,0.792132505175983,114,120,133,136,153,159,183,186,"ATGATGA","CAGC","CTTATGA","CTGA",2.64812117342624,13,17,24,63,1.73754534906853,4.84792162631087,8.0164516470148,101,"ENSG00000079974.19"
"3994","ENSG00000091656.19_105493",105485,105493,9,"ENSG00000091656.19",1,8,"VVVVVVVMV",0,8,0.884057971014493,92,98,133,136,143,149,177,180,"ATAATTA","CTGA","GTGTTCC","CTGA",2.51059796343627,35,7,28,79,1.18317561715648,4.48012384334956,8.01635572740753,101,"ENSG00000079974.19"
"47504","ENSG00000288597.1_118374",118366,118374,9,"ENSG00000288597.1",0,NA,"VVVUVVVVV",1,8,0.880745341614907,116,122,133,136,147,153,165,168,"AAAATGA","TAGA","GGGCTGG","CTGA",2.27890455908833,11,11,12,43,2.78034280521069,4.49325996644988,8.01624133290951,101,"ENSG00000079974.19"
"9883","ENSG00000127989.14_183846",183838,183846,9,"ENSG00000127989.14",1,5,"VVVVMVVVV",0,8,0.886542443064182,92,98,133,136,141,147,159,162,"GTGAGGA","TTGT","CAGAGGA","CTGA",2.39731678906077,35,5,12,61,1.89811212393909,4.47005601275272,8.01622578500945,101,"ENSG00000079974.19"
"28200","ENSG00000188452.15_26261",26253,26261,9,"ENSG00000188452.15",1,5,"VVVVMVVVV",0,8,0.886542443064182,116,122,133,136,139,145,160,163,"ATCTTGA","AAGA","TTAATGT","CTGA",2.29911256549503,11,3,15,38,2.5526012398039,4.47000458577603,8.01617435803276,101,"ENSG00000079974.19"
"29423","ENSG00000197959.15_593418",593410,593418,9,"ENSG00000197959.15",1,6,"VVVVVMVVV",0,8,0.902691511387163,113,119,133,136,143,149,177,180,"ATTTTGA","CATA","ATGACAA","CTGA",2.32242995009867,14,7,28,58,2.13839017061524,4.4053141261516,8.01608017170025,101,"ENSG00000079974.19"
"19909","ENSG00000163960.12_43081",43073,43081,9,"ENSG00000163960.12",1,5,"VVVVMVVVV",0,8,0.886542443064182,84,90,133,136,138,144,153,156,"ATGATGA","TAGA","TTGAAGA","CTGT",2.45327970895086,43,2,9,63,1.52428958342042,4.4698719107732,8.01604168302993,101,"ENSG00000079974.19"
"44346","ENSG00000281106.4_17572",17564,17572,9,"ENSG00000281106.4",1,8,"VVVVVUVMV",1,7,0.806211180124224,107,113,133,136,140,146,157,160,"ATGACAA","CAGA","GTGATGC","CTGA",2.52632185044708,20,4,11,44,2.32259649635135,4.79118554149964,8.01603026199654,101,"ENSG00000079974.19"
"45334","ENSG00000285444.1_17554",17546,17554,9,"ENSG00000285444.1",1,8,"VVVVVUVMV",1,7,0.806211180124224,107,113,133,136,140,146,157,160,"ATGACAA","CAGA","GTGATGC","CTGA",2.52632185044708,20,4,11,44,2.32259649635135,4.79118554149964,8.01603026199654,101,"ENSG00000079974.19"
"40149","ENSG00000255121.2_286",278,286,9,"ENSG00000255121.2",0,NA,"VVVUUVVVV",2,7,0.770600414078675,115,121,133,136,151,157,174,177,"ATGAGGA","TTGA","GTGTTAA","CTGA",2.62236821618478,12,15,17,53,2.25175894151834,4.93355342902088,8.01595508533558,101,"ENSG00000079974.19"
"6725","ENSG00000111700.13_48306",48298,48306,9,"ENSG00000111700.13",0,NA,"VVVVUVVVV",1,8,0.889855072463768,114,120,133,136,145,151,161,164,"ATGATTA","CATA","CTGAAAA","CTTA",2.22836370608977,13,9,10,41,2.97034679915309,4.45652620993789,8.01594649979296,101,"ENSG00000079974.19"
"40573","ENSG00000257046.5_43334",43326,43334,9,"ENSG00000257046.5",0,NA,"VVVVUVVVV",1,8,0.889855072463768,114,120,133,136,145,151,161,164,"ATGATTA","CATA","CTGAAAA","CTTA",2.22836370608977,13,9,10,41,2.97034679915309,4.45652620993789,8.01594649979296,101,"ENSG00000079974.19"
"7098","ENSG00000112773.16_235171",235163,235171,9,"ENSG00000112773.16",1,7,"VVVVVVMVV",0,8,0.885300207039338,112,118,133,136,145,151,160,163,"CAGATGT","CTTC","GTTATGT","CTGA",2.25342307236658,15,9,9,42,2.87609901230305,4.47472987368674,8.01593070184409,101,"ENSG00000079974.19"
"14197","ENSG00000144560.16_148942",148934,148942,9,"ENSG00000144560.16",1,2,"VMVVVVVVV",0,8,0.884057971014493,106,112,133,136,148,154,167,170,"ATGATTT","TTAA","GGGAAGA","CTGA",2.37357256222976,21,12,13,55,2.09481370195028,4.4796576958705,8.01588957992847,101,"ENSG00000079974.19"
"1097","ENSG00000047621.12_43479",43471,43479,9,"ENSG00000047621.12",1,1,"MVVVVVVVV",0,8,0.90600414078675,96,102,133,136,143,149,168,171,"CTGAAGA","GTTA","GTGATCT","CTGA",2.3940180508375,31,7,19,66,1.6073354641676,4.39186395077106,8.01588051391806,101,"ENSG00000079974.19"
"11075","ENSG00000133812.18_467547",467539,467547,9,"ENSG00000133812.18",1,8,"VVVVVVVMV",0,8,0.884057971014493,113,119,133,136,153,159,175,178,"GTGATCT","CTCA","ATGAGCT","CTGA",2.36518159557746,14,17,16,56,2.15055376380129,4.47960776691276,8.01583965097073,101,"ENSG00000079974.19"
"20175","ENSG00000164402.14_44386",44378,44386,9,"ENSG00000164402.14",0,NA,"VVVVUVVVV",1,8,0.889855072463768,98,104,133,136,143,149,157,160,"ATGGTGA","CTGC","TTGTTGA","CAGA",2.36801352712054,29,7,8,53,2.03889014702559,4.45641174862397,8.01583203847904,101,"ENSG00000079974.19"
"1754","ENSG00000065882.18_7183",7175,7183,9,"ENSG00000065882.18",0,NA,"UVVVVUVVV",2,7,0.824844720496894,112,118,133,136,142,148,157,160,"ATGGTGA","CAGA","CTGCTGA","CTAA",2.38932077773787,15,6,9,39,2.93671406819146,4.71637981327764,8.01575869526522,101,"ENSG00000079974.19"
"12193","ENSG00000137601.18_111539",111531,111539,9,"ENSG00000137601.18",1,5,"VVVVMUVVV",1,7,0.808695652173913,88,94,103,106,112,118,133,136,"TTGTTGA","CTGT","CTGATAC","CTGA",2.46627815669411,9,6,15,39,2.68196591304732,4.78095507275201,8.01573768144766,101,"ENSG00000079974.19"
"22034","ENSG00000169744.13_126000",125992,126000,9,"ENSG00000169744.13",1,6,"VVVVVMVVV",0,8,0.902691511387163,106,112,133,136,148,154,185,188,"ATGGTGA","TTTA","ATTATGT","CTGA",2.45054826075235,21,12,31,73,1.28284061990907,4.40495725623119,8.01572330177984,101,"ENSG00000079974.19"
"9281","ENSG00000123636.19_208046",208038,208046,9,"ENSG00000123636.19",1,1,"MVVVVVVVV",0,8,0.90600414078675,90,96,105,108,115,121,133,136,"ATGATTA","TTTA","TTGCTAA","GTGA",2.20402845624803,9,7,12,37,2.87316593225306,4.39167224347664,8.01568880662364,101,"ENSG00000079974.19"
"22794","ENSG00000171444.19_287229",287221,287229,9,"ENSG00000171444.19",1,7,"VVVVVVMVV",0,8,0.885300207039338,115,121,133,136,155,161,175,178,"ATGAGGA","TTGA","ATGTTAA","CTGG",2.35547632429289,12,19,14,54,2.1943386975864,4.47437854821807,8.01557937637542,101,"ENSG00000079974.19"
"5817","ENSG00000106780.9_109876",109868,109876,9,"ENSG00000106780.9",1,7,"VVVVVUMVV",1,7,0.807453416149068,116,122,133,136,149,155,179,182,"GTGATGA","CAGG","GGGAGGA","CTGA",2.57398632699432,11,13,24,57,1.98276243609417,4.78566782068074,8.01548148527701,101,"ENSG00000079974.19"
"2561","ENSG00000075856.12_31268",31260,31268,9,"ENSG00000075856.12",0,NA,"VVVUUVVVV",2,7,0.770600414078675,111,117,133,136,187,193,204,207,"ATGATGA","CTTG","ATGAAGA","CTGA",2.68615435679735,16,51,11,87,1.82434465670175,4.93301009217102,8.01541174848572,101,"ENSG00000079974.19"
"1984","ENSG00000068724.18_15721",15713,15721,9,"ENSG00000068724.18",1,1,"MVVVVUVVV",1,7,0.82815734989648,105,111,133,136,148,154,167,170,"GTGATGA","GTCA","ATGCAGT","CTGA",2.51836570324165,22,12,13,56,2.02200679202127,4.70277787007474,8.01540726966066,101,"ENSG00000079974.19"
"18689","ENSG00000158161.16_30518",30510,30518,9,"ENSG00000158161.16",1,6,"VVVVVMVVV",0,8,0.902691511387163,92,98,104,107,114,120,133,136,"CTGATGG","ATGA","TTTAAGA","TTGA",2.26203528951328,6,7,13,35,2.53820570476804,4.40461024204748,8.01537628759614,101,"ENSG00000079974.19"
"16237","ENSG00000151229.13_224610",224602,224610,9,"ENSG00000151229.13",0,NA,"UVVVVVUVV",2,7,0.788819875776397,110,116,133,136,142,148,171,174,"ATGATGA","TTGT","AAGATTA","CTGA",2.60141900348408,17,6,23,55,2.09752825616772,4.86008040318207,8.01535990628766,101,"ENSG00000079974.19"
"21001","ENSG00000166206.15_198276",198268,198276,9,"ENSG00000166206.15",1,2,"VMVVVUVVV",1,7,0.806211180124223,112,118,133,136,154,160,198,201,"CTGAAGA","CTGA","ATGATGG","CTGA",2.67740807806748,15,18,38,80,1.31250780089134,4.79047374700197,8.01531846749887,101,"ENSG00000079974.19"
"13914","ENSG00000143951.16_137456",137448,137456,9,"ENSG00000143951.16",1,8,"VVVVVVVMV",0,8,0.884057971014493,88,94,107,110,116,122,133,136,"AGGATGT","CTTA","ATGGTGT","CAGA",2.23588407304282,13,6,11,39,3.01000559323771,4.47897485338079,8.01520673743876,101,"ENSG00000079974.19"
"336","ENSG00000008513.16_23610",23602,23610,9,"ENSG00000008513.16",0,NA,"UVVVVUVVV",2,7,0.824844720496894,116,122,133,136,160,166,180,183,"AGGGTGA","CAGA","GTGATGC","CTGA",2.53055614825936,11,24,14,58,1.99282814522306,4.71580061673803,8.01517949872561,101,"ENSG00000079974.19"
"43186","ENSG00000269802.1_2386",2378,2386,9,"ENSG00000269802.1",0,NA,"UVVVVVVVV",1,8,0.902691511387163,116,122,133,136,143,149,181,184,"AAAATGT","CTCA","ATGATTT","CTGA",2.33286616661639,11,7,32,59,2.0651358157593,4.40439423163381,8.01516027718246,101,"ENSG00000079974.19"
"24521","ENSG00000176771.18_113853",113845,113853,9,"ENSG00000176771.18",1,7,"VVVVVVMVV",0,8,0.885300207039338,97,103,133,136,148,154,166,169,"ATGATTA","CTCC","AAGCTGA","CTGA",2.41917850958449,30,12,12,63,1.76745334808507,4.47382751966208,8.01502834781943,101,"ENSG00000079974.19"
"26500","ENSG00000184305.16_615060",615052,615060,9,"ENSG00000184305.16",1,6,"VVVVVMVVV",0,8,0.902691511387163,108,114,133,136,140,146,154,157,"ATGATTA","CTTA","ATGTTAT","CTTA",2.27836233190582,19,4,8,40,2.42787061583007,4.40423820713389,8.01500425268254,101,"ENSG00000079974.19"
"20240","ENSG00000164500.7_50426",50418,50426,9,"ENSG00000164500.7",0,NA,"UVVVVVVVV",1,8,0.902691511387163,62,68,78,81,113,119,133,136,"ATGAGGA","CAGA","TTCATGA","CAGA",2.36865085984891,10,32,14,65,1.82586847167111,4.4042185509993,8.01498459654795,101,"ENSG00000079974.19"
"6836","ENSG00000112041.13_2380",2372,2380,9,"ENSG00000112041.13",1,1,"MVVVVVVVV",0,8,0.90600414078675,114,120,133,136,150,156,166,169,"GTGATTA","ATCA","GTGATGG","CTGG",2.24116275627572,13,14,10,46,2.62251187635804,4.39089922954904,8.01491579269604,101,"ENSG00000079974.19"
"37133","ENSG00000245552.9_45415",45407,45415,9,"ENSG00000245552.9",0,NA,"UVVVVVVVV",1,8,0.902691511387163,110,116,133,136,180,186,198,201,"ATGCTTC","CTTA","GTGATGT","CTGA",2.38503550623955,17,44,12,82,1.71629920932006,4.40413397939593,8.01490002494458,101,"ENSG00000079974.19"
"33273","ENSG00000229175.2_35811",35803,35811,9,"ENSG00000229175.2",0,NA,"VVVUVVVVV",1,8,0.880745341614907,112,118,133,136,144,150,159,162,"ATTAGGC","CAGG","GGGATGA","CTGA",2.25727289072813,15,8,9,41,2.91891028477788,4.49184905574135,8.01483042220098,101,"ENSG00000079974.19"
"23743","ENSG00000173821.20_118469",118461,118469,9,"ENSG00000173821.20",1,8,"UVVVVVVMV",1,7,0.786749482401656,83,89,106,109,113,119,133,136,"ATCATGA","GTGA","ATGGAGG","CTGA",2.54974511159331,17,4,14,44,2.47281007051852,4.86777770361849,8.01477563322511,101,"ENSG00000079974.19"
"9049","ENSG00000122484.9_25981",25973,25981,9,"ENSG00000122484.9",1,6,"VVVVVMVVV",0,8,0.902691511387163,116,122,133,136,182,188,205,208,"ATAATGT","TTTA","ATGTAGA","CTGA",2.39117183024633,11,46,17,83,1.67453332867683,4.4039197159131,8.01468576146175,101,"ENSG00000079974.19"
"4525","ENSG00000100890.16_135987",135979,135987,9,"ENSG00000100890.16",1,1,"MVVVVVVVV",0,8,0.90600414078675,115,121,133,136,160,166,176,179,"AGGAGGA","ATAA","TTGCTGT","CTGA",2.3123594443541,12,24,10,55,2.1468540609999,4.39064592250681,8.01466248565381,101,"ENSG00000079974.19"
"41304","ENSG00000258790.1_135284",135276,135284,9,"ENSG00000258790.1",1,1,"MVVVVVVVV",0,8,0.90600414078675,115,121,133,136,160,166,176,179,"AGGAGGA","ATAA","TTGCTGT","CTGA",2.3123594443541,12,24,10,55,2.1468540609999,4.39064592250681,8.01466248565381,101,"ENSG00000079974.19"
"511","ENSG00000015171.21_21443",21435,21443,9,"ENSG00000015171.21",1,1,"MVVVVVVVV",0,8,0.90600414078675,100,106,133,136,165,171,186,189,"AAGAGGA","ATGA","GTGAAAA","CTGA",2.48722505720592,27,29,15,80,0.981071320660495,4.39064292550832,8.01465948865532,101,"ENSG00000079974.19"
"22314","ENSG00000170289.13_95311",95303,95311,9,"ENSG00000170289.13",0,NA,"VVVVVUVVV",1,8,0.922153209109731,111,117,133,136,168,174,187,190,"AAGTAGA","TTGA","GTGAACA","CTGA",2.32678365182154,16,32,13,70,1.79224493933398,4.3260339878694,8.01464682430832,101,"ENSG00000079974.19"
"25994","ENSG00000183117.20_557934",557926,557934,9,"ENSG00000183117.20",1,8,"VVVVVVVMV",0,8,0.884057971014493,116,122,133,136,161,167,181,184,"ACCTTGA","CTGA","ATCAGGA","CTGA",2.39151906626104,11,25,14,59,1.97003494633319,4.47837384701836,8.01460573107633,101,"ENSG00000079974.19"
"12607","ENSG00000138688.17_170285",170277,170285,9,"ENSG00000138688.17",1,1,"MVVVVVVVV",0,8,0.90600414078675,111,117,133,136,157,163,217,220,"ATGATTT","CTGC","GTAATGT","CTGA",2.47276115946278,16,21,54,100,1.07726075542978,4.39058378796209,8.01460035110908,101,"ENSG00000079974.19"
"28740","ENSG00000196417.13_21957",21949,21957,9,"ENSG00000196417.13",1,2,"VMVVVVVVV",0,8,0.884057971014493,83,89,98,101,109,115,133,136,"ATGTTTC","TTGA","TTGTAGA","CTGA",2.31684968159514,9,8,18,44,2.46765359204008,4.47832953400192,8.01456141805989,101,"ENSG00000079974.19"
"6964","ENSG00000112367.12_130596",130588,130596,9,"ENSG00000112367.12",1,8,"VVVVVUVMV",1,7,0.806211180124224,111,117,133,136,142,148,204,207,"GAGATGA","CAGA","TTGAGGA","CTGA",2.60049001119781,16,6,56,87,1.82224209590259,4.78971054263867,8.01455526313556,101,"ENSG00000079974.19"
"26853","ENSG00000185053.14_394957",394949,394957,9,"ENSG00000185053.14",1,5,"VVVVMUVVV",1,7,0.808695652173913,108,114,133,136,179,185,201,204,"ATGATGA","CTTA","GTCATTT","CTGA",2.66688512667862,19,43,16,87,1.33938772782117,4.77965547641966,8.01443808511531,101,"ENSG00000079974.19"
"11503","ENSG00000135218.19_122219",122211,122219,9,"ENSG00000135218.19",1,1,"MVVUVVVVV",1,7,0.786749482401656,97,103,110,113,116,122,133,136,"GTGATGA","CTGA","GTGGAAA","CTAA",2.51968314547156,7,3,11,30,2.67173332818336,4.86740524116511,8.01440317077174,101,"ENSG00000079974.19"
"33284","ENSG00000229209.1_41001",40993,41001,9,"ENSG00000229209.1",0,NA,"UVVVVVVVV",1,8,0.902691511387163,74,80,101,104,112,118,133,136,"TTGATAA","CTGA","TTAATTA","GTGA",2.31007727201821,21,8,15,53,2.21369505163349,4.40355254960539,8.01431859515405,101,"ENSG00000079974.19"
"12523","ENSG00000138448.13_64566",64558,64566,9,"ENSG00000138448.13",1,1,"MVVVVUVVV",1,7,0.82815734989648,84,90,133,136,142,148,165,168,"ATGAAGA","GAGA","GTGATAA","CTGA",2.56871982352927,43,6,17,75,1.68190236285921,4.70167529659692,8.01430469618284,101,"ENSG00000079974.19"
"9784","ENSG00000127249.15_86795",86787,86795,9,"ENSG00000127249.15",0,NA,"UVVVVVVVV",1,8,0.902691511387163,87,93,105,108,116,122,133,136,"AAGAGGA","CTCA","CTGAGGT","CAGA",2.19110091282419,12,8,11,40,3.00568632882915,4.40325643691426,8.01402248246292,101,"ENSG00000079974.19"
"14271","ENSG00000144642.22_873490",873482,873490,9,"ENSG00000144642.22",0,NA,"VVUVVVVVV",1,8,0.883643892339545,114,120,133,136,148,154,166,169,"AGTATGA","CTCC","TTTAAGA","CTGA",2.27902438448197,13,12,12,46,2.7236491260237,4.47928625564254,8.01386182500071,101,"ENSG00000079974.19"
"44776","ENSG00000283563.1_1099103",1099095,1099103,9,"ENSG00000283563.1",0,NA,"VVUVVVVVV",1,8,0.883643892339545,114,120,133,136,148,154,166,169,"AGTATGA","CTCC","TTTAAGA","CTGA",2.27902438448197,13,12,12,46,2.7236491260237,4.47928625564254,8.01386182500071,101,"ENSG00000079974.19"
"2528","ENSG00000075429.9_37482",37474,37482,9,"ENSG00000075429.9",1,8,"VVVVVVVMV",0,8,0.884057971014493,43,49,57,60,71,77,133,136,"ATGATGA","CTAA","GTGCAGG","CTGG",2.45152883249332,8,11,56,84,1.56674630482409,4.47756796369489,8.01379984775286,101,"ENSG00000079974.19"
"30792","ENSG00000213614.11_9171",9163,9171,9,"ENSG00000213614.11",1,1,"MVVVVVVVV",0,8,0.90600414078675,18,24,36,39,73,79,133,136,"AGGATGA","CTGA","GTGCTGC","CTAA",2.48003845932458,12,34,54,109,1.02527219607982,4.38971548122759,8.01373204437459,101,"ENSG00000079974.19"
"42108","ENSG00000260729.1_8732",8724,8732,9,"ENSG00000260729.1",1,1,"MVVVVVVVV",0,8,0.90600414078675,18,24,36,39,73,79,133,136,"AGGATGA","CTGA","GTGCTGC","CTAA",2.48003845932458,12,34,54,109,1.02527219607982,4.38971548122759,8.01373204437459,101,"ENSG00000079974.19"
"44262","ENSG00000280241.4_184604",184596,184604,9,"ENSG00000280241.4",1,2,"VMVVVVVVV",0,8,0.884057971014493,60,66,96,99,109,115,133,136,"AAGATGA","CTGA","GTAATAA","CTGC",2.44979077146508,30,10,18,67,1.57782995424133,4.47744210766881,8.01367399172678,101,"ENSG00000079974.19"
"1870","ENSG00000066855.16_80931",80923,80931,9,"ENSG00000066855.16",0,NA,"VVVUVVVVV",1,8,0.880745341614907,113,119,133,136,183,189,243,246,"ATAATGA","GTCA","ATGAAGA","CTGA",2.54937788161622,14,47,54,124,0.966620834181768,4.49061834457247,8.01359971103209,101,"ENSG00000079974.19"
"18904","ENSG00000159216.19_474399",474391,474399,9,"ENSG00000159216.19",1,8,"VVVVVVVMV",0,8,0.884057971014493,78,84,93,96,105,111,133,136,"GGGAAGA","TTGA","ATGAATG","CTGA",2.35704421849266,9,9,22,49,2.19563628137991,4.47731610116608,8.01354798522405,101,"ENSG00000079974.19"
"41631","ENSG00000259385.1_1987",1979,1987,9,"ENSG00000259385.1",0,NA,"VVUVVVVVV",1,8,0.883643892339545,89,95,133,136,142,148,162,165,"CTGAAGA","CAGA","GGATTGA","CTGA",2.40865945225143,38,6,14,67,1.85812783374545,4.47896437885541,8.01353994821359,101,"ENSG00000079974.19"
"17826","ENSG00000155313.16_119476",119468,119476,9,"ENSG00000155313.16",1,1,"MVVVVVVVV",0,8,0.90600414078675,77,83,89,92,96,102,133,136,"ATGATGA","CTGA","TTGAGGA","ATGT",2.41873793436293,6,4,31,50,1.4331315714796,4.38951278347479,8.01352934662179,101,"ENSG00000079974.19"
"1917","ENSG00000067715.15_271718",271710,271718,9,"ENSG00000067715.15",0,NA,"VVUVVVVVV",1,8,0.883643892339545,67,73,84,87,93,99,133,136,"GTGATGA","CAGA","ATGGTTT","CTCA",2.38395816830416,11,6,34,60,2.02214258122108,4.47879925914553,8.01337482850371,101,"ENSG00000079974.19"
"4419","ENSG00000100505.14_22042",22034,22042,9,"ENSG00000100505.14",0,NA,"VVVVVUUVV",2,7,0.808281573498965,52,58,72,75,111,117,133,136,"ATGATCA","GTGA","GTGCTGG","CTGA",2.60730509747899,14,36,16,75,1.73880515329123,4.78020978412112,8.01333607811698,101,"ENSG00000079974.19"
"14093","ENSG00000144406.19_2300",2292,2300,9,"ENSG00000144406.19",0,NA,"VVVUUVVVV",2,7,0.770600414078675,109,115,133,136,142,148,158,161,"TGGATGA","CTGA","GTTAGGG","CTGA",2.55917049724389,18,6,10,43,2.66252010637791,4.93091418866763,8.01331584498233,101,"ENSG00000079974.19"
"7038","ENSG00000112541.19_479487",479479,479487,9,"ENSG00000112541.19",1,3,"VVMVVVVVV",0,8,0.882815734989648,113,119,133,136,142,148,183,186,"TTGAGGG","CTCA","GTGGAGA","CTGA",2.38912230587138,14,6,35,64,2.00071961248833,4.48205041290772,8.01331335286631,101,"ENSG00000079974.19"
"17951","ENSG00000155897.10_36328",36320,36328,9,"ENSG00000155897.10",1,6,"VVVVVMUVV",1,7,0.788819875776397,101,107,133,136,148,154,164,167,"GTGATGA","CTGG","TTCATAA","CTGA",2.62989711497253,26,12,10,57,1.89940838808625,4.85801395530912,8.01329345841471,101,"ENSG00000079974.19"
"27041","ENSG00000185477.5_13324",13316,13324,9,"ENSG00000185477.5",1,1,"MVVVVVVVV",0,8,0.90600414078675,110,116,133,136,180,186,198,201,"ATTAGGA","CGAA","ATGATAA","CTGA",2.37609309018507,17,44,12,82,1.71629920932006,4.38922995263846,8.01324651578546,101,"ENSG00000079974.19"
"39339","ENSG00000253496.3_170011",170003,170011,9,"ENSG00000253496.3",1,3,"VVMVVVVVV",0,8,0.882815734989648,111,117,133,136,139,145,154,157,"AATATGA","GTCA","CTAAAGA","CTGA",2.29671982262215,16,3,9,37,2.61624885539775,4.48192858488635,8.01319152484494,101,"ENSG00000079974.19"
"28000","ENSG00000187889.13_33825",33817,33825,9,"ENSG00000187889.13",1,8,"VVVVVVVMV",0,8,0.884057971014493,106,112,133,136,148,154,210,213,"GTGCTGA","GGGA","GTGAAGA","CTGA",2.5097051545375,21,12,56,98,1.17624122701603,4.47690223098317,8.01313411504114,101,"ENSG00000079974.19"
"36741","ENSG00000242808.12_553830",553822,553830,9,"ENSG00000242808.12",1,3,"UVMVVVVVV",1,7,0.785507246376811,50,56,97,100,116,122,133,136,"CTGATGA","CTGA","GTAAGCA","CTGA",2.70131988021896,41,16,11,77,1.47542260533645,4.87105545169905,8.0130844372063,101,"ENSG00000079974.19"
"47029","ENSG00000287532.1_4143",4135,4143,9,"ENSG00000287532.1",1,2,"VMVVVVVVV",0,8,0.884057971014493,116,122,133,136,147,153,162,165,"ATTCTGA","AAGA","ATCAGTA","CTGA",2.25983891684639,11,11,9,40,2.84164240492455,4.47680879597511,8.01304068003309,101,"ENSG00000079974.19"
"30981","ENSG00000214960.11_68520",68512,68520,9,"ENSG00000214960.11",1,2,"VMVVVVVVV",0,8,0.884057971014493,100,106,133,136,144,150,160,163,"ATTCTGA","CACA","CTGATGT","CTGA",2.37264937671176,27,8,10,54,2.08934808204538,4.47675264836427,8.01298453242224,101,"ENSG00000079974.19"
"26040","ENSG00000183230.18_1214147",1214139,1214147,9,"ENSG00000183230.18",1,2,"VMVVVUVVV",1,7,0.806211180124223,111,117,133,136,171,177,189,192,"GTGAAGA","ATGA","TTGAAGA","CTGA",2.60049967621448,16,35,12,72,1.81583772867911,4.78812555919391,8.01297027969081,101,"ENSG00000079974.19"
"13719","ENSG00000143248.13_91755",91747,91755,9,"ENSG00000143248.13",1,1,"MVVVVVVVV",0,8,0.90600414078675,61,67,79,82,89,95,133,136,"ATGGTGA","TTGA","ATTATGG","ATGA",2.32878861669921,12,7,38,66,2.03035285521447,4.38890257496897,8.01291913811597,101,"ENSG00000079974.19"
"31276","ENSG00000221882.4_76770",76762,76770,9,"ENSG00000221882.4",1,1,"MVVVVVVVV",0,8,0.90600414078675,114,120,133,136,142,148,158,161,"ATGAAGA","CTTT","AGGGTGA","CTTA",2.17734710135242,13,6,10,38,3.03922922923171,4.38871914289529,8.01273570604229,101,"ENSG00000079974.19"
"31252","ENSG00000221818.9_102950",102942,102950,9,"ENSG00000221818.9",0,NA,"VVUVVVVVV",1,8,0.883643892339545,114,120,133,136,157,163,212,215,"CTAATGA","GTGA","ATGCTGC","CTGA",2.50121519494413,13,21,49,92,1.23711254760237,4.47797012847415,8.01254569783232,101,"ENSG00000079974.19"
"7969","ENSG00000116171.19_75920",75912,75920,9,"ENSG00000116171.19",1,8,"VVVVVUVMV",1,7,0.806211180124224,80,86,100,103,113,119,133,136,"ATGGTGT","CTGT","GAGATAA","CTGA",2.46217707475472,14,10,14,47,2.73623958476761,4.78768835411644,8.01253307461334,101,"ENSG00000079974.19"
"39456","ENSG00000253619.1_50935",50927,50935,9,"ENSG00000253619.1",1,2,"VMVVVUVVV",1,7,0.806211180124223,61,67,89,92,109,115,133,136,"ATGGTGG","CTGA","ATGAAGA","CTGA",2.66240952049438,22,17,18,66,1.40120464337965,4.78765036166889,8.01249508216578,101,"ENSG00000079974.19"
"18648","ENSG00000157992.12_2824",2816,2824,9,"ENSG00000157992.12",0,NA,"VVVVVUVVV",1,8,0.922153209109731,65,71,90,93,104,110,133,136,"ATGATGA","TTGA","ATGAGGA","CAGT",2.32871873051981,19,11,23,62,1.77060271841038,4.32384856380228,8.0124614002412,101,"ENSG00000079974.19"
"12601","ENSG00000138675.17_41901",41893,41901,9,"ENSG00000138675.17",1,1,"MVVVVVVVV",0,8,0.90600414078675,106,112,133,136,138,144,161,164,"ATGATGG","ATTA","AAAATCA","CTGA",2.38798301666792,21,2,17,49,1.63385048129142,4.38843431476939,8.01245087791639,101,"ENSG00000079974.19"
"7657","ENSG00000115271.11_39590",39582,39590,9,"ENSG00000115271.11",1,2,"VMVVVVVVV",0,8,0.884057971014493,92,98,133,136,142,148,157,160,"ATGATCA","AAGA","GACATCA","CTGA",2.38707467854316,35,6,9,59,1.99102328387966,4.47621361854184,8.01244550259981,101,"ENSG00000079974.19"
"8454","ENSG00000118965.16_45357",45349,45357,9,"ENSG00000118965.16",1,3,"VVMVVVVVV",0,8,0.882815734989648,114,120,133,136,143,149,204,207,"ATTTTGG","CTGA","GTGCTCT","CTGA",2.3892090970646,13,7,55,84,1.99631785446664,4.481094625391,8.01235756534959,101,"ENSG00000079974.19"
"15577","ENSG00000148737.18_31430",31422,31430,9,"ENSG00000148737.18",0,NA,"UVVVVVVVV",1,8,0.902691511387163,111,117,133,136,155,161,215,218,"ATGATGT","CACA","ATGCAAA","CTGA",2.46665388757407,16,19,54,98,1.16161999892037,4.40149481235354,8.01226085790219,101,"ENSG00000079974.19"
"31771","ENSG00000224750.6_5629",5621,5629,9,"ENSG00000224750.6",0,NA,"VVVVVUVVV",1,8,0.922153209109731,110,116,133,136,137,143,153,156,"GAGATGT","GTGT","CTCTTGA","CTGA",2.27021763114004,17,1,10,37,2.15952659441294,4.32357770050331,8.01219053694223,101,"ENSG00000079974.19"
"137","ENSG00000005469.12_9021",9013,9021,9,"ENSG00000005469.12",1,8,"VVVVVVVMV",0,8,0.884057971014493,78,84,90,93,102,108,133,136,"TTGATGA","CTGA","ATTATCT","GTGA",2.42873387189614,6,9,25,49,1.71227009658925,4.47595731064088,8.01218919469886,101,"ENSG00000079974.19"
"19478","ENSG00000163104.18_36230",36222,36230,9,"ENSG00000163104.18",1,8,"VVVVVVVMV",0,8,0.884057971014493,80,86,98,101,107,113,133,136,"GTGGTGA","TTGA","GTGATCT","CTCA",2.31010303630205,12,6,20,47,2.50314091347921,4.47595695553989,8.01218883959786,101,"ENSG00000079974.19"
"36218","ENSG00000238755.3_375020",375012,375020,9,"ENSG00000238755.3",1,1,"MVVVVVVVV",0,8,0.90600414078675,105,111,133,136,143,149,190,193,"ATGATGC","ATGG","GGGCTGG","CTGA",2.42982274104301,22,7,41,79,1.35381359545194,4.388157967268,8.012174530415,101,"ENSG00000079974.19"
"22062","ENSG00000169760.18_535597",535589,535597,9,"ENSG00000169760.18",0,NA,"VVVVUVVVV",1,8,0.889855072463768,51,57,77,80,87,93,133,136,"GTTAAGA","GTGA","ATGGTGA","CTGA",2.44502164032741,20,7,40,76,1.51083789798341,4.45274554170821,8.01216583156328,101,"ENSG00000079974.19"
"34872","ENSG00000234323.10_50062",50054,50062,9,"ENSG00000234323.10",0,NA,"VVVVVVUVV",1,8,0.886128364389234,107,113,133,136,145,151,187,190,"GTGATGT","ATCA","CTGAATA","CTGA",2.45778696472906,20,9,36,74,1.48506899176012,4.46757885582179,8.01209231337872,101,"ENSG00000079974.19"
"35206","ENSG00000235337.1_40947",40939,40947,9,"ENSG00000235337.1",0,NA,"VVUVVVVVV",1,8,0.883643892339545,114,120,133,136,149,155,172,175,"ATGAGGA","CAGA","TTCAAGA","TTGA",2.32835163204969,13,13,17,52,2.38767349220293,4.47750442646687,8.01207999582505,101,"ENSG00000079974.19"
"36286","ENSG00000239498.1_62837",62829,62837,9,"ENSG00000239498.1",0,NA,"VVUVVVVVV",1,8,0.883643892339545,114,120,133,136,149,155,172,175,"ATGAGGA","CAGA","TTCAAGA","TTGA",2.32835163204969,13,13,17,52,2.38767349220293,4.47750442646687,8.01207999582505,101,"ENSG00000079974.19"
"41413","ENSG00000259024.7_76934",76926,76934,9,"ENSG00000259024.7",1,8,"VVVVVVVMV",0,8,0.884057971014493,94,100,133,136,154,160,178,181,"ATGATGT","TTAA","ATGAACA","CTGA",2.53164168904888,33,18,18,78,1.02577614690939,4.47584685180882,8.01207873586679,101,"ENSG00000079974.19"
"46135","ENSG00000286215.1_519519",519511,519519,9,"ENSG00000286215.1",1,1,"MVVVVVVVV",0,8,0.90600414078675,114,120,133,136,141,147,168,171,"ATGAAAA","TTAA","TTAATAA","CTGA",2.27435266484472,13,5,21,48,2.38922311088128,4.38789355246152,8.01191011560852,101,"ENSG00000079974.19"
"4526","ENSG00000100890.16_146045",146037,146045,9,"ENSG00000100890.16",1,5,"VVVVMVVVV",0,8,0.886542443064182,76,82,98,101,113,119,133,136,"TTGAGGA","TTGG","AAGAGGG","CTGA",2.30803420430004,16,12,14,51,2.47557781913843,4.465618128618,8.01178790087473,101,"ENSG00000079974.19"
"41305","ENSG00000258790.1_145342",145334,145342,9,"ENSG00000258790.1",1,5,"VVVVMVVVV",0,8,0.886542443064182,76,82,98,101,113,119,133,136,"TTGAGGA","TTGG","AAGAGGG","CTGA",2.30803420430004,16,12,14,51,2.47557781913843,4.465618128618,8.01178790087473,101,"ENSG00000079974.19"
"3923","ENSG00000091127.14_52218",52210,52218,9,"ENSG00000091127.14",1,8,"VVVVVVVMV",0,8,0.884057971014493,114,120,133,136,148,154,163,166,"ATTATGG","CTGT","TTGATGT","CTTA",2.26944108213341,13,12,9,43,2.77248270211289,4.47552247908391,8.01175436314188,101,"ENSG00000079974.19"
"12867","ENSG00000139278.10_22258",22250,22258,9,"ENSG00000139278.10",0,NA,"VVVVVUVVV",1,8,0.922153209109731,50,56,86,89,106,112,133,136,"ATGATCA","CTGA","TTGTGGA","ATGA",2.45405708536442,30,17,21,77,0.932026369758182,4.32310173471359,8.01171457115251,101,"ENSG00000079974.19"
"14811","ENSG00000145934.17_254958",254950,254958,9,"ENSG00000145934.17",1,2,"VMVVVVVVV",0,8,0.884057971014493,73,79,99,102,110,116,133,136,"AGGATGA","CTTA","TTTATGA","ATGA",2.35900732152444,20,8,17,54,2.17469626997483,4.4753529367011,8.01158482075907,101,"ENSG00000079974.19"
"24454","ENSG00000176406.25_513517",513509,513517,9,"ENSG00000176406.25",1,2,"VMVVVVVVV",0,8,0.884057971014493,116,122,133,136,142,148,158,161,"AGCCTGA","CTGG","GGGAGAA","CTGA",2.22597228329541,11,6,10,36,3.06115136982541,4.4752416479487,8.01147353200667,101,"ENSG00000079974.19"
"5393","ENSG00000104408.11_264313",264305,264313,9,"ENSG00000104408.11",1,8,"VVVVVUVMV",1,7,0.806211180124224,83,89,133,136,148,154,196,199,"CTGATGA","CTGA","ATGGTTA","CTGA",2.75495163697572,44,12,42,107,0.779996218099107,4.78658511615098,8.01142983664787,101,"ENSG00000079974.19"
"36251","ENSG00000239381.7_36913",36905,36913,9,"ENSG00000239381.7",1,7,"VVVVVVMVV",0,8,0.885300207039338,110,116,133,136,141,147,160,163,"ATTATGG","CTCC","GTGTTTC","CTGA",2.28993318495499,17,5,13,44,2.61427522123416,4.47012411356685,8.0113249417242,101,"ENSG00000079974.19"
"22197","ENSG00000169946.14_194807",194799,194807,9,"ENSG00000169946.14",0,NA,"VVUVVVVVV",1,8,0.883643892339545,114,120,133,136,138,144,155,158,"TTGTTGA","ATCA","GAGTTTA","CTGA",2.29030808853458,13,2,11,35,2.63827653205076,4.47674928057033,8.01132484992851,101,"ENSG00000079974.19"
"10810","ENSG00000132874.15_63481",63473,63481,9,"ENSG00000132874.15",0,NA,"VVVVVUVVV",1,8,0.922153209109731,89,95,133,136,187,193,210,213,"ATGTTGA","AGGA","GTGTTCA","CTGA",2.48841943610921,38,51,17,115,0.701373411262904,4.32270907966441,8.01132191610333,101,"ENSG00000079974.19"
"2095","ENSG00000070087.15_85292",85284,85292,9,"ENSG00000070087.15",1,8,"VVVVVVVMV",0,8,0.884057971014493,97,103,133,136,142,148,162,165,"ATGAAGA","CTTC","ATGACCT","CTGA",2.40021474539106,30,6,14,59,1.89869945480909,4.47503277268736,8.01126465674534,101,"ENSG00000079974.19"
"30662","ENSG00000206199.11_2889",2881,2889,9,"ENSG00000206199.11",1,8,"VVVVVVVMV",0,8,0.884057971014493,97,103,133,136,142,148,162,165,"ATGAAGA","CTTC","ATGACCT","CTGA",2.40021474539106,30,6,14,59,1.89869945480909,4.47503277268736,8.01126465674534,101,"ENSG00000079974.19"
"29521","ENSG00000198130.16_145434",145426,145434,9,"ENSG00000198130.16",0,NA,"VVVVUVVVV",1,8,0.889855072463768,110,116,133,136,145,151,165,168,"AAGAGGA","CAGG","ATGAATG","CTGA",2.28435058150995,17,9,14,49,2.57813038670168,4.45178356585866,8.01120385571373,101,"ENSG00000079974.19"
"11206","ENSG00000134250.21_124004",123996,124004,9,"ENSG00000134250.21",1,8,"VVVVVVVMV",0,8,0.884057971014493,88,94,105,108,114,120,133,136,"CTGAGGA","GTGA","TTGAGAA","CAGA",2.24655232008344,11,6,13,39,2.9225369314352,4.47488809966453,8.0111199837225,101,"ENSG00000079974.19"
"39741","ENSG00000254171.1_581",573,581,9,"ENSG00000254171.1",0,NA,"VVVVVUVVV",1,8,0.922153209109731,114,120,133,136,174,180,191,194,"GTGAGGG","CGGT","GTTAGGA","CTGA",2.29461465875443,13,38,11,71,1.99242100978447,4.32246301703684,8.01107585347576,101,"ENSG00000079974.19"
"24946","ENSG00000178795.10_78759",78751,78759,9,"ENSG00000178795.10",1,1,"MVVVVVVVV",0,8,0.90600414078675,81,87,96,99,106,112,133,136,"TTGAAGA","ATGA","GTGAGAA","ATGA",2.28712038333404,9,7,21,46,2.30067448591197,4.38703592703473,8.01105249018173,101,"ENSG00000079974.19"
"21208","ENSG00000166833.23_205606",205598,205606,9,"ENSG00000166833.23",0,NA,"VVVVUVVVV",1,8,0.889855072463768,114,120,133,136,143,149,188,191,"ATTATGT","ATGT","ATGTTTA","CTGA",2.36787520983739,13,7,39,68,2.02050653749587,4.45158531743628,8.01100560729135,101,"ENSG00000079974.19"
"6979","ENSG00000112414.15_106211",106203,106211,9,"ENSG00000112414.15",1,2,"UMVVVVVVV",1,7,0.786749482401656,85,91,108,111,114,120,133,136,"GTGATAA","CTGA","ATCTTAA","CTGA",2.55953885254344,17,3,13,42,2.39241030607213,4.86400066409043,8.01099859369706,101,"ENSG00000079974.19"
"31585","ENSG00000224184.7_121013",121005,121013,9,"ENSG00000224184.7",0,NA,"VVVUUVVVV",2,7,0.770600414078675,78,84,98,101,106,112,133,136,"AGGATGC","GTGA","ATGATGA","CTGA",2.60362661085899,14,5,21,49,2.35685975405862,4.92859262327964,8.01099427959434,101,"ENSG00000079974.19"
"38889","ENSG00000251218.1_8672",8664,8672,9,"ENSG00000251218.1",1,1,"MVVVVVVVV",0,8,0.90600414078675,115,121,133,136,154,160,169,172,"GAGATGA","CTCA","TTGAAAA","ATGA",2.27617776761148,12,18,9,48,2.37338542165261,4.38697596809895,8.01099253124594,101,"ENSG00000079974.19"
"1891","ENSG00000067191.17_18943",18935,18943,9,"ENSG00000067191.17",0,NA,"VVVVVVUVV",1,8,0.886128364389234,72,78,89,92,115,121,133,136,"ATGATAA","CTAA","TTGATCA","CAGA",2.36397141215207,11,23,12,55,2.10599239277575,4.46645045178072,8.01096390933765,101,"ENSG00000079974.19"
"10224","ENSG00000130021.15_319431",319423,319431,9,"ENSG00000130021.15",1,1,"MVVVVVVVV",0,8,0.90600414078675,114,120,133,136,148,154,167,170,"ATGGAGA","CTGT","GGGATGA","CAGA",2.22964382996517,13,12,13,47,2.683370189747,4.3869155973787,8.0109321605257,101,"ENSG00000079974.19"
"35913","ENSG00000237463.7_96199",96191,96199,9,"ENSG00000237463.7",0,NA,"UVVVVVVVV",1,8,0.902691511387163,115,121,133,136,143,149,180,183,"GAGATTA","TTGA","ATGGCCA","CTGA",2.32394350133231,12,7,31,59,2.10728733223195,4.40006100194517,8.01082704749382,101,"ENSG00000079974.19"
"16448","ENSG00000151532.15_60752",60744,60752,9,"ENSG00000151532.15",1,8,"VVVVVVVMV",0,8,0.884057971014493,110,116,133,136,138,144,154,157,"ATGATGA","TTGG","TGGTTGA","CTCA",2.33375050890109,17,2,10,38,2.34002972362185,4.47459161240728,8.01082349646525,101,"ENSG00000079974.19"
"32120","ENSG00000226026.7_70801",70793,70801,9,"ENSG00000226026.7",1,1,"MVVVVVVVV",0,8,0.90600414078675,93,99,133,136,146,152,199,202,"ATGAAGT","ATGA","CTGAGAA","CTGA",2.49479511623813,34,10,47,100,0.915198084852667,4.38679138161005,8.01080794475705,101,"ENSG00000079974.19"
"43452","ENSG00000271945.3_165189",165181,165189,9,"ENSG00000271945.3",0,NA,"UVVVVVVVV",1,8,0.902691511387163,114,120,133,136,146,152,197,200,"AAAATTA","GTGA","ATGCTGA","CTGA",2.354828831958,13,10,45,77,1.90118265058173,4.40001038257543,8.01077642812409,101,"ENSG00000079974.19"
"12038","ENSG00000136928.7_252675",252667,252675,9,"ENSG00000136928.7",1,6,"VVVVVMUVV",1,7,0.788819875776397,50,56,67,70,76,82,133,136,"GTGCTGA","CTGA","ATCATGC","CTGA",2.61921598733525,11,6,51,77,1.96052339231342,4.85549082697044,8.01077033007603,101,"ENSG00000079974.19"
"37032","ENSG00000244468.1_15071",15063,15071,9,"ENSG00000244468.1",1,2,"VMVVVVVVV",0,8,0.884057971014493,108,114,133,136,142,148,156,159,"GTAATTA","TAGA","ATGCAGA","CTGA",2.30097756496294,19,6,8,42,2.55820840465107,4.47451470943433,8.0107465934923,101,"ENSG00000079974.19"
"19867","ENSG00000163864.18_107977",107969,107977,9,"ENSG00000163864.18",1,1,"MVVVVVVVV",0,8,0.90600414078675,95,101,133,136,165,171,186,189,"ATGATAA","ACGA","ATGAAAA","CTGA",2.496652232108,32,29,15,85,0.901826085985828,4.38654357500979,8.01056013815679,101,"ENSG00000079974.19"
"12501","ENSG00000138430.16_11566",11558,11566,9,"ENSG00000138430.16",0,NA,"UVVVVVVVV",1,8,0.902691511387163,115,121,133,136,155,161,195,198,"TTGATAA","TTGG","TTGAAGA","CTGA",2.43189486586139,12,19,34,74,1.38648374070092,4.3997790449442,8.01054509049286,101,"ENSG00000079974.19"
"13541","ENSG00000141905.19_129895",129887,129895,9,"ENSG00000141905.19",1,8,"VVVVUVVMV",1,7,0.773913043478261,60,66,96,99,109,115,133,136,"GTGATGA","CAGA","GTGTTAA","CTGA",2.71223398876748,30,10,18,67,1.57782995424133,4.91484746983946,8.01049964375251,101,"ENSG00000079974.19"
"38392","ENSG00000250103.3_12241",12233,12241,9,"ENSG00000250103.3",1,7,"VVVVVVMVV",0,8,0.885300207039338,105,111,133,136,147,153,163,166,"ATGATGA","CAGG","CAGAAGA","CTGG",2.3556726313297,22,11,10,52,2.17238007204125,4.46921607022648,8.01041689838383,101,"ENSG00000079974.19"
"27758","ENSG00000187323.12_271319",271311,271319,9,"ENSG00000187323.12",1,3,"UVMVVVVVV",1,7,0.785507246376811,87,93,105,108,113,119,133,136,"TTGATAC","CTGA","GTGCTGG","CTGA",2.49560804850369,12,5,14,40,2.83609251362198,4.86836987591165,8.01039886141889,101,"ENSG00000079974.19"
"27626","ENSG00000186889.10_9527",9519,9527,9,"ENSG00000186889.10",0,NA,"VVUVVVVVV",1,8,0.883643892339545,113,119,133,136,145,151,160,163,"TTCATAA","GTGA","AGAAAGA","CTGA",2.24486702646867,14,9,9,41,2.93727423392056,4.47576360259459,8.01033917195277,101,"ENSG00000079974.19"
"13531","ENSG00000141750.7_6640",6632,6640,9,"ENSG00000141750.7",1,7,"VVVVVVMVV",0,8,0.885300207039338,75,81,94,97,106,112,133,136,"AGGATAA","CTGA","GAGAAGA","CAGA",2.32041902160881,13,9,21,52,2.40678863774675,4.46906219545138,8.01026302360873,101,"ENSG00000079974.19"
"14124","ENSG00000144451.20_729393",729385,729393,9,"ENSG00000144451.20",1,6,"UVVVVMVVV",1,7,0.805383022774327,57,63,73,76,86,92,133,136,"AAGATGA","GTGA","TTGAAGG","CTGA",2.59803154419741,10,10,41,70,1.83427518201456,4.78862136916599,8.01015346026329,101,"ENSG00000079974.19"
"21249","ENSG00000166900.17_55743",55735,55743,9,"ENSG00000166900.17",1,6,"VVVUVMVVV",1,7,0.78343685300207,110,116,133,136,142,148,165,168,"GTGATGG","CTGG","ATGTTGC","CTGA",2.56018438442265,17,6,17,49,2.43761531228374,4.87637780210868,8.01012521411696,101,"ENSG00000079974.19"
"19082","ENSG00000160963.14_23258",23250,23258,9,"ENSG00000160963.14",0,NA,"VVUVVUVVV",2,7,0.805797101449275,111,117,133,136,163,169,191,194,"AGGATGT","CTGA","ATGATGC","CTGA",2.67219030736806,16,27,22,74,1.33311584240744,4.78692947288196,8.01011787867906,101,"ENSG00000079974.19"
"8212","ENSG00000117419.16_27616",27608,27616,9,"ENSG00000117419.16",1,7,"VVVVVVMVV",0,8,0.885300207039338,97,103,133,136,167,173,186,189,"CTGATGA","TAGA","TTGACTA","CTGA",2.53056484013507,30,31,13,83,1.00519678309013,4.46890726266432,8.01010809082167,101,"ENSG00000079974.19"
"32287","ENSG00000226644.5_5434",5426,5434,9,"ENSG00000226644.5",1,7,"VVVVUVMVV",1,7,0.775155279503105,115,121,133,136,141,147,156,159,"AGGGTGA","CTGA","AGGAGGG","CTGA",2.48638247677812,12,5,9,35,3.06188807165969,4.90944281254512,8.01006393055754,101,"ENSG00000079974.19"
"45891","ENSG00000286022.1_5323",5315,5323,9,"ENSG00000286022.1",1,7,"VVVVUVMVV",1,7,0.775155279503105,115,121,133,136,141,147,156,159,"AGGGTGA","CTGA","AGGAGGG","CTGA",2.48638247677812,12,5,9,35,3.06188807165969,4.90944281254512,8.01006393055754,101,"ENSG00000079974.19"
"33215","ENSG00000229017.7_77586",77578,77586,9,"ENSG00000229017.7",1,1,"MVVVVVVVV",0,8,0.90600414078675,70,76,89,92,96,102,133,136,"GTGATGG","ATGA","GAGAAGA","ATGA",2.34053368990102,13,4,31,57,1.94053508481866,4.38602325437303,8.01003981752003,101,"ENSG00000079974.19"
"10772","ENSG00000132792.19_72589",72581,72589,9,"ENSG00000132792.19",0,NA,"VVVVVVUVV",1,8,0.886128364389234,91,97,133,136,141,147,203,206,"ATGCTGG","CTGT","ATGAAGA","CTGA",2.53858457346727,36,5,56,106,0.938160126019643,4.46551432061702,8.01002777817396,101,"ENSG00000079974.19"
"32853","ENSG00000228065.13_78905",78897,78905,9,"ENSG00000228065.13",0,NA,"VVVVVVUVV",1,8,0.886128364389234,112,118,133,136,146,152,188,191,"ATGATGC","CAGA","CTTATGA","CTAA",2.40151911978139,15,10,36,70,1.85179964436226,4.46548177739289,8.00999523494982,101,"ENSG00000079974.19"
"1249","ENSG00000050628.21_112570",112562,112570,9,"ENSG00000050628.21",1,8,"VVVVVVVMV",0,8,0.884057971014493,108,114,133,136,145,151,162,165,"ATTATAA","TTGC","TTGACAA","CTGA",2.30698344257617,19,9,11,48,2.51503176545526,4.47373034565743,8.0099622297154,101,"ENSG00000079974.19"
"4835","ENSG00000102034.18_44259",44251,44259,9,"ENSG00000102034.18",1,8,"VVVVVVVMV",0,8,0.884057971014493,84,90,106,109,114,120,133,136,"ATGCTTT","CTGA","GTGATGG","TTGA",2.27909698200696,16,5,13,43,2.70086535882246,4.47371130971721,8.00994319377519,101,"ENSG00000079974.19"
"22550","ENSG00000170802.17_28831",28823,28831,9,"ENSG00000170802.17",1,2,"VMVVVVVVV",0,8,0.884057971014493,35,41,54,57,108,114,133,136,"ATTATGA","CTGA","ATTAGGA","CTTA",2.44848177330976,13,51,19,92,1.57159579902318,4.47370190527205,8.00993378933002,101,"ENSG00000079974.19"
"39958","ENSG00000254532.2_178638",178630,178638,9,"ENSG00000254532.2",1,8,"VVVVVVVMV",0,8,0.884057971014493,112,118,133,136,143,149,157,160,"AGGATAG","ATGT","GTGAGGG","CTGA",2.24399517684038,15,7,8,39,2.93442611390744,4.4735984898775,8.00983037393547,101,"ENSG00000079974.19"
"14351","ENSG00000144724.20_512330",512322,512330,9,"ENSG00000144724.20",1,1,"MVVVVVVVV",0,8,0.90600414078675,96,102,133,136,153,159,176,179,"ATGAAGA","AGGA","TTGATCC","CTGA",2.45774759895801,31,17,17,74,1.15783553187036,4.38570488123095,8.00972144437794,101,"ENSG00000079974.19"
"38170","ENSG00000249738.10_450466",450458,450466,9,"ENSG00000249738.10",1,5,"VVUVMUVVV",2,6,0.692339544513457,48,54,63,66,72,78,133,136,"ATGATGA","GTGA","ATGATGA","CTGA",2.87109308933464,9,6,55,79,1.82075168660743,5.24034307054293,8.00970124859676,101,"ENSG00000079974.19"
"6834","ENSG00000112038.18_46768",46760,46768,9,"ENSG00000112038.18",1,6,"VVVVVMVVV",0,8,0.902691511387163,109,115,133,136,157,163,177,180,"TTGTTGA","CTCT","GTGAGCA","CTGA",2.37285531817975,18,21,14,62,1.7760641909639,4.39877491137389,8.00954095692254,101,"ENSG00000079974.19"
"42574","ENSG00000264513.1_1584",1576,1584,9,"ENSG00000264513.1",1,2,"VMVVVVVVV",0,8,0.884057971014493,112,118,133,136,147,153,163,166,"GTGAATA","CACA","GTGGTAA","CTGA",2.27128968074197,15,11,10,45,2.75057396201523,4.47312629174042,8.0093581757984,101,"ENSG00000079974.19"
"12294","ENSG00000137819.14_8579",8571,8579,9,"ENSG00000137819.14",1,8,"VVVVVVVMV",0,8,0.884057971014493,111,117,133,136,141,147,156,159,"GAGAGGA","CAGG","AGGAAGA","CTGA",2.2619548177151,16,5,9,39,2.81278283517189,4.4731204049848,8.00935228904278,101,"ENSG00000079974.19"
"25809","ENSG00000182827.9_15256",15248,15256,9,"ENSG00000182827.9",1,1,"MVVVVVVVV",0,8,0.90600414078675,111,117,133,136,141,147,160,163,"ATTCTGT","CAGA","AAAATAA","CTGA",2.22606310767114,16,5,13,43,2.70086535882246,4.38532151915751,8.00933808230451,101,"ENSG00000079974.19"
"19231","ENSG00000162599.18_73861",73853,73861,9,"ENSG00000162599.18",1,2,"VMVVVVVVV",0,8,0.884057971014493,91,97,104,107,110,116,133,136,"ATGATGC","CTGC","CTGAATA","TTGA",2.36693966839187,7,3,17,36,2.11280683486432,4.47310115603586,8.00933304009383,101,"ENSG00000079974.19"
"8243","ENSG00000117594.10_8229",8221,8229,9,"ENSG00000117594.10",0,NA,"UVVVVVVVV",1,8,0.902691511387163,113,119,133,136,142,148,198,201,"ATGGCTA","ATGA","ATGATTA","CTGA",2.34658068577026,14,6,50,79,1.95013791802191,4.39850228912258,8.00926833467123,101,"ENSG00000079974.19"
"12467","ENSG00000138336.9_76331",76323,76331,9,"ENSG00000138336.9",1,1,"MVVVVVUVV",1,7,0.792132505175983,115,121,133,136,149,155,170,173,"GTGATAA","AAGA","GTGAAGA","CTGA",2.52754679321252,12,13,15,49,2.51260178087105,4.84072843390529,8.00925845460923,101,"ENSG00000079974.19"
"39894","ENSG00000254394.2_824566",824558,824566,9,"ENSG00000254394.2",1,1,"MVVVVVVVV",0,8,0.90600414078675,59,65,80,83,90,96,133,136,"ATGATAA","ATGA","AAGAAGA","CAGA",2.33923292992767,15,7,37,68,1.94603081252431,4.38522925301052,8.00924581615752,101,"ENSG00000079974.19"
"46756","ENSG00000287147.1_10918",10910,10918,9,"ENSG00000287147.1",0,NA,"UVVVVVVVV",1,8,0.902691511387163,99,105,133,136,140,146,168,171,"ATAATGA","ATAA","ATGAAAT","CTGA",2.44056735409871,28,4,22,63,1.32331747130011,4.39844162465621,8.00920767020487,101,"ENSG00000079974.19"
"9224","ENSG00000123124.14_63559",63551,63559,9,"ENSG00000123124.14",1,1,"MVVVVVVVV",0,8,0.90600414078675,115,121,133,136,142,148,167,170,"ATGATGT","TAGA","CTTCTGA","CTCA",2.2466019237897,12,6,19,46,2.5633594974395,4.38517641400938,8.00919297715638,101,"ENSG00000079974.19"
"15884","ENSG00000150054.19_256596",256588,256596,9,"ENSG00000150054.19",1,1,"MVVVVVVVV",0,8,0.90600414078675,46,52,74,77,80,86,133,136,"ATAATGA","CTGA","ATGAGTA","CTCA",2.47468181033261,22,3,47,81,1.04269345473529,4.38514304757151,8.00915961071851,101,"ENSG00000079974.19"
"38606","ENSG00000250590.6_106372",106364,106372,9,"ENSG00000250590.6",1,1,"MVVVVUVVV",1,7,0.82815734989648,55,61,73,76,87,93,133,136,"AAGATGT","CAGA","GTGAAGT","CTGA",2.53954896473498,12,11,40,72,1.85571602885551,4.69651061510551,8.00914001469143,101,"ENSG00000079974.19"
"37193","ENSG00000245832.7_613054",613046,613054,9,"ENSG00000245832.7",1,5,"VVVVMUVVV",1,7,0.808695652173913,84,90,103,106,112,118,133,136,"ATGGTGA","CATA","GTGAAAG","CTGA",2.44318104920413,13,6,15,43,2.80890812931346,4.77419544766858,8.00897805636424,101,"ENSG00000079974.19"
"13442","ENSG00000141441.16_244193",244185,244193,9,"ENSG00000141441.16",0,NA,"VVVVUVVVV",1,8,0.889855072463768,113,119,133,136,164,170,218,221,"CTTATGA","ATGA","GTAAAGA","CTGA",2.51354905012968,14,28,48,99,1.04116932986051,4.44954074934793,8.008961039203,101,"ENSG00000079974.19"
"1068","ENSG00000047365.13_278052",278044,278052,9,"ENSG00000047365.13",1,8,"VVVVVVVMV",0,8,0.884057971014493,82,88,106,109,114,120,133,136,"ATGATCA","TTGA","TTAATTA","GTGA",2.30515757264099,18,5,13,45,2.52296193527474,4.47266977155367,8.00890165561164,101,"ENSG00000079974.19"
"29219","ENSG00000197467.17_145367",145359,145367,9,"ENSG00000197467.17",1,8,"VVVVVUVMV",1,7,0.806211180124224,111,117,133,136,155,161,178,181,"TTGATGA","CTGT","CTCATTA","CTGA",2.59169717574845,16,19,17,61,1.85823040228483,4.78405289348529,8.00889761398219,101,"ENSG00000079974.19"
"16796","ENSG00000152270.9_85799",85791,85799,9,"ENSG00000152270.9",0,NA,"UVVVVVVVV",1,8,0.902691511387163,107,113,133,136,163,169,178,181,"ATGTTTA","CTGT","GTGAGAT","CTGA",2.40236970431088,20,27,9,65,1.57657542086439,4.39809336240091,8.00885940794956,101,"ENSG00000079974.19"
"24668","ENSG00000177398.19_76783",76775,76783,9,"ENSG00000177398.19",0,NA,"VVUVVVVVV",1,8,0.883643892339545,83,89,98,101,109,115,133,136,"GTGTTGG","CTGG","ATCTTAA","CTGA",2.31441063563858,9,8,18,44,2.46765359204008,4.47426445740765,8.00884002676582,101,"ENSG00000079974.19"
"19854","ENSG00000163810.13_12847",12839,12847,9,"ENSG00000163810.13",1,1,"MVVVVVVVV",0,8,0.90600414078675,116,122,133,136,141,147,157,160,"CTGATGG","AGGA","GAGAGGA","CTCA",2.17519343301795,11,5,10,35,3.03788541383819,4.38479374182281,8.0088103049698,101,"ENSG00000079974.19"
"35590","ENSG00000236404.12_132572",132564,132572,9,"ENSG00000236404.12",0,NA,"VVVVVVUVV",1,8,0.886128364389234,81,87,98,101,116,122,133,136,"ATGAGGA","GTGA","GTGGTTT","CTGC",2.300752468822,11,15,11,46,2.51852225069635,4.46421801071076,8.00873146826769,101,"ENSG00000079974.19"
"42806","ENSG00000266908.2_115714",115706,115714,9,"ENSG00000266908.2",1,1,"MVVVVVVVV",0,8,0.90600414078675,114,120,133,136,178,184,193,196,"TTGTTGA","CCAA","TTGGTGC","CTGA",2.33094059369306,13,42,9,73,1.99913596121742,4.38468497979279,8.00870154293979,101,"ENSG00000079974.19"
"9533","ENSG00000125257.16_266428",266420,266428,9,"ENSG00000125257.16",1,7,"VVVVVVMVV",0,8,0.885300207039338,106,112,133,136,140,146,191,194,"AGGCTGA","CTAA","ATGATAA","CTGA",2.49224878233024,21,4,45,79,1.25492577290145,4.46747941377577,8.00868024193312,101,"ENSG00000079974.19"
"25474","ENSG00000181804.15_101627",101619,101627,9,"ENSG00000181804.15",1,8,"UVVVVVVMV",1,7,0.786749482401656,116,122,133,136,154,160,171,174,"GTGATGA","TTTA","ATGTTTA","CTGA",2.56680727294026,11,18,11,49,2.33454197024237,4.86164761412769,8.00864554373432,101,"ENSG00000079974.19"
"10520","ENSG00000131379.10_23788",23780,23788,9,"ENSG00000131379.10",1,2,"VMVVVVVVV",0,8,0.884057971014493,98,104,133,136,145,151,167,170,"ATGTTGT","TTCA","CTGATGT","CTGA",2.418281134122,29,9,16,63,1.76767436071691,4.47238714704923,8.0086190311072,101,"ENSG00000079974.19"
"7065","ENSG00000112685.14_8286",8278,8286,9,"ENSG00000112685.14",0,NA,"UVVVVVVVV",1,8,0.902691511387163,88,94,133,136,141,147,177,180,"CTGTTGA","CTGC","ATGATTC","CTGA",2.4796794441907,39,5,30,83,1.06017460345874,4.39784272451586,8.00860877006451,101,"ENSG00000079974.19"
"18321","ENSG00000157064.11_90850",90842,90850,9,"ENSG00000157064.11",0,NA,"VVVVUVVVV",1,8,0.889855072463768,68,74,94,97,102,108,133,136,"CTGATGT","CTGA","GAGAAGA","CTGG",2.41528036725858,20,5,25,59,1.69484885562282,4.44917949267,8.00859978252507,101,"ENSG00000079974.19"
"22015","ENSG00000169604.21_51797",51789,51797,9,"ENSG00000169604.21",1,1,"MVVVVVVVV",0,8,0.90600414078675,85,91,101,104,115,121,133,136,"AAGAAGA","ATGA","ATGAAAA","CTTA",2.22115387556708,10,11,12,42,2.72987507426285,4.38439189451084,8.00840845765784,101,"ENSG00000079974.19"
"10763","ENSG00000132718.9_14397",14389,14397,9,"ENSG00000132718.9",1,8,"VVVVVVVMV",0,8,0.884057971014493,78,84,96,99,107,113,133,136,"AAAATGA","CTGA","CTGATTT","CAGA",2.307616886817,12,8,20,49,2.5043942902884,4.4721267172671,8.00835860132507,101,"ENSG00000079974.19"
"590","ENSG00000020577.14_61109",61101,61109,9,"ENSG00000020577.14",1,1,"MVVVVVVVV",0,8,0.90600414078675,115,121,133,136,139,145,167,170,"AAAAAGA","CAGA","GTAAAGA","CTGA",2.31367146850198,12,3,22,46,2.11274591967421,4.38430559408851,8.00832215723551,101,"ENSG00000079974.19"
"46567","ENSG00000286836.1_116338",116330,116338,9,"ENSG00000286836.1",0,NA,"UVVVVVVVV",1,8,0.902691511387163,111,117,133,136,159,165,182,185,"ATGTTGG","CTGC","GTTTTCA","CTGA",2.38221102261104,16,23,17,65,1.70859561126899,4.39750060716899,8.00826665271764,101,"ENSG00000079974.19"
"4725","ENSG00000101782.15_9886",9878,9886,9,"ENSG00000101782.15",1,8,"VVVVVVVMV",0,8,0.884057971014493,93,99,133,136,164,170,184,187,"TTGATGA","GTGC","GTGATAC","CTGA",2.53966370062752,34,28,14,85,0.956899678634066,4.47199775403772,8.00822963809569,101,"ENSG00000079974.19"
"26587","ENSG00000184588.18_127239",127231,127239,9,"ENSG00000184588.18",1,6,"VVVUVMVVV",1,7,0.78343685300207,111,117,133,136,140,146,158,161,"ATGGTGT","CTGC","ATGCTGA","CTGA",2.52595929408294,16,4,12,41,2.65788790436904,4.87440413289716,8.00815154490544,101,"ENSG00000079974.19"
"19601","ENSG00000163444.12_1734",1726,1734,9,"ENSG00000163444.12",1,2,"VMVVVVVVV",0,8,0.884057971014493,115,121,133,136,143,149,176,179,"ATTATCA","ATAA","GTGAAAA","CTGA",2.35258825379163,12,7,27,55,2.20375066540696,4.47191808933779,8.00814997339576,101,"ENSG00000079974.19"
"3120","ENSG00000081237.21_104753",104745,104753,9,"ENSG00000081237.21",0,NA,"VVVVVUVVV",1,8,0.922153209109731,80,86,99,102,115,121,133,136,"ATGTGGA","CTGT","ATGTTGT","ATGA",2.1941281333973,13,13,12,47,2.65060692815329,4.31953195436715,8.00814479080607,101,"ENSG00000079974.19"
"5057","ENSG00000102893.18_64333",64325,64333,9,"ENSG00000102893.18",1,8,"VVVVVVUMV",1,7,0.770186335403727,110,116,133,136,145,151,160,163,"ATGGAGA","CTGT","ATGATGA","CTGA",2.54947370448255,17,9,9,44,2.71289597308844,4.92734683407635,8.00809217569126,101,"ENSG00000079974.19"
"8996","ENSG00000121988.18_300887",300879,300887,9,"ENSG00000121988.18",0,NA,"VVVVVVUVV",1,8,0.886128364389234,94,100,133,136,142,148,204,207,"GTGAAGA","CTCA","GTCAAGA","CTGA",2.52792162256634,33,6,56,104,1.00132412334577,4.46353373511368,8.00804719267061,101,"ENSG00000079974.19"
"34798","ENSG00000234162.3_52384",52376,52384,9,"ENSG00000234162.3",1,1,"MVVVVVVVV",0,8,0.90600414078675,82,88,99,102,111,117,133,136,"GTAATGA","CTAA","TTTATAA","CTGC",2.22690247555618,11,9,16,45,2.68993440327286,4.38398772674519,8.00800428989218,101,"ENSG00000079974.19"
"2663","ENSG00000077157.23_200196",200188,200196,9,"ENSG00000077157.23",1,5,"UVVVMVVVV",1,7,0.789233954451346,96,102,133,136,156,162,172,175,"ATGATAA","CTGA","CTGAGGT","CTGA",2.71411367039234,31,20,10,70,1.31006852303866,4.8510399147469,8.00797573255228,101,"ENSG00000079974.19"
"6548","ENSG00000110693.19_4376",4368,4376,9,"ENSG00000110693.19",0,NA,"VVVVVVUVV",1,8,0.886128364389234,32,38,54,57,106,112,133,136,"GTGATGG","CTGA","CTGATCA","TTGA",2.48315091685218,16,49,21,95,1.29932207885024,4.46341538113286,8.00792883868979,101,"ENSG00000079974.19"
"10530","ENSG00000131437.16_21316",21308,21316,9,"ENSG00000131437.16",1,8,"VVVVVVVMV",0,8,0.884057971014493,115,121,133,136,145,151,159,162,"TGGTTGA","CTCA","ATCGTAA","CTGA",2.23433201805357,12,9,8,38,2.99071377040895,4.47156513935819,8.00779702341616,101,"ENSG00000079974.19"
"1479","ENSG00000057935.14_55722",55714,55722,9,"ENSG00000057935.14",1,8,"VVVVVVVMV",0,8,0.884057971014493,101,107,133,136,146,152,171,174,"ATGATAA","TTAA","TGGAAGA","CTGA",2.44184554807728,26,10,19,64,1.60707015152819,4.47151011801085,8.00774200206882,101,"ENSG00000079974.19"
"30394","ENSG00000204843.13_10031",10023,10031,9,"ENSG00000204843.13",0,NA,"VVVVVUVVV",1,8,0.922153209109731,110,116,133,136,146,152,176,179,"ATGGTGA","CAGA","GTCAGGT","CTCA",2.29641537233246,17,10,24,60,1.96699945417022,4.31910881742999,8.00772165386891,101,"ENSG00000079974.19"
"16079","ENSG00000150672.19_2118827",2118819,2118827,9,"ENSG00000150672.19",1,8,"VVVVVVVMV",0,8,0.884057971014493,107,113,133,136,149,155,177,180,"ATGAGTA","CTGT","CTGAAGT","CTGA",2.44405524570973,20,13,22,64,1.59209735754472,4.47144974890239,8.00768163296037,101,"ENSG00000079974.19"
"16077","ENSG00000150672.19_2098963",2098955,2098963,9,"ENSG00000150672.19",0,NA,"VVVVVUVVV",1,8,0.922153209109731,105,111,133,136,143,149,161,164,"AAGAAGA","AAGA","AGCAAGA","CTGA",2.24704810689388,22,7,12,50,2.29584283740129,4.31904088750679,8.00765372394571,101,"ENSG00000079974.19"
"25877","ENSG00000183032.12_192163",192155,192163,9,"ENSG00000183032.12",1,1,"MVVVVVVVV",0,8,0.90600414078675,92,98,133,136,167,173,186,189,"ATGAAGC","ATGA","GTAAAGA","CTGA",2.48461468174577,35,31,13,88,0.970273215098769,4.38359277335098,8.00760933649798,101,"ENSG00000079974.19"
"47421","ENSG00000288098.1_699033",699025,699033,9,"ENSG00000288098.1",1,2,"VMVVVVVVV",0,8,0.884057971014493,83,89,103,106,113,119,133,136,"ATGATCA","CTGG","ATCAAAA","CTGC",2.25620517648702,14,7,14,44,2.84394342984433,4.47132781827277,8.00755970233075,101,"ENSG00000079974.19"
"24026","ENSG00000174891.14_99765",99757,99765,9,"ENSG00000174891.14",1,1,"MVVVVVVVV",0,8,0.90600414078675,82,88,101,104,116,122,133,136,"GTGATTA","ATGA","AGGAAAA","CTGT",2.21706628977077,13,12,11,45,2.75327200458812,4.38342848409832,8.00744504724532,101,"ENSG00000079974.19"
"11527","ENSG00000135297.17_32756",32748,32756,9,"ENSG00000135297.17",1,8,"VVVVVVVMV",0,8,0.884057971014493,113,119,133,136,147,153,173,176,"ATGATGT","GGGA","ATGGTGA","ATGA",2.33538594767816,14,11,20,54,2.31548075654835,4.47118010193401,8.00741198599198,101,"ENSG00000079974.19"
"7347","ENSG00000113638.14_18071",18063,18071,9,"ENSG00000113638.14",1,1,"MVVVVVVVV",0,8,0.90600414078675,113,119,133,136,172,178,190,193,"CTCTTGA","ATGA","AGGAAGA","CTGA",2.3392824228814,14,36,12,71,1.93832176496301,4.38338447937642,8.00740104252342,101,"ENSG00000079974.19"
"31592","ENSG00000224184.7_437773",437765,437773,9,"ENSG00000224184.7",1,2,"VMVVVVVVV",0,8,0.884057971014493,95,101,110,113,116,122,133,136,"ATGAAGA","CTGG","AAGAAAA","CTTA",2.26574835460818,9,3,11,32,2.7794809799021,4.47111750265582,8.00734938671379,101,"ENSG00000079974.19"
"32386","ENSG00000226926.7_48480",48472,48480,9,"ENSG00000226926.7",1,5,"UVVVMVVVV",1,7,0.789233954451346,111,117,133,136,143,149,160,163,"CTGATGG","GAGA","TTGAAGA","CTGA",2.48479620778226,16,7,11,43,2.83604865207137,4.85033917598827,8.00727499379365,101,"ENSG00000079974.19"
"9877","ENSG00000127955.17_314749",314741,314749,9,"ENSG00000127955.17",1,1,"MVVVVVVVV",0,8,0.90600414078675,82,88,133,136,177,183,193,196,"ATGTTGA","AAGA","ATGGTTA","CTGA",2.47899094864177,45,41,10,105,1.00632729261728,4.38323340422393,8.00724996737093,101,"ENSG00000079974.19"
"18853","ENSG00000158941.17_12469",12461,12469,9,"ENSG00000158941.17",1,8,"VVVVVVVMV",0,8,0.884057971014493,107,113,133,136,143,149,161,164,"AAGATCA","CAGG","GCGATGC","CTGA",2.31502241866114,20,7,12,48,2.45025438910794,4.47093429504555,8.00716617910352,101,"ENSG00000079974.19"
"30542","ENSG00000205669.4_8481",8473,8481,9,"ENSG00000205669.4",1,2,"VMVVVVVVV",0,8,0.884057971014493,87,93,109,112,116,122,133,136,"ATGATTA","ATGA","AGGAAAA","CTAA",2.27828324082431,16,4,11,40,2.69455314292949,4.47077702043955,8.00700890449752,101,"ENSG00000079974.19"
"41684","ENSG00000259532.1_4207",4199,4207,9,"ENSG00000259532.1",1,6,"VVVVVMVVV",0,8,0.902691511387163,115,121,133,136,146,152,162,165,"ATAAGGA","CTTA","ATGAACA","CAGA",2.19930305395033,12,10,10,41,2.92251211305717,4.39613311818151,8.00689916373016,101,"ENSG00000079974.19"
"32540","ENSG00000227124.11_95447",95439,95447,9,"ENSG00000227124.11",1,2,"VMVVVVVVV",0,8,0.884057971014493,79,85,94,97,115,121,133,136,"ATGATGA","CTGA","ATTAAGA","AAGA",2.35705236486486,9,18,12,48,2.16892597460812,4.47065210176014,8.00688398581811,101,"ENSG00000079974.19"
"40561","ENSG00000257004.1_11239",11231,11239,9,"ENSG00000257004.1",1,1,"MVVVVVVVV",0,8,0.90600414078675,115,121,133,136,142,148,163,166,"GTGATAT","CACA","AAAAAGA","CTGA",2.20693598336075,12,6,15,42,2.81847126751759,4.38284445581398,8.00686101896098,101,"ENSG00000079974.19"
"16746","ENSG00000152208.13_807558",807550,807558,9,"ENSG00000152208.13",1,7,"VVVVUVMVV",1,7,0.775155279503105,59,65,80,83,112,118,133,136,"GTGATGA","ATGA","CTGTTCA","CTGA",2.67550945133894,15,29,15,68,1.78784611332247,4.90614394722884,8.00676506524127,101,"ENSG00000079974.19"
"4151","ENSG00000095787.25_59638",59630,59638,9,"ENSG00000095787.25",1,6,"UVVVVMVVV",1,7,0.805383022774327,43,49,65,68,77,83,133,136,"AAGATGA","CTGC","GTGTTAA","CTGA",2.60242311896993,16,9,50,84,1.79092913061742,4.78510414760423,8.00663623870154,101,"ENSG00000079974.19"
"3687","ENSG00000087884.16_49612",49604,49612,9,"ENSG00000087884.16",1,1,"MVVVVVVVV",0,8,0.90600414078675,115,121,133,136,160,166,185,188,"ATGTAGA","GGGA","TTGATGT","CTGA",2.37122591356399,12,24,19,64,1.72211022768245,4.38257074619393,8.00658730934093,101,"ENSG00000079974.19"
"10769","ENSG00000132792.19_150207",150199,150207,9,"ENSG00000132792.19",1,8,"VVVVVVVMV",0,8,0.884057971014493,84,90,133,136,141,147,156,159,"ATAATTA","ATGA","GTTAGAA","CTGA",2.39262480019167,43,5,9,66,1.93052800336169,4.47034000115987,8.00657188521784,101,"ENSG00000079974.19"
"28840","ENSG00000196569.14_563820",563812,563820,9,"ENSG00000196569.14",1,1,"MVVVVVUVV",1,7,0.792132505175983,91,97,108,111,112,118,133,136,"ATGATGT","CAGA","GTAGTAA","CTGA",2.56978956392626,11,1,15,36,2.22016898516939,4.83802485283612,8.00655487354005,101,"ENSG00000079974.19"
"38495","ENSG00000250333.2_2687",2679,2687,9,"ENSG00000250333.2",0,NA,"VVVUVVVVV",1,8,0.880745341614907,95,101,110,113,116,122,133,136,"ATAATGA","ATGG","TTGATAA","CTTA",2.27320881350018,9,3,11,32,2.7794809799021,4.48355160080916,8.00653296726879,101,"ENSG00000079974.19"
"10693","ENSG00000132394.11_45088",45080,45088,9,"ENSG00000132394.11",1,2,"VMVVVVVVV",0,8,0.884057971014493,114,120,133,136,187,193,214,217,"ATGCTGG","GTGA","TTGCAGA","CTGA",2.46368467748242,13,51,21,94,1.45662733464379,4.47029796279832,8.00652984685629,101,"ENSG00000079974.19"
"22059","ENSG00000169760.18_466487",466479,466487,9,"ENSG00000169760.18",1,2,"VMVVVVVVV",0,8,0.884057971014493,106,112,133,136,142,148,186,189,"ATAATAA","TTGA","TAGATGA","CTGA",2.46852772475828,21,6,38,74,1.42384800416756,4.47017487563902,8.00640675969699,101,"ENSG00000079974.19"
"41443","ENSG00000259048.1_53235",53227,53235,9,"ENSG00000259048.1",1,8,"VVVVUVVMV",1,7,0.773913043478261,91,97,111,114,115,121,133,136,"GTGAAGA","CTGA","GGGAGAA","CTGA",2.59389513675638,14,1,12,36,2.35022931290287,4.91071588948634,8.00636806339939,101,"ENSG00000079974.19"
"6378","ENSG00000109667.12_28989",28981,28989,9,"ENSG00000109667.12",1,1,"MVVVVVVVV",0,8,0.90600414078675,113,119,133,136,138,144,153,156,"ATGAAGC","CCGA","GAGAAGA","GTGA",2.23123060276916,14,2,9,34,2.65446669549672,4.38233434515611,8.00635090830311,101,"ENSG00000079974.19"
"1422","ENSG00000055609.21_194472",194464,194472,9,"ENSG00000055609.21",0,NA,"UVVVVVVVV",1,8,0.902691511387163,105,111,133,136,150,156,188,191,"ATGATCT","CTGC","GGGAAGA","CTGA",2.47979567280464,22,14,32,77,1.05022824202148,4.3955498485131,8.00631589406175,101,"ENSG00000079974.19"
"4874","ENSG00000102174.10_80825",80817,80825,9,"ENSG00000102174.10",0,NA,"VVVVUVVVV",1,8,0.889855072463768,71,77,85,88,103,109,133,136,"AAGATGA","CTGC","GTGAAGA","CTGT",2.42831597611278,8,15,24,56,1.59877400591932,4.44688679500114,8.00630708485621,101,"ENSG00000079974.19"
"17659","ENSG00000154678.18_489637",489629,489637,9,"ENSG00000154678.18",1,1,"MVVVVVVVV",0,8,0.90600414078675,86,92,133,136,149,155,175,178,"ATGATTA","CTTT","TTGAATA","CTGA",2.44762993112492,41,13,20,83,1.2115908737976,4.38228093699094,8.00629750013794,101,"ENSG00000079974.19"
"25734","ENSG00000182667.15_213638",213630,213638,9,"ENSG00000182667.15",1,8,"VVVVVVVMV",0,8,0.884057971014493,110,116,133,136,147,153,163,166,"AGGACTA","CAGA","CTGACAA","CTGA",2.2931121168073,17,11,10,47,2.59283814094333,4.470063063248,8.00629494730597,101,"ENSG00000079974.19"
"23644","ENSG00000173473.11_113812",113804,113812,9,"ENSG00000173473.11",1,1,"MVVVVVVVV",0,8,0.90600414078675,90,96,133,136,148,154,167,170,"ATGATGA","GTGG","TTGAAAA","ATGA",2.37594388315993,37,12,13,71,1.68925106782708,4.38221923888999,8.00623580203699,101,"ENSG00000079974.19"
"4422","ENSG00000100505.14_64379",64371,64379,9,"ENSG00000100505.14",1,1,"MVVVVVVVV",0,8,0.90600414078675,116,122,133,136,162,168,183,186,"TTAATGT","CAGA","GGGAAAA","CTGA",2.34488719596197,11,26,15,61,1.89620335731589,4.38219616593226,8.00621272907925,101,"ENSG00000079974.19"
"4545","ENSG00000100997.20_13275",13267,13275,9,"ENSG00000100997.20",0,NA,"VVUVVVVVV",1,8,0.883643892339545,102,108,133,136,148,154,173,176,"ATCATGA","GTGT","CTGATCC","CTGA",2.45604215096686,25,12,19,65,1.51287840885336,4.4716231871581,8.00619875651628,101,"ENSG00000079974.19"
"37707","ENSG00000248690.8_267166",267158,267166,9,"ENSG00000248690.8",0,NA,"UVVVVVVVV",1,8,0.902691511387163,89,95,133,136,187,193,208,211,"TTTATGA","ATGA","GTGCTGC","CTGA",2.51409890088022,38,51,15,113,0.820844592329257,4.39537598288268,8.00614202843133,101,"ENSG00000079974.19"
"29077","ENSG00000197121.15_30867",30859,30867,9,"ENSG00000197121.15",1,3,"VVMVVVVVV",0,8,0.882815734989648,116,122,133,136,139,145,156,159,"ATGATTT","ATGA","ATGAAAA","CTTA",2.26067398848168,11,3,11,34,2.8281652332091,4.47483128910508,8.00609422906367,101,"ENSG00000079974.19"
"714","ENSG00000028116.18_105583",105575,105583,9,"ENSG00000028116.18",1,1,"MVVVVVVVV",0,8,0.90600414078675,96,102,133,136,141,147,155,158,"ATGATGA","CTTT","ATCATAA","TTGA",2.33763076643826,31,5,8,53,1.9438417027073,4.38201170307393,8.00602826622092,101,"ENSG00000079974.19"
"19461","ENSG00000163082.10_7819",7811,7819,9,"ENSG00000163082.10",1,8,"VVVVVVVMV",0,8,0.884057971014493,112,118,133,136,186,192,200,203,"ATGATTT","CAAA","ATTATGA","CTGA",2.39829994527613,15,50,8,82,1.89047145570123,4.46978443938553,8.0060163234435,101,"ENSG00000079974.19"
"1120","ENSG00000047936.11_102259",102251,102259,9,"ENSG00000047936.11",1,2,"VMVVVVVVV",0,8,0.884057971014493,107,113,133,136,138,144,152,155,"ATGATAA","CAAA","GGAATGG","CTGA",2.37577901220474,20,2,8,39,2.04054964598742,4.46976909850476,8.00600098256273,101,"ENSG00000079974.19"
"44443","ENSG00000282218.1_249888",249880,249888,9,"ENSG00000282218.1",1,2,"VMVVVVVVV",0,8,0.884057971014493,107,113,133,136,138,144,152,155,"ATGATAA","CAAA","GGAATGG","CTGA",2.37577901220474,20,2,8,39,2.04054964598742,4.46976909850476,8.00600098256273,101,"ENSG00000079974.19"
"6206","ENSG00000108669.17_78725",78717,78725,9,"ENSG00000108669.17",1,1,"MVVVVVVVV",0,8,0.90600414078675,113,119,133,136,151,157,165,168,"AGGATTA","GTGA","GAGATGA","CTAA",2.25387323265091,14,15,8,46,2.50199353247491,4.38195377087024,8.00597033401724,101,"ENSG00000079974.19"
"48170","ENSG00000290551.1_573878",573870,573878,9,"ENSG00000290551.1",1,8,"VVVVVVVMV",0,8,0.884057971014493,8,14,27,30,73,79,133,136,"ATGATGG","CTGA","GTGAAAA","GTGA",2.53172911307946,13,43,54,119,1.00063356495966,4.46970691303901,8.00593879709698,101,"ENSG00000079974.19"
"205","ENSG00000006576.17_121594",121586,121594,9,"ENSG00000006576.17",1,7,"VVVVVVMVV",0,8,0.885300207039338,67,73,85,88,106,112,133,136,"TTGATAA","CTGA","TTGATGG","GTGA",2.40382727201821,12,18,21,60,1.83319933043232,4.4646786193051,8.00587944746245,101,"ENSG00000079974.19"
"1743","ENSG00000065833.9_121948",121940,121948,9,"ENSG00000065833.9",0,NA,"VVUVVVVVV",1,8,0.883643892339545,37,43,60,63,81,87,133,136,"GTGATGG","CTGC","CTTATCA","CTGA",2.51268360219486,17,18,46,90,1.13374879367097,4.47124320207584,8.00581877143402,101,"ENSG00000079974.19"
"13912","ENSG00000143924.19_119525",119517,119525,9,"ENSG00000143924.19",1,3,"VVMVVVVVV",0,8,0.882815734989648,114,120,133,136,149,155,174,177,"GAGAAGA","TTGA","ATGAGCC","CTGA",2.34492515032428,13,13,19,54,2.26513622539741,4.47449264022315,8.00575558018175,101,"ENSG00000079974.19"
"35024","ENSG00000234717.2_77699",77691,77699,9,"ENSG00000234717.2",1,2,"VMVVVVVVV",0,8,0.884057971014493,101,107,133,136,141,147,157,160,"GTGACTA","CTGC","TTGAGGT","CTGA",2.37183806585047,26,5,10,50,2.06579343922886,4.46951180289133,8.00574368694931,101,"ENSG00000079974.19"
"9821","ENSG00000127527.14_8692",8684,8692,9,"ENSG00000127527.14",1,1,"MVVVVUVVV",1,7,0.82815734989648,83,89,103,106,116,122,133,136,"GTGATCA","CTGA","AGGAAGA","CTGG",2.38738043353869,14,10,11,44,2.85658025701803,4.69311245348566,8.00574185307158,101,"ENSG00000079974.19"
"47821","ENSG00000289427.1_5968",5960,5968,9,"ENSG00000289427.1",1,8,"VVVVVVVMV",0,8,0.884057971014493,116,122,133,136,151,157,178,181,"ATAGTGA","ATGA","ATGCTCT","CTGA",2.38332293481182,11,15,21,56,1.98893751341155,4.46943926970593,8.0056711537639,101,"ENSG00000079974.19"
"28606","ENSG00000196220.17_33836",33828,33836,9,"ENSG00000196220.17",1,2,"VMVVVVVVV",0,8,0.884057971014493,113,119,133,136,156,162,178,181,"TGAATGA","CTGT","TTGATTA","CTGA",2.38160084308904,14,20,16,59,2.00041452002124,4.46943836848705,8.00567025254502,101,"ENSG00000079974.19"
"33840","ENSG00000231304.2_208312",208304,208312,9,"ENSG00000231304.2",1,2,"VMVVVVVVV",0,8,0.884057971014493,113,119,133,136,156,162,178,181,"TGAATGA","CTGT","TTGATTA","CTGA",2.38160084308904,14,20,16,59,2.00041452002124,4.46943836848705,8.00567025254502,101,"ENSG00000079974.19"
"39932","ENSG00000254485.5_34086",34078,34086,9,"ENSG00000254485.5",1,2,"VMVVVVVVV",0,8,0.884057971014493,113,119,133,136,156,162,178,181,"TGAATGA","CTGT","TTGATTA","CTGA",2.38160084308904,14,20,16,59,2.00041452002124,4.46943836848705,8.00567025254502,101,"ENSG00000079974.19"
"6504","ENSG00000110395.8_56465",56457,56465,9,"ENSG00000110395.8",1,2,"VMVVVVUVV",1,7,0.770186335403727,111,117,133,136,142,148,163,166,"GTGATGG","ATGA","TTGCTGT","CTGA",2.55849942349175,16,6,15,46,2.64291398431127,4.9248942018974,8.00563954351231,101,"ENSG00000079974.19"
"199","ENSG00000006468.15_6871",6863,6871,9,"ENSG00000006468.15",0,NA,"UVVVVVVVV",1,8,0.902691511387163,114,120,133,136,139,145,153,156,"ACGATGT","GTTA","GTGATGT","CTAA",2.20409421591653,13,3,8,33,2.88489831338736,4.39471493820772,8.00548098375638,101,"ENSG00000079974.19"
"21564","ENSG00000168356.13_23494",23486,23494,9,"ENSG00000168356.13",1,6,"VVVVVMVVV",0,8,0.902691511387163,115,121,133,136,146,152,166,169,"ATGATGC","CTTG","GTCATCA","CTCA",2.22044237266507,12,10,14,45,2.77574796086026,4.39467427799017,8.00544032353883,101,"ENSG00000079974.19"
"21543","ENSG00000168273.8_13944",13936,13944,9,"ENSG00000168273.8",1,3,"VVMVVVVVV",0,8,0.882815734989648,113,119,133,136,172,178,188,191,"GTGATGT","ATAA","GTAACTA","CTGA",2.38745147357457,14,36,10,69,1.98022887283794,4.47414300750044,8.00540594745903,101,"ENSG00000079974.19"
"41165","ENSG00000258628.1_8853",8845,8853,9,"ENSG00000258628.1",0,NA,"VVVVVUVVV",1,8,0.922153209109731,111,117,133,136,158,164,183,186,"TTTATGT","ATGA","TTTATGC","CTGA",2.34756952305497,16,22,19,66,1.6166936567665,4.31678928594991,8.00540212238883,101,"ENSG00000079974.19"
"41871","ENSG00000259882.2_4722",4714,4722,9,"ENSG00000259882.2",0,NA,"VVVVVUVVV",1,8,0.922153209109731,111,117,133,136,158,164,183,186,"TTTATGT","ATGA","TTTATGC","CTGA",2.34756952305497,16,22,19,66,1.6166936567665,4.31678928594991,8.00540212238883,101,"ENSG00000079974.19"
"5391","ENSG00000104408.11_246325",246317,246325,9,"ENSG00000104408.11",1,8,"VVVVVVVMV",0,8,0.884057971014493,25,31,71,74,110,116,133,136,"GTGTTGA","CAGA","TTGCTGA","CTGA",2.57414605079422,40,36,17,102,0.715522165507558,4.46912395936725,8.00535584342522,101,"ENSG00000079974.19"
"47721","ENSG00000289094.1_334",326,334,9,"ENSG00000289094.1",1,8,"VVVVVVVMV",0,8,0.884057971014493,25,31,71,74,110,116,133,136,"GTGTTGA","CAGA","TTGCTGA","CTGA",2.57414605079422,40,36,17,102,0.715522165507558,4.46912395936725,8.00535584342522,101,"ENSG00000079974.19"
"42764","ENSG00000266573.6_176817",176809,176817,9,"ENSG00000266573.6",1,1,"MVVVVVVVV",0,8,0.90600414078675,100,106,133,136,165,171,186,189,"ATGAGAA","ATGA","GTGAAAA","CTGA",2.48157932678955,27,29,15,80,0.981071320660495,4.38123337481437,8.00524993796136,101,"ENSG00000079974.19"
"6111","ENSG00000108018.16_355589",355581,355589,9,"ENSG00000108018.16",1,8,"VVVVVVVMV",0,8,0.884057971014493,114,120,133,136,151,157,166,169,"AAGAAGA","TTGT","ATCATCA","CTGA",2.29853349403321,13,15,9,46,2.55218987166196,4.46893662463751,8.00516850869548,101,"ENSG00000079974.19"
"10322","ENSG00000130540.14_33229",33221,33229,9,"ENSG00000130540.14",0,NA,"UVVVVVVVV",1,8,0.902691511387163,82,88,96,99,107,113,133,136,"CTGATGT","GTGA","GTAAGGA","CTCA",2.30058074423801,8,8,20,45,2.24018881458485,4.39434844404289,8.00511448959154,101,"ENSG00000079974.19"
"3732","ENSG00000088538.13_572296",572288,572296,9,"ENSG00000088538.13",1,1,"MVVVVVVVV",0,8,0.90600414078675,44,50,66,69,116,122,133,136,"ACGTTGA","CTAA","GTTTTAA","CTGA",2.35485195757677,16,47,11,83,1.82536697683345,4.3810950068363,8.0051115699833,101,"ENSG00000079974.19"
"23671","ENSG00000173482.17_776404",776396,776404,9,"ENSG00000173482.17",1,1,"MVVVVVVVV",0,8,0.90600414078675,79,85,100,103,113,119,133,136,"ATGATGG","TTCA","TTTAAGA","CTCA",2.22651462863703,15,10,14,48,2.68088650240767,4.38107933999697,8.00509590314397,101,"ENSG00000079974.19"
"37290","ENSG00000246662.6_346518",346510,346518,9,"ENSG00000246662.6",0,NA,"VVVVVVUVV",1,8,0.886128364389234,66,72,88,91,97,103,133,136,"ATGAGGA","CTGG","CTGATCA","TTGA",2.38410597447096,16,6,30,61,1.94827494019458,4.46057869250024,8.00509215005717,101,"ENSG00000079974.19"
"27582","ENSG00000186566.13_87766",87758,87766,9,"ENSG00000186566.13",0,NA,"VVVUVVVVV",1,8,0.880745341614907,23,29,45,48,97,103,133,136,"GTGATGC","CTGG","GTAATAA","CTGA",2.54440351887114,16,49,30,104,0.965653449710697,4.48208589387957,8.0050672603392,101,"ENSG00000079974.19"
"34960","ENSG00000234464.2_58579",58571,58579,9,"ENSG00000234464.2",1,8,"VVVVVVVMV",0,8,0.884057971014493,111,117,133,136,142,148,166,169,"ATGAAGT","ATAA","ATGTGCA","CTGA",2.31245570548821,16,6,18,49,2.45896113268225,4.46883312565091,8.00506500970888,101,"ENSG00000079974.19"
"22960","ENSG00000171824.14_25599",25591,25599,9,"ENSG00000171824.14",1,8,"VVVVVVVMV",0,8,0.884057971014493,83,89,133,136,172,178,194,197,"GTGCTGA","CAGA","GTGAGTA","CTGA",2.56499438854623,44,36,16,105,0.775336211873093,4.46882470054532,8.00505658460329,101,"ENSG00000079974.19"
"11769","ENSG00000136010.14_87611",87603,87611,9,"ENSG00000136010.14",1,2,"VMVVVVVVV",0,8,0.884057971014493,103,109,133,136,140,146,155,158,"ATGATTA","TTTA","AATAGGA","CTGA",2.37243458559166,24,4,9,46,2.05851881026219,4.46868734521831,8.00491922927628,101,"ENSG00000079974.19"
"43155","ENSG00000269504.3_3083",3075,3083,9,"ENSG00000269504.3",0,NA,"VVVVVUVVV",1,8,0.922153209109731,81,87,94,97,114,120,133,136,"ATCATGA","CAGA","GTTAATA","CTCA",2.29531000841173,7,17,13,46,1.9631137894797,4.31629512805614,8.00490796449507,101,"ENSG00000079974.19"
"11835","ENSG00000136155.17_95790",95782,95790,9,"ENSG00000136155.17",1,2,"VMVVVVVVV",0,8,0.884057971014493,62,68,99,102,114,120,133,136,"ATGATGG","CTGA","GTCACCA","GTGA",2.42362100497135,31,12,13,65,1.71703487635674,4.4686270607081,8.00485894476607,101,"ENSG00000079974.19"
"42163","ENSG00000260971.4_113048",113040,113048,9,"ENSG00000260971.4",1,1,"MVVVVVVVV",0,8,0.90600414078675,106,112,133,136,147,153,208,211,"ATCATGA","AGGA","GTGTTAG","CTGA",2.44156142336817,21,11,55,96,1.24565265915153,4.38068220373483,8.00469876688183,101,"ENSG00000079974.19"
"44989","ENSG00000284686.1_159856",159848,159856,9,"ENSG00000284686.1",1,1,"MVVVVVVVV",0,8,0.90600414078675,106,112,133,136,147,153,208,211,"ATCATGA","AGGA","GTGTTAG","CTGA",2.44156142336817,21,11,55,96,1.24565265915153,4.38068220373483,8.00469876688183,101,"ENSG00000079974.19"
"32964","ENSG00000228352.2_2669",2661,2669,9,"ENSG00000228352.2",1,2,"VMVVVVVVV",0,8,0.884057971014493,116,122,133,136,141,147,158,161,"ATGATGT","GGGA","GTGGACA","CTGC",2.23186278165499,11,5,11,36,2.9946049370839,4.46842253702929,8.00465442108726,101,"ENSG00000079974.19"
"33058","ENSG00000228566.2_945436",945428,945436,9,"ENSG00000228566.2",0,NA,"UVVVVVVVV",1,8,0.902691511387163,115,121,133,136,138,144,154,157,"GGGATCT","CTCA","TTTATGT","CTGA",2.22628303752753,12,2,10,33,2.73361353275093,4.39387511240028,8.00464115794893,101,"ENSG00000079974.19"
"42949","ENSG00000267383.9_146045",146037,146045,9,"ENSG00000267383.9",1,8,"VVVVVVVMV",0,8,0.884057971014493,114,120,133,136,149,155,163,166,"ATGATAT","CAGA","TTGATCA","CAGA",2.27868484628772,13,13,8,43,2.68231038213909,4.46838567268097,8.00461755673894,101,"ENSG00000079974.19"
"43029","ENSG00000267641.1_1803",1795,1803,9,"ENSG00000267641.1",1,8,"VVVVVVVMV",0,8,0.884057971014493,114,120,133,136,149,155,163,166,"ATGATAT","CAGA","TTGATCA","CAGA",2.27868484628772,13,13,8,43,2.68231038213909,4.46838567268097,8.00461755673894,101,"ENSG00000079974.19"
"45602","ENSG00000285733.1_245969",245961,245969,9,"ENSG00000285733.1",0,NA,"VVVVVUVVV",1,8,0.922153209109731,112,118,133,136,176,182,193,196,"ATAAAGC","CAGA","ATTTTGA","CTGA",2.30402657969998,15,40,11,75,1.90264079189998,4.31570449747496,8.00431733391388,101,"ENSG00000079974.19"
"11151","ENSG00000134086.9_3988",3980,3988,9,"ENSG00000134086.9",1,3,"VVMVVVVVV",0,8,0.882815734989648,109,115,133,136,146,152,198,201,"ATAATTT","CAGA","TTGATGA","CTGA",2.44820847330848,18,10,46,83,1.57052267597269,4.4729781245073,8.00424106446589,101,"ENSG00000079974.19"
"2916","ENSG00000079246.16_4273",4265,4273,9,"ENSG00000079246.16",1,6,"VVVVVMVVV",0,8,0.902691511387163,84,90,104,107,116,122,133,136,"AAGATGT","CTCA","TTGATCG","CTGC",2.19912909566602,14,9,11,43,2.91263987276715,4.39337512763515,8.0041411731838,101,"ENSG00000079974.19"
"36577","ENSG00000241956.11_217832",217824,217832,9,"ENSG00000241956.11",1,2,"VMVVVVVVV",0,8,0.884057971014493,88,94,133,136,140,146,182,185,"ATTATGA","TTTA","ATGATGT","CTGA",2.54812158610664,39,4,36,88,0.884000504807199,4.46786943637953,8.0041013204375,101,"ENSG00000079974.19"
"2324","ENSG00000073060.17_99894",99886,99894,9,"ENSG00000073060.17",1,1,"MVVVVVVVV",0,8,0.90600414078675,109,115,133,136,141,147,165,168,"ATTTTGG","CTCA","ATAAGGA","CTGA",2.29283017746916,18,5,18,50,2.23463831231653,4.3800432071944,8.0040597703414,101,"ENSG00000079974.19"
"3127","ENSG00000081377.17_116100",116092,116100,9,"ENSG00000081377.17",1,2,"VMVVVVVVV",0,8,0.884057971014493,111,117,133,136,143,149,162,165,"GTCTTGC","GTGA","CTGAAGG","CTGA",2.26618335426436,16,7,13,45,2.76303691370971,4.46773148553469,8.00396336959266,101,"ENSG00000079974.19"
"28464","ENSG00000189223.15_59451",59443,59451,9,"ENSG00000189223.15",1,7,"VVVVVVMVV",0,8,0.885300207039338,110,116,133,136,140,146,199,202,"ATGACGA","GGGA","ATGAATT","CTGA",2.43850678388385,17,4,53,83,1.59394754169059,4.4626648585624,8.00386568671975,101,"ENSG00000079974.19"
"1133","ENSG00000048052.24_506691",506683,506691,9,"ENSG00000048052.24",1,7,"VVVVVVMVV",0,8,0.885300207039338,66,72,92,95,110,116,133,136,"ATGATGA","CTTA","GTAATCT","CAGA",2.416312008918,20,15,17,61,1.74178137566464,4.46263202544616,8.00383285360351,101,"ENSG00000079974.19"
"14443","ENSG00000145012.14_202094",202086,202094,9,"ENSG00000145012.14",1,3,"VVMVVVVVV",0,8,0.882815734989648,92,98,108,111,115,121,133,136,"ATAATGA","CTCA","GTAGTAA","CTGG",2.25640979228157,10,4,12,35,2.84677672509838,4.47237716841055,8.00364010836915,101,"ENSG00000079974.19"
"11901","ENSG00000136449.15_10231",10223,10231,9,"ENSG00000136449.15",1,8,"VVVVVVVMV",0,8,0.884057971014493,88,94,133,136,142,148,184,187,"CTGATGA","CCAA","GAGAAGA","CTGA",2.52591111334821,39,6,36,90,1.03005271376655,4.46736503402199,8.00359691807996,101,"ENSG00000079974.19"
"18500","ENSG00000157540.22_93020",93012,93020,9,"ENSG00000157540.22",1,1,"MVVVUVVVV",1,7,0.795859213250517,99,105,133,136,141,147,159,162,"ATGATGA","CGGG","TTGTTGC","CTGA",2.59694233501336,28,5,12,54,1.9675790825118,4.82013199565022,8.00356884865229,101,"ENSG00000079974.19"
"21807","ENSG00000169057.25_61955",61947,61955,9,"ENSG00000169057.25",1,3,"VVMVVVVVV",0,8,0.882815734989648,115,121,133,136,140,146,176,179,"ATTATGT","ATTA","GTGCTGT","CTGA",2.3885984322776,12,4,30,55,1.96454947209589,4.47213475515331,8.0033976951119,101,"ENSG00000079974.19"
"5373","ENSG00000104381.14_114927",114919,114927,9,"ENSG00000104381.14",1,2,"VMVVVVVVV",0,8,0.884057971014493,105,111,133,136,176,182,195,198,"AGGATAA","CTGA","GTATTAA","CTGA",2.49075565288295,22,40,13,84,1.26357399181923,4.46715291942638,8.00338480348436,101,"ENSG00000079974.19"
"45316","ENSG00000285407.1_142098",142090,142098,9,"ENSG00000285407.1",0,NA,"VVVVVUVVV",1,8,0.922153209109731,116,122,133,136,146,152,166,169,"CTTATGG","TTGT","ATATTTA","CTGA",2.17589740522739,11,10,14,44,2.7530661077662,4.31476220232054,8.00337503875947,101,"ENSG00000079974.19"
"24477","ENSG00000176563.10_3174",3166,3174,9,"ENSG00000176563.10",1,8,"VVVVVVVMV",0,8,0.884057971014493,114,120,133,136,146,152,168,171,"CTAAAGA","ATGA","ATTTGGA","CTGA",2.28215605913233,13,10,16,48,2.65419740473622,4.46714278307128,8.00337466712925,101,"ENSG00000079974.19"
"27984","ENSG00000187783.12_2751",2743,2751,9,"ENSG00000187783.12",1,7,"VVVVVVMVV",0,8,0.885300207039338,75,81,94,97,103,109,133,136,"CTCATTA","CTGG","CTGCAGA","CTGA",2.33323281658805,13,6,24,52,2.29353035600265,4.46210394998075,8.0033047781381,101,"ENSG00000079974.19"
"21029","ENSG00000166262.16_259775",259767,259775,9,"ENSG00000166262.16",0,NA,"UVVVVVVVV",1,8,0.902691511387163,115,121,133,136,145,151,165,168,"TTTATGG","ATGT","ATGTATA","CTGA",2.21090280429847,12,9,14,44,2.83078849053812,4.39253512979865,8.0033011753473,101,"ENSG00000079974.19"
"23412","ENSG00000172927.9_21893",21885,21893,9,"ENSG00000172927.9",1,1,"MVVVVVVVV",0,8,0.90600414078675,111,117,133,136,144,150,171,174,"TTGTTCA","TTGA","GAGTGGA","CTGA",2.28481171119708,16,8,21,54,2.2849160480881,4.37924853068382,8.00326509383082,101,"ENSG00000079974.19"
"42134","ENSG00000260877.3_16770",16762,16770,9,"ENSG00000260877.3",1,1,"MVVVVVVVV",0,8,0.90600414078675,111,117,133,136,144,150,171,174,"TTGTTCA","TTGA","GAGTGGA","CTGA",2.28481171119708,16,8,21,54,2.2849160480881,4.37924853068382,8.00326509383082,101,"ENSG00000079974.19"
"23104","ENSG00000172260.15_792876",792868,792876,9,"ENSG00000172260.15",1,8,"VVVVVVVMV",0,8,0.884057971014493,114,120,133,136,142,148,163,166,"AAGAAAA","CTGT","CAGAAGA","CTGA",2.25882587599068,13,6,15,43,2.80890812931346,4.46693682564617,8.00316870970414,101,"ENSG00000079974.19"
"10066","ENSG00000129083.13_27786",27778,27786,9,"ENSG00000129083.13",1,1,"MVVVVUVVV",1,7,0.82815734989648,112,118,133,136,149,155,178,181,"CTGATGG","ATGA","CTGCTAA","CTGA",2.51996844588394,15,13,23,60,1.96230013004813,4.6905224423186,8.00315184190452,101,"ENSG00000079974.19"
"46407","ENSG00000286605.1_104646",104638,104646,9,"ENSG00000286605.1",1,1,"MVVVVUVVV",1,7,0.82815734989648,105,111,133,136,145,151,159,162,"ATAATGA","TAGA","ATTATAA","CTGA",2.47384110422556,22,9,8,48,2.26959673365347,4.69046769045596,8.00309709004188,101,"ENSG00000079974.19"
"3210","ENSG00000082293.13_342239",342231,342239,9,"ENSG00000082293.13",1,8,"VVVVVVVMV",0,8,0.884057971014493,61,67,85,88,96,102,133,136,"AGGATGA","CTGA","GTTTAGA","GTGA",2.41609058287671,18,8,31,66,1.76014464427291,4.46685379919607,8.00308568325404,101,"ENSG00000079974.19"
"38063","ENSG00000249464.8_359033",359025,359033,9,"ENSG00000249464.8",1,1,"MVVVVVVVV",0,8,0.90600414078675,62,68,83,86,114,120,133,136,"ATGCTGT","CTGA","ATAAAGA","TTGA",2.34214921693419,15,28,13,65,1.90194689189209,4.37906875119668,8.00308531434368,101,"ENSG00000079974.19"
"6068","ENSG00000107890.17_54008",54000,54008,9,"ENSG00000107890.17",0,NA,"VVVUVVVVV",1,8,0.880745341614907,59,65,103,106,114,120,133,136,"CTTATGT","CTGC","ATGAAGG","CTGA",2.4017106077643,38,8,13,68,1.90872845611461,4.48003312696915,8.00301449342878,101,"ENSG00000079974.19"
"10632","ENSG00000132122.12_175123",175115,175123,9,"ENSG00000132122.12",1,1,"MVVVVVVVV",0,8,0.90600414078675,111,117,133,136,142,148,157,160,"AGGATTA","ATGA","ATGCTGG","CTGT",2.19938106308325,16,6,9,40,2.85344667370478,4.37899677356495,8.00301333671195,101,"ENSG00000079974.19"
"26778","ENSG00000185008.19_884312",884304,884312,9,"ENSG00000185008.19",0,NA,"VVUVVVVVV",1,8,0.883643892339545,111,117,133,136,187,193,201,204,"GAGATGA","AAGA","ATCATTA","CTGA",2.40819252362889,16,51,8,84,1.81870786447297,4.4683311721664,8.00290674152457,101,"ENSG00000079974.19"
"2705","ENSG00000077522.15_2476",2468,2476,9,"ENSG00000077522.15",1,1,"MVVVVVVVV",0,8,0.90600414078675,113,119,133,136,151,157,168,171,"AAAAAGA","ATGA","TTTATCA","CTGA",2.2516090932356,14,15,11,49,2.50469874044195,4.37885650716982,8.00287307031681,101,"ENSG00000079974.19"
"1058","ENSG00000047315.17_15176",15168,15176,9,"ENSG00000047315.17",1,7,"VVVVVUMVV",1,7,0.807453416149068,107,113,133,136,149,155,163,166,"AAGATGG","TTGA","GTTATGA","CTGA",2.53900309382883,20,13,8,50,2.16543109507265,4.77302959681621,8.00284326141248,101,"ENSG00000079974.19"
"12483","ENSG00000138385.16_13654",13646,13654,9,"ENSG00000138385.16",1,5,"VVVVMVVVV",0,8,0.886542443064182,106,112,133,136,156,162,178,181,"ATGATAA","TTTA","CTGTTTA","CTGA",2.45703292334366,21,20,16,66,1.44633754661117,4.45663925889223,8.00280903114896,101,"ENSG00000079974.19"
"39484","ENSG00000253656.1_44580",44572,44580,9,"ENSG00000253656.1",1,8,"VVVVUVVMV",1,7,0.773913043478261,95,101,108,111,116,122,133,136,"GTGATGA","TTGG","TTTATGG","CTGA",2.52645488989389,7,5,11,32,2.78555061077569,4.90714580251707,8.00279797643011,101,"ENSG00000079974.19"
"33758","ENSG00000231046.1_14467",14459,14467,9,"ENSG00000231046.1",0,NA,"VVVVVUUVV",2,7,0.808281573498965,91,97,133,136,144,150,158,161,"CTGATGA","ATGG","AGGATGA","CTGA",2.56587608222823,36,8,8,61,1.97284317829051,4.76967093161968,8.00279722561554,101,"ENSG00000079974.19"
"39281","ENSG00000253408.6_37033",37025,37033,9,"ENSG00000253408.6",1,8,"VVUVVVVMV",1,7,0.767701863354037,106,112,133,136,141,147,161,164,"GTCATGA","CTGA","GTGAAAG","CTGA",2.62711774495031,21,5,14,49,2.2138187781879,4.93198426946416,8.00279172288031,101,"ENSG00000079974.19"
"35490","ENSG00000236197.5_55443",55435,55443,9,"ENSG00000236197.5",1,1,"MVVVVVVVV",0,8,0.90600414078675,112,118,133,136,141,147,161,164,"ATCATAC","ATTA","GTGATTT","CTGA",2.21851514106472,15,5,14,43,2.7246821084173,4.3786957622122,8.00271232535919,101,"ENSG00000079974.19"
"4830","ENSG00000101977.22_102808",102800,102808,9,"ENSG00000101977.22",1,2,"VMVVVVVVV",0,8,0.884057971014493,115,121,133,136,166,172,185,188,"ATCGTGA","GAGA","GTCATGA","CTGA",2.38431806114585,12,30,13,64,1.97032129316041,4.46644375853319,8.00267564259116,101,"ENSG00000079974.19"
"33933","ENSG00000231533.2_84698",84690,84698,9,"ENSG00000231533.2",0,NA,"UVVVVVVVV",1,8,0.902691511387163,113,119,133,136,150,156,164,167,"ATGATAA","CCAA","GTGAAAA","TTGA",2.24909944985364,14,14,8,45,2.57287265732546,4.39171724742076,8.00248329296941,101,"ENSG00000079974.19"
"20736","ENSG00000165476.14_72567",72559,72567,9,"ENSG00000165476.14",0,NA,"VVVVUVVVV",1,8,0.889855072463768,110,116,133,136,138,144,152,155,"ATCATTA","CAGG","TTGTTGT","CTGA",2.31122174298547,17,2,8,36,2.36294570922802,4.44277266561611,8.00219295547119,101,"ENSG00000079974.19"
"6221","ENSG00000108684.15_42917",42909,42917,9,"ENSG00000108684.15",0,NA,"VVVVVUVVV",1,8,0.922153209109731,109,115,133,136,151,157,168,171,"ATTATGA","CAGA","GGCATAA","CTCA",2.25716437336243,18,15,11,53,2.20611573897874,4.3134695570154,8.00208239345432,101,"ENSG00000079974.19"
"42632","ENSG00000265356.2_23953",23945,23953,9,"ENSG00000265356.2",0,NA,"VVVVVUVVV",1,8,0.922153209109731,109,115,133,136,151,157,168,171,"ATTATGA","CAGA","GGCATAA","CTCA",2.25716437336243,18,15,11,53,2.20611573897874,4.3134695570154,8.00208239345432,101,"ENSG00000079974.19"
"33728","ENSG00000230962.2_20863",20855,20863,9,"ENSG00000230962.2",1,8,"VVVVVVVMV",0,8,0.884057971014493,110,116,133,136,142,148,157,160,"AAGAAGA","GAGA","AAGCAGA","CTGA",2.26525287298663,17,6,9,41,2.76159694676467,4.46582069166888,8.00205257572686,101,"ENSG00000079974.19"
"43256","ENSG00000270558.1_106",98,106,9,"ENSG00000270558.1",1,8,"UVVVVVVMV",1,7,0.786749482401656,82,88,108,111,120,126,147,150,"CTGAAGA","CTGG","GTGATGA","CTGA",2.62784284872675,20,9,21,59,1.90122195874861,4.85504357089841,8.00204150050503,101,"ENSG00000079974.19"
"42566","ENSG00000264424.1_18389",18381,18389,9,"ENSG00000264424.1",1,3,"VVMVVVVVV",0,8,0.882815734989648,112,118,133,136,150,156,172,175,"ATTATGA","ATGA","TTGGGGA","CTGG",2.33883389964045,15,14,16,54,2.29088740152071,4.47077834978092,8.00204128973952,101,"ENSG00000079974.19"
"41434","ENSG00000259040.5_128170",128162,128170,9,"ENSG00000259040.5",1,1,"MVVVVVVVV",0,8,0.90600414078675,102,108,133,136,138,144,171,174,"GTGATGC","ATAA","CTGATGC","CTGA",2.49171360664978,25,2,27,63,0.900541181270858,4.37799130640068,8.00200786954768,101,"ENSG00000079974.19"
"10589","ENSG00000131773.15_143050",143042,143050,9,"ENSG00000131773.15",1,8,"VVVVVUVMV",1,7,0.806211180124224,115,121,133,136,148,154,177,180,"ATGGTAA","CTGA","ATGTTAA","CTGA",2.54758727278796,12,12,23,56,2.12470436630239,4.77715487955553,8.00199960005243,101,"ENSG00000079974.19"
"21700","ENSG00000168702.18_774151",774143,774151,9,"ENSG00000168702.18",1,8,"VVVVVVVMV",0,8,0.884057971014493,116,122,133,136,142,148,186,189,"ATAATAA","TTGA","ATTTAGA","CTGA",2.38111218421774,11,6,38,64,1.98880621861104,4.46572186168232,8.00195374574029,101,"ENSG00000079974.19"
"39094","ENSG00000251600.8_702612",702604,702612,9,"ENSG00000251600.8",1,1,"MVVVVVVVV",0,8,0.90600414078675,116,122,133,136,140,146,161,164,"ATAATGA","CAAA","GTAATAA","ATGA",2.22554237415274,11,4,15,39,2.67446341308508,4.37785314352583,8.00186970667283,101,"ENSG00000079974.19"
"1438","ENSG00000055917.17_5633",5625,5633,9,"ENSG00000055917.17",0,NA,"UVVVUVVVV",2,7,0.792546583850932,111,117,133,136,145,151,172,175,"CTTATGA","CTGG","GTGGTGA","CTGA",2.56168671376328,16,9,21,55,2.24881259893554,4.83168100600601,8.00186734140974,101,"ENSG00000079974.19"
"28482","ENSG00000189319.14_98324",98316,98324,9,"ENSG00000189319.14",0,NA,"VVUVVVVVV",1,8,0.883643892339545,95,101,133,136,142,148,158,161,"TTGCTGT","TTGA","CTGGTGT","CTGA",2.37925312243895,32,6,10,57,2.00715883768404,4.46721158015259,8.00178714951077,101,"ENSG00000079974.19"
"41098","ENSG00000258539.1_145673",145665,145673,9,"ENSG00000258539.1",0,NA,"VVUVVVVVV",1,8,0.883643892339545,95,101,133,136,142,148,158,161,"TTGCTGT","TTGA","CTGGTGT","CTGA",2.37925312243895,32,6,10,57,2.00715883768404,4.46721158015259,8.00178714951077,101,"ENSG00000079974.19"
"31510","ENSG00000223930.9_46895",46887,46895,9,"ENSG00000223930.9",1,2,"VMVVVVVVV",0,8,0.884057971014493,87,93,133,136,161,167,180,183,"AGGATGG","CTGG","CTGATGC","CTGA",2.52265118476215,40,25,13,87,1.04451890039338,4.4655483663686,8.00178025042657,101,"ENSG00000079974.19"
"36725","ENSG00000242808.12_196131",196123,196131,9,"ENSG00000242808.12",1,6,"VVVVVMVVV",0,8,0.902691511387163,116,122,133,136,142,148,174,177,"GAGAAGA","CAGG","AGGATGA","CTGA",2.30530689862452,11,6,26,52,2.19523878117389,4.39098785966767,8.00175390521633,101,"ENSG00000079974.19"
"13594","ENSG00000142599.20_255228",255220,255228,9,"ENSG00000142599.20",1,2,"VMVVVVVVV",0,8,0.884057971014493,65,71,81,84,91,97,133,136,"GAGATGA","CTGA","CTGTTTA","CTGC",2.38474298064321,10,7,36,62,1.96337758108368,4.46541602967627,8.00164791373424,101,"ENSG00000079974.19"
"23263","ENSG00000172456.18_255204",255196,255204,9,"ENSG00000172456.18",1,1,"MVVVVVVVV",0,8,0.90600414078675,51,57,72,75,83,89,133,136,"ATGAGGA","ATGA","TTGTTGT","CTCA",2.34079456566361,15,8,44,76,1.90518763378861,4.37762118455318,8.00163774770017,101,"ENSG00000079974.19"
"40260","ENSG00000255395.1_23467",23459,23467,9,"ENSG00000255395.1",1,1,"MVVVVVVVV",0,8,0.90600414078675,103,109,133,136,140,146,156,159,"AGTATGA","CTGA","ATGTTAA","CAGA",2.31775768437179,24,4,10,47,2.05852515841106,4.37756076355575,8.00157732670275,101,"ENSG00000079974.19"
"25654","ENSG00000182348.7_526615",526607,526615,9,"ENSG00000182348.7",1,8,"VVVVVVVMV",0,8,0.884057971014493,113,119,133,136,139,145,155,158,"AAGAAGA","GTCA","AGTATGA","CTGA",2.26405839001805,14,3,10,36,2.76731708750663,4.46525992190675,8.00149180596472,101,"ENSG00000079974.19"
"21892","ENSG00000169282.18_394876",394868,394876,9,"ENSG00000169282.18",1,5,"VVVUMVVVV",1,7,0.767287784679089,115,121,133,136,162,168,178,181,"GTGATGA","ATGG","ATGAGGA","CTGA",2.64368070848469,12,26,10,57,2.1044481582225,4.93224655369678,8.00139769241313,101,"ENSG00000079974.19"
"47268","ENSG00000287916.1_289007",288999,289007,9,"ENSG00000287916.1",1,5,"VVVUMVVVV",1,7,0.767287784679089,115,121,133,136,162,168,178,181,"GTGATGA","ATGG","ATGAGGA","CTGA",2.64368070848469,12,26,10,57,2.1044481582225,4.93224655369678,8.00139769241313,101,"ENSG00000079974.19"
"43214","ENSG00000270087.7_8227",8219,8227,9,"ENSG00000270087.7",1,8,"VVVVVVVMV",0,8,0.884057971014493,113,119,133,136,140,146,173,176,"ATGGTGC","CAGA","AGGTTCA","CTGA",2.37830232642412,14,4,27,54,2.00531214935564,4.46516524804577,8.00139713210375,101,"ENSG00000079974.19"
"31952","ENSG00000225434.5_30436",30428,30436,9,"ENSG00000225434.5",0,NA,"UVVVVVVVV",1,8,0.902691511387163,115,121,133,136,152,158,176,179,"AAAATGA","TAGA","ATGTAGT","CTGA",2.31564442395319,12,16,18,55,2.12489034749499,4.39062996012906,8.00139600567772,101,"ENSG00000079974.19"
"35728","ENSG00000236911.6_31562",31554,31562,9,"ENSG00000236911.6",1,8,"VVVVVUVMV",1,7,0.806211180124224,110,116,133,136,142,148,158,161,"ATGATGA","ATGA","ATGACCT","ATGA",2.45249015721872,17,6,10,42,2.7561906869595,4.77653126710442,8.00137598760131,101,"ENSG00000079974.19"
"857","ENSG00000038295.8_159643",159635,159643,9,"ENSG00000038295.8",0,NA,"VVVUVVVVV",1,8,0.880745341614907,94,100,133,136,141,147,177,180,"AGGATGA","GTTA","CTGATAA","CTGA",2.52576884715252,33,5,30,77,1.07500216709004,4.4783652870267,8.00134665348633,101,"ENSG00000079974.19"
"6132","ENSG00000108094.17_35792",35784,35792,9,"ENSG00000108094.17",1,8,"VVVVVVVMV",0,8,0.884057971014493,94,100,108,111,116,122,133,136,"CTGATGG","TTGA","ATGAAAG","CTAA",2.25056477980279,8,5,11,33,2.85660886966123,4.46509351708662,8.00132540114459,101,"ENSG00000079974.19"
"24198","ENSG00000175497.17_1095369",1095361,1095369,9,"ENSG00000175497.17",1,1,"MVVVVVVVV",0,8,0.90600414078675,113,119,133,136,150,156,167,170,"ATGATAC","CTTA","ATAATGA","CCGA",2.24018425502362,14,14,11,48,2.57431153672816,4.3772183092214,8.0012348723684,101,"ENSG00000079974.19"
"19921","ENSG00000164023.15_71587",71579,71587,9,"ENSG00000164023.15",0,NA,"VVVVVUVVV",1,8,0.922153209109731,107,113,133,136,173,179,190,193,"TTGATGA","CTAC","TTGATGA","ATGA",2.36412695343871,20,37,11,77,1.48960754826087,4.31261347612973,8.00122631256865,101,"ENSG00000079974.19"
"32279","ENSG00000226620.8_40767",40759,40767,9,"ENSG00000226620.8",1,1,"MVVVVVVVV",0,8,0.90600414078675,93,99,133,136,149,155,173,176,"AAGATAA","ATGC","TTGATGA","CTGA",2.42491497746902,34,13,18,74,1.34235799335714,4.37711446078765,8.00113102393465,101,"ENSG00000079974.19"
"40919","ENSG00000258081.4_610760",610752,610760,9,"ENSG00000258081.4",1,7,"VVVVVVMVV",0,8,0.885300207039338,90,96,133,136,138,144,155,158,"CTGTTTA","CTGA","CTGAGCA","CTGA",2.4486594370482,37,2,11,59,1.51524522955056,4.45991036913464,8.00111119729199,101,"ENSG00000079974.19"
"20980","ENSG00000166147.15_179573",179565,179573,9,"ENSG00000166147.15",1,1,"MVVVVVVVV",0,8,0.90600414078675,82,88,133,136,186,192,204,207,"AAGATGA","ATAA","GTGGTTA","CTGA",2.48236912411149,45,50,12,116,0.959247463096359,4.37709373929324,8.00111030244024,101,"ENSG00000079974.19"
"28438","ENSG00000189108.13_662364",662356,662364,9,"ENSG00000189108.13",0,NA,"UVVVVVVVV",1,8,0.902691511387163,53,59,76,79,90,96,133,136,"ATTATGA","CAGA","TTGATCA","CTAA",2.39018802201108,17,11,37,74,1.62667293532023,4.39031493718185,8.0010809827305,101,"ENSG00000079974.19"
"34652","ENSG00000233723.11_218784",218776,218784,9,"ENSG00000233723.11",1,7,"VVVVVVMVV",0,8,0.885300207039338,90,96,133,136,137,143,153,156,"CTGATGA","ATCA","GTAAGGT","CTGA",2.47641036494649,37,1,10,57,1.32992895068783,4.45983284591611,8.00103367407346,101,"ENSG00000079974.19"
"29787","ENSG00000198730.9_28921",28913,28921,9,"ENSG00000198730.9",1,8,"VVVVUVVMV",1,7,0.773913043478261,82,88,133,136,149,155,165,168,"GTGATGA","GTGA","TTGAAGG","CTGA",2.68906894716142,45,13,10,77,1.6943723013201,4.90537465393239,8.00102682784543,101,"ENSG00000079974.19"
"46792","ENSG00000287176.1_55017",55009,55017,9,"ENSG00000287176.1",0,NA,"UVVVVVVVV",1,8,0.902691511387163,105,111,133,136,142,148,161,164,"CTAATGT","TGGA","ATGGAGA","CTGA",2.29804320219482,22,6,13,50,2.24072173330521,4.39025243698434,8.00101848253299,101,"ENSG00000079974.19"
"12890","ENSG00000139354.11_21031",21023,21031,9,"ENSG00000139354.11",1,1,"MVVVVVVVV",0,8,0.90600414078675,115,121,133,136,138,144,153,156,"TTTATGA","GTGA","ATGAATT","CTCA",2.20909541407722,12,2,9,32,2.78058107509119,4.3769709589015,8.00098752204849,101,"ENSG00000079974.19"
"25085","ENSG00000179399.15_326346",326338,326346,9,"ENSG00000179399.15",1,3,"VVMVVVVVV",0,8,0.882815734989648,95,101,133,136,141,147,159,162,"TTGAAGT","TTGA","CTGAACA","CTGA",2.39489510969791,32,5,12,58,1.91288806991763,4.46971386697592,8.00097680693452,101,"ENSG00000079974.19"
"42201","ENSG00000261105.6_12737",12729,12737,9,"ENSG00000261105.6",0,NA,"UVVVVVVVV",1,8,0.902691511387163,70,76,89,92,96,102,133,136,"TTAATGA","CTGA","TTGTTCA","ATGA",2.34302716871524,13,4,31,57,1.94053508481866,4.39017905239673,8.00094509794539,101,"ENSG00000079974.19"
"32721","ENSG00000227646.7_289008",289000,289008,9,"ENSG00000227646.7",1,7,"UVVVVVMVV",1,7,0.787991718426501,109,115,133,136,146,152,171,174,"ATGGTGT","CTGA","TTGAATA","CTGA",2.58839692727307,18,10,19,56,2.1398482473028,4.84895694061416,8.00092381432016,101,"ENSG00000079974.19"
"17725","ENSG00000154975.14_257432",257424,257432,9,"ENSG00000154975.14",1,8,"VVVVVUVMV",1,7,0.806211180124224,86,92,104,107,112,118,133,136,"AAGAGGA","CAGA","CTGTTGT","CTGA",2.44962527031014,12,5,15,41,2.77288109657987,4.77592905799519,8.00077377849209,101,"ENSG00000079974.19"
"24253","ENSG00000175600.16_19450",19442,19450,9,"ENSG00000175600.16",1,3,"VVMVVVVVV",0,8,0.882815734989648,83,89,101,104,111,117,133,136,"TTGCTTA","AAGA","GTGAAAA","CTGA",2.26659597162523,12,7,16,44,2.76737040921505,4.46950255501248,8.00076549497107,101,"ENSG00000079974.19"
"42675","ENSG00000265656.1_2370",2362,2370,9,"ENSG00000265656.1",1,8,"VVVVVUVMV",1,7,0.806211180124224,65,71,100,103,114,120,133,136,"ATGGTGA","TTGA","ATGGTGG","CTGA",2.59362935028995,29,11,13,62,1.81278343837046,4.77591144340919,8.00075616390609,101,"ENSG00000079974.19"
"47239","ENSG00000287899.1_8009",8001,8009,9,"ENSG00000287899.1",1,5,"VVVVMVVVV",0,8,0.886542443064182,103,109,133,136,147,153,171,174,"GTGCTGA","ATGT","GGGAAGA","CTGA",2.41936418778852,24,11,18,62,1.68914832554463,4.45456072770036,8.00073049995709,101,"ENSG00000079974.19"
"20557","ENSG00000165084.16_212399",212391,212399,9,"ENSG00000165084.16",0,NA,"VVVVVUVVV",1,8,0.922153209109731,103,109,133,136,184,190,198,201,"ATTATGA","CAGA","CTGTTGA","GTGA",2.40732122664428,24,48,8,89,1.19954394263918,4.31208803006693,8.00070086650585,101,"ENSG00000079974.19"
"14740","ENSG00000145808.10_181033",181025,181033,9,"ENSG00000145808.10",1,2,"VMVVVVVVV",0,8,0.884057971014493,112,118,133,136,139,145,154,157,"GTTCTGA","TTCA","CTGAAGT","CTGA",2.27189447311378,15,3,9,36,2.71154812569429,4.46437781994654,8.00060970400451,101,"ENSG00000079974.19"
"7683","ENSG00000115353.11_9342",9334,9342,9,"ENSG00000115353.11",1,8,"VVVVVVVMV",0,8,0.884057971014493,81,87,102,105,114,120,133,136,"GTGAGCA","CTGA","GTGTTCA","CTTA",2.26111558522682,15,9,13,46,2.78330205243867,4.46435148848771,8.00058337254568,101,"ENSG00000079974.19"
"27105","ENSG00000185565.12_463360",463352,463360,9,"ENSG00000185565.12",1,1,"MVVVVUVVV",1,7,0.82815734989648,113,119,133,136,141,147,158,161,"ATGAAGA","TTGA","TTTATGA","ATGA",2.37385253647644,14,5,11,39,2.92593659726229,4.68790504344297,8.00053444302889,101,"ENSG00000079974.19"
"13324","ENSG00000140945.17_816595",816587,816595,9,"ENSG00000140945.17",1,6,"VVVVVMVVV",0,8,0.902691511387163,116,122,133,136,185,191,207,210,"ATGTTGA","CTCT","GTAATCC","CTGA",2.37368828991295,11,49,16,85,1.73441170007706,4.38975007487418,8.00051612042283,101,"ENSG00000079974.19"
"2986","ENSG00000079950.14_48733",48725,48733,9,"ENSG00000079950.14",1,1,"MVVVVUVVV",1,7,0.82815734989648,101,107,133,136,174,180,189,192,"ATGATGA","GAGA","CTGTGGA","CTGA",2.64119581486994,26,38,9,82,1.14328948929917,4.68781539710802,8.00044479669394,101,"ENSG00000079974.19"
"29952","ENSG00000198929.13_170225",170217,170225,9,"ENSG00000198929.13",1,1,"MVVVVVVVV",0,8,0.90600414078675,42,48,93,96,101,107,133,136,"ATAATGA","CTGA","ATGCTCA","CTGT",2.45064102847933,45,5,26,85,1.16808260338446,4.37642236497833,8.00043892812533,101,"ENSG00000079974.19"
"44878","ENSG00000283992.2_2004",1996,2004,9,"ENSG00000283992.2",1,3,"VVMVVUVVV",1,7,0.804968944099379,112,118,133,136,169,175,183,186,"CTGAGGA","CTGC","GTGAGGA","CTGA",2.58048660721117,15,33,8,65,1.9187750879075,4.78050478399549,8.000380560393,101,"ENSG00000079974.19"
"44938","ENSG00000284505.1_10400",10392,10400,9,"ENSG00000284505.1",1,3,"VVMVVUVVV",1,7,0.804968944099379,112,118,133,136,169,175,183,186,"CTGAGGA","CTGC","GTGAGGA","CTGA",2.58048660721117,15,33,8,65,1.9187750879075,4.78050478399549,8.000380560393,101,"ENSG00000079974.19"
"12785","ENSG00000139132.16_158896",158888,158896,9,"ENSG00000139132.16",1,6,"VVVVVMVVV",0,8,0.902691511387163,98,104,133,136,172,178,188,191,"TGGATGA","GTGA","TCGAAGA","CTGA",2.47249331630826,29,36,10,84,1.07497832738759,4.389566775694,8.00033282124265,101,"ENSG00000079974.19"
"8631","ENSG00000119927.14_52088",52080,52088,9,"ENSG00000119927.14",1,6,"VVVVVMVVV",0,8,0.902691511387163,108,114,133,136,144,150,175,178,"AATATGA","TTGC","GTGGAGA","CTGA",2.35823728110065,19,8,25,61,1.83649876785412,4.38952016046462,8.00028620601327,101,"ENSG00000079974.19"
"40757","ENSG00000257545.5_260636",260628,260636,9,"ENSG00000257545.5",0,NA,"UVVVVVVVV",1,8,0.902691511387163,104,110,133,136,148,154,166,169,"ATGATGT","CTCA","TTAATGC","ATGA",2.33415975277236,23,12,12,56,1.99692544044519,4.3894976147319,8.00026366028055,101,"ENSG00000079974.19"
"37091","ENSG00000245248.9_87580",87572,87580,9,"ENSG00000245248.9",0,NA,"VVVVVVUVV",1,8,0.886128364389234,106,112,133,136,149,155,202,205,"AGGATGA","ATGC","GTGAGCA","CTGA",2.50712645632614,21,13,47,90,1.10878471067735,4.45574027154624,8.00025372910318,101,"ENSG00000079974.19"
"10013","ENSG00000128815.20_160594",160586,160594,9,"ENSG00000128815.20",1,1,"MVVVVVVVV",0,8,0.90600414078675,115,121,133,136,163,169,177,180,"ATTATGC","GTGC","TGGAGGA","CTGA",2.31552635536059,12,27,8,56,2.06790982424133,4.37618804832798,8.00020461147498,101,"ENSG00000079974.19"
"21744","ENSG00000168843.14_339176",339168,339176,9,"ENSG00000168843.14",1,8,"VVVVVVVMV",0,8,0.884057971014493,111,117,133,136,140,146,156,159,"CTAAAGA","CCTA","CTGATAA","CTGA",2.27031323617796,16,4,10,39,2.72043573713809,4.46396432791446,8.00019621197243,101,"ENSG00000079974.19"
"31998","ENSG00000225546.6_274128",274120,274128,9,"ENSG00000225546.6",1,5,"VVVVMVVVV",0,8,0.886542443064182,47,53,68,71,75,81,133,136,"TTGAGGA","CTGA","CTGTTGA","CTTA",2.41006434211709,15,4,52,80,1.74875483591036,4.45396261250608,8.00013238476281,101,"ENSG00000079974.19"
"2453","ENSG00000074964.17_58839",58831,58839,9,"ENSG00000074964.17",1,1,"MVVVVUVVV",1,7,0.82815734989648,66,72,84,87,91,97,133,136,"CTGATGA","CTGA","TAGATGA","CAGA",2.53013865435024,12,4,36,61,1.88199407852217,4.68739627688094,8.00002567646686,101,"ENSG00000079974.19"
"3498","ENSG00000085276.19_199268",199260,199268,9,"ENSG00000085276.19",1,5,"VVVVMVVVV",0,8,0.886542443064182,113,119,133,136,147,153,197,200,"GTGAATA","ATGA","GTGGTGC","CTGA",2.40104541426022,14,11,44,78,1.80807400739666,4.45376085894953,7.99993063120626,101,"ENSG00000079974.19"
"35687","ENSG00000236780.7_114775",114767,114775,9,"ENSG00000236780.7",1,8,"VVVVVVVMV",0,8,0.884057971014493,101,107,133,136,142,148,158,161,"GTGGAGA","GTGA","TTGTTAA","CTGA",2.36053953118934,26,6,10,51,2.11785045510557,4.46369516575863,7.9999270498166,101,"ENSG00000079974.19"
"42305","ENSG00000261609.8_20908",20900,20908,9,"ENSG00000261609.8",1,1,"MVVVVVVVV",0,8,0.90600414078675,98,104,133,136,177,183,192,195,"TTGGTGA","TTGG","GTGAAGA","CTGA",2.46595074381061,29,41,9,88,1.06328643397096,4.37573951484376,7.99975607799076,101,"ENSG00000079974.19"
"29402","ENSG00000197951.10_30685",30677,30685,9,"ENSG00000197951.10",1,2,"VMVVVVVVV",0,8,0.884057971014493,116,122,133,136,149,155,163,166,"TTGGAGA","CTGC","GTGCCAA","CTGA",2.27711889802351,11,13,8,41,2.67327712232689,4.46351744395423,7.9997493280122,101,"ENSG00000079974.19"
"43184","ENSG00000269793.7_30672",30664,30672,9,"ENSG00000269793.7",1,2,"VMVVVVVVV",0,8,0.884057971014493,116,122,133,136,149,155,163,166,"TTGGAGA","CTGC","GTGCCAA","CTGA",2.27711889802351,11,13,8,41,2.67327712232689,4.46351744395423,7.9997493280122,101,"ENSG00000079974.19"
"17096","ENSG00000153107.13_221756",221748,221756,9,"ENSG00000153107.13",1,8,"VVVVVVVMV",0,8,0.884057971014493,76,82,103,106,114,120,133,136,"CTGCTGG","CTGA","GTGAGGA","CTGG",2.33065133323161,21,8,13,51,2.31603847409212,4.46342850724238,7.99966039130035,101,"ENSG00000079974.19"
"45105","ENSG00000285016.1_36099",36091,36099,9,"ENSG00000285016.1",1,8,"VVVVVVVMV",0,8,0.884057971014493,76,82,103,106,114,120,133,136,"CTGCTGG","CTGA","GTGAGGA","CTGG",2.33065133323161,21,8,13,51,2.31603847409212,4.46342850724238,7.99966039130035,101,"ENSG00000079974.19"
"19846","ENSG00000163807.6_6909",6901,6909,9,"ENSG00000163807.6",1,8,"UVVVVVVMV",1,7,0.786749482401656,82,88,103,106,111,117,133,136,"TTGATGG","CTAA","GAGAAGA","CTGA",2.52076353561564,15,5,16,45,2.60549078817484,4.8526452564031,7.99964318600973,101,"ENSG00000079974.19"
"32748","ENSG00000227722.2_19318",19310,19318,9,"ENSG00000227722.2",0,NA,"VVVVVVUVV",1,8,0.886128364389234,110,116,133,136,144,150,200,203,"ATCATGG","CTTC","GTGGTGA","CTGA",2.4114442176297,17,8,50,84,1.74408389649748,4.45509467017387,7.99960812773081,101,"ENSG00000079974.19"
"4991","ENSG00000102595.21_214008",214000,214008,9,"ENSG00000102595.21",1,1,"MVVVVVVVV",0,8,0.90600414078675,87,93,133,136,169,175,183,186,"ATGTTGT","TTGA","TTGACAA","CTGA",2.4736972158796,40,33,8,90,1.01081312982898,4.37553197558992,7.99954853873691,101,"ENSG00000079974.19"
"7379","ENSG00000113805.9_194707",194699,194707,9,"ENSG00000113805.9",0,NA,"VVVVVVUVV",1,8,0.886128364389234,111,117,133,136,141,147,162,165,"GTTATCA","GGGA","GTGTTAA","CTGA",2.28408544740976,16,5,15,45,2.59247467372287,4.45492774744699,7.99944120500393,101,"ENSG00000079974.19"
"18443","ENSG00000157423.18_223774",223766,223774,9,"ENSG00000157423.18",0,NA,"VVVVUUVVV",2,7,0.812008281573499,113,119,133,136,145,151,161,164,"GTGAGGA","CAGT","ATCAAGA","CTGA",2.41106444237741,14,9,10,42,2.93186797411539,4.75140773082454,7.99944085711853,101,"ENSG00000079974.19"
"44024","ENSG00000276975.4_156943",156935,156943,9,"ENSG00000276975.4",0,NA,"VVVVUUVVV",2,7,0.812008281573499,113,119,133,136,145,151,161,164,"GTGAGGA","CAGT","ATCAAGA","CTGA",2.41106444237741,14,9,10,42,2.93186797411539,4.75140773082454,7.99944085711853,101,"ENSG00000079974.19"
"20329","ENSG00000164659.15_90908",90900,90908,9,"ENSG00000164659.15",1,7,"VVVVUVMVV",1,7,0.775155279503105,64,70,91,94,113,119,133,136,"CTGATGT","CTGA","TTGATAA","CTGA",2.69864185374506,21,19,14,63,1.60388603870812,4.89870793258547,7.99932905059789,101,"ENSG00000079974.19"
"27231","ENSG00000185760.18_562809",562801,562809,9,"ENSG00000185760.18",0,NA,"VVVUVVVVV",1,8,0.880745341614907,115,121,133,136,144,150,162,165,"ATGCTGA","CAGT","ATGAATA","GTGA",2.24039930561423,12,8,12,41,2.9690210902687,4.47625411525756,7.99923548171718,101,"ENSG00000079974.19"
"4602","ENSG00000101290.14_1127",1119,1127,9,"ENSG00000101290.14",1,1,"MVUVVUVVV",2,6,0.711801242236025,78,84,105,108,116,122,133,136,"GTGATCA","CTGA","GTGATGT","CTGA",2.73366421732247,21,8,11,49,2.38341259339507,5.15196017721956,7.99916514616366,101,"ENSG00000079974.19"
"16861","ENSG00000152495.11_166263",166255,166263,9,"ENSG00000152495.11",1,3,"VVMVVVVVV",0,8,0.882815734989648,88,94,133,136,142,148,160,163,"TGGATGA","GAGA","GTCATGG","CTGA",2.38913320400572,39,6,12,66,1.94391345343011,4.4678670367004,7.99912997665899,101,"ENSG00000079974.19"
"37833","ENSG00000248932.8_357536",357528,357536,9,"ENSG00000248932.8",1,8,"VVVVUVVMV",1,7,0.773913043478261,111,117,133,136,149,155,169,172,"AAGATGT","CTGA","CTCAAGA","CTGA",2.58152394190238,16,13,14,52,2.40368896102204,4.90346214342615,7.99911431733919,101,"ENSG00000079974.19"
"30544","ENSG00000205678.8_114518",114510,114518,9,"ENSG00000205678.8",1,7,"VVVVVVMVV",0,8,0.885300207039338,74,80,95,98,105,111,133,136,"AAGATAA","CTGA","GTGATAC","CTTA",2.32715251135549,15,7,22,53,2.3172294361571,4.4578948779651,7.99909570612245,101,"ENSG00000079974.19"
"6804","ENSG00000111907.21_101839",101831,101839,9,"ENSG00000111907.21",1,1,"MVVVVVVVV",0,8,0.90600414078675,109,115,133,136,143,149,169,172,"AGGAGGA","CTCC","AGGAGGA","CTGA",2.29760546556305,18,7,20,54,2.18283306324305,4.37505070841584,7.99906727156284,101,"ENSG00000079974.19"
"2654","ENSG00000077092.20_901334",901326,901334,9,"ENSG00000077092.20",1,8,"VVVVVVUMV",1,7,0.770186335403727,75,81,97,100,113,119,133,136,"GAGGTGA","CTGA","GTGAAGA","CTGA",2.59038115832841,16,13,14,52,2.40368896102204,4.91822417080285,7.99896951241776,101,"ENSG00000079974.19"
"2922","ENSG00000079332.15_3188",3180,3188,9,"ENSG00000079332.15",1,6,"VVVVVMVVV",0,8,0.902691511387163,88,94,133,136,149,155,201,204,"TTCATGA","CTGT","CTGCTGA","CTGA",2.52752825206118,39,13,46,107,0.702265649143298,4.38811349905445,7.9988795446031,101,"ENSG00000079974.19"
"7850","ENSG00000115896.16_5739",5731,5739,9,"ENSG00000115896.16",0,NA,"VVVUVVVVV",1,8,0.880745341614907,105,111,133,136,143,149,157,160,"ATGAAGA","TTGT","TTGATGA","TTGA",2.33731053144843,22,7,8,46,2.32128704944544,4.47583931477542,7.99882068123504,101,"ENSG00000079974.19"
"13922","ENSG00000143951.16_43792",43784,43792,9,"ENSG00000143951.16",1,1,"MVVVVVVVV",0,8,0.90600414078675,77,83,97,100,115,121,133,136,"ATGATGA","CTCA","TTAATGA","ATTA",2.25334357075205,14,15,12,50,2.47654932043076,4.37470994802777,7.99872651117477,101,"ENSG00000079974.19"
"46187","ENSG00000286259.1_36068",36060,36068,9,"ENSG00000286259.1",0,NA,"VVVVVUVVV",1,8,0.922153209109731,109,115,133,136,146,152,161,164,"ATGTTTG","AAGA","GTAGTGA","CTGA",2.20095571289437,18,10,9,46,2.56730584202412,4.31008598199665,7.99869881843558,101,"ENSG00000079974.19"
"12954","ENSG00000139687.16_108461",108453,108461,9,"ENSG00000139687.16",1,2,"UMVVVVVVV",1,7,0.786749482401656,113,119,133,136,145,151,164,167,"GTGTTGT","CTGA","GTAAAAA","CTGA",2.48506462310935,14,9,13,45,2.83962813440549,4.85168140545028,7.99867933505691,101,"ENSG00000079974.19"
"41836","ENSG00000259833.5_4841",4833,4841,9,"ENSG00000259833.5",1,3,"VVMVVVVVV",0,8,0.882815734989648,98,104,133,136,143,149,178,181,"TTGATGA","CTTC","TTGAATA","CTGA",2.49930708932285,29,7,29,74,1.20755818039262,4.46740136063624,7.99866430059483,101,"ENSG00000079974.19"
"8343","ENSG00000118322.14_149580",149572,149580,9,"ENSG00000118322.14",1,7,"VVVVVVMVV",0,8,0.885300207039338,91,97,104,107,114,120,133,136,"TTCATAA","CAGA","GAGACAA","CTGA",2.27943409510176,7,7,13,36,2.63343184141058,4.45741478552224,7.99861561367959,101,"ENSG00000079974.19"
"31897","ENSG00000225206.12_22572",22564,22572,9,"ENSG00000225206.12",1,5,"VVVVMVVVV",0,8,0.886542443064182,108,114,133,136,149,155,169,172,"AGGATAA","ATAA","GTGAGCA","CTGA",2.3500714572668,19,13,14,55,2.14238049638888,4.45238088620856,7.99855065846529,101,"ENSG00000079974.19"
"39518","ENSG00000253706.5_38110",38102,38110,9,"ENSG00000253706.5",0,NA,"VVUVVVVVV",1,8,0.883643892339545,115,121,133,136,168,174,186,189,"ATGGAGT","CAGA","TTGATGC","CTGA",2.3793513641704,12,32,12,65,1.99342029689749,4.46394068117504,7.99851625053322,101,"ENSG00000079974.19"
"44061","ENSG00000277258.5_4168",4160,4168,9,"ENSG00000277258.5",1,7,"VVVVVVMVV",0,8,0.885300207039338,64,70,83,86,96,102,133,136,"GGGATGA","CTGC","GTGAGGA","CTGG",2.37424101793806,13,10,31,63,2.00097704281049,4.45731262393272,7.99851345209007,101,"ENSG00000079974.19"
"44005","ENSG00000276644.5_259975",259967,259975,9,"ENSG00000276644.5",0,NA,"UVVVVVVVV",1,8,0.902691511387163,112,118,133,136,150,156,174,177,"ATTATCA","ATGC","GTTATTA","CTGA",2.30737178810817,15,14,18,56,2.16834432199952,4.38770572734683,7.99847177289549,101,"ENSG00000079974.19"
"15975","ENSG00000150471.17_687786",687778,687786,9,"ENSG00000150471.17",1,3,"VVMVVVVVV",0,8,0.882815734989648,114,120,133,136,144,150,160,163,"ATTATGA","AAGA","TTGTTTA","ATGA",2.22796413482826,13,8,10,40,3.01535129197326,4.46711138104041,7.998374320999,101,"ENSG00000079974.19"
"44288","ENSG00000280560.3_97121",97113,97121,9,"ENSG00000280560.3",1,7,"VVVVVVMVV",0,8,0.885300207039338,109,115,133,136,145,151,187,190,"GGGGTGA","CTGA","GTACTGC","CTGA",2.42513536163192,18,9,36,72,1.66105050426487,4.45715489545275,7.9983557236101,101,"ENSG00000079974.19"
"44509","ENSG00000282890.1_288335",288327,288335,9,"ENSG00000282890.1",1,8,"UVVVVVVMV",1,7,0.786749482401656,58,64,86,89,112,118,133,136,"ATGAAGA","CTGA","GTTAGGA","CTGA",2.71173008974041,22,23,15,69,1.32722243040784,4.85135575716931,7.99835368677594,101,"ENSG00000079974.19"
"1155","ENSG00000048342.18_75947",75939,75947,9,"ENSG00000048342.18",1,1,"MVVVVVVVV",0,8,0.90600414078675,99,105,133,136,141,147,193,196,"TTGATGA","GAGA","GAGTTGG","CTGA",2.47228851881241,28,5,46,88,1.01541660288313,4.37433501540814,7.99835157855514,101,"ENSG00000079974.19"
"43615","ENSG00000272865.2_18815",18807,18815,9,"ENSG00000272865.2",1,2,"VMVVVVVVV",0,8,0.884057971014493,97,103,133,136,154,160,177,180,"ATGCTGT","TTGA","GTGGTGT","CTGA",2.51015366173972,30,18,17,74,1.11396788786991,4.46208140820034,7.99831329225831,101,"ENSG00000079974.19"
"31148","ENSG00000216937.14_269309",269301,269309,9,"ENSG00000216937.14",1,2,"VMVVVVVVV",0,8,0.884057971014493,116,122,133,136,144,150,161,164,"AAGATGA","GTGC","CTGAAAA","CAGA",2.22843295540882,11,8,11,39,2.99201626321764,4.46205899148577,7.99829087554374,101,"ENSG00000079974.19"
"32293","ENSG00000226674.11_279546",279538,279546,9,"ENSG00000226674.11",1,3,"VVMVVVVVV",0,8,0.882815734989648,93,99,133,136,144,150,163,166,"AAAATGA","CTGG","TTAATAA","CTGA",2.39249301848013,34,8,13,64,1.91786292295078,4.46695409487125,7.99821703482984,101,"ENSG00000079974.19"
"17129","ENSG00000153233.13_60728",60720,60728,9,"ENSG00000153233.13",1,8,"VVVVVVVMV",0,8,0.884057971014493,81,87,104,107,112,118,133,136,"TTTATGA","CTTA","CTGAGGA","ATGA",2.30100834910459,17,5,15,46,2.50766730677879,4.46193074186902,7.99816262592699,101,"ENSG00000079974.19"
"36211","ENSG00000238290.1_93194",93186,93194,9,"ENSG00000238290.1",1,8,"VVVVVUVMV",1,7,0.806211180124224,110,116,133,136,147,153,166,169,"TTGGTGA","CTGG","ATGCAGA","CTGA",2.48746729321358,17,11,13,50,2.50997852237021,4.77327345261519,7.99811817311208,101,"ENSG00000079974.19"
"45926","ENSG00000286046.1_87577",87569,87577,9,"ENSG00000286046.1",0,NA,"VVVUVVVVV",1,8,0.880745341614907,67,73,84,87,95,101,133,136,"ATGATAA","CTCA","GTTATGA","CAGA",2.37729676817142,11,8,32,60,2.05177784119006,4.47510574058321,7.99808710704284,101,"ENSG00000079974.19"
"4285","ENSG00000100077.16_30278",30270,30278,9,"ENSG00000100077.16",1,8,"VVVVVVVMV",0,8,0.884057971014493,103,109,133,136,153,159,168,171,"ATGATCA","TTCA","TTCATGT","CTGA",2.43039424184864,24,17,9,59,1.64473836177464,4.46184166019139,7.99807354424936,101,"ENSG00000079974.19"
"39596","ENSG00000253892.1_1353",1345,1353,9,"ENSG00000253892.1",0,NA,"VVVVUUVVV",2,7,0.812008281573499,114,120,133,136,148,154,164,167,"ATGCAGA","CTGC","CTGAGGT","CTGA",2.43448528876146,13,12,10,44,2.77014281131419,4.75001118409764,7.99804431039163,101,"ENSG00000079974.19"
"19323","ENSG00000162745.11_19332",19324,19332,9,"ENSG00000162745.11",1,5,"VVVVMVVVV",0,8,0.886542443064182,81,87,105,108,115,121,133,136,"ATGTTCC","CAGA","CTTTTGA","CTGA",2.27682103744283,18,7,12,46,2.62852234995922,4.45183231656119,7.99800208881792,101,"ENSG00000079974.19"
"42332","ENSG00000261652.3_1617",1609,1617,9,"ENSG00000261652.3",1,6,"VVVVVMVVV",0,8,0.902691511387163,113,119,133,136,145,151,166,169,"ATGATGT","ATGG","TTTCTGA","GTGA",2.22218826240796,14,9,15,47,2.73434737282643,4.38723394721987,7.99799999276852,101,"ENSG00000079974.19"
"25565","ENSG00000182168.15_307936",307928,307936,9,"ENSG00000182168.15",1,6,"VVVVVMVVV",0,8,0.902691511387163,114,120,133,136,142,148,157,160,"CTGCTGA","CAGC","GTAATGA","CTGC",2.17378687813438,13,6,9,37,3.05690452077254,4.3872042604171,7.99797030596575,101,"ENSG00000079974.19"
"25366","ENSG00000181143.15_115027",115019,115027,9,"ENSG00000181143.15",1,1,"MVVUVVVVV",1,7,0.786749482401656,109,115,133,136,151,157,168,171,"GTGATGA","TTGG","GAGAAGA","CTGA",2.57966434935335,18,15,11,53,2.20611573897874,4.85096951700026,7.99796744660688,101,"ENSG00000079974.19"
"19844","ENSG00000163803.13_94645",94637,94645,9,"ENSG00000163803.13",1,6,"VVVVVMVVV",0,8,0.902691511387163,69,75,95,98,108,114,133,136,"ATAATGA","CGGA","GTCATAA","CTTA",2.3376770677369,20,10,19,58,1.96383294163372,4.38708668163659,7.99785272718525,101,"ENSG00000079974.19"
"21883","ENSG00000169282.18_196061",196053,196061,9,"ENSG00000169282.18",0,NA,"VVVUVVVVV",1,8,0.880745341614907,90,96,133,136,141,147,158,161,"GTGAGGA","GGGA","TTGCTAA","CTGA",2.39669100683298,37,5,11,62,1.92147540175052,4.47485386182594,7.99783522828556,101,"ENSG00000079974.19"
"47273","ENSG00000287916.1_90192",90184,90192,9,"ENSG00000287916.1",0,NA,"VVVUVVVVV",1,8,0.880745341614907,90,96,133,136,141,147,158,161,"GTGAGGA","GGGA","TTGCTAA","CTGA",2.39669100683298,37,5,11,62,1.92147540175052,4.47485386182594,7.99783522828556,101,"ENSG00000079974.19"
"19164","ENSG00000162378.13_71770",71762,71770,9,"ENSG00000162378.13",1,8,"VVVVVVVMV",0,8,0.884057971014493,9,15,29,32,75,81,133,136,"GTGATGG","CTCA","GTGAATT","CTGA",2.53152947795172,14,43,52,118,0.969512978512846,4.46159404121441,7.99782592527238,101,"ENSG00000079974.19"
"20478","ENSG00000164930.12_8533",8525,8533,9,"ENSG00000164930.12",0,NA,"VVVVVUVVV",1,8,0.922153209109731,116,122,133,136,186,192,220,223,"ACCATGA","CAAA","GTGATGT","CTGA",2.41297842712778,11,50,28,98,1.15022996980878,4.30918820433183,7.99780104077075,101,"ENSG00000079974.19"
"9277","ENSG00000123612.16_97914",97906,97914,9,"ENSG00000123612.16",1,6,"UVVVVMVVV",1,7,0.805383022774327,104,110,133,136,147,153,162,165,"ATTATGA","GTGA","ATGCAGC","CTGA",2.54960623330077,23,11,9,52,2.10701343603961,4.77609708117785,7.99762917227515,101,"ENSG00000079974.19"
"11913","ENSG00000136504.13_42336",42328,42336,9,"ENSG00000136504.13",1,1,"MVVVVVVVV",0,8,0.90600414078675,97,103,109,112,114,120,133,136,"ATTATTA","ATTA","CTCATTA","CTGA",2.27839314274318,6,2,13,30,2.30513208050417,4.37360492469801,7.99762148784501,101,"ENSG00000079974.19"
"26629","ENSG00000184672.12_20686",20678,20686,9,"ENSG00000184672.12",0,NA,"UVVVVVVVV",1,8,0.902691511387163,114,120,133,136,159,165,174,177,"ATAGTGA","GTGC","CTGTTGG","CTGA",2.30699547311984,13,23,9,54,2.16742420863421,4.38684850735829,7.99761455290694,101,"ENSG00000079974.19"
"27552","ENSG00000186487.21_119007",118999,119007,9,"ENSG00000186487.21",0,NA,"UVVVVVVVV",1,8,0.902691511387163,112,118,133,136,142,148,164,167,"ATGATGG","AGGA","CAGATAA","ATGA",2.23367688291482,15,6,16,46,2.65593009876324,4.38677732954884,7.9975433750975,101,"ENSG00000079974.19"
"42314","ENSG00000261638.2_2533",2525,2533,9,"ENSG00000261638.2",1,1,"MVVVVVVVV",0,8,0.90600414078675,97,103,133,136,165,171,186,189,"AAGAAGA","ATGA","GTGAAAA","CTGA",2.48581362460182,30,29,15,83,0.921989260334717,4.37352002275339,7.99753658590038,101,"ENSG00000079974.19"
"43536","ENSG00000272180.1_141850",141842,141850,9,"ENSG00000272180.1",1,1,"MVVVVVVVV",0,8,0.90600414078675,97,103,133,136,165,171,186,189,"AAGAAGA","ATGA","GTGAAAA","CTGA",2.48581362460182,30,29,15,83,0.921989260334717,4.37352002275339,7.99753658590038,101,"ENSG00000079974.19"
"7774","ENSG00000115648.14_35899",35891,35899,9,"ENSG00000115648.14",1,2,"VMUVVVVVV",1,7,0.767701863354037,106,112,133,136,142,148,166,169,"ATGATGA","GTGA","GGCATGC","CTGA",2.65149849474005,21,6,18,54,2.02975432282772,4.92660273860701,7.99741019202316,101,"ENSG00000079974.19"
"640","ENSG00000021645.20_861522",861514,861522,9,"ENSG00000021645.20",1,8,"VVVVVVVMV",0,8,0.884057971014493,115,121,133,136,158,164,180,183,"GTGGTGC","ATGG","GTGAAGA","CTGA",2.38237017423838,12,22,16,59,1.9621832532035,4.46116277036484,7.99739465442281,101,"ENSG00000079974.19"
"37281","ENSG00000246662.6_135708",135700,135708,9,"ENSG00000246662.6",1,1,"MVVVVVVVV",0,8,0.90600414078675,71,77,92,95,108,114,133,136,"ATACTGA","CTGA","GTCATGC","CTGG",2.29718762516928,15,13,19,56,2.1789172186468,4.37337534661049,7.99739190975749,101,"ENSG00000079974.19"
"23638","ENSG00000173452.14_4023",4015,4023,9,"ENSG00000173452.14",1,5,"VVVVMUVVV",1,7,0.808695652173913,95,101,133,136,143,149,157,160,"GTAATGT","CTGA","ATGAGCA","CTGA",2.5570223540407,32,7,8,56,2.00353742400158,4.76258827940157,7.99737088809722,101,"ENSG00000079974.19"
"44622","ENSG00000283167.2_24998",24990,24998,9,"ENSG00000283167.2",1,8,"VVVVVUVMV",1,7,0.806211180124224,63,69,101,104,107,113,133,136,"AGGATGA","CTGA","CTCATGC","CTGA",2.67740211762574,32,3,20,64,1.24065632002859,4.77250094271672,7.99734566321361,101,"ENSG00000079974.19"
"44658","ENSG00000283283.2_25073",25065,25073,9,"ENSG00000283283.2",1,8,"VVVVVUVMV",1,7,0.806211180124224,63,69,101,104,107,113,133,136,"AGGATGA","CTGA","CTCATGC","CTGA",2.67740211762574,32,3,20,64,1.24065632002859,4.77250094271672,7.99734566321361,101,"ENSG00000079974.19"
"32973","ENSG00000228395.3_7439",7431,7439,9,"ENSG00000228395.3",0,NA,"VVVVUVVVV",1,8,0.889855072463768,89,95,133,136,145,151,163,166,"GTGAAGG","CTGT","GTGGAGC","CTGA",2.37600309422868,38,9,12,68,1.91160872787052,4.43790733901543,7.9973276288705,101,"ENSG00000079974.19"
"17616","ENSG00000154645.14_321759",321751,321759,9,"ENSG00000154645.14",1,1,"MVVVVVVVV",0,8,0.90600414078675,115,121,133,136,151,157,173,176,"ATGAAAA","CCAA","ATAATCA","CTGA",2.27703972299173,12,15,16,52,2.31279323573076,4.37326451391891,7.9972810770659,101,"ENSG00000079974.19"
"6643","ENSG00000111218.12_170625",170617,170625,9,"ENSG00000111218.12",0,NA,"VVVVVUVVV",1,8,0.922153209109731,112,118,133,136,153,159,168,171,"AAGAAGA","CAAA","AGGCTGG","CTGA",2.23462442695612,15,17,9,50,2.33699300389704,4.30862229590112,7.99723513234005,101,"ENSG00000079974.19"
"33954","ENSG00000231646.6_130661",130653,130661,9,"ENSG00000231646.6",1,1,"MVVVVVVVV",0,8,0.90600414078675,113,119,133,136,140,146,157,160,"AGGATGC","TGGA","GTGATTA","CTTA",2.19674992257585,14,4,11,38,2.84726313322388,4.37306565426573,7.99708221741272,101,"ENSG00000079974.19"
"19252","ENSG00000162620.16_161532",161524,161532,9,"ENSG00000162620.16",1,8,"VVVVVVVMV",0,8,0.884057971014493,62,68,99,102,111,117,133,136,"GTGATGT","CTGA","GTGGGAA","ATGA",2.41532196262701,31,9,16,65,1.74116593684398,4.46082808858934,7.99705997264731,101,"ENSG00000079974.19"
"2831","ENSG00000078328.23_2357052",2357044,2357052,9,"ENSG00000078328.23",0,NA,"VVUVVVVVV",1,8,0.883643892339545,100,106,133,136,143,149,168,171,"ATGATTT","CTTG","GTGTTGA","CTGA",2.42574504134216,27,7,19,62,1.677906236562,4.46238496137744,7.99696053073561,101,"ENSG00000079974.19"
"22250","ENSG00000170035.16_91283",91275,91283,9,"ENSG00000170035.16",1,2,"VMVVVVVVV",0,8,0.884057971014493,107,113,133,136,145,151,178,181,"ATGGTCA","CTGG","ATGAGCA","CTGA",2.42974875957762,20,9,27,65,1.64450090145942,4.46070649132755,7.99693837538552,101,"ENSG00000079974.19"
"25230","ENSG00000180071.21_30680",30672,30680,9,"ENSG00000180071.21",1,1,"MVVVVVVVV",0,8,0.90600414078675,109,115,133,136,170,176,190,193,"GGGAAGA","CAGA","GTTTTGA","CTGA",2.38937295289039,18,34,14,75,1.56182929254496,4.37274557795355,7.99676214110055,101,"ENSG00000079974.19"
"33608","ENSG00000230453.11_30185",30177,30185,9,"ENSG00000230453.11",1,1,"MVVVVVVVV",0,8,0.90600414078675,109,115,133,136,170,176,190,193,"GGGAAGA","CAGA","GTTTTGA","CTGA",2.38937295289039,18,34,14,75,1.56182929254496,4.37274557795355,7.99676214110055,101,"ENSG00000079974.19"
"46971","ENSG00000287424.1_57301",57293,57301,9,"ENSG00000287424.1",1,8,"VVVVVVVMV",0,8,0.884057971014493,110,116,133,136,140,146,155,158,"ACGAAGA","TAGA","GAGACAA","CTGA",2.28086584244296,17,4,9,39,2.63618549034849,4.46048944332539,7.99672132738336,101,"ENSG00000079974.19"
"2716","ENSG00000077585.14_78520",78512,78520,9,"ENSG00000077585.14",1,1,"MVVVVVVVV",0,8,0.90600414078675,113,119,133,136,163,169,182,185,"ATAATAA","TTAA","GTTAGGA","CTGA",2.32799574644079,14,27,13,63,1.97060328656144,4.372643732375,7.996660295522,101,"ENSG00000079974.19"
"43618","ENSG00000272886.6_11155",11147,11155,9,"ENSG00000272886.6",1,1,"MVVVVVVVV",0,8,0.90600414078675,110,116,133,136,141,147,179,182,"ATTATAA","CAGC","GTGAAAA","CTGA",2.35704866346038,17,5,32,63,1.77680162597846,4.37261484559525,7.99663140874225,101,"ENSG00000079974.19"
"4986","ENSG00000102572.15_63657",63649,63657,9,"ENSG00000102572.15",1,2,"UMVVVVVVV",1,7,0.786749482401656,79,85,99,102,111,117,133,136,"CTGATGA","GTCA","TTGGGGA","CTGA",2.50855094185006,14,9,16,48,2.67484456445411,4.84962937753029,7.99662730713691,101,"ENSG00000079974.19"
"28945","ENSG00000196782.13_92449",92441,92449,9,"ENSG00000196782.13",1,5,"VVVVMVVVV",0,8,0.886542443064182,112,118,133,136,177,183,195,198,"ATGAAGT","TTGG","ATGAAAA","CTGA",2.3892371764147,15,41,12,77,1.8735695791074,4.45045435546802,7.99662412772475,101,"ENSG00000079974.19"
"4316","ENSG00000100154.15_533987",533979,533987,9,"ENSG00000100154.15",1,6,"VVVVVMVVV",0,8,0.902691511387163,89,95,107,110,115,121,133,136,"ATGAGGT","TTGA","GTTAGTA","CTTA",2.18906760283829,12,5,12,38,2.94950207693477,4.38582152396418,7.99658756951283,101,"ENSG00000079974.19"
"41143","ENSG00000258583.7_173347",173339,173347,9,"ENSG00000258583.7",0,NA,"UVVVVUVVV",2,7,0.824844720496894,114,120,133,136,139,145,159,162,"GTGAGGG","CTGT","ATGAGGG","CTGA",2.42640101331926,13,3,14,39,2.61265716166711,4.69716597928221,7.99654486126979,101,"ENSG00000079974.19"
"47356","ENSG00000288035.1_175469",175461,175469,9,"ENSG00000288035.1",1,5,"VVVVMVVVV",0,8,0.886542443064182,112,118,133,136,156,162,171,174,"AATATGT","GTGA","ATGACTA","CTGA",2.3422788238518,15,20,9,53,2.18627959285558,4.45036793796689,7.99653771022362,101,"ENSG00000079974.19"
"1738","ENSG00000065809.14_221724",221716,221724,9,"ENSG00000065809.14",1,1,"MVVVVVVVV",0,8,0.90600414078675,37,43,59,62,71,77,133,136,"ATGATGT","CTGT","ATAATTA","TTGA",2.35514531598845,16,9,56,90,1.78902839245381,4.37249929142753,7.99651585457453,101,"ENSG00000079974.19"
"10127","ENSG00000129514.8_6230",6222,6230,9,"ENSG00000129514.8",1,1,"MVVVVVVVV",0,8,0.90600414078675,105,111,133,136,148,154,162,165,"ATAATGA","GTGA","GTAAAGT","TTGA",2.31096553673289,22,12,8,51,2.08350312771049,4.37248500981578,7.99650157296277,101,"ENSG00000079974.19"
"1978","ENSG00000068654.17_69872",69864,69872,9,"ENSG00000068654.17",1,8,"VVVUVVVMV",1,7,0.764803312629399,113,119,133,136,181,187,195,198,"GAGATGA","CTGA","ATGAAAA","CTGA",2.67033660998684,14,45,8,76,1.94664602941081,4.93722252399743,7.99643577451503,101,"ENSG00000079974.19"
"477","ENSG00000012983.12_82843",82835,82843,9,"ENSG00000012983.12",1,1,"MVVVVVVVV",0,8,0.90600414078675,87,93,133,136,142,148,158,161,"ATGATAA","AAGA","GTGATAA","ATGA",2.32564236395717,40,6,10,65,1.98518518883741,4.37236690380464,7.99638346695164,101,"ENSG00000079974.19"
"28022","ENSG00000187957.8_70576",70568,70576,9,"ENSG00000187957.8",1,6,"VVVVVMUVV",1,7,0.788819875776397,67,73,84,87,96,102,133,136,"ATCATGA","CTGT","ATGAGGC","CTGA",2.59972946703762,11,9,31,60,2.03252168717155,4.84101286685559,7.99629236996118,101,"ENSG00000079974.19"
"21194","ENSG00000166788.10_32838",32830,32838,9,"ENSG00000166788.10",0,NA,"VVVVUVUVV",2,7,0.775983436853002,99,105,133,136,144,150,162,165,"ATGCTGA","CTTA","ATGATCA","CTGA",2.63197660753845,28,8,12,57,2.02265978189431,4.89229262470432,7.99622637211633,101,"ENSG00000079974.19"
"47076","ENSG00000287612.1_16561",16553,16561,9,"ENSG00000287612.1",0,NA,"UVVVVVVVV",1,8,0.902691511387163,57,63,69,72,77,83,133,136,"GTGATGA","GTGA","ATCACGA","CTTA",2.41807473866721,6,5,50,70,1.42129647875494,4.38544868413408,7.99621472968274,101,"ENSG00000079974.19"
"18638","ENSG00000157985.20_270452",270444,270452,9,"ENSG00000157985.20",1,2,"VMVVVVVVV",0,8,0.884057971014493,114,120,133,136,152,158,175,178,"TTGGTGA","GTTA","ATCAGGA","CTGA",2.34865938721622,13,16,17,55,2.18190973503158,4.45990974578493,7.9961416298429,101,"ENSG00000079974.19"
"4493","ENSG00000100722.20_46228",46220,46228,9,"ENSG00000100722.20",0,NA,"VVVUVVVVV",1,8,0.880745341614907,111,117,133,136,166,172,224,227,"GTGATGG","CTTA","TTGAATA","CTGA",2.55028338909064,16,30,52,107,0.890575301856795,4.47311614061527,7.9960975070749,101,"ENSG00000079974.19"
"47867","ENSG00000289535.2_1129",1121,1129,9,"ENSG00000289535.2",1,8,"VVVVVVVMV",0,8,0.884057971014493,75,81,93,96,100,106,133,136,"GTTATAA","CTGG","ATGTTTA","CTGA",2.36965230770938,12,4,27,52,2.04177102644943,4.45986326946132,7.99609515351929,101,"ENSG00000079974.19"
"12376","ENSG00000138028.17_3423",3415,3423,9,"ENSG00000138028.17",0,NA,"VVUVVUVVV",2,7,0.805797101449275,91,97,133,136,145,151,181,184,"AAGATGA","TTGA","GTGAAGA","CTGA",2.70119893248682,36,9,30,84,1.08332600777952,4.77282972275625,7.99601812855335,101,"ENSG00000079974.19"
"25324","ENSG00000180817.12_16433",16425,16433,9,"ENSG00000180817.12",1,7,"VVVVVVMVV",0,8,0.885300207039338,51,57,79,82,92,98,133,136,"GTTATAA","CTGA","CTGTTCA","CTGA",2.47960605056362,22,10,35,76,1.28830070795606,4.45475192792838,7.99595275608573,101,"ENSG00000079974.19"
"13484","ENSG00000141564.16_298674",298666,298674,9,"ENSG00000141564.16",0,NA,"VVVVVUVVV",1,8,0.922153209109731,109,115,133,136,156,162,181,184,"ATGATTC","CGGG","GTGTTAA","CTGA",2.35633569317392,18,20,19,66,1.51963979964971,4.3071361052023,7.99574894164122,101,"ENSG00000079974.19"
"2140","ENSG00000070729.14_45135",45127,45135,9,"ENSG00000070729.14",0,NA,"UVVVVVVVV",1,8,0.902691511387163,111,117,133,136,184,190,202,205,"ATGAAGG","ATCA","CTGAGGT","CTGA",2.36136460067481,16,48,12,85,1.79731727550029,4.38493698666643,7.99570303221508,101,"ENSG00000079974.19"
"17652","ENSG00000154678.18_184899",184891,184899,9,"ENSG00000154678.18",0,NA,"VVVVVUVVV",1,8,0.922153209109731,59,65,80,83,113,119,133,136,"ATGAGCA","CTGA","GTGCTCA","CTGT",2.30945246871279,15,30,14,68,1.83189334810599,4.30706078488115,7.99567362132007,101,"ENSG00000079974.19"
"43008","ENSG00000267586.7_294466",294458,294466,9,"ENSG00000267586.7",1,1,"MVVVVUVVV",1,7,0.82815734989648,91,97,107,110,115,121,133,136,"GTGATGA","CAAA","ATGATTA","CTGC",2.3731016243496,10,5,12,36,2.9113933483765,4.68301771101013,7.99564711059605,101,"ENSG00000079974.19"
"15877","ENSG00000149972.12_880808",880800,880808,9,"ENSG00000149972.12",1,8,"VVVVVVVMV",0,8,0.884057971014493,115,121,133,136,137,143,151,154,"TTAATAA","GTGA","ATTAAAA","CTGA",2.27373344581674,12,1,8,30,2.67934450310494,4.45939186880414,7.99562375286211,101,"ENSG00000079974.19"
"42546","ENSG00000264151.6_167454",167446,167454,9,"ENSG00000264151.6",1,1,"MVVVVVVVV",0,8,0.90600414078675,68,74,91,94,107,113,133,136,"TAGATGA","GTGA","GTGCTGA","ATGA",2.3281348659005,17,13,20,59,1.9655285569814,4.37160691574618,7.99562347889318,101,"ENSG00000079974.19"
"3822","ENSG00000089177.19_118804",118796,118804,9,"ENSG00000089177.19",1,1,"MVVVVVVVV",0,8,0.90600414078675,89,95,133,136,168,174,187,190,"CTGATGA","CTAC","ATTATTA","CTGA",2.47934689033296,38,32,13,92,0.957408526272266,4.37159694878966,7.99561351193666,101,"ENSG00000079974.19"
"17646","ENSG00000154655.16_61742",61734,61742,9,"ENSG00000154655.16",1,2,"VMVVVVVVV",0,8,0.884057971014493,114,120,133,136,143,149,158,161,"ACAAAGA","TTTA","TTGCTGA","CTGA",2.217514658166,13,7,9,38,3.05406504890221,4.45937402583555,7.99560590989352,101,"ENSG00000079974.19"
"5125","ENSG00000103274.11_15399",15391,15399,9,"ENSG00000103274.11",1,1,"MVVVVVVVV",0,8,0.90600414078675,105,111,133,136,143,149,163,166,"ATGCCGG","CTGG","CTGGTGG","CTGA",2.29163519170487,22,7,14,52,2.20865977333057,4.37155692950743,7.99557349265443,101,"ENSG00000079974.19"
"7292","ENSG00000113448.20_626246",626238,626246,9,"ENSG00000113448.20",1,1,"MVVVVVVVV",0,8,0.90600414078675,116,122,133,136,145,151,166,169,"TTCATGA","AGGA","GTGGTGA","TTGA",2.21024461958864,11,9,15,44,2.75117389582503,4.37153450660398,7.99555106975098,101,"ENSG00000079974.19"
"46693","ENSG00000287054.1_3634",3626,3634,9,"ENSG00000287054.1",0,NA,"VVVVUVVVV",1,8,0.889855072463768,69,75,94,97,106,112,133,136,"AAGAAGA","TTGA","ATTCTGG","CTGA",2.36352023844345,19,9,21,58,1.98769968335267,4.43612531824392,7.99554560809899,101,"ENSG00000079974.19"
"13652","ENSG00000143061.18_41439",41431,41439,9,"ENSG00000143061.18",1,2,"UMVVVVVVV",1,7,0.786749482401656,83,89,100,103,115,121,133,136,"CTGAGGA","ATGA","ATGTTTA","CTGA",2.50299161769725,11,12,12,44,2.70740943193863,4.84850505414674,7.99550298375337,101,"ENSG00000079974.19"
"30042","ENSG00000198963.11_179859",179851,179859,9,"ENSG00000198963.11",0,NA,"UVVVVVVVV",1,8,0.902691511387163,113,119,133,136,175,181,210,213,"ATGATCA","CAGC","AGGAAGA","CTGA",2.46245818157059,14,39,29,91,1.12195823877639,4.38458652897841,7.99535257452707,101,"ENSG00000079974.19"
"32625","ENSG00000227345.9_23301",23293,23301,9,"ENSG00000227345.9",0,NA,"UVVVVUVVV",2,7,0.824844720496894,110,116,133,136,144,150,197,200,"ATGATGT","TTGA","AAGTTCA","CTGA",2.55561961331232,17,8,47,81,1.74642084793525,4.69597123417101,7.99535011615859,101,"ENSG00000079974.19"
"27965","ENSG00000187720.15_577948",577940,577948,9,"ENSG00000187720.15",1,2,"VMVVUVVVV",1,7,0.773913043478261,115,121,133,136,142,148,167,170,"GTGCTGA","CTGG","TTGATCA","CTGA",2.55529264988642,12,6,19,46,2.5633594974395,4.8996609575039,7.99531313141694,101,"ENSG00000079974.19"
"37980","ENSG00000249306.7_30507",30499,30507,9,"ENSG00000249306.7",1,8,"VVUVVVVMV",1,7,0.767701863354037,112,118,133,136,147,153,170,173,"CTGAGGA","CAGA","GTGACGA","CTGA",2.58828034431498,15,11,17,52,2.44247399365069,4.92441907227097,7.99522652568712,101,"ENSG00000079974.19"
"6039","ENSG00000107798.18_144264",144256,144264,9,"ENSG00000107798.18",1,2,"VMVVVVVVV",0,8,0.884057971014493,83,89,133,136,172,178,192,195,"ATGATGT","TTGC","ATGAAGG","CTGA",2.54216846660867,44,36,14,103,0.888158156406695,4.45898698344946,7.99521886750743,101,"ENSG00000079974.19"
"10878","ENSG00000133026.14_84817",84809,84817,9,"ENSG00000133026.14",1,8,"VVVVVVVMV",0,8,0.884057971014493,116,122,133,136,157,163,173,176,"ACTATGT","CAGA","ATGTTCA","CTGA",2.34334552770585,11,21,10,51,2.21362879871143,4.45898307918761,7.99521496324558,101,"ENSG00000079974.19"
"22006","ENSG00000169570.10_978",970,978,9,"ENSG00000169570.10",1,8,"VVVVVVVMV",0,8,0.884057971014493,108,114,133,136,179,185,193,196,"GTAATTA","GTGA","GTCATGA","CTGA",2.44122096465174,19,43,8,79,1.5609789554188,4.45894634660759,7.99517823066556,101,"ENSG00000079974.19"
"34857","ENSG00000234281.5_137704",137696,137704,9,"ENSG00000234281.5",1,1,"MVVVVVUVV",1,7,0.792132505175983,75,81,98,101,111,117,133,136,"ATGATGC","CTAA","AGGAGAA","CTGA",2.53410956071625,17,10,16,52,2.41201664847038,4.82652009664468,7.99505011734861,101,"ENSG00000079974.19"
"7630","ENSG00000115233.12_18853",18845,18853,9,"ENSG00000115233.12",1,8,"UVVVVVVMV",1,7,0.786749482401656,115,121,133,136,142,148,195,198,"AGGATGA","CTGG","GTGTTGG","CTGA",2.61052269909582,12,6,47,74,1.988723794868,4.8480521138767,7.99505004348333,101,"ENSG00000079974.19"
"43208","ENSG00000269994.3_12270",12262,12270,9,"ENSG00000269994.3",1,3,"UVMVVVVVV",1,7,0.785507246376811,84,90,133,136,151,157,171,174,"ATGATGA","CTGG","GTGGGAA","CTGA",2.69790098687549,43,15,14,81,1.42568872437903,4.85292382588723,7.99495281139448,101,"ENSG00000079974.19"
"4766","ENSG00000101868.13_183326",183318,183326,9,"ENSG00000101868.13",1,6,"VVVVVMVVV",0,8,0.902691511387163,111,117,133,136,146,152,167,170,"CTGATTA","TTGA","GTCTTGA","CTTA",2.24736161712428,16,10,15,50,2.553965310048,4.38409402271913,7.99486006826778,101,"ENSG00000079974.19"
"41939","ENSG00000260086.5_121907",121899,121907,9,"ENSG00000260086.5",1,7,"VVVVVVMVV",0,8,0.885300207039338,71,77,108,111,115,121,133,136,"CTGATGT","CTGA","AGGAAGA","CTGG",2.39796617806939,31,4,12,56,1.82789698629505,4.45358454335608,7.99478537151343,101,"ENSG00000079974.19"
"6702","ENSG00000111596.14_85441",85433,85441,9,"ENSG00000111596.14",0,NA,"VVVVVUVVV",1,8,0.922153209109731,104,110,133,136,167,173,183,186,"TTGATGA","CTAA","GAGAGGA","CAGA",2.38635585110761,23,31,10,73,1.3154548596818,4.30612346676646,7.99473630320539,101,"ENSG00000079974.19"
"15294","ENSG00000147642.17_29881",29873,29881,9,"ENSG00000147642.17",1,7,"VVVVVVMVV",0,8,0.885300207039338,115,121,133,136,141,147,161,164,"AGAATGA","CTGA","AAGAGAA","CAGA",2.24667852255295,12,5,14,40,2.83609251362198,4.45348733266041,7.99468816081776,101,"ENSG00000079974.19"
"20729","ENSG00000165471.7_339",331,339,9,"ENSG00000165471.7",1,8,"VVVVVUVMV",1,7,0.806211180124224,93,99,133,136,144,150,158,161,"CTGCTGA","CTGA","ATGAAAG","CTGA",2.56506000972744,34,8,8,59,1.97887941397964,4.76981986970731,7.99466459020421,101,"ENSG00000079974.19"
"39569","ENSG00000253819.3_97344",97336,97344,9,"ENSG00000253819.3",1,8,"VVVVVVVMV",0,8,0.884057971014493,111,117,133,136,154,160,168,171,"CTGTTGT","CATA","GTGATGC","CTGA",2.34635933555329,16,18,8,51,2.19128641146447,4.45842049545493,7.9946523795129,101,"ENSG00000079974.19"
"24490","ENSG00000176571.13_406975",406967,406975,9,"ENSG00000176571.13",0,NA,"VVVVUVVVV",1,8,0.889855072463768,115,121,133,136,175,181,195,198,"ACGATTA","CAAA","ATGCTGA","CTGA",2.37904444021214,12,39,14,74,1.88054781757821,4.43521102141479,7.99463131126986,101,"ENSG00000079974.19"
"21272","ENSG00000166960.17_113817",113809,113817,9,"ENSG00000166960.17",1,1,"MVVVVVVVV",0,8,0.90600414078675,112,118,133,136,141,147,158,161,"ATTATTA","ATGA","CTGATAC","ATGA",2.19337336355491,15,5,11,40,2.85983504323997,4.37058103340151,7.99459759654851,101,"ENSG00000079974.19"
"40521","ENSG00000256806.6_39767",39759,39767,9,"ENSG00000256806.6",1,1,"MVVVVVVVV",0,8,0.90600414078675,116,122,133,136,183,189,202,205,"ATGAAGT","GAGA","GAGAAGT","CTGA",2.33800125651483,11,47,13,80,1.89561162410058,4.37057166688319,7.99458823003019,101,"ENSG00000079974.19"
"48073","ENSG00000290366.1_34495",34487,34495,9,"ENSG00000290366.1",1,1,"MVVVVVVVV",0,8,0.90600414078675,116,122,133,136,183,189,202,205,"ATGAAGT","GAGA","GAGAAGT","CTGA",2.33800125651483,11,47,13,80,1.89561162410058,4.37057166688319,7.99458823003019,101,"ENSG00000079974.19"
"39376","ENSG00000253535.5_32430",32422,32430,9,"ENSG00000253535.5",1,3,"VVMVVVVVV",0,8,0.882815734989648,89,95,133,136,149,155,181,184,"GTGATGA","ATAA","GTGTAAA","CTGA",2.53793355410253,38,13,26,86,0.933541259226689,4.46327457164421,7.99453751160281,101,"ENSG00000079974.19"
"38983","ENSG00000251372.7_286836",286828,286836,9,"ENSG00000251372.7",1,8,"VVVVVVVMV",0,8,0.884057971014493,112,118,133,136,149,155,176,179,"ATTATGA","CAGA","ATGATTT","ATGA",2.36536297374853,15,13,21,58,2.06391495686817,4.45825036213126,7.99448224618923,101,"ENSG00000079974.19"
"36084","ENSG00000237874.2_3186",3178,3186,9,"ENSG00000237874.2",1,7,"VVVVVVMVV",0,8,0.885300207039338,92,98,133,136,146,152,162,165,"ATTATCA","CAGA","ATGGTTT","CTGA",2.38584139115928,35,10,10,64,1.90678761505725,4.45309922236312,7.99430005052047,101,"ENSG00000079974.19"
"16976","ENSG00000152910.19_219831",219823,219831,9,"ENSG00000152910.19",0,NA,"VVVVVVUVV",1,8,0.886128364389234,90,96,106,109,115,121,133,136,"ATAATGG","CAGA","AGGAAGA","CTGG",2.2288543825381,10,6,12,37,2.94002531109953,4.44976363200505,7.99427708956199,101,"ENSG00000079974.19"
"47119","ENSG00000287694.1_219821",219813,219821,9,"ENSG00000287694.1",0,NA,"VVVVVVUVV",1,8,0.886128364389234,90,96,106,109,115,121,133,136,"ATAATGG","CAGA","AGGAAGA","CTGG",2.2288543825381,10,6,12,37,2.94002531109953,4.44976363200505,7.99427708956199,101,"ENSG00000079974.19"
"30359","ENSG00000204740.11_473548",473540,473548,9,"ENSG00000204740.11",1,1,"MVUVVVVVV",1,7,0.789648033126294,81,87,99,102,116,122,133,136,"ATGATTT","CTGA","ATACTGG","CTGA",2.50943865751779,12,14,11,46,2.61284691321392,4.83560949083312,7.9942016233383,101,"ENSG00000079974.19"
"36503","ENSG00000241472.8_136118",136110,136118,9,"ENSG00000241472.8",0,NA,"VVVVUVVVV",1,8,0.889855072463768,89,95,133,136,148,154,167,170,"ATGAGGA","CAGA","TTGAGGA","CTGG",2.40765303166358,38,12,13,72,1.68796100027924,4.43474530284245,7.99416559269752,101,"ENSG00000079974.19"
"41303","ENSG00000258785.7_84942",84934,84942,9,"ENSG00000258785.7",1,1,"MVVVVVVVV",0,8,0.90600414078675,110,116,133,136,140,146,156,159,"TGGATGA","AAGA","ATGAAGA","CTGG",2.22819195142648,17,4,10,40,2.6258528981385,4.3701164769121,7.9941330400591,101,"ENSG00000079974.19"
"35863","ENSG00000237356.7_581171",581163,581171,9,"ENSG00000237356.7",1,8,"VVVVVUVMV",1,7,0.806211180124224,115,121,133,136,173,179,189,192,"AAGATGG","CAGA","GTGCTGA","CTGA",2.55950750390223,12,37,10,68,2.01356284532824,4.76923655116911,7.99408127166601,101,"ENSG00000079974.19"
"3192","ENSG00000082074.19_48075",48067,48075,9,"ENSG00000082074.19",1,5,"VVVVMUVVV",1,7,0.808695652173913,79,85,102,105,115,121,133,136,"ATGAAGT","ATGC","GTGAAGA","CTGA",2.463607483048,17,10,12,48,2.6131047904488,4.75928866935886,7.99407127805451,101,"ENSG00000079974.19"
"27814","ENSG00000187391.22_649573",649565,649573,9,"ENSG00000187391.22",1,2,"VMVVVVVVV",0,8,0.884057971014493,115,121,133,136,140,146,156,159,"TTGCTGT","ATTA","ATTATTA","CTGA",2.22924244608675,12,4,10,35,2.9695409736259,4.45778932021773,7.9940212042757,101,"ENSG00000079974.19"
"16","ENSG00000001461.17_33271",33263,33271,9,"ENSG00000001461.17",1,6,"VVVVVMVVV",0,8,0.902691511387163,84,90,133,136,166,172,183,186,"ATGCTGA","CAAA","GTCAAGA","CTGA",2.47430749834791,43,30,11,93,1.03738593436371,4.38319231417077,7.99395835971942,101,"ENSG00000079974.19"
"32083","ENSG00000225882.1_112483",112475,112483,9,"ENSG00000225882.1",1,8,"VVVVVUVMV",1,7,0.806211180124224,90,96,133,136,144,150,161,164,"GTCATGA","CTCA","CTGATCA","CTGA",2.56494490643595,37,8,11,65,1.97666123580486,4.76907348634447,7.99391820684137,101,"ENSG00000079974.19"
"25014","ENSG00000179133.15_29566",29558,29566,9,"ENSG00000179133.15",0,NA,"VVVVVUVVV",1,8,0.922153209109731,59,65,75,78,82,88,133,136,"ATGTTCA","CTGA","ATGAATA","ATGA",2.31850293117495,10,4,45,68,1.76438313163231,4.30526733486633,7.99388017130525,101,"ENSG00000079974.19"
"38325","ENSG00000249988.1_70140",70132,70140,9,"ENSG00000249988.1",1,5,"UVVVMVVVV",1,7,0.789233954451346,63,69,78,81,94,100,133,136,"TTGATGA","CTGG","GTGAGTA","CTGA",2.66117274487201,9,13,33,64,1.60631912586201,4.83686768958553,7.99380350739091,101,"ENSG00000079974.19"
"46682","ENSG00000287042.3_97646",97638,97646,9,"ENSG00000287042.3",0,NA,"VVVVVUVVV",1,8,0.922153209109731,111,117,133,136,150,156,165,168,"TTGATGA","CTTG","CTTTTGA","CTGC",2.21391694490971,16,14,9,48,2.46115777463775,4.30515101850895,7.99376385494787,101,"ENSG00000079974.19"
"10873","ENSG00000133026.14_12724",12716,12724,9,"ENSG00000133026.14",1,1,"MVVVVVVVV",0,8,0.90600414078675,88,94,133,136,175,181,190,193,"ATGATGT","TTGT","AATATGA","CTGA",2.47036259863181,39,39,9,96,1.00980566927583,4.36972241503864,7.99373897818564,101,"ENSG00000079974.19"
"26328","ENSG00000183850.14_52861",52853,52861,9,"ENSG00000183850.14",0,NA,"VVVVVUUVV",2,7,0.808281573498965,85,91,102,105,112,118,133,136,"GTGAAGG","GTGA","ATGAATA","CTGA",2.43497144148708,11,7,15,42,2.80930442936659,4.76061184315344,7.9937381371493,101,"ENSG00000079974.19"
"43080","ENSG00000268105.1_2406",2398,2406,9,"ENSG00000268105.1",0,NA,"VVVVVUUVV",2,7,0.808281573498965,85,91,102,105,112,118,133,136,"GTGAAGG","GTGA","ATGAATA","CTGA",2.43497144148708,11,7,15,42,2.80930442936659,4.76061184315344,7.9937381371493,101,"ENSG00000079974.19"
"30534","ENSG00000205629.12_52692",52684,52692,9,"ENSG00000205629.12",0,NA,"VVVVVUVVV",1,8,0.922153209109731,106,112,133,136,139,145,167,170,"CTGCTCA","CGGA","GTGACGG","CTGA",2.35529647411777,21,3,22,55,1.51831074117186,4.30507180882258,7.99368464526151,101,"ENSG00000079974.19"
"6822","ENSG00000111961.19_44274",44266,44274,9,"ENSG00000111961.19",1,8,"VVVVVUVMV",1,7,0.806211180124224,116,122,133,136,141,147,190,193,"ATGATTA","CTCA","ATGCTGG","CTGA",2.57367695358543,11,5,43,68,1.917399533707,4.76881147273581,7.9936561932327,101,"ENSG00000079974.19"
"2633","ENSG00000077092.20_170315",170307,170315,9,"ENSG00000077092.20",0,NA,"UVVVVVVVV",1,8,0.902691511387163,115,121,133,136,141,147,190,193,"TTTATTA","ATGA","AAGAAGA","CTGA",2.33829328757461,12,5,43,69,1.9427564988388,4.38284460400071,7.99361064954936,101,"ENSG00000079974.19"
"22588","ENSG00000170921.16_313348",313340,313348,9,"ENSG00000170921.16",1,8,"VVVVVVVMV",0,8,0.884057971014493,109,115,133,136,142,148,161,164,"CTGATCT","CTAA","GCTAGGA","CTGA",2.28840972140976,18,6,13,46,2.57340124586314,4.45736651381538,7.99359839787335,101,"ENSG00000079974.19"
"43521","ENSG00000272168.10_278541",278533,278541,9,"ENSG00000272168.10",1,1,"MVUVVVVVV",1,7,0.789648033126294,116,122,133,136,141,147,161,164,"CTGGTGA","CAGA","TTGACTA","CTGA",2.47761580274448,11,5,14,39,2.82242244801047,4.83496528324341,7.99355741574859,101,"ENSG00000079974.19"
"23209","ENSG00000172318.6_44792",44784,44792,9,"ENSG00000172318.6",0,NA,"VVUVVVVVV",1,8,0.883643892339545,47,53,64,67,73,79,133,136,"ATTCTGA","CTTA","ATGTAAA","CTGA",2.38143569745052,11,6,54,80,1.95951595388783,4.45893848422282,7.993514053581,101,"ENSG00000079974.19"
"32895","ENSG00000228222.1_44622",44614,44622,9,"ENSG00000228222.1",0,NA,"VVUVVVVVV",1,8,0.883643892339545,47,53,64,67,73,79,133,136,"ATTCTGA","CTTA","ATGTAAA","CTGA",2.38143569745052,11,6,54,80,1.95951595388783,4.45893848422282,7.993514053581,101,"ENSG00000079974.19"
"18076","ENSG00000156110.15_188430",188422,188430,9,"ENSG00000156110.15",1,8,"UVVVVVVMV",1,7,0.786749482401656,85,91,133,136,141,147,162,165,"ATGATGG","ATGA","ATGAACA","CTGA",2.64550667377309,42,5,15,71,1.74923029475855,4.84648536331145,7.99348329291807,101,"ENSG00000079974.19"
"31857","ENSG00000225087.2_101434",101426,101434,9,"ENSG00000225087.2",1,1,"MVVVVVVVV",0,8,0.90600414078675,109,115,133,136,146,152,177,180,"TTGTTGA","CTTC","TTGAAAA","CTGA",2.34601644864689,18,10,25,62,1.83759269958926,4.36942558930879,7.99344215245579,101,"ENSG00000079974.19"
"18857","ENSG00000158966.16_22687",22679,22687,9,"ENSG00000158966.16",1,1,"MVVVVVUVV",1,7,0.792132505175983,115,121,133,136,147,153,161,164,"ATGTTGA","CAGG","TTGAAAA","CTGA",2.46758469335644,12,11,8,40,2.84852128879153,4.82477147779195,7.99330149849589,101,"ENSG00000079974.19"
"30798","ENSG00000213639.11_21695",21687,21695,9,"ENSG00000213639.11",1,8,"UVVVVVVMV",1,7,0.786749482401656,113,119,133,136,144,150,159,162,"GTGGTGA","CTGG","GTTAGAA","CTGA",2.46041463628707,14,8,9,40,2.98227872674073,4.84626074216364,7.99325867177026,101,"ENSG00000079974.19"
"15421","ENSG00000148219.18_124761",124753,124761,9,"ENSG00000148219.18",0,NA,"VVVVVUVVV",1,8,0.922153209109731,107,113,133,136,150,156,171,174,"AAAATAA","CAGA","AGGAAGA","CTGA",2.29325099509985,20,14,15,58,1.93023577367234,4.30464393525117,7.99325677169009,101,"ENSG00000079974.19"
"44847","ENSG00000283765.1_55873",55865,55873,9,"ENSG00000283765.1",1,1,"MVVVVUVVV",1,7,0.82815734989648,115,121,133,136,146,152,160,163,"ATTAAGA","GTGA","ATTCAGA","CTGA",2.36986672844658,12,10,8,39,2.92332041146315,4.68060798361009,7.99323738319601,101,"ENSG00000079974.19"
"5236","ENSG00000104059.5_189370",189362,189370,9,"ENSG00000104059.5",0,NA,"VVVVUVUVV",2,7,0.775983436853002,109,115,133,136,141,147,157,160,"ATGCTGA","CTGT","CTCATGG","CTGA",2.54115203374688,18,5,10,42,2.61520177498464,4.8890538333243,7.99298758073631,101,"ENSG00000079974.19"
"29336","ENSG00000197779.15_105857",105849,105857,9,"ENSG00000197779.15",1,1,"MVVVVVVVV",0,8,0.90600414078675,114,120,133,136,147,153,163,166,"ATGGAGA","CAGA","CTGGGGA","ATGA",2.19489135975627,13,11,10,43,2.84307618458625,4.36892131240701,7.99293787555401,101,"ENSG00000079974.19"
"24612","ENSG00000177156.11_10376",10368,10376,9,"ENSG00000177156.11",1,8,"VVVUVVVMV",1,7,0.764803312629399,115,121,133,136,146,152,174,177,"GGGATGA","CTGG","GTGATGG","CTGA",2.61430936773341,12,10,22,53,2.3061237337128,4.93371321298388,7.99292646350148,101,"ENSG00000079974.19"
"36397","ENSG00000240438.2_8810",8802,8810,9,"ENSG00000240438.2",1,2,"VMVVVVVVV",0,8,0.884057971014493,108,114,133,136,149,155,166,169,"ATGATGG","TTTA","ATGATGT","TTGA",2.33545917684159,19,13,11,52,2.25704930139589,4.45669428675163,7.9929261708096,101,"ENSG00000079974.19"
"36612","ENSG00000242153.8_26100",26092,26100,9,"ENSG00000242153.8",1,2,"VMVVVVVVV",0,8,0.884057971014493,108,114,133,136,149,155,166,169,"ATGATGG","TTTA","ATGATGT","TTGA",2.33545917684159,19,13,11,52,2.25704930139589,4.45669428675163,7.9929261708096,101,"ENSG00000079974.19"
"30180","ENSG00000203970.4_3640",3632,3640,9,"ENSG00000203970.4",1,1,"MVVVVVVVV",0,8,0.90600414078675,110,116,133,136,150,156,168,171,"GAAATGA","AGGA","AAGAAGA","CTGA",2.27083202027065,17,14,12,52,2.33613758728491,4.36875443060564,7.99277099375264,101,"ENSG00000079974.19"
"46617","ENSG00000286924.1_28634",28626,28634,9,"ENSG00000286924.1",0,NA,"UVVVVVVVV",1,8,0.902691511387163,113,119,133,136,138,144,152,155,"ATGTAGC","GTGT","ATAATGA","CTGA",2.22753192761718,14,2,8,33,2.67753215470937,4.38193625137265,7.9927022969213,101,"ENSG00000079974.19"
"16800","ENSG00000152284.5_53227",53219,53227,9,"ENSG00000152284.5",1,7,"VVVVVVMVV",0,8,0.885300207039338,90,96,133,136,144,150,171,174,"AAGATGA","TTCA","TTGATTC","CTGA",2.45321528316165,37,8,21,75,1.45123017935073,4.45149968344044,7.99270051159779,101,"ENSG00000079974.19"
"33774","ENSG00000231134.1_210",202,210,9,"ENSG00000231134.1",1,7,"VVVVVVMVV",0,8,0.885300207039338,90,96,133,136,144,150,171,174,"AAGATGA","TTCA","TTGATTC","CTGA",2.45321528316165,37,8,21,75,1.45123017935073,4.45149968344044,7.99270051159779,101,"ENSG00000079974.19"
"26743","ENSG00000185008.19_1341338",1341330,1341338,9,"ENSG00000185008.19",1,2,"VMVVVVVVV",0,8,0.884057971014493,112,118,133,136,149,155,163,166,"GTCCTGT","CAGA","GAGAGGA","CTGA",2.28530960054722,15,13,8,45,2.58980815956807,4.45630137413738,7.99253325819535,101,"ENSG00000079974.19"
"16528","ENSG00000151773.13_972",964,972,9,"ENSG00000151773.13",0,NA,"VVUVVVVVV",1,8,0.883643892339545,111,117,133,136,148,154,173,176,"AGCAGGA","CTCA","ATGATAA","CTGA",2.34781674263348,16,12,19,56,2.17903096238938,4.45778564498648,7.99236121434466,101,"ENSG00000079974.19"
"20804","ENSG00000165682.15_12631",12623,12631,9,"ENSG00000165682.15",1,1,"MVVVVUVVV",1,7,0.82815734989648,110,116,133,136,142,148,185,188,"CTGATGA","AGGA","GGGAGGA","CTGA",2.54150968673386,17,6,37,69,1.77536425109782,4.67969054066423,7.99231994025015,101,"ENSG00000079974.19"
"6896","ENSG00000112232.10_124313",124305,124313,9,"ENSG00000112232.10",1,6,"VVVVVMVVV",0,8,0.902691511387163,88,94,133,136,139,145,159,162,"AAGATGT","GTAA","GTGCAGA","CTGA",2.39274383670332,39,3,14,65,1.57427662911596,4.38147555178452,7.99224159733317,101,"ENSG00000079974.19"
"41622","ENSG00000259367.1_28564",28556,28564,9,"ENSG00000259367.1",0,NA,"VVVUVVVVV",1,8,0.880745341614907,116,122,133,136,150,156,172,175,"AACAAGA","CTGG","CTGATCA","CTGA",2.32789047265626,11,14,16,50,2.35689230956863,4.46904053181925,7.99202189827888,101,"ENSG00000079974.19"
"31715","ENSG00000224525.2_6605",6597,6605,9,"ENSG00000224525.2",0,NA,"VVVVVUVVV",1,8,0.922153209109731,97,103,133,136,160,166,181,184,"ATGATGA","AAGA","GTGAATA","TTGA",2.43093627078491,30,24,15,78,1.00738763701303,4.30340736056144,7.99202019700036,101,"ENSG00000079974.19"
"8348","ENSG00000118407.15_111343",111335,111343,9,"ENSG00000118407.15",0,NA,"VVVVVVUVV",1,8,0.886128364389234,92,98,104,107,114,120,133,136,"AGAATCA","CAGA","ATTATGT","CTGA",2.28777245507429,6,7,13,35,2.53820570476804,4.4475055179825,7.99201897553943,101,"ENSG00000079974.19"
"20328","ENSG00000164659.15_3658",3650,3658,9,"ENSG00000164659.15",1,1,"MVVVVVVVV",0,8,0.90600414078675,114,120,133,136,146,152,192,195,"TACATGA","CAGA","ATTATGT","CTGA",2.33364401470732,13,10,40,72,1.91429752046264,4.36798107129453,7.99199763444153,101,"ENSG00000079974.19"
"19899","ENSG00000163939.18_13960",13952,13960,9,"ENSG00000163939.18",0,NA,"VVVVVUVVV",1,8,0.922153209109731,66,72,92,95,101,107,133,136,"ATAATAA","CTGA","GTGGTAA","GTGA",2.32543882049329,20,6,26,61,1.71049075235361,4.30335405557723,7.99196689201615,101,"ENSG00000079974.19"
"43018","ENSG00000267586.7_488413",488405,488413,9,"ENSG00000267586.7",1,8,"VVVVVVVMV",0,8,0.884057971014493,115,121,133,136,147,153,190,193,"TTTATGA","CATA","GTGTTAA","CTGA",2.39253964606846,12,11,37,69,1.87181288692869,4.45551929851294,7.99175118257091,101,"ENSG00000079974.19"
"17977","ENSG00000155966.14_40230",40222,40230,9,"ENSG00000155966.14",1,6,"VVVVVMVVV",0,8,0.902691511387163,56,62,75,78,85,91,133,136,"ATGAGGA","CTCA","GAGATAA","GTGA",2.32715714908111,13,7,42,71,2.00930397569376,4.38092124239196,7.99168728794061,101,"ENSG00000079974.19"
"4095","ENSG00000095002.15_142690",142682,142690,9,"ENSG00000095002.15",1,3,"VVMVVVVVV",0,8,0.882815734989648,95,101,133,136,140,146,185,188,"CTGATGA","CAGC","GTGCTAA","CTGA",2.54327551310466,32,4,39,84,0.886111294576517,4.46032034548524,7.99158328544383,101,"ENSG00000079974.19"
"33583","ENSG00000230426.5_419485",419477,419485,9,"ENSG00000230426.5",1,5,"VVVVMVVVV",0,8,0.886542443064182,111,117,133,136,142,148,195,198,"TTAATGA","CAGC","ATGAGAA","CTGA",2.39323569735384,16,6,47,78,1.82647978559437,4.44534610865499,7.99151588091172,101,"ENSG00000079974.19"
"33629","ENSG00000230533.5_96972",96964,96972,9,"ENSG00000230533.5",1,8,"VVVVVVVMV",0,8,0.884057971014493,110,116,133,136,144,150,158,161,"AGGTTGA","TGGA","ATCAGGC","CTGA",2.26227816757658,17,8,8,42,2.7391952019519,4.4552624131156,7.99149429717357,101,"ENSG00000079974.19"
"7952","ENSG00000116138.13_48531",48523,48531,9,"ENSG00000116138.13",0,NA,"VVVVVVUVV",1,8,0.886128364389234,76,82,100,103,114,120,133,136,"CTGATGG","CTGA","ATCCTGC","CAGA",2.30502051839495,18,11,13,51,2.42104662627206,4.44696252055959,7.99147597811653,101,"ENSG00000079974.19"
"21083","ENSG00000166407.14_11182",11174,11182,9,"ENSG00000166407.14",1,2,"VMVVVUVVV",1,7,0.806211180124223,79,85,100,103,107,113,133,136,"GCCATGC","CTGA","GTGATGA","CTGA",2.52011291460833,15,4,20,48,2.26548669825556,4.76655986557777,7.99140458607466,101,"ENSG00000079974.19"
"27307","ENSG00000185942.13_275263",275255,275263,9,"ENSG00000185942.13",0,NA,"VVVVUVVVV",1,8,0.889855072463768,47,53,65,68,112,118,133,136,"GTAATGA","GTGT","GTGGAGC","CTGA",2.38607699570927,12,44,15,80,1.82048687012309,4.43191671037955,7.99133700023463,101,"ENSG00000079974.19"
"19080","ENSG00000160953.17_3699",3691,3699,9,"ENSG00000160953.17",0,NA,"VVVVVVUVV",1,8,0.886128364389234,85,91,104,107,110,116,133,136,"GTGGTGT","TTGT","CTGCAGA","CTGA",2.30635597777312,13,3,17,42,2.41152703136077,4.44680838746206,7.991321845019,101,"ENSG00000079974.19"
"13170","ENSG00000140470.15_248458",248450,248458,9,"ENSG00000140470.15",0,NA,"VVVVVUVVV",1,8,0.922153209109731,111,117,133,136,151,157,170,173,"AGCATGG","CCCA","TTGGTGA","CTGA",2.23489989037502,16,15,13,53,2.31100742416479,4.30258500666623,7.99119784310515,101,"ENSG00000079974.19"
"12393","ENSG00000138068.12_26793",26785,26793,9,"ENSG00000138068.12",1,2,"VMVVVVVVV",0,8,0.884057971014493,22,28,69,72,85,91,133,136,"ATAATGA","CTAA","ATCATGT","CTGA",2.56656416599196,41,13,42,105,0.708953957886463,4.45484543279154,7.99107731684951,101,"ENSG00000079974.19"
"5763","ENSG00000106571.15_202777",202769,202777,9,"ENSG00000106571.15",1,8,"UVVVVVVMV",1,7,0.786749482401656,107,113,133,136,159,165,179,182,"ATGATGA","TTTA","CTGTTGA","CTGA",2.67619627997835,20,23,14,66,1.53480864408902,4.84402929431951,7.99102722392613,101,"ENSG00000079974.19"
"45761","ENSG00000285876.1_77242",77234,77242,9,"ENSG00000285876.1",1,7,"VVVVVVMVV",0,8,0.885300207039338,88,94,133,136,148,154,162,165,"ATTATGA","CTTT","TTTATTA","CTGA",2.40752301272099,39,12,8,68,1.74805749269138,4.44955272770782,7.99075355586517,101,"ENSG00000079974.19"
"12495","ENSG00000138411.13_273670",273662,273670,9,"ENSG00000138411.13",0,NA,"VVVVVUVVV",1,8,0.922153209109731,102,108,133,136,143,149,157,160,"GTGGTGA","CTCA","CTGATTT","CTTA",2.25831619699761,25,7,8,49,2.15309983959121,4.30213528822716,7.99074812466608,101,"ENSG00000079974.19"
"14744","ENSG00000145808.10_3706",3698,3706,9,"ENSG00000145808.10",1,2,"VMVVVVVVV",0,8,0.884057971014493,98,104,133,136,143,149,163,166,"ATGATGA","CTTG","GTGGGGA","CAGA",2.38321637417187,29,7,14,59,1.92991051104976,4.45450491804888,7.99073680210685,101,"ENSG00000079974.19"
"4737","ENSG00000101846.9_316281",316273,316281,9,"ENSG00000101846.9",1,8,"VVVVVVVMV",0,8,0.884057971014493,108,114,133,136,142,148,178,181,"CTGATAA","CTCA","GAGACGT","CTGA",2.41956138777262,19,6,30,64,1.68722593369095,4.4544087963771,7.99064068043507,101,"ENSG00000079974.19"
"14455","ENSG00000145012.14_433087",433079,433087,9,"ENSG00000145012.14",1,8,"VVVVVVVMV",0,8,0.884057971014493,79,85,96,99,103,109,133,136,"GTAATGA","ATGA","ATGATTA","CTGC",2.35334642576421,11,4,24,48,2.12822338841365,4.45429989004377,7.99053177410174,101,"ENSG00000079974.19"
"7090","ENSG00000112763.17_16737",16729,16737,9,"ENSG00000112763.17",1,3,"VVMVVUVVV",1,7,0.804968944099379,108,114,133,136,145,151,165,168,"GTGAGGA","AAGA","CTGAAGA","CTGA",2.50250369921874,19,9,14,51,2.39924880188034,4.77065169916798,7.99052747556549,101,"ENSG00000079974.19"
"39041","ENSG00000251557.4_18745",18737,18745,9,"ENSG00000251557.4",1,8,"VVVVVVVMV",0,8,0.884057971014493,36,42,53,56,106,112,133,136,"GTGATGG","CTGA","GTGAGCA","CTGC",2.45717963306839,11,50,21,91,1.43598416453247,4.45429542958044,7.99052731363841,101,"ENSG00000079974.19"
"11912","ENSG00000136504.13_32788",32780,32788,9,"ENSG00000136504.13",0,NA,"UVVVVVVVV",1,8,0.902691511387163,61,67,97,100,111,117,133,136,"GTGATGA","TTGA","AAGAAAA","GTGA",2.38227615205315,30,11,16,66,1.63717478992015,4.37975395090195,7.99051999645061,101,"ENSG00000079974.19"
"40884","ENSG00000258028.3_426900",426892,426900,9,"ENSG00000258028.3",1,2,"VMVVVVVVV",0,8,0.884057971014493,73,79,93,96,113,119,133,136,"CAGAGGA","GTGA","TTGTTAA","CTGA",2.33301659540952,14,17,14,54,2.26346186822336,4.45422645940504,7.99045834346301,101,"ENSG00000079974.19"
"32555","ENSG00000227193.2_10547",10539,10547,9,"ENSG00000227193.2",0,NA,"VVVVUVVVV",1,8,0.889855072463768,116,122,133,136,141,147,202,205,"GAGATGA","ATGT","ATGGAGG","CTGA",2.37251183746714,11,5,55,80,1.90695062474446,4.43092405196467,7.99034434181975,101,"ENSG00000079974.19"
"33539","ENSG00000230186.3_10495",10487,10495,9,"ENSG00000230186.3",0,NA,"VVVVUVVVV",1,8,0.889855072463768,116,122,133,136,141,147,202,205,"GAGATGA","ATGT","ATGGAGG","CTGA",2.37251183746714,11,5,55,80,1.90695062474446,4.43092405196467,7.99034434181975,101,"ENSG00000079974.19"
"18665","ENSG00000158019.21_360104",360096,360104,9,"ENSG00000158019.21",0,NA,"VVUVVVVVV",1,8,0.883643892339545,110,116,133,136,160,166,181,184,"GTGATGG","ATGA","GTGAGGA","CTGT",2.41564228063461,17,24,15,65,1.71876847572255,4.45576258665499,7.99033815601316,101,"ENSG00000079974.19"
"30147","ENSG00000203805.11_31785",31777,31785,9,"ENSG00000203805.11",0,NA,"VVVVUVVVV",1,8,0.889855072463768,89,95,133,136,142,148,197,200,"AAGATGT","CTCA","TTGATCA","CTGA",2.51006056284748,38,6,49,102,0.989931034761362,4.43091703010281,7.99033731995788,101,"ENSG00000079974.19"
"44514","ENSG00000282890.1_492617",492609,492617,9,"ENSG00000282890.1",1,5,"VVUVMVVVV",1,7,0.770186335403727,94,100,111,114,116,122,133,136,"AGGAAGA","CTGA","TTGACCA","CTGA",2.54158153169048,11,2,11,33,2.69406087293081,4.90948443771683,7.99022977933174,101,"ENSG00000079974.19"
"8292","ENSG00000117868.18_98195",98187,98195,9,"ENSG00000117868.18",1,6,"VVVVVMVVV",0,8,0.902691511387163,113,119,133,136,141,147,166,169,"ACAATTA","CAGA","GTGGTAG","CTGA",2.25665567094719,14,5,19,47,2.47341181075845,4.37944573760159,7.99021178315025,101,"ENSG00000079974.19"
"12964","ENSG00000139726.11_4164",4156,4164,9,"ENSG00000139726.11",1,6,"VVVVVMVVV",0,8,0.902691511387163,113,119,133,136,144,150,173,176,"AGGATGA","GTTA","TTGAGGA","CTGG",2.28125871201738,14,8,23,54,2.30930899247617,4.37942510148134,7.99019114703,101,"ENSG00000079974.19"
"13099","ENSG00000140199.13_54242",54234,54242,9,"ENSG00000140199.13",1,5,"VVVVMUVVV",1,7,0.808695652173913,80,86,101,104,115,121,133,136,"AGGCTGA","TTGA","TTGAGGC","CTGA",2.44741285989341,15,11,12,47,2.70540742960106,4.75537329055595,7.9901558992516,101,"ENSG00000079974.19"
"3798","ENSG00000089101.19_188849",188841,188849,9,"ENSG00000089101.19",1,1,"MVVVVVVVV",0,8,0.90600414078675,114,120,133,136,144,150,165,168,"ATGAAGA","TTCA","CTAAAGA","CTGT",2.19886599139837,13,8,15,45,2.80537572273423,4.36612058301418,7.99013714616118,101,"ENSG00000079974.19"
"1973","ENSG00000068650.19_178129",178121,178129,9,"ENSG00000068650.19",1,7,"VVVVVVMVV",0,8,0.885300207039338,91,97,133,136,144,150,173,176,"TTGTTGA","CGGA","TTGATAG","CTGA",2.46662381680979,36,8,23,76,1.35144317038576,4.44890048727943,7.99010131543678,101,"ENSG00000079974.19"
"39650","ENSG00000254024.1_14911",14903,14911,9,"ENSG00000254024.1",1,8,"VVVVVVVMV",0,8,0.884057971014493,32,38,53,56,94,100,133,136,"GGGATAA","CTGA","GTGGTGT","CTGA",2.52283624043945,15,38,33,95,0.996523675050197,4.45385798616163,7.99008987021961,101,"ENSG00000079974.19"
"35772","ENSG00000237036.7_54481",54473,54481,9,"ENSG00000237036.7",0,NA,"UVVVVVVVV",1,8,0.902691511387163,78,84,99,102,115,121,133,136,"GTGTTGA","CTTA","TTGGTAA","CAGA",2.24315938823098,15,13,12,49,2.56289048897069,4.37932160262763,7.99008764817629,101,"ENSG00000079974.19"
"7567","ENSG00000114853.15_1745",1737,1745,9,"ENSG00000114853.15",0,NA,"VVUVVUVVV",2,7,0.805797101449275,42,48,66,69,81,87,133,136,"ATCATGG","CTGA","GAGATGA","CTGA",2.64441226468176,18,12,46,85,1.43817134321823,4.76689661027416,7.99008501607126,101,"ENSG00000079974.19"
"19810","ENSG00000163738.19_185472",185464,185472,9,"ENSG00000163738.19",0,NA,"VVVVVVUVV",1,8,0.886128364389234,60,66,99,102,110,116,133,136,"AAAATGA","CTAA","TTGTTTA","CTGA",2.41216816139526,33,8,17,67,1.70115444478065,4.44556888018727,7.9900823377442,101,"ENSG00000079974.19"
"43724","ENSG00000273297.4_15841",15833,15841,9,"ENSG00000273297.4",0,NA,"UVVVVUVVV",2,7,0.824844720496894,113,119,133,136,144,150,174,177,"ATGATAC","CTGG","GTGTTGC","CTGA",2.47474741251778,14,8,24,55,2.26438637022738,4.69067561341982,7.9900544954074,101,"ENSG00000079974.19"
"19582","ENSG00000163374.20_3977",3969,3977,9,"ENSG00000163374.20",1,1,"MVVVVVVVV",0,8,0.90600414078675,97,103,133,136,160,166,175,178,"GGGATGT","CTTA","ATGTAGA","CTGA",2.44125737295453,30,24,9,72,1.18889263657038,4.36598544740015,7.99000201054715,101,"ENSG00000079974.19"
"28892","ENSG00000196639.7_51675",51667,51675,9,"ENSG00000196639.7",1,8,"VVVVVVVMV",0,8,0.884057971014493,112,118,133,136,142,148,196,199,"ATGATGA","CACA","GTGTTTA","CTAA",2.38767771520627,15,6,48,78,1.89711651255447,4.45374198681573,7.9899738708737,101,"ENSG00000079974.19"
"14143","ENSG00000144455.14_351243",351235,351243,9,"ENSG00000144455.14",1,6,"VVVVVMUVV",1,7,0.788819875776397,113,119,133,136,147,153,196,199,"ATGTTGA","CTGC","GTCATGA","CTGA",2.62928861802579,14,11,43,77,1.81016702863101,4.83468945386741,7.989968956973,101,"ENSG00000079974.19"
"45111","ENSG00000285045.1_268",260,268,9,"ENSG00000285045.1",1,1,"MVVVVUVVV",1,7,0.82815734989648,113,119,133,136,146,152,175,178,"ATGATAG","GTGA","CTGGAGA","CTGA",2.47326429944737,14,10,23,56,2.22080677515034,4.67730885953319,7.98993825911912,101,"ENSG00000079974.19"
"8807","ENSG00000120727.13_24892",24884,24892,9,"ENSG00000120727.13",0,NA,"VVVUVUVVV",2,7,0.802898550724638,115,121,133,136,173,179,205,208,"AGGATGG","CTGA","GTGATGG","CTGA",2.6794799276164,12,37,26,84,1.24999921999886,4.77829968436037,7.98989388725892,101,"ENSG00000079974.19"
"20821","ENSG00000165731.21_24745",24737,24745,9,"ENSG00000165731.21",1,8,"VVVVVVVMV",0,8,0.884057971014493,108,114,133,136,145,151,166,169,"ATGAGGG","AAGA","GAGAATA","CTGA",2.32047389462586,19,9,15,52,2.34479655289162,4.453655629266,7.98988751332397,101,"ENSG00000079974.19"
"23811","ENSG00000174238.16_18440",18432,18440,9,"ENSG00000174238.16",1,2,"VMVVVVVVV",0,8,0.884057971014493,112,118,133,136,145,151,164,167,"AAGATGA","CAGC","ATGAAGT","CAGA",2.25455407809596,15,9,13,46,2.78330205243867,4.4534156432696,7.98964752732757,101,"ENSG00000079974.19"
"18102","ENSG00000156113.24_714736",714728,714736,9,"ENSG00000156113.24",1,8,"VVVVVUVMV",1,7,0.806211180124224,79,85,103,106,116,122,133,136,"AAGATGA","CTGA","ATGTTGT","ATGA",2.47603353208284,18,10,11,48,2.55217806762677,4.7647670703781,7.98961179087499,101,"ENSG00000079974.19"
"32417","ENSG00000226983.3_165900",165892,165900,9,"ENSG00000226983.3",0,NA,"VVVVVUVVV",1,8,0.922153209109731,66,72,87,90,98,104,133,136,"TTGATAA","CTTA","TTGTTGA","TTGA",2.27383739869683,15,8,29,61,2.04504490317929,4.30099022362288,7.9896030600618,101,"ENSG00000079974.19"
"23527","ENSG00000173163.11_13458",13450,13458,9,"ENSG00000173163.11",1,5,"VVVVMVVVV",0,8,0.886542443064182,100,106,133,136,148,154,169,172,"ATGGAGA","CTAA","ATAAAGA","CTGA",2.41311765976449,27,12,15,63,1.68558315466374,4.44325855494008,7.98942832719681,101,"ENSG00000079974.19"
"12832","ENSG00000139173.10_443197",443189,443197,9,"ENSG00000139173.10",1,7,"VVVVVVMVV",0,8,0.885300207039338,109,115,133,136,146,152,164,167,"ATGATAA","ATGA","ATGTTTC","ATGA",2.29033693571917,18,10,12,49,2.5238215176267,4.4481836056053,7.98938443376265,101,"ENSG00000079974.19"
"1876","ENSG00000066933.16_97853",97845,97853,9,"ENSG00000066933.16",1,7,"VVVVVVMVV",0,8,0.885300207039338,76,82,94,97,100,106,133,136,"GTGATGC","TTGA","ATGATTA","CAGA",2.38311218915639,12,3,27,51,1.90507553126999,4.44812253141148,7.98932335956883,101,"ENSG00000079974.19"
"40742","ENSG00000257522.7_90132",90124,90132,9,"ENSG00000257522.7",1,8,"VVVVUVVMV",1,7,0.773913043478261,115,121,133,136,142,148,160,163,"AAGATGG","ATGA","CTGAGGG","CTGA",2.48815458809531,12,6,12,39,2.98682487368228,4.89363053191275,7.9892827058258,101,"ENSG00000079974.19"
"2339","ENSG00000073417.15_100445",100437,100445,9,"ENSG00000073417.15",1,8,"VVVVVVVMV",0,8,0.884057971014493,107,113,133,136,147,153,166,169,"GTGAGGA","CAAA","GTAGTCA","CTGA",2.33509691117287,20,11,13,53,2.24474300493431,4.45301393652169,7.98924582057966,101,"ENSG00000079974.19"
"13529","ENSG00000141682.12_1092",1084,1092,9,"ENSG00000141682.12",1,8,"VVVVVVVMV",0,8,0.884057971014493,114,120,133,136,146,152,162,165,"GTGTGGG","TTGT","GTGATGT","CTGA",2.23512422864573,13,10,10,42,2.9112208143975,4.45301225134226,7.98924413540023,101,"ENSG00000079974.19"
"38630","ENSG00000250682.6_11750",11742,11750,9,"ENSG00000250682.6",0,NA,"VVUUVVVVV",2,7,0.764389233954451,79,85,99,102,114,120,133,136,"ATCATCA","CTGA","GTCAAGA","CTGA",2.56140119256518,14,12,13,48,2.65071350396686,4.93168036360035,7.98923729941816,101,"ENSG00000079974.19"
"10608","ENSG00000131844.17_2781",2773,2781,9,"ENSG00000131844.17",1,5,"VVVVMVVVV",0,8,0.886542443064182,94,100,133,136,137,143,152,155,"ATGCTGA","ATAA","CTGAACA","CTGA",2.46460998794639,33,1,9,52,1.34151996180721,4.44306330369579,7.98923307595252,101,"ENSG00000079974.19"
"22625","ENSG00000170965.10_103166",103158,103166,9,"ENSG00000170965.10",0,NA,"VVVVVUVVV",1,8,0.922153209109731,88,94,105,108,112,118,133,136,"AGGATGT","CTGA","CTGAAGA","ATGC",2.17918837686613,11,4,15,39,2.67446341308508,4.30059648138148,7.98920931782041,101,"ENSG00000079974.19"
"34667","ENSG00000233723.11_555375",555367,555375,9,"ENSG00000233723.11",1,7,"VVVVVVMVV",0,8,0.885300207039338,98,104,133,136,144,150,197,200,"GTGATAA","CAGT","GTGAAGA","CTGA",2.51127645529012,29,8,47,93,1.05006133174122,4.44797609175217,7.98917691990952,101,"ENSG00000079974.19"
"14486","ENSG00000145103.15_8677",8669,8677,9,"ENSG00000145103.15",1,5,"VVUVMVVVV",1,7,0.770186335403727,113,119,133,136,149,155,179,182,"CTGAGGA","CTGA","TTGGTGA","CTGA",2.64925869986076,14,13,24,60,1.97184490609458,4.90839239295825,7.98913773457316,101,"ENSG00000079974.19"
"23708","ENSG00000173610.13_59453",59445,59453,9,"ENSG00000173610.13",1,5,"VVVVMVVVV",0,8,0.886542443064182,108,114,133,136,137,143,153,156,"ATGATAA","TTCA","GAAATAA","CTGA",2.37366752571825,19,1,10,39,1.94731916052282,4.44294233299446,7.98911210525119,101,"ENSG00000079974.19"
"43315","ENSG00000271271.6_45846",45838,45846,9,"ENSG00000271271.6",1,5,"VVVVMVVVV",0,8,0.886542443064182,108,114,133,136,137,143,153,156,"ATGATAA","TTCA","GAAATAA","CTGA",2.37366752571825,19,1,10,39,1.94731916052282,4.44294233299446,7.98911210525119,101,"ENSG00000079974.19"
"13264","ENSG00000140836.17_402440",402432,402440,9,"ENSG00000140836.17",1,8,"VVVVVVVMV",0,8,0.884057971014493,44,50,57,60,107,113,133,136,"ATGATGT","CTGA","ATGCTGG","CTAA",2.50223872063035,7,47,20,83,1.12984956437086,4.45286025880996,7.98909214286793,101,"ENSG00000079974.19"
"8970","ENSG00000121904.19_485484",485476,485484,9,"ENSG00000121904.19",0,NA,"VVVUVVVVV",1,8,0.880745341614907,72,78,91,94,113,119,133,136,"GTGATGT","CTGA","AGCAGGA","ATGA",2.35113277343782,13,19,14,55,2.18975522224899,4.46599342795861,7.98897479441824,101,"ENSG00000079974.19"
"34421","ENSG00000233005.2_518380",518372,518380,9,"ENSG00000233005.2",1,3,"VVMVVVVVV",0,8,0.882815734989648,115,121,133,136,150,156,177,180,"ATTATGT","TTGT","TTGATAT","CTGA",2.36213587773307,12,14,21,56,2.08326217592912,4.4577086735374,7.98897161349599,101,"ENSG00000079974.19"
"31144","ENSG00000216863.11_80402",80394,80402,9,"ENSG00000216863.11",1,1,"MVVVVVVVV",0,8,0.90600414078675,114,120,133,136,144,150,198,201,"AGGAAGA","CAGT","GGGATTA","CTGA",2.32102183713986,13,8,48,78,1.98608632854626,4.36489131070299,7.98890787384999,101,"ENSG00000079974.19"
"25942","ENSG00000183117.20_1064516",1064508,1064516,9,"ENSG00000183117.20",1,1,"MVVVVVVVV",0,8,0.90600414078675,111,117,133,136,142,148,159,162,"ATGGTGA","CTTC","AGGAAGA","TTGA",2.19519064221615,16,6,11,42,2.82489093175048,4.36487380329787,7.98889036644487,101,"ENSG00000079974.19"
"19845","ENSG00000163806.16_19512",19504,19512,9,"ENSG00000163806.16",0,NA,"UVVVVVVVV",1,8,0.902691511387163,102,108,133,136,144,150,163,166,"ATGCTGC","CCTA","GTGAAAT","CTGA",2.31523797964055,25,8,13,55,2.07755193993382,4.37811795105104,7.98888399659969,101,"ENSG00000079974.19"
"30799","ENSG00000213639.11_50389",50381,50389,9,"ENSG00000213639.11",0,NA,"UVVVVVVVV",1,8,0.902691511387163,102,108,133,136,144,150,163,166,"ATGCTGC","CCTA","GTGAAAT","CTGA",2.31523797964055,25,8,13,55,2.07755193993382,4.37811795105104,7.98888399659969,101,"ENSG00000079974.19"
"7245","ENSG00000113391.19_412486",412478,412486,9,"ENSG00000113391.19",1,7,"VVVVVVMVV",0,8,0.885300207039338,108,114,133,136,139,145,154,157,"ATGTTTA","CAGG","CTGAAGC","CTGA",2.32218448545624,19,3,9,40,2.30945858250804,4.4476721213874,7.98887294954475,101,"ENSG00000079974.19"
"23439","ENSG00000172965.17_386499",386491,386499,9,"ENSG00000172965.17",1,1,"MVVVVVVVV",0,8,0.90600414078675,116,122,133,136,153,159,183,186,"ATGGAGA","GTGA","ATTCAGA","CTGA",2.36139813282202,11,17,24,61,1.71672174353569,4.3648439905873,7.98886055373429,101,"ENSG00000079974.19"
"32270","ENSG00000226571.2_311452",311444,311452,9,"ENSG00000226571.2",1,2,"VMVVVVVVV",0,8,0.884057971014493,41,47,83,86,96,102,133,136,"CTGATGA","CTGA","ATGTTAA","GTGA",2.51982253465912,36,10,31,86,1.01153119841245,4.45258702403497,7.98881890809294,101,"ENSG00000079974.19"
"18434","ENSG00000157404.17_21238",21230,21238,9,"ENSG00000157404.17",1,6,"VVVVVMVVV",0,8,0.902691511387163,83,89,133,136,143,149,158,161,"GTAATTA","TTTA","TTGAAGA","CTGA",2.32698293907923,44,7,9,69,1.9989278340542,4.37803685697893,7.98880290252759,101,"ENSG00000079974.19"
"3892","ENSG00000090376.11_62832",62824,62832,9,"ENSG00000090376.11",1,8,"VVVUVVVMV",1,7,0.764803312629399,66,72,93,96,110,116,133,136,"ATGAAGA","CTGA","ATTAAGA","CTGA",2.6982165762269,21,14,17,61,1.73019414855162,4.92957616418273,7.98878941470033,101,"ENSG00000079974.19"
"43638","ENSG00000273002.1_3759",3751,3759,9,"ENSG00000273002.1",0,NA,"UVVVVVVVV",1,8,0.902691511387163,76,82,105,108,115,121,133,136,"ATTATGA","CTGA","ATGAAGA","GTGC",2.29208095284643,23,7,12,51,2.23153678653346,4.37801911804409,7.98878516359274,101,"ENSG00000079974.19"
"4238","ENSG00000099715.15_696871",696863,696871,9,"ENSG00000099715.15",0,NA,"VVVUVVVVV",1,8,0.880745341614907,110,116,133,136,145,151,167,170,"CTGTTGT","CTGT","ATCAGGT","CTGA",2.30975636055075,17,9,16,51,2.46457668551793,4.46573810563074,7.98871947209036,101,"ENSG00000079974.19"
"4904","ENSG00000102290.23_798766",798758,798766,9,"ENSG00000102290.23",0,NA,"VVVUVVVVV",1,8,0.880745341614907,110,116,133,136,145,151,167,170,"CTGTTGT","CTGT","ATCAGGT","CTGA",2.30975636055075,17,9,16,51,2.46457668551793,4.46573810563074,7.98871947209036,101,"ENSG00000079974.19"
"2786","ENSG00000078295.17_257206",257198,257206,9,"ENSG00000078295.17",0,NA,"UVVVVVVVV",1,8,0.902691511387163,82,88,107,110,115,121,133,136,"GAGATGT","TTGA","TTGAAGA","ATGA",2.25587900322194,19,5,12,45,2.47238119257838,4.37789363684783,7.98865968239648,101,"ENSG00000079974.19"
"19620","ENSG00000163510.14_36786",36778,36786,9,"ENSG00000163510.14",1,6,"VVVVVMVVV",0,8,0.902691511387163,113,119,133,136,154,160,209,212,"ATGAAGA","ATTA","TTTATAA","CTGA",2.42576029641768,14,18,49,90,1.33977139924925,4.37787667717511,7.98864272272376,101,"ENSG00000079974.19"
"1676","ENSG00000064999.16_95843",95835,95843,9,"ENSG00000064999.16",1,8,"VVVVVUVMV",1,7,0.806211180124224,116,122,133,136,142,148,167,170,"GTGACGT","GTGA","CTGATTA","CTGA",2.47722948331507,11,6,19,45,2.53991395977249,4.76369429546824,7.98853901596514,101,"ENSG00000079974.19"
"1497","ENSG00000058091.17_431133",431125,431133,9,"ENSG00000058091.17",0,NA,"UVVVVVVVV",1,8,0.902691511387163,116,122,133,136,141,147,189,192,"ATTATAA","CTTA","ATACTGG","CTGA",2.3386504545506,11,5,42,67,1.91993686572905,4.37773497401659,7.98850101956525,101,"ENSG00000079974.19"
"18594","ENSG00000157800.18_50337",50329,50337,9,"ENSG00000157800.18",1,7,"VVVVVUMVV",1,7,0.807453416149068,112,118,133,136,156,162,176,179,"ATGATAA","ATGC","ATGAGGA","CTGA",2.54637179287653,15,20,14,58,2.05882974619865,4.75866042467721,7.98847408927348,101,"ENSG00000079974.19"
"12866","ENSG00000139220.17_56427",56419,56427,9,"ENSG00000139220.17",1,2,"VMVVVUVVV",1,7,0.806211180124223,110,116,133,136,144,150,175,178,"GTTATGA","CTCA","GTGTAGA","CTGA",2.55593778490016,17,8,25,59,2.01465624499716,4.76356036941623,7.98840508991312,101,"ENSG00000079974.19"
"34004","ENSG00000231718.1_143334",143326,143334,9,"ENSG00000231718.1",1,3,"VVMVVVVVV",0,8,0.882815734989648,115,121,133,136,160,166,182,185,"ATGTTTA","TTGA","ATGACCT","CTGA",2.38840746688573,12,24,16,61,1.90534764626567,4.45701602304263,7.98827896300122,101,"ENSG00000079974.19"
"3728","ENSG00000088538.13_488545",488537,488545,9,"ENSG00000088538.13",1,7,"VVVVVVMVV",0,8,0.885300207039338,116,122,133,136,146,152,172,175,"CTAATGA","TTAA","ATAAATA","CTGA",2.30971209140254,11,10,20,50,2.39018323324557,4.44706596064896,7.98826678880631,101,"ENSG00000079974.19"
"1666","ENSG00000064933.19_43448",43440,43448,9,"ENSG00000064933.19",0,NA,"UVVVVUVVV",2,7,0.824844720496894,113,119,133,136,150,156,170,173,"ATAATAA","CTGC","ATGCAGA","CTGA",2.444498532863,14,14,14,51,2.45852857315324,4.68879636472665,7.98817524671422,101,"ENSG00000079974.19"
"34565","ENSG00000233420.2_71058",71050,71058,9,"ENSG00000233420.2",1,1,"MVVVVVVVV",0,8,0.90600414078675,106,112,133,136,176,182,190,193,"GTGGAGA","CTGA","GGCAGGA","CTGA",2.40878765807091,21,40,8,78,1.3973530889582,4.36398436902441,7.98800093217141,101,"ENSG00000079974.19"
"6090","ENSG00000107957.17_6710",6702,6710,9,"ENSG00000107957.17",0,NA,"VVVUVVVVV",1,8,0.880745341614907,95,101,133,136,182,188,196,199,"ATGATGA","TAGA","ACAATCA","CTGA",2.52814698694314,32,46,8,95,1.00570488595053,4.46500453305953,7.98798589951916,101,"ENSG00000079974.19"
"40061","ENSG00000254861.2_18279",18271,18279,9,"ENSG00000254861.2",1,1,"MVVUVVVVV",1,7,0.786749482401656,116,122,133,136,140,146,171,174,"CTCATGA","CTGA","CTGGTTA","CTGA",2.59154284842358,11,4,25,49,2.08681420618472,4.84094163225215,7.98793956185878,101,"ENSG00000079974.19"
"17105","ENSG00000153113.24_41138",41130,41138,9,"ENSG00000153113.24",1,1,"MVVVVVUVV",1,7,0.792132505175983,111,117,133,136,141,147,158,161,"GGGAAGA","GTGA","GTGATGC","CTGA",2.47473831668973,16,5,11,41,2.77930076081277,4.81938905135274,7.98791907205668,101,"ENSG00000079974.19"
"38939","ENSG00000251314.2_604404",604396,604404,9,"ENSG00000251314.2",1,1,"MVVVVVUVV",1,7,0.792132505175983,111,117,133,136,141,147,158,161,"GGGAAGA","GTGA","GTGATGC","CTGA",2.47473831668973,16,5,11,41,2.77930076081277,4.81938905135274,7.98791907205668,101,"ENSG00000079974.19"
"13044","ENSG00000139970.18_55872",55864,55872,9,"ENSG00000139970.18",1,8,"VVVVVVVMV",0,8,0.884057971014493,116,122,133,136,146,152,160,163,"CTGCAGA","CAAA","ATGAGAA","CTGA",2.23406354938836,11,10,8,38,2.91299138763703,4.45168709588986,7.98791897994783,101,"ENSG00000079974.19"
"20961","ENSG00000166069.14_1190",1182,1190,9,"ENSG00000166069.14",1,2,"VMVVVVUVV",1,7,0.770186335403727,86,92,105,108,114,120,133,136,"ATTATGA","GTAA","AAGATGA","CTGA",2.50578033606436,13,6,13,41,2.9227224780417,4.90698117961769,7.98772652123259,101,"ENSG00000079974.19"
"6957","ENSG00000112339.15_22489",22481,22489,9,"ENSG00000112339.15",1,2,"VMVVVVVVV",0,8,0.884057971014493,60,66,100,103,111,117,133,136,"ATTATGT","CTGT","ATTAAAA","CTGA",2.40730107578469,34,8,16,67,1.75727663833904,4.45148761922591,7.98771950328388,101,"ENSG00000079974.19"
"11536","ENSG00000135298.15_349570",349562,349570,9,"ENSG00000135298.15",1,1,"MVVVVVUVV",1,7,0.792132505175983,111,117,133,136,154,160,173,176,"AAGATGA","CTTA","GAGATTA","CTGA",2.57203304100084,16,18,13,56,2.12979007577524,4.81916925394522,7.98769927464915,101,"ENSG00000079974.19"
"19630","ENSG00000163530.4_1283",1275,1283,9,"ENSG00000163530.4",1,3,"VVMVVVVVV",0,8,0.882815734989648,35,41,65,68,78,84,133,136,"ATTATGT","CTGG","GTGAGTA","CTGA",2.50591515842177,24,10,49,92,1.11934037983337,4.45636035899462,7.98762329895322,101,"ENSG00000079974.19"
"15462","ENSG00000148408.14_43345",43337,43345,9,"ENSG00000148408.14",1,5,"UVVVMVVVV",1,7,0.789233954451346,106,112,133,136,144,150,158,161,"AGGATGA","CAGA","AAGAAGG","CTGA",2.54125484316104,21,8,8,46,2.38070738542802,4.83060158495874,7.98753740276412,101,"ENSG00000079974.19"
"29741","ENSG00000198663.17_7684",7676,7684,9,"ENSG00000198663.17",1,2,"VMVVVVVVV",0,8,0.884057971014493,113,119,133,136,160,166,181,184,"TGAATGA","CTGT","TTGATTA","CTGA",2.38160084308904,14,24,15,62,1.92766137223664,4.4512500815409,7.98748196559887,101,"ENSG00000079974.19"
"7698","ENSG00000115368.10_4908",4900,4908,9,"ENSG00000115368.10",0,NA,"VVVVUUVVV",2,7,0.812008281573499,114,120,133,136,150,156,167,170,"CTGGAGA","CTGA","CTGGAGA","CTGA",2.45260465343608,13,14,11,47,2.60696822250829,4.73941647802053,7.98744960431453,101,"ENSG00000079974.19"
"2373","ENSG00000073910.23_16787",16779,16787,9,"ENSG00000073910.23",1,2,"VMVVVVVVV",0,8,0.884057971014493,95,101,109,112,115,121,133,136,"ATGAGGA","CTGG","ATGACTG","CTGC",2.27367523122771,8,3,12,32,2.6466277482812,4.45111565578315,7.98734753984113,101,"ENSG00000079974.19"
"10235","ENSG00000130052.14_11520",11512,11520,9,"ENSG00000130052.14",1,1,"MVVVVVUVV",1,7,0.792132505175983,111,117,133,136,147,153,165,168,"ATGATGA","CTGC","GTGCTCA","TTGA",2.49635218341218,16,11,12,48,2.63288850677677,4.81880909904783,7.98733911975176,101,"ENSG00000079974.19"
"23651","ENSG00000173482.17_195464",195456,195464,9,"ENSG00000173482.17",0,NA,"VVVVVVUVV",1,8,0.886128364389234,47,53,69,72,83,89,133,136,"ATGATAA","CTGT","GTGATGG","CTCA",2.41333421362689,16,11,44,80,1.68207892341265,4.4427434202313,7.98725687778824,101,"ENSG00000079974.19"
"37050","ENSG00000244694.8_115770",115762,115770,9,"ENSG00000244694.8",1,1,"MVVVVVVVV",0,8,0.90600414078675,113,119,133,136,155,161,184,187,"CTCAAGA","CAGT","GTGATGA","CTGA",2.37114229766743,14,19,23,65,1.64532396490986,4.36323482067318,7.98725138382017,101,"ENSG00000079974.19"
"12446","ENSG00000138193.17_19575",19567,19575,9,"ENSG00000138193.17",1,1,"MVVVVUVVV",1,7,0.82815734989648,115,121,133,136,143,149,161,164,"CTTGTGA","CTGA","AAAAGGA","CTGA",2.3560431130672,12,7,12,40,2.99132810114279,4.67457054706436,7.98719994665028,101,"ENSG00000079974.19"
"37338","ENSG00000247317.5_6970",6962,6970,9,"ENSG00000247317.5",1,2,"VMVVVVVVV",0,8,0.884057971014493,109,115,133,136,145,151,170,173,"TGGTTGA","CTGT","GAGAAGA","CTGA",2.34173770675228,18,9,19,55,2.19224701547607,4.45095793178949,7.98718981584746,101,"ENSG00000079974.19"
"31973","ENSG00000225493.1_8167",8159,8167,9,"ENSG00000225493.1",1,8,"VVVVVVVMV",0,8,0.884057971014493,114,120,133,136,142,148,161,164,"ATCATCA","CTAC","GAGGTGT","CTGA",2.23216468916566,13,6,13,41,2.9227224780417,4.4509551014532,7.98718698551117,101,"ENSG00000079974.19"
"19685","ENSG00000163608.15_13565",13557,13565,9,"ENSG00000163608.15",1,8,"VVVVVVUMV",1,7,0.770186335403727,70,76,106,109,116,122,133,136,"GTGATGT","CAGA","GTTATGA","CTGA",2.63945461094223,30,7,11,57,2.02931650988535,4.90642014570839,7.98716548732329,101,"ENSG00000079974.19"
"8733","ENSG00000120549.19_213330",213322,213330,9,"ENSG00000120549.19",1,1,"MVVVUVVVV",1,7,0.795859213250517,76,82,96,99,109,115,133,136,"ATAATGA","TTGC","GTGAGCA","CTGA",2.50743250225688,14,10,18,51,2.49864537163068,4.80371551333581,7.98715236633788,101,"ENSG00000079974.19"
"4075","ENSG00000093000.19_12694",12686,12694,9,"ENSG00000093000.19",1,7,"VVVVVVMVV",0,8,0.885300207039338,113,119,133,136,141,147,167,170,"AGGATCA","TGGA","ATCCTGA","CTGA",2.3054970326131,14,5,20,48,2.41360275810169,4.44589574388059,7.98709657203794,101,"ENSG00000079974.19"
"19312","ENSG00000162706.13_20602",20594,20602,9,"ENSG00000162706.13",1,5,"VVVVMVVVV",0,8,0.886542443064182,88,94,108,111,115,121,133,136,"AGGCTGA","CTGC","TTGAGGA","ATGA",2.24384698846146,14,4,12,39,2.80452374081856,4.44087591597374,7.98704568823047,101,"ENSG00000079974.19"
"37931","ENSG00000249231.8_43173",43165,43173,9,"ENSG00000249231.8",1,3,"VVMVVVVVV",0,8,0.882815734989648,114,120,133,136,146,152,161,164,"TCAATGA","AAGA","ATAAGGA","CTGA",2.2359524465723,13,10,9,41,2.91662707420267,4.4557441795045,7.9870071194631,101,"ENSG00000079974.19"
"20536","ENSG00000165061.15_145042",145034,145042,9,"ENSG00000165061.15",1,1,"MVVVUVVVV",1,7,0.795859213250517,96,102,133,136,143,149,172,175,"GTGATGG","CTGA","CTGTCGA","CTGA",2.67351650565527,31,7,23,70,1.39076464378918,4.80355200370607,7.98698885670814,101,"ENSG00000079974.19"
"45045","ENSG00000284848.2_8603",8595,8603,9,"ENSG00000284848.2",1,1,"MVVVVUVVV",1,7,0.82815734989648,92,98,133,136,151,157,174,177,"ATGATAA","CTGG","ATAATGA","CTGA",2.61556195456512,35,15,17,76,1.26009301491463,4.67429317800386,7.98692257758979,101,"ENSG00000079974.19"
"47424","ENSG00000288098.1_770949",770941,770949,9,"ENSG00000288098.1",1,1,"MVVVVVVVV",0,8,0.90600414078675,115,121,133,136,162,168,177,180,"ATCAAGC","ATGA","GTGAAAG","CTGA",2.30220251481526,12,26,9,56,2.10311469882405,4.36278286606477,7.98679942921177,101,"ENSG00000079974.19"
"18849","ENSG00000158856.19_23974",23966,23974,9,"ENSG00000158856.19",1,7,"VVVVVVMVV",0,8,0.885300207039338,112,118,133,136,142,148,172,175,"TTGATAT","CAGA","GTGGTCC","CTGA",2.33627972204486,15,6,24,54,2.20718755595103,4.44559642572919,7.98679725388654,101,"ENSG00000079974.19"
"6840","ENSG00000112077.18_22736",22728,22736,9,"ENSG00000112077.18",1,2,"VMVVVVVVV",0,8,0.884057971014493,109,115,133,136,138,144,182,185,"ATGAAGG","TTGA","TTGAGGT","CTGA",2.48705486384161,18,2,38,67,1.22179424352262,4.45054000061667,7.98677188467464,101,"ENSG00000079974.19"
"43222","ENSG00000270106.6_60152",60144,60152,9,"ENSG00000270106.6",1,7,"VVVVVVMVV",0,8,0.885300207039338,115,121,133,136,163,169,180,183,"AGGATCA","CAGG","GTGACGT","CTGA",2.35628000034303,12,27,11,59,2.07350491570728,4.44550956283188,7.98671039098923,101,"ENSG00000079974.19"
"11455","ENSG00000135002.12_8539",8531,8539,9,"ENSG00000135002.12",0,NA,"UVVVVVVVV",1,8,0.902691511387163,57,63,99,102,108,114,133,136,"ATTATGA","CTGA","ATAAAAA","CTCA",2.39077786404335,36,6,19,70,1.56517682547865,4.37592397977524,7.98669002532389,101,"ENSG00000079974.19"
"4484","ENSG00000100650.16_14693",14685,14693,9,"ENSG00000100650.16",1,7,"VVVVVVMVV",0,8,0.885300207039338,113,119,133,136,146,152,164,167,"ATACTGA","GTCA","AAGAAAA","CTGA",2.24335449761118,14,10,12,45,2.82619369388064,4.44547258615546,7.98667341431281,101,"ENSG00000079974.19"
"32644","ENSG00000227463.3_13834",13826,13834,9,"ENSG00000227463.3",1,5,"VVVVMVVVV",0,8,0.886542443064182,95,101,133,136,139,145,158,161,"TTGCTGA","GTAA","ATGATCA","CTGA",2.41779259311675,32,3,13,57,1.64337845679667,4.44049893606042,7.98666870831715,101,"ENSG00000079974.19"
"45568","ENSG00000285713.1_280006",279998,280006,9,"ENSG00000285713.1",1,1,"MVVUVVVVV",1,7,0.786749482401656,84,90,133,136,144,150,165,168,"ATGAAGG","CTGA","GTGAAGT","CTGA",2.63314911594728,43,8,15,75,1.8042105130552,4.83963448817593,7.98663241778256,101,"ENSG00000079974.19"
"45668","ENSG00000285783.1_52785",52777,52785,9,"ENSG00000285783.1",1,1,"MVVUVVVVV",1,7,0.786749482401656,84,90,133,136,144,150,165,168,"ATGAAGG","CTGA","GTGAAGT","CTGA",2.63314911594728,43,8,15,75,1.8042105130552,4.83963448817593,7.98663241778256,101,"ENSG00000079974.19"
"29537","ENSG00000198169.9_33103",33095,33103,9,"ENSG00000198169.9",1,2,"VMVVVVVVV",0,8,0.884057971014493,115,121,133,136,143,149,178,181,"CCGAAGA","CAGA","ATCAAGA","CTGA",2.34787456936219,12,7,29,57,2.14909010847978,4.45039680939026,7.98662869344823,101,"ENSG00000079974.19"
"52","ENSG00000003096.15_147546",147538,147546,9,"ENSG00000003096.15",1,6,"VVVVVMVVV",0,8,0.902691511387163,69,75,88,91,98,104,133,136,"ATGATGA","TTGT","ATTAGTA","CTTA",2.30382006526015,13,7,29,58,2.14454649301031,4.37583673201949,7.98660277756814,101,"ENSG00000079974.19"
"28796","ENSG00000196511.15_168756",168748,168756,9,"ENSG00000196511.15",1,1,"MVVVVUVVV",1,7,0.82815734989648,110,116,133,136,150,156,170,173,"ATGATGT","CCCA","TGGATGT","CTGA",2.46699531943146,17,14,14,54,2.24923297717074,4.67396711001178,7.9865965095977,101,"ENSG00000079974.19"
"40069","ENSG00000254878.1_2140",2132,2140,9,"ENSG00000254878.1",0,NA,"UVVVVVVVV",1,8,0.902691511387163,75,81,92,95,103,109,133,136,"ATGATGC","CTGA","CTGATTA","CACA",2.2841371954044,11,8,24,52,2.27554102598257,4.37578058216964,7.98654662771829,101,"ENSG00000079974.19"
"36369","ENSG00000240303.8_14228",14220,14228,9,"ENSG00000240303.8",0,NA,"VVUVVVVVV",1,8,0.883643892339545,74,80,90,93,100,106,133,136,"GTGGTGG","CTGA","GTGATTA","CTCA",2.35270077407405,10,7,27,53,2.12302876598959,4.45192514828749,7.98650071764567,101,"ENSG00000079974.19"
"43872","ENSG00000274810.4_76605",76597,76605,9,"ENSG00000274810.4",0,NA,"VVUVVVVVV",1,8,0.883643892339545,74,80,90,93,100,106,133,136,"GTGGTGG","CTGA","GTGATTA","CTCA",2.35270077407405,10,7,27,53,2.12302876598959,4.45192514828749,7.98650071764567,101,"ENSG00000079974.19"
"23154","ENSG00000172264.19_365195",365187,365195,9,"ENSG00000172264.19",1,1,"MVVVVVVVV",0,8,0.90600414078675,114,120,133,136,157,163,178,181,"CTGCTGT","CTTG","CTGAGGA","CTGA",2.309769448159,13,21,15,58,2.05107120124471,4.36238354724284,7.98640011038984,101,"ENSG00000079974.19"
"9725","ENSG00000126777.18_22419",22411,22419,9,"ENSG00000126777.18",0,NA,"VVVVVUUVV",2,7,0.808281573498965,112,118,133,136,181,187,202,205,"GTGATGA","TTGA","GTGATGA","TTGA",2.5925802061072,15,45,15,84,1.72920452746965,4.75326814204608,7.98639443604194,101,"ENSG00000079974.19"
"30853","ENSG00000214113.11_35031",35023,35031,9,"ENSG00000214113.11",1,8,"VVUVVVVMV",1,7,0.767701863354037,116,122,133,136,144,150,166,169,"ATGATGA","ATTA","ATACTGT","CTGA",2.54004372019078,11,8,16,44,2.72866022066996,4.91557125548546,7.9863787089016,101,"ENSG00000079974.19"
"12475","ENSG00000138375.14_32840",32832,32840,9,"ENSG00000138375.14",1,7,"VVVVVVMVV",0,8,0.885300207039338,88,94,133,136,146,152,171,174,"AGGGTGA","CTTG","GTGATGA","CTGA",2.44576318492682,39,10,19,77,1.47558337970693,4.44516781980476,7.98636864796211,101,"ENSG00000079974.19"
"24807","ENSG00000178031.18_84102",84094,84102,9,"ENSG00000178031.18",1,1,"MVVVVVVVV",0,8,0.90600414078675,100,106,133,136,143,149,202,205,"ATTAAGA","CTCA","CAGATGA","CTGA",2.45180350330029,27,7,53,96,1.10389155805199,4.36231206168014,7.98632862482714,101,"ENSG00000079974.19"
"30615","ENSG00000206052.11_421578",421570,421578,9,"ENSG00000206052.11",0,NA,"UVVVVVVVV",1,8,0.902691511387163,115,121,133,136,186,192,226,229,"AAGATGA","CAGG","TTGGGGA","CTGA",2.46563473484112,12,50,34,105,1.06465029939968,4.37555379958512,7.98631984513377,101,"ENSG00000079974.19"
"31877","ENSG00000225107.1_17395",17387,17395,9,"ENSG00000225107.1",1,2,"VMVVVVVVV",0,8,0.884057971014493,92,98,133,136,141,147,174,177,"AGGATGA","GAGA","CTGAGGC","CTGA",2.49849658114433,35,5,27,76,1.14367907709145,4.45008073784674,7.98631262190471,101,"ENSG00000079974.19"
"38703","ENSG00000250910.8_135587",135579,135587,9,"ENSG00000250910.8",0,NA,"UVVVUVVVV",2,7,0.792546583850932,114,120,133,136,153,159,169,172,"ATGATAA","GTGG","TTGAAGA","CTGA",2.52592869254841,13,17,10,49,2.42491819254317,4.81611070238315,7.98629703778687,101,"ENSG00000079974.19"
"27067","ENSG00000185532.20_179794",179786,179794,9,"ENSG00000185532.20",1,6,"VVVVVMUVV",1,7,0.788819875776397,59,65,80,83,92,98,133,136,"ATGAGGT","CTGA","GAGAAGA","CTGA",2.61164592830304,15,9,35,68,1.91309060048006,4.83101586395841,7.986295367064,101,"ENSG00000079974.19"
"18825","ENSG00000158636.17_41928",41920,41928,9,"ENSG00000158636.17",1,8,"UVVVVVVMV",1,7,0.786749482401656,97,103,133,136,144,150,169,172,"ATGATGA","CTAT","ATGGTGA","CTGA",2.66272452051551,30,8,19,66,1.60546889077876,4.83924142355387,7.9862393531605,101,"ENSG00000079974.19"
"37200","ENSG00000245832.7_869445",869437,869445,9,"ENSG00000245832.7",0,NA,"VVVVVVUVV",1,8,0.886128364389234,77,83,98,101,108,114,133,136,"AAGATGA","CTTC","GTGTTGA","GTGA",2.29220279198059,15,7,19,50,2.48551652562052,4.44171711803945,7.98623057559639,101,"ENSG00000079974.19"
"7552","ENSG00000114805.18_16366",16358,16366,9,"ENSG00000114805.18",1,1,"MVVVVUVVV",1,7,0.82815734989648,84,90,104,107,115,121,133,136,"AAAATGG","CTGA","ATAGGGA","CTGA",2.36601105781152,14,8,12,43,2.92097912702687,4.67359654477591,7.98622594436183,101,"ENSG00000079974.19"
"21250","ENSG00000166900.17_81999",81991,81999,9,"ENSG00000166900.17",1,8,"VVVVVVVMV",0,8,0.884057971014493,113,119,133,136,146,152,160,163,"GAGATGA","GTGA","GTCAGGC","GTGA",2.2399999213292,14,10,8,41,2.86643073501561,4.44994088596924,7.98617277002721,101,"ENSG00000079974.19"
"17322","ENSG00000153914.16_2274",2266,2274,9,"ENSG00000153914.16",1,3,"VVMVVVVVV",0,8,0.882815734989648,110,116,133,136,148,154,162,165,"ATTATTA","TTTA","ATTATAA","CTGA",2.29714705388211,17,12,8,46,2.50511453636657,4.45485705722849,7.98611999718708,101,"ENSG00000079974.19"
"27765","ENSG00000187323.12_414824",414816,414824,9,"ENSG00000187323.12",1,1,"MVVUVUVVV",2,6,0.708902691511387,85,91,103,106,110,116,133,136,"GTGATGA","TTGA","ATGAGTA","CTGA",2.70735457869408,12,4,17,42,2.55294787749184,5.15049460052975,7.9861053665753,101,"ENSG00000079974.19"
"31481","ENSG00000223812.8_7112",7104,7112,9,"ENSG00000223812.8",1,2,"VMVVVVVVV",0,8,0.884057971014493,99,105,133,136,138,144,153,156,"TTGTTGT","CTGA","ATCAGGT","CTGA",2.42934700976559,28,2,9,48,1.60367379732598,4.44983013227414,7.98606201633211,101,"ENSG00000079974.19"
"29836","ENSG00000198793.14_11220",11212,11220,9,"ENSG00000198793.14",1,8,"VVVVVVVMV",0,8,0.884057971014493,110,116,133,136,146,152,172,175,"ATGAAGG","CTAC","GGGAAGA","CTGA",2.3444531530883,17,10,20,56,2.16961579642561,4.44982587092024,7.98605775497821,101,"ENSG00000079974.19"
"17856","ENSG00000155530.4_79600",79592,79600,9,"ENSG00000155530.4",1,1,"MVVVVUVVV",1,7,0.82815734989648,113,119,133,136,145,151,168,171,"CTGACTA","ATGA","ATGATAA","CTGA",2.41206209872874,14,9,17,49,2.61329259943963,4.67342664774114,7.98605604732706,101,"ENSG00000079974.19"
"47051","ENSG00000287555.1_39287",39279,39287,9,"ENSG00000287555.1",0,NA,"UVVVVVVVV",1,8,0.902691511387163,115,121,133,136,145,151,172,175,"AATATGT","TTGA","AGGATAC","CTGA",2.26343607700608,12,9,21,51,2.41151398869837,4.37527195885139,7.98603800440004,101,"ENSG00000079974.19"
"35939","ENSG00000237505.8_309347",309339,309347,9,"ENSG00000237505.8",1,6,"VVVVVMVVV",0,8,0.902691511387163,67,73,86,89,101,107,133,136,"ATGATCA","TGGA","GTGAGGA","CTTA",2.32542840919586,13,12,26,60,1.99779206148463,4.37516203069758,7.98592807624624,101,"ENSG00000079974.19"
"21918","ENSG00000169306.10_23215",23207,23215,9,"ENSG00000169306.10",0,NA,"UVVVVUVVV",2,7,0.824844720496894,114,120,133,136,141,147,181,184,"CTGATGT","CTGT","TTGTTGC","CTGA",2.51330037960509,13,5,34,61,1.99061524450171,4.68648777713392,7.98586665912149,101,"ENSG00000079974.19"
"4015","ENSG00000091879.14_35538",35530,35538,9,"ENSG00000091879.14",1,1,"MVVVVVVVV",0,8,0.90600414078675,111,117,133,136,148,154,172,175,"GTGGGGA","TTAA","GTGATCT","CTGA",2.28108975214374,16,12,18,55,2.2398415730199,4.36177664682787,7.98579320997487,101,"ENSG00000079974.19"
"8902","ENSG00000121351.8_6902",6894,6902,9,"ENSG00000121351.8",1,1,"MVVVVVVVV",0,8,0.90600414078675,116,122,133,136,165,171,186,189,"AAAAAGA","ATGA","GTGAAAA","CTGA",2.33902463377614,11,29,15,64,1.85315334787354,4.36166272659528,7.98567928974228,101,"ENSG00000079974.19"
"18511","ENSG00000157542.11_470656",470648,470656,9,"ENSG00000157542.11",0,NA,"VVVVVVUVV",1,8,0.886128364389234,94,100,133,136,144,150,205,208,"GTAATGA","ATAA","GTGAAGA","CTGA",2.51403307679035,33,8,55,105,1.00433338222891,4.44113847354115,7.98565193109808,101,"ENSG00000079974.19"
"30396","ENSG00000204904.7_6587",6579,6587,9,"ENSG00000204904.7",1,2,"VMVVVUVVV",1,7,0.806211180124223,46,52,72,75,87,93,133,136,"GTGATGA","TAGA","ATGAGGA","CTGA",2.66495730422937,20,12,40,81,1.27671731676575,4.76077483624039,7.98561955673729,101,"ENSG00000079974.19"
"36597","ENSG00000242009.2_60392",60384,60392,9,"ENSG00000242009.2",1,1,"MVVVVVVVV",0,8,0.90600414078675,116,122,133,136,140,146,159,162,"ATTAAGA","CTAA","CTGAGGT","TTGA",2.19532539631569,11,4,13,37,2.81054232819474,4.36151124257483,7.98552780572183,101,"ENSG00000079974.19"
"32922","ENSG00000228262.11_581785",581777,581785,9,"ENSG00000228262.11",1,8,"VVVVVVVMV",0,8,0.884057971014493,111,117,133,136,152,158,170,173,"ATGAAGG","TAGA","TTAATCA","CTGA",2.32683664343096,16,16,12,53,2.28475512965969,4.44924985479986,7.98548173885783,101,"ENSG00000079974.19"
"28278","ENSG00000188596.11_93769",93761,93769,9,"ENSG00000188596.11",1,2,"VMVVVUVVV",1,7,0.806211180124223,113,119,133,136,145,151,164,167,"ATGTAGA","GTGA","CTGATCT","CTGA",2.43037713299368,14,9,13,45,2.83962813440549,4.76053558859085,7.98538030908774,101,"ENSG00000079974.19"
"5163","ENSG00000103528.17_30402",30394,30402,9,"ENSG00000103528.17",1,7,"VVVVVVMVV",0,8,0.885300207039338,75,81,91,94,107,113,133,136,"ATGAAGA","CTGG","GTGGTGC","CAGA",2.34698025615258,10,13,20,52,2.13014911703055,4.44417103951193,7.98537186766928,101,"ENSG00000079974.19"
"28154","ENSG00000188266.14_27120",27112,27120,9,"ENSG00000188266.14",1,8,"VVVVVUVMV",1,7,0.806211180124224,112,118,133,136,145,151,168,171,"AAGATGC","TTGA","TTGGAGA","CTGA",2.47254655260165,15,9,17,50,2.55843997602604,4.76052091500925,7.98536563550615,101,"ENSG00000079974.19"
"28219","ENSG00000188517.17_335243",335235,335243,9,"ENSG00000188517.17",1,5,"VVVVMVVVV",0,8,0.886542443064182,18,24,35,38,80,86,133,136,"ATGATTA","CTGA","ATGATTA","CTCA",2.51576653920404,11,42,47,109,0.984577952196174,4.43908872005578,7.98525849231251,101,"ENSG00000079974.19"
"45876","ENSG00000286016.1_27591",27583,27591,9,"ENSG00000286016.1",1,1,"MVVVVVVVV",0,8,0.90600414078675,116,122,133,136,139,145,153,156,"TTTATAA","AGGA","GTCAGGC","CTGA",2.17159513562665,11,3,8,31,2.96752828093801,4.36120729627892,7.98522385942592,101,"ENSG00000079974.19"
"22416","ENSG00000170522.10_129509",129501,129509,9,"ENSG00000170522.10",0,NA,"VVUVVVVVV",1,8,0.883643892339545,108,114,133,136,145,151,160,163,"AGGATCA","CTGA","CAGAAGA","CTTA",2.29084626862723,19,9,9,46,2.5301595398526,4.45061699934187,7.98519256870005,101,"ENSG00000079974.19"
"23225","ENSG00000172340.15_261624",261616,261624,9,"ENSG00000172340.15",0,NA,"UVVVVVVVV",1,8,0.902691511387163,109,115,133,136,152,158,175,178,"GTGAGTA","CAGT","GTGATGC","CTGA",2.34674531555829,18,16,17,60,1.85258251012999,4.37438782012965,7.9851538656783,101,"ENSG00000079974.19"
"31697","ENSG00000224478.3_20527",20519,20527,9,"ENSG00000224478.3",1,1,"MVVVVVVVV",0,8,0.90600414078675,115,121,133,136,141,147,186,189,"ATTCTGT","ATGA","CTGATTC","CTGA",2.32320681348584,12,5,39,65,1.95649666036811,4.36113552090176,7.98515208404876,101,"ENSG00000079974.19"
"4276","ENSG00000100024.15_3319",3311,3319,9,"ENSG00000100024.15",0,NA,"VVVUVVVVV",1,8,0.880745341614907,114,120,133,136,145,151,173,176,"GTGCTGG","ATCA","AAGATGA","CTGA",2.3241714442156,13,9,22,53,2.35395841980873,4.46210867864485,7.98509004510448,101,"ENSG00000079974.19"
"36961","ENSG00000243943.10_19920",19912,19920,9,"ENSG00000243943.10",1,8,"VVVVVUVMV",1,7,0.806211180124224,28,34,46,49,98,104,133,136,"GTGATGA","GTGA","GGGATGG","CTGA",2.68357908229655,12,49,29,99,1.15024998919107,4.76019430112535,7.98503902162225,101,"ENSG00000079974.19"
"41478","ENSG00000259080.1_19843",19835,19843,9,"ENSG00000259080.1",1,8,"VVVVVUVMV",1,7,0.806211180124224,28,34,46,49,98,104,133,136,"GTGATGA","GTGA","GGGATGG","CTGA",2.68357908229655,12,49,29,99,1.15024998919107,4.76019430112535,7.98503902162225,101,"ENSG00000079974.19"
"25409","ENSG00000181355.21_336982",336974,336982,9,"ENSG00000181355.21",1,2,"VMVVVVVVV",0,8,0.884057971014493,115,121,133,136,148,154,182,185,"AATATGA","GAGA","AAGATGA","CTGA",2.37815079207721,12,12,28,61,1.94050296136106,4.44871039380228,7.98494227786025,101,"ENSG00000079974.19"
"28307","ENSG00000188641.14_747800",747792,747800,9,"ENSG00000188641.14",1,7,"UVVVVVMVV",1,7,0.787991718426501,114,120,133,136,150,156,179,182,"ATGATGT","TAGA","ATGATAA","CTGA",2.60317166317194,13,14,23,59,1.97708763688371,4.83289134784083,7.98485822154684,101,"ENSG00000079974.19"
"29814","ENSG00000198765.12_79011",79003,79011,9,"ENSG00000198765.12",1,1,"MVVVVVVVV",0,8,0.90600414078675,90,96,133,136,165,171,189,192,"ATGAAGC","ATGA","GTGAAAA","CTGA",2.5112194114755,37,29,18,93,0.701697982328131,4.36079018137453,7.98480674452153,101,"ENSG00000079974.19"
"10737","ENSG00000132561.14_75875",75867,75875,9,"ENSG00000132561.14",1,7,"VVVVVVMVV",0,8,0.885300207039338,83,89,133,136,140,146,159,162,"ATTATGT","GTGC","GTGAAGG","CTGA",2.40256489796106,44,4,13,70,1.75720176293184,4.44357527066805,7.9847760988254,101,"ENSG00000079974.19"
"23758","ENSG00000173898.15_28002",27994,28002,9,"ENSG00000173898.15",0,NA,"UVVVVUVVV",2,7,0.824844720496894,115,121,133,136,147,153,166,169,"CTGTTGA","ATGT","CAGATGA","CTGA",2.39716392648276,12,11,13,45,2.76039948308047,4.68537308157471,7.98475196356229,101,"ENSG00000079974.19"
"719","ENSG00000028116.18_194608",194600,194608,9,"ENSG00000028116.18",1,8,"VVVVVVVMV",0,8,0.884057971014493,116,122,133,136,138,144,153,156,"ATCATGA","CTCA","ATATTAA","TTGA",2.24748183818447,11,2,9,31,2.81035846144707,4.44839267900255,7.98462456306052,101,"ENSG00000079974.19"
"12357","ENSG00000137947.12_37082",37074,37082,9,"ENSG00000137947.12",1,2,"VMVVVVUVV",1,7,0.770186335403727,104,110,133,136,144,150,158,161,"ATGATGG","CTAA","CTGATTT","CTGA",2.6060559668083,23,8,8,48,2.24163511032147,4.90383538892753,7.98458073054244,101,"ENSG00000079974.19"
"5845","ENSG00000107021.16_12245",12237,12245,9,"ENSG00000107021.16",1,8,"VVVVVUVMV",1,7,0.806211180124224,84,90,133,136,142,148,160,163,"AGGATGA","CTGG","CTCAGGA","CTGA",2.56449229369042,43,6,12,70,1.94232581758066,4.75973527721253,7.98457999770942,101,"ENSG00000079974.19"
"4803","ENSG00000101938.15_41697",41689,41697,9,"ENSG00000101938.15",1,5,"VVVVMVVVV",0,8,0.886542443064182,105,111,133,136,145,151,159,162,"AAGATCA","CTTA","AGCATGT","CTGA",2.3226031572533,22,9,8,48,2.26959673365347,4.4384044455022,7.98457421775893,101,"ENSG00000079974.19"
"46537","ENSG00000286785.1_74890",74882,74890,9,"ENSG00000286785.1",0,NA,"UVVVVVVVV",1,8,0.902691511387163,112,118,133,136,161,167,222,225,"ATGATGT","CTTT","GTGCAAA","CTGA",2.46915278822691,15,25,55,104,1.03416701010872,4.37379639957203,7.98456244512068,101,"ENSG00000079974.19"
"1697","ENSG00000065413.20_34850",34842,34850,9,"ENSG00000065413.20",1,2,"VMVVVVVVV",0,8,0.884057971014493,78,84,94,97,115,121,133,136,"ATCATGA","CTGT","GAGATGG","CTTA",2.3312690423272,10,18,12,49,2.25133038153497,4.4482809992624,7.98451288332037,101,"ENSG00000079974.19"
"35753","ENSG00000236977.1_26196",26188,26196,9,"ENSG00000236977.1",1,2,"VMVVVVVVV",0,8,0.884057971014493,78,84,94,97,115,121,133,136,"ATCATGA","CTGT","GAGATGG","CTTA",2.3312690423272,10,18,12,49,2.25133038153497,4.4482809992624,7.98451288332037,101,"ENSG00000079974.19"
"7265","ENSG00000113448.20_1055681",1055673,1055681,9,"ENSG00000113448.20",0,NA,"VVVUVVVVV",1,8,0.880745341614907,95,101,133,136,179,185,202,205,"ATGCTGA","TTGA","ATAATTA","CTGA",2.56815263415956,32,43,17,101,0.725087135651869,4.4615261741789,7.98450754063853,101,"ENSG00000079974.19"
"42123","ENSG00000260850.4_100909",100901,100909,9,"ENSG00000260850.4",1,8,"VVVVUVVMV",1,7,0.773913043478261,88,94,102,105,114,120,133,136,"ATGTTGA","AAGA","CTGTTGA","CTGA",2.5364233810742,8,9,13,39,2.64563170568707,4.8887802282121,7.98443240212514,101,"ENSG00000079974.19"
"47228","ENSG00000287876.1_143781",143773,143781,9,"ENSG00000287876.1",1,1,"MVVVVVVVV",0,8,0.90600414078675,108,114,133,136,149,155,200,203,"AAGATAA","ATGA","CTTAAGA","CTGA",2.42443031336186,19,13,45,86,1.27837806777937,4.36031170588128,7.98432826902828,101,"ENSG00000079974.19"
"8626","ENSG00000119906.13_45749",45741,45749,9,"ENSG00000119906.13",1,8,"VVVVVVVMV",0,8,0.884057971014493,115,121,133,136,148,154,177,180,"TAGATGA","TAGA","TTTATAA","CTGA",2.35011395655919,12,12,23,56,2.12470436630239,4.44803268584091,7.98426456989889,101,"ENSG00000079974.19"
"47743","ENSG00000289158.1_109",101,109,9,"ENSG00000289158.1",1,2,"VMVVVVVVV",0,8,0.884057971014493,40,46,65,68,72,78,111,114,"AGGATGA","CTGA","ATTATGC","TTGA",2.44522909639022,19,4,33,65,1.49050817598706,4.4480088713138,7.98424075537177,101,"ENSG00000079974.19"
"17311","ENSG00000153904.21_106576",106568,106576,9,"ENSG00000153904.21",1,8,"VVVVVUVMV",1,7,0.806211180124224,84,90,100,103,116,122,133,136,"AGGAGGA","CAGA","TTGAAGT","CTGA",2.463855824965,10,13,11,43,2.61162070483054,4.75933155114931,7.9841762716462,101,"ENSG00000079974.19"
"3413","ENSG00000083312.19_70160",70152,70160,9,"ENSG00000083312.19",1,7,"VVVVUVMVV",1,7,0.775155279503105,83,89,97,100,115,121,133,136,"ATCATGA","ATGA","ATGGTTA","CTGA",2.59235115631137,8,15,12,44,2.25170591514295,4.88351173930469,7.98413285731712,101,"ENSG00000079974.19"
"16589","ENSG00000151834.16_27530",27522,27530,9,"ENSG00000151834.16",1,8,"VVVVVVVMV",0,8,0.884057971014493,99,105,133,136,145,151,195,198,"ATGCTGA","ATGA","GTACTCA","CTGA",2.51308115545307,28,9,44,90,1.03768806021788,4.44789060747626,7.98412249153423,101,"ENSG00000079974.19"
"44553","ENSG00000282987.1_214688",214680,214688,9,"ENSG00000282987.1",1,5,"VVVVMVVVV",0,8,0.886542443064182,115,121,133,136,147,153,163,166,"ATCAGGA","CTGT","TTGATGG","GTGA",2.23483648166012,12,11,10,42,2.85263932279037,4.43788730013112,7.98405707238785,101,"ENSG00000079974.19"
"27643","ENSG00000186998.16_38091",38083,38091,9,"ENSG00000186998.16",1,1,"MVVVVVVVV",0,8,0.90600414078675,97,103,133,136,178,184,197,200,"ATGATGA","CAGG","GTGAAGA","CTGC",2.47083913712121,30,42,13,94,0.967662645315286,4.35998088986417,7.98399745301117,101,"ENSG00000079974.19"
"48011","ENSG00000290019.1_1278",1270,1278,9,"ENSG00000290019.1",1,5,"VVVVMVVVV",0,8,0.886542443064182,99,105,133,136,147,153,204,207,"ATGATGG","AAGA","CTGCAGA","CTGA",2.52540669660568,28,11,51,99,0.915076665132952,4.4377803272927,7.98395009954943,101,"ENSG00000079974.19"
"24834","ENSG00000178175.12_55831",55823,55831,9,"ENSG00000178175.12",1,1,"MVVVVVVVV",0,8,0.90600414078675,114,120,133,136,174,180,188,191,"ATAATGA","CTAA","GTGAATT","TTGA",2.31792155016184,13,38,8,68,1.98678427798463,4.35989865309922,7.98391521624622,101,"ENSG00000079974.19"
"37146","ENSG00000245662.4_67843",67835,67843,9,"ENSG00000245662.4",1,2,"VMVVVVVVV",0,8,0.884057971014493,100,106,133,136,144,150,158,161,"ATGCTGA","TTGG","AACTTGA","CTGA",2.35811443184586,27,8,8,52,2.0697255810976,4.4476221150175,7.98385399907547,101,"ENSG00000079974.19"
"10145","ENSG00000129521.15_462141",462133,462141,9,"ENSG00000129521.15",0,NA,"VVUVUVVVV",2,7,0.773498964803312,59,65,79,82,88,94,133,136,"AGGATGA","ATGA","GTGTGGA","CTGA",2.63797625167844,14,6,39,68,1.97259815259283,4.88977662427894,7.98377248349219,101,"ENSG00000079974.19"
"21149","ENSG00000166579.16_5296",5288,5296,9,"ENSG00000166579.16",1,8,"VVVVVVVMV",0,8,0.884057971014493,116,122,133,136,171,177,187,190,"CTGATAA","AGGA","GTTATTA","CTGA",2.36922133009918,11,35,10,65,1.99463223915366,4.44736027662037,7.98359216067835,101,"ENSG00000079974.19"
"14655","ENSG00000145681.11_57016",57008,57016,9,"ENSG00000145681.11",1,1,"MVVVVVVVV",0,8,0.90600414078675,111,117,133,136,172,178,197,200,"AGGATGG","ATGG","GTGAAGG","CTGA",2.40129964313918,16,36,19,80,1.42957592165815,4.35956005231317,7.98357661546016,101,"ENSG00000079974.19"
"41618","ENSG00000259360.1_1819",1811,1819,9,"ENSG00000259360.1",1,6,"VVVVVMVVV",0,8,0.902691511387163,113,119,133,136,138,144,153,156,"ATGGCAA","AGGA","ATGCTGA","CTGA",2.22549064193041,14,2,9,34,2.65446669549672,4.37276774375821,7.98353378930686,101,"ENSG00000079974.19"
"45344","ENSG00000285471.1_201572",201564,201572,9,"ENSG00000285471.1",1,3,"UVMVVVVVV",1,7,0.785507246376811,115,121,133,136,143,149,161,164,"ATCATGA","TTGT","CTTAAGA","CTGA",2.45616899871573,12,7,12,40,2.99132810114279,4.84144702314525,7.9834760086525,101,"ENSG00000079974.19"
"33546","ENSG00000230257.7_6363",6355,6363,9,"ENSG00000230257.7",1,1,"MVVVVVVVV",0,8,0.90600414078675,72,78,91,94,108,114,133,136,"AAGGTGA","CTGA","TTGCTGT","CTAA",2.28661258814642,13,14,19,55,2.19373332485957,4.35945431145892,7.98347087460592,101,"ENSG00000079974.19"
"28074","ENSG00000188107.15_1756477",1756469,1756477,9,"ENSG00000188107.15",1,1,"MVVVVVVVV",0,8,0.90600414078675,114,120,133,136,142,148,182,185,"GAGAAGA","ATCA","CTGATTA","CTGA",2.30918421148181,13,6,34,62,2.04296431747788,4.35938143183915,7.98339799498615,101,"ENSG00000079974.19"
"21548","ENSG00000168297.16_40771",40763,40771,9,"ENSG00000168297.16",0,NA,"VVVUVVVVV",1,8,0.880745341614907,111,117,133,136,142,148,165,168,"CTGATGT","ATGA","TTGAGGT","CTGT",2.29803114223792,16,6,17,48,2.52115635066347,4.46034099139573,7.98332235785536,101,"ENSG00000079974.19"
"26253","ENSG00000183722.9_173538",173530,173538,9,"ENSG00000183722.9",1,8,"VVVVVVVMV",0,8,0.884057971014493,99,105,133,136,142,148,163,166,"GTTATGA","AAGA","GAGAAGG","CTGA",2.38637194246198,28,6,15,58,1.8788576423334,4.44700098135332,7.98323286541129,101,"ENSG00000079974.19"
"10598","ENSG00000131773.15_78304",78296,78304,9,"ENSG00000131773.15",1,6,"VVVVVMVVV",0,8,0.902691511387163,88,94,108,111,114,120,133,136,"GTGCTGC","TTGA","CTGAGGA","CAGA",2.22911583217838,14,3,13,39,2.62870264911643,4.37236871590974,7.98313476145839,101,"ENSG00000079974.19"
"7429","ENSG00000114126.18_9481",9473,9481,9,"ENSG00000114126.18",1,1,"MVVVVVVVV",0,8,0.90600414078675,66,72,85,88,97,103,133,136,"GTGATTA","ATGA","GAGAAGA","ATGA",2.30454215849664,13,9,30,61,2.0727745457934,4.35909723394275,7.98311379708975,101,"ENSG00000079974.19"
"34625","ENSG00000233635.2_35303",35295,35303,9,"ENSG00000233635.2",1,1,"MVVVVVVVV",0,8,0.90600414078675,110,116,133,136,140,146,157,160,"AATATGG","CAAA","GTGATTG","CTGA",2.22502245333465,17,4,11,41,2.60270341598938,4.35904660955509,7.98306317270209,101,"ENSG00000079974.19"
"11117","ENSG00000133962.8_73593",73585,73593,9,"ENSG00000133962.8",0,NA,"UVVVVVVVV",1,8,0.902691511387163,90,96,133,136,144,150,196,199,"ATCATGA","TGGA","GTAATTA","CTGA",2.47382884802061,37,8,46,100,0.996926451249511,4.37227969284672,7.98304573839537,101,"ENSG00000079974.19"
"38885","ENSG00000251209.10_66432",66424,66432,9,"ENSG00000251209.10",1,8,"UVVVVVVMV",1,7,0.786749482401656,73,79,92,95,112,118,133,136,"ATGATGA","GTGA","CTGAGGA","TTGA",2.56544033836939,13,17,15,54,2.24092249656429,4.83596452142339,7.98296245103002,101,"ENSG00000079974.19"
"13114","ENSG00000140280.14_17182",17174,17182,9,"ENSG00000140280.14",1,5,"VVVVMVVVV",0,8,0.886542443064182,83,89,133,136,142,148,156,159,"GTGAAGA","GGGA","TTTCTGA","CTGA",2.36740795260727,44,6,8,67,1.96425965237848,4.43674483410674,7.98291460636347,101,"ENSG00000079974.19"
"28059","ENSG00000188107.15_1183208",1183200,1183208,9,"ENSG00000188107.15",0,NA,"UVVVVVVVV",1,8,0.902691511387163,116,122,133,136,145,151,160,163,"ATGATAA","CAAA","ATGTAAA","CTGG",2.17561009328582,11,9,9,38,2.98383488654197,4.37197554377853,7.98274158932718,101,"ENSG00000079974.19"
"38199","ENSG00000249781.7_167749",167741,167749,9,"ENSG00000249781.7",1,6,"VVVVVMVVV",0,8,0.902691511387163,113,119,133,136,142,148,160,163,"ATGACTT","GTGC","GTGAAAC","CTGA",2.18367929791147,14,6,12,41,2.92993519723474,4.3719492958278,7.98271534137645,101,"ENSG00000079974.19"
"7406","ENSG00000114021.12_5848",5840,5848,9,"ENSG00000114021.12",1,8,"VVVVUVVMV",1,7,0.773913043478261,88,94,133,136,153,159,168,171,"ATGATGA","TGGA","GTGATGG","CTGA",2.71789642035653,39,17,9,74,1.42882910741317,4.88703464411417,7.98268681802722,101,"ENSG00000079974.19"
"19616","ENSG00000163492.16_154719",154711,154719,9,"ENSG00000163492.16",1,1,"MVVVVVVVV",0,8,0.90600414078675,68,74,93,96,101,107,133,136,"AATATGA","CTGA","GTGAAGT","CTGG",2.35350903126132,19,5,26,59,1.74461745173048,4.35866941503483,7.98268597818183,101,"ENSG00000079974.19"
"8395","ENSG00000118557.16_36786",36778,36786,9,"ENSG00000118557.16",1,1,"MVVVVVVVV",0,8,0.90600414078675,85,91,102,105,114,120,133,136,"TTGAAGA","CTGT","ATGCAGC","CTAA",2.18587779637689,11,9,13,42,2.8619218755468,4.35861012951485,7.98262669266185,101,"ENSG00000079974.19"
"28222","ENSG00000188517.17_471746",471738,471746,9,"ENSG00000188517.17",1,1,"MVVVVUVVV",1,7,0.82815734989648,91,97,133,136,182,188,201,204,"GTGATGA","ATGA","AAGATCA","CTGA",2.66284053242002,36,46,13,104,0.92740761018476,4.66991945657955,7.98254885616547,101,"ENSG00000079974.19"
"8176","ENSG00000117114.21_483147",483139,483147,9,"ENSG00000117114.21",1,5,"UVVVMVVVV",1,7,0.789233954451346,116,122,133,136,154,160,171,174,"GTGATGT","CTAT","TTGATGA","CTGA",2.54516762213866,11,18,11,49,2.33454197024237,4.82558152945835,7.98251734726374,101,"ENSG00000079974.19"
"16372","ENSG00000151414.15_91105",91097,91105,9,"ENSG00000151414.15",0,NA,"VVUVVVVVV",1,8,0.883643892339545,79,85,101,104,111,117,133,136,"GTCATGT","CAGA","GTGAGGA","CGGA",2.27898380501557,16,7,16,48,2.59825334375833,4.44786967763221,7.98244524699038,101,"ENSG00000079974.19"
"1310","ENSG00000053108.17_369617",369609,369617,9,"ENSG00000053108.17",1,1,"MVVVVVVVV",0,8,0.90600414078675,109,115,133,136,142,148,159,162,"GTCATGA","GAGA","TTGATTA","CTGT",2.21836182236851,18,6,11,44,2.64463021358059,4.35842725734267,7.98244382048967,101,"ENSG00000079974.19"
"31755","ENSG00000224658.1_45333",45325,45333,9,"ENSG00000224658.1",1,5,"VVVVMVVVV",0,8,0.886542443064182,112,118,133,136,143,149,203,206,"TTGAAGA","GTAA","ATGGGGA","CTGA",2.37515755334868,15,7,54,85,1.9103995659129,4.43619581372603,7.98236558598276,101,"ENSG00000079974.19"
"18703","ENSG00000158220.14_40056",40048,40056,9,"ENSG00000158220.14",1,1,"MVVVVVVVV",0,8,0.90600414078675,106,112,133,136,153,159,193,196,"ATGAAGT","TTGA","TTGATCT","CTGA",2.47976524359327,21,17,34,81,0.901541378051612,4.35832741716836,7.98234398031536,101,"ENSG00000079974.19"
"30458","ENSG00000205035.9_191589",191581,191589,9,"ENSG00000205035.9",1,7,"VVVVVVMVV",0,8,0.885300207039338,97,103,110,113,116,122,133,136,"ATGATTA","ATGA","AAGGTGT","CAGA",2.2639251327162,7,3,11,30,2.67173332818336,4.44114188657284,7.98234271473019,101,"ENSG00000079974.19"
"48090","ENSG00000290401.1_193861",193853,193861,9,"ENSG00000290401.1",1,7,"VVVVVVMVV",0,8,0.885300207039338,97,103,110,113,116,122,133,136,"ATGATTA","ATGA","AAGGTGT","CAGA",2.2639251327162,7,3,11,30,2.67173332818336,4.44114188657284,7.98234271473019,101,"ENSG00000079974.19"
"6414","ENSG00000109756.10_124535",124527,124535,9,"ENSG00000109756.10",1,6,"VVVVVMVVV",0,8,0.902691511387163,104,110,133,136,171,177,194,197,"CTGATCA","CTGT","CTGATAG","CTGA",2.47431879260172,23,35,17,84,0.99055801773701,4.37150415877045,7.9822702043191,101,"ENSG00000079974.19"
"31676","ENSG00000224384.1_10397",10389,10397,9,"ENSG00000224384.1",1,1,"MVVVVVVVV",0,8,0.90600414078675,110,116,133,136,143,149,159,162,"AAGATAA","CTGC","GTGTTGC","CTCA",2.19983191484489,17,7,10,43,2.76734840728039,4.35822362656159,7.98224018970858,101,"ENSG00000079974.19"
"27236","ENSG00000185774.16_1138918",1138910,1138918,9,"ENSG00000185774.16",1,1,"MVVVVUVVV",1,7,0.82815734989648,113,119,133,136,150,156,164,167,"ATGCTGA","AAGA","ATAAGGG","CTGA",2.41578523233972,14,14,8,45,2.57287265732546,4.66952688489756,7.98215628448349,101,"ENSG00000079974.19"
"18067","ENSG00000156103.16_28890",28882,28890,9,"ENSG00000156103.16",1,1,"MVVVVVVVV",0,8,0.90600414078675,45,51,95,98,104,110,133,136,"ATGAAAA","CAGA","GTGTCGT","CTGA",2.41342959377616,44,6,23,82,1.34286354319348,4.35809854209197,7.98211510523896,101,"ENSG00000079974.19"
"13900","ENSG00000143889.16_33730",33722,33730,9,"ENSG00000143889.16",1,1,"MVVVVUVVV",1,7,0.82815734989648,72,78,96,99,109,115,133,136,"ATGAAGA","CTGG","GTGATGA","CTGT",2.47158812294794,18,10,18,55,2.20065885793331,4.6694782527299,7.98210765231582,101,"ENSG00000079974.19"
"6968","ENSG00000112378.12_9622",9614,9622,9,"ENSG00000112378.12",1,2,"VMVVVVVVV",0,8,0.884057971014493,67,73,81,84,92,98,133,136,"GCGATAA","CTGG","GTGGAGA","CTGA",2.40189144301617,8,8,35,60,1.77076312197898,4.4458431855217,7.98207506957967,101,"ENSG00000079974.19"
"8039","ENSG00000116667.15_146035",146027,146035,9,"ENSG00000116667.15",1,6,"VVVVVMVVV",0,8,0.902691511387163,107,113,133,136,150,156,171,174,"ATCATGT","CTTC","CTGCTGC","CTGA",2.33320865143542,20,14,15,58,1.93023577367234,4.37124002914379,7.98200607469244,101,"ENSG00000079974.19"
"25318","ENSG00000180777.15_12682",12674,12682,9,"ENSG00000180777.15",1,2,"UMVVVVVVV",1,7,0.786749482401656,67,73,85,88,112,118,133,136,"GAGATGA","ATGA","ATGTTGA","CTGA",2.6064175007963,12,24,15,60,1.96391485903387,4.8350078827523,7.98200581235892,101,"ENSG00000079974.19"
"21062","ENSG00000166352.18_80489",80481,80489,9,"ENSG00000166352.18",1,1,"MVVVVVVVV",0,8,0.90600414078675,90,96,133,136,145,151,186,189,"ATGAAGT","ATGA","TCGAAGA","CTGA",2.46354511623813,37,9,35,90,1.00796373685182,4.35789946127651,7.98191602442351,101,"ENSG00000079974.19"
"1142","ENSG00000048052.24_704294",704286,704294,9,"ENSG00000048052.24",1,1,"MVVVVVVVV",0,8,0.90600414078675,103,109,133,136,147,153,162,165,"ATGATGT","CTTA","ATGGTTC","CCGA",2.30694358669121,24,11,9,53,2.0518942865626,4.35787954945933,7.98189611260633,101,"ENSG00000079974.19"
"36640","ENSG00000242428.6_130870",130862,130870,9,"ENSG00000242428.6",1,8,"VVVVVVVMV",0,8,0.884057971014493,115,121,133,136,143,149,163,166,"ATATTGC","CTAA","AGGAAAA","CTGA",2.2340299292146,12,7,14,42,2.88891902407969,4.44561297137759,7.98184485543556,101,"ENSG00000079974.19"
"17063","ENSG00000153064.12_217208",217200,217208,9,"ENSG00000153064.12",1,1,"MVVVVVVVV",0,8,0.90600414078675,105,111,133,136,146,152,200,203,"ATTATTA","TTGA","TTGATTC","CTGA",2.42882611639268,22,10,48,89,1.23911298751752,4.35782177420051,7.98183833734751,101,"ENSG00000079974.19"
"3856","ENSG00000089472.18_76060",76052,76060,9,"ENSG00000089472.18",1,6,"VVVUVMVVV",1,7,0.78343685300207,109,115,133,136,145,151,170,173,"CTGATGA","GTGA","ATCAGGG","CTGA",2.58001432090496,18,9,19,55,2.19224701547607,4.84808562204394,7.98183303405222,101,"ENSG00000079974.19"
"13580","ENSG00000142224.18_62145",62137,62145,9,"ENSG00000142224.18",0,NA,"VVUVVVVVV",1,8,0.883643892339545,56,62,71,74,85,91,133,136,"ATTATGT","CTGG","ATCAAGT","CTGA",2.41554353680015,9,11,42,71,1.68504652910703,4.44716752694367,7.98174309630185,101,"ENSG00000079974.19"
"47756","ENSG00000289197.2_54951",54943,54951,9,"ENSG00000289197.2",1,1,"MVVVVUVVV",1,7,0.82815734989648,105,111,133,136,147,153,199,202,"ATGATGA","GAGA","CTGGTGG","CTGA",2.62472622027534,22,11,46,88,1.17810055899728,4.66906884020823,7.98169823979415,101,"ENSG00000079974.19"
"28895","ENSG00000196659.10_1997",1989,1997,9,"ENSG00000196659.10",1,7,"VVVVVVMVV",0,8,0.885300207039338,86,92,133,136,150,156,172,175,"ATGTTGG","TTGA","AGGATGG","CTGA",2.45691589018199,41,14,16,80,1.38234548882302,4.44044618917574,7.98164701733309,101,"ENSG00000079974.19"
"9241","ENSG00000123297.20_19265",19257,19265,9,"ENSG00000123297.20",0,NA,"VVUVVVVVV",1,8,0.883643892339545,111,117,133,136,156,162,173,176,"AAGAGGA","GGGA","ATGAGGT","CTGA",2.35295090116627,16,20,11,56,2.10168915665585,4.44700712444109,7.98158269379926,101,"ENSG00000079974.19"
"13785","ENSG00000143473.14_347360",347352,347360,9,"ENSG00000143473.14",1,8,"VVVVVVVMV",0,8,0.884057971014493,110,116,133,136,174,180,234,237,"AAGATGA","TGGA","ATGATGG","CTGA",2.55209838873281,17,38,54,118,0.767070556467374,4.44526495367152,7.98149683772949,101,"ENSG00000079974.19"
"40270","ENSG00000255410.2_694",686,694,9,"ENSG00000255410.2",1,8,"VVVVVVUMV",1,7,0.770186335403727,93,99,106,109,116,122,133,136,"GTGAGCA","CTGA","GTGCAGA","CTGA",2.52577533426157,7,7,11,34,2.76422608568165,4.90068207852303,7.98142742013794,101,"ENSG00000079974.19"
"27536","ENSG00000186452.11_7968",7960,7968,9,"ENSG00000186452.11",1,6,"VVVVVMVVV",0,8,0.902691511387163,107,113,133,136,154,160,181,184,"ACCATGA","ATGA","AGGATTA","CTGA",2.42388046261132,20,18,21,68,1.32343294300534,4.37065900677021,7.98142505231886,101,"ENSG00000079974.19"
"23434","ENSG00000172965.17_246834",246826,246834,9,"ENSG00000172965.17",1,2,"VMVVVVVVV",0,8,0.884057971014493,75,81,102,105,110,116,133,136,"CTCATGA","CTGA","TTGAAAA","CTCA",2.36124000093323,21,5,17,52,2.03916359148268,4.44519089942606,7.98142278348403,101,"ENSG00000079974.19"
"45053","ENSG00000284879.1_218914",218906,218914,9,"ENSG00000284879.1",1,2,"VMVVVVVVV",0,8,0.884057971014493,75,81,102,105,110,116,133,136,"CTCATGA","CTGA","TTGAAAA","CTCA",2.36124000093323,21,5,17,52,2.03916359148268,4.44519089942606,7.98142278348403,101,"ENSG00000079974.19"
"5268","ENSG00000104218.16_6023",6015,6023,9,"ENSG00000104218.16",1,8,"UVVVVVVMV",1,7,0.786749482401656,113,119,133,136,148,154,193,196,"ATGATGT","GTGA","TTGTAGA","CTGA",2.63741844123912,14,12,39,74,1.75466766165219,4.83436431747825,7.98136224708488,101,"ENSG00000079974.19"
"19723","ENSG00000163630.11_145275",145267,145275,9,"ENSG00000163630.11",1,1,"MVVVVVVVV",0,8,0.90600414078675,110,116,133,136,148,154,163,166,"ATGATGG","CAAA","TTGGTAA","GTGA",2.23604648191888,17,12,9,47,2.52224465846997,4.35730530114897,7.98132186429597,101,"ENSG00000079974.19"
"1107","ENSG00000047648.23_388325",388317,388325,9,"ENSG00000047648.23",1,8,"VVVVVVVMV",0,8,0.884057971014493,66,72,94,97,110,116,133,136,"TTCATCA","CTGA","CTTATCA","CTGA",2.40769659921036,22,13,17,61,1.72877074590039,4.4450203518257,7.98125223588367,101,"ENSG00000079974.19"
"13781","ENSG00000143473.14_197986",197978,197986,9,"ENSG00000143473.14",1,1,"MVVVVVVVV",0,8,0.90600414078675,85,91,103,106,112,118,133,136,"GTGATGA","TTGA","ATCAGGA","GTTA",2.19151843004543,12,6,15,42,2.81847126751759,4.35714853362177,7.98116509676877,101,"ENSG00000079974.19"
"32209","ENSG00000226320.6_694770",694762,694770,9,"ENSG00000226320.6",1,2,"VMVVVVVVV",0,8,0.884057971014493,104,110,133,136,141,147,163,166,"CTGAGGA","ATCA","TTGAAAA","CTGA",2.37240661702073,23,5,16,53,1.96315714141114,4.44480031372066,7.98103219777864,101,"ENSG00000079974.19"
"37842","ENSG00000248973.3_21005",20997,21005,9,"ENSG00000248973.3",1,8,"VVVVVVVMV",0,8,0.884057971014493,107,113,133,136,177,183,195,198,"AAAATGA","GTGA","TTGAAAA","CTGA",2.44870876958794,20,41,12,82,1.45447356061369,4.44479967279998,7.98103155685795,101,"ENSG00000079974.19"
"39428","ENSG00000253577.2_2095",2087,2095,9,"ENSG00000253577.2",0,NA,"VVVVVVUVV",1,8,0.886128364389234,115,121,133,136,168,174,187,190,"TTGAGGA","ATCA","CTGGAGA","CTGA",2.36873349479829,12,32,13,66,1.9544891636254,4.43651144890351,7.98102490646044,101,"ENSG00000079974.19"
"35495","ENSG00000236202.1_33356",33348,33356,9,"ENSG00000236202.1",1,1,"MVVVVVVVV",0,8,0.90600414078675,115,121,133,136,139,145,156,159,"AATCTGA","CAAA","CAGATGA","CTGA",2.1914145025822,12,3,11,35,2.81845516435072,4.35697129539135,7.98098785853835,101,"ENSG00000079974.19"
"38463","ENSG00000250266.3_22432",22424,22432,9,"ENSG00000250266.3",0,NA,"VVVVVUUVV",2,7,0.808281573498965,111,117,133,136,144,150,160,163,"ATGATGT","ATCA","ATTACCA","CTGA",2.42317259338877,16,8,10,43,2.8368911233464,4.74784376981788,7.98097006381374,101,"ENSG00000079974.19"
"33390","ENSG00000229618.3_298075",298067,298075,9,"ENSG00000229618.3",0,NA,"UVVVVVVVV",1,8,0.902691511387163,115,121,133,136,187,193,243,246,"GGGATGG","CTCA","ATGTTGA","CTGA",2.47160051449638,12,51,50,122,1.00336132805673,4.37017452284148,7.98094056839013,101,"ENSG00000079974.19"
"42366","ENSG00000261801.8_14677",14669,14677,9,"ENSG00000261801.8",1,7,"VVVVVVMVV",0,8,0.885300207039338,86,92,106,109,115,121,133,136,"TTGCTAA","ATAA","ATGAATA","CTGA",2.22434338930823,14,6,12,41,2.92993519723474,4.43972278148907,7.98092360964642,101,"ENSG00000079974.19"
"12115","ENSG00000137269.15_95316",95308,95316,9,"ENSG00000137269.15",1,1,"MVVVVVVVV",0,8,0.90600414078675,112,118,133,136,149,155,165,168,"ATTATAT","TGGA","TTGAAGC","CTGA",2.22313237040326,15,13,10,47,2.60638116151698,4.35681590771801,7.980832470865,101,"ENSG00000079974.19"
"23058","ENSG00000172159.16_209519",209511,209519,9,"ENSG00000172159.16",1,8,"VVVVVVVMV",0,8,0.884057971014493,107,113,133,136,157,163,219,222,"ACGATGA","ATGT","ATGAAGA","CTGA",2.55735318242889,20,21,56,106,0.72935835125845,4.44459489186277,7.98082677592074,101,"ENSG00000079974.19"
"28252","ENSG00000188580.15_432567",432559,432567,9,"ENSG00000188580.15",1,1,"MVVVVUVVV",1,7,0.82815734989648,103,109,133,136,166,172,191,194,"TTGATGG","CAGA","GTGATGA","CTGA",2.67421918541437,24,30,19,82,0.844408764048458,4.66813416670274,7.98076356628866,101,"ENSG00000079974.19"
"29870","ENSG00000198822.11_94399",94391,94399,9,"ENSG00000198822.11",0,NA,"UVVVVVVVV",1,8,0.902691511387163,93,99,133,136,185,191,199,202,"AAGATGT","TGGA","GTGAGGA","CTGA",2.4729845514481,34,49,8,100,0.99341330539427,4.36999424542873,7.98076029097738,101,"ENSG00000079974.19"
"14938","ENSG00000146247.15_115785",115777,115785,9,"ENSG00000146247.15",1,1,"MVVVUVVVV",1,7,0.795859213250517,116,122,133,136,150,156,167,170,"AACATGA","CTGG","TTGAGGA","CTGA",2.48989349102395,11,14,11,45,2.58940137554691,4.79717282892665,7.98060968192872,101,"ENSG00000079974.19"
"44720","ENSG00000283434.2_62494",62486,62494,9,"ENSG00000283434.2",1,8,"VVVVVVUMV",1,7,0.770186335403727,111,117,133,136,142,148,180,183,"ATGATGC","TGGA","GTGATGA","CTGA",2.6530953918227,16,6,32,63,1.91204830351095,4.89983772891557,7.98058307053048,101,"ENSG00000079974.19"
"24216","ENSG00000175497.17_382752",382744,382752,9,"ENSG00000175497.17",1,6,"VVVVVMVVV",0,8,0.902691511387163,111,117,133,136,146,152,204,207,"ATGCTGT","ATCA","CTGTAGA","CTGA",2.36123704722157,16,10,52,87,1.73764749435186,4.36980695229058,7.98057299783923,101,"ENSG00000079974.19"
"21790","ENSG00000168959.15_189418",189410,189418,9,"ENSG00000168959.15",1,7,"VVVVVVMVV",0,8,0.885300207039338,97,103,110,113,116,122,133,136,"ATGATTA","ATGA","AAGGTGT","CCGA",2.26280906128763,7,3,11,30,2.67173332818336,4.43928176752522,7.98048259568257,101,"ENSG00000079974.19"
"21372","ENSG00000167306.21_63595",63587,63595,9,"ENSG00000167306.21",1,6,"VVVVVMVVV",0,8,0.902691511387163,99,105,133,136,153,159,178,181,"ATGATGA","CTGG","ATATTGA","CAGA",2.45957449073649,28,17,19,73,1.08140271791882,4.36964149737386,7.98040754292251,101,"ENSG00000079974.19"
"13743","ENSG00000143341.12_367870",367862,367870,9,"ENSG00000143341.12",1,1,"MVVVVVVVV",0,8,0.90600414078675,92,98,133,136,146,152,160,163,"ATTTTGA","GTCA","GTGGTGT","CTGA",2.33076437573207,35,10,8,62,1.88695673469613,4.35634647656081,7.98036303970781,101,"ENSG00000079974.19"
"29877","ENSG00000198836.11_65382",65374,65382,9,"ENSG00000198836.11",1,8,"VVVVVVVMV",0,8,0.884057971014493,109,115,133,136,139,145,159,162,"ATGTAGG","ATGA","ATGATCT","CTGA",2.32936842013483,18,3,14,44,2.24728178200999,4.44410114572722,7.98033302978519,101,"ENSG00000079974.19"
"5737","ENSG00000106536.21_382559",382551,382559,9,"ENSG00000106536.21",1,1,"MVVVVUVVV",1,7,0.82815734989648,113,119,133,136,141,147,162,165,"ATGATTT","TAGA","TTGAAGT","CTGA",2.39189307689336,14,5,15,43,2.72483913333804,4.66769824482344,7.98032764440936,101,"ENSG00000079974.19"
"5559","ENSG00000105877.19_124190",124182,124190,9,"ENSG00000105877.19",1,6,"VVVVVMVVV",0,8,0.902691511387163,110,116,133,136,180,186,198,201,"GTGTTTG","CTGA","GTCATAA","CTGA",2.36426822464666,17,44,12,82,1.71629920932006,4.36952184340779,7.98028788895644,101,"ENSG00000079974.19"
"21348","ENSG00000167258.15_67447",67439,67447,9,"ENSG00000167258.15",1,8,"VVUVVVVMV",1,7,0.767701863354037,94,100,108,111,114,120,133,136,"GTGATGT","TAGA","GTGTTGA","CTGA",2.56177252099872,8,3,13,33,2.55937492151536,4.90946459871004,7.98027205212619,101,"ENSG00000079974.19"
"463","ENSG00000012232.10_143098",143090,143098,9,"ENSG00000012232.10",1,2,"VMVVVUVVV",1,7,0.806211180124223,68,74,109,112,116,122,133,136,"GTTATGA","CTGA","GTCACCA","CTGA",2.57841467746858,35,4,11,59,1.83212975310437,4.75539023405705,7.98023495455395,101,"ENSG00000079974.19"
"7235","ENSG00000113389.16_59310",59302,59310,9,"ENSG00000113389.16",1,1,"MVVVVUVVV",1,7,0.82815734989648,81,87,102,105,115,121,133,136,"GTGATTC","ATGA","TTTAAGA","CTGA",2.38507172841841,15,10,12,46,2.76986761191382,4.66758645034248,7.9802158499284,101,"ENSG00000079974.19"
"26092","ENSG00000183308.6_16431",16423,16431,9,"ENSG00000183308.6",1,6,"VVVVVMVVV",0,8,0.902691511387163,99,105,133,136,142,148,166,169,"ATAATCA","CTGA","CTGATGT","CTTA",2.36699299801364,28,6,18,61,1.69782082263067,4.3694435356804,7.98020958122906,101,"ENSG00000079974.19"
"20518","ENSG00000165006.14_36363",36355,36363,9,"ENSG00000165006.14",1,1,"MVVVVVVVV",0,8,0.90600414078675,102,108,133,136,156,162,172,175,"ATGATGG","ATGA","TGGATGA","CTGT",2.39623061199702,25,20,10,64,1.44973259716051,4.35615083595183,7.98016739909883,101,"ENSG00000079974.19"
"47348","ENSG00000288024.1_4722",4714,4722,9,"ENSG00000288024.1",0,NA,"UVVVVVVVV",1,8,0.902691511387163,82,88,103,106,115,121,133,136,"AGCATGA","TTGA","CTGACAA","CTGT",2.19801490708376,15,9,12,45,2.82414445701873,4.36939429272762,7.98016033827627,101,"ENSG00000079974.19"
"18119","ENSG00000156170.14_128505",128497,128505,9,"ENSG00000156170.14",1,7,"VVVVVVMVV",0,8,0.885300207039338,107,113,133,136,146,152,171,174,"ATCAAGT","CTGT","TTGATAA","CTGA",2.36874774652035,20,10,19,58,1.96383294163372,4.43887114627568,7.98007197443303,101,"ENSG00000079974.19"
"46329","ENSG00000286481.2_53403",53395,53403,9,"ENSG00000286481.2",1,1,"MVVVVVVVV",0,8,0.90600414078675,112,118,133,136,181,187,198,201,"ATGTTGT","AAGA","GTGCCCA","CTGA",2.32893116541111,15,45,11,80,1.89786819953682,4.35601899223606,7.98003555538305,101,"ENSG00000079974.19"
"6772","ENSG00000111859.17_145157",145149,145157,9,"ENSG00000111859.17",0,NA,"VVVVVUUVV",2,7,0.808281573498965,110,116,133,136,180,186,194,197,"ATTATGA","CTTA","GGGAGGA","CTGA",2.5873746219961,17,44,8,78,1.73837383550547,4.74688449553653,7.98001078953239,101,"ENSG00000079974.19"
"15677","ENSG00000149179.14_150088",150080,150088,9,"ENSG00000149179.14",1,6,"UVVVVMVVV",1,7,0.805383022774327,100,106,133,136,178,184,193,196,"CTGATGA","CTTA","GTAATGA","CTGA",2.68915095284353,27,42,9,87,1.10622839008773,4.75847535226115,7.98000744335845,101,"ENSG00000079974.19"
"18649","ENSG00000158006.14_19988",19980,19988,9,"ENSG00000158006.14",1,6,"VVVVVMVVV",0,8,0.902691511387163,83,89,100,103,111,117,133,136,"ATGCTGA","CTGA","GGGAGGA","TTGG",2.21222589205674,11,8,16,44,2.72866022066996,4.36920820859539,7.97997425414405,101,"ENSG00000079974.19"
"37384","ENSG00000248049.8_208189",208181,208189,9,"ENSG00000248049.8",1,3,"VVMVVUVVV",1,7,0.804968944099379,83,89,97,100,111,117,133,136,"TTCATGA","CTAA","GTGATAT","CTGA",2.50603707220798,8,11,16,44,2.33344045056286,4.76008856632068,7.9799643427182,101,"ENSG00000079974.19"
"1003","ENSG00000042980.14_22748",22740,22748,9,"ENSG00000042980.14",1,2,"VMVVVVVVV",0,8,0.884057971014493,76,82,103,106,111,117,133,136,"ATGAAGA","CAGA","ATGATTC","CTAA",2.35119212994752,21,5,16,51,2.10026507700415,4.44371981916358,7.97995170322155,101,"ENSG00000079974.19"
"4559","ENSG00000101076.20_39442",39434,39442,9,"ENSG00000101076.20",0,NA,"UVVVVUVVV",2,7,0.824844720496894,115,121,133,136,139,145,197,200,"GTGATGA","CTCG","GTTAAGA","CTGA",2.55294387105277,12,3,52,76,1.70252823455073,4.68053851039229,7.97991739237987,101,"ENSG00000079974.19"
"21013","ENSG00000166233.15_27089",27081,27089,9,"ENSG00000166233.15",0,NA,"VVVVUVVVV",1,8,0.889855072463768,116,122,133,136,141,147,159,162,"TGGATGA","GTGA","CTAATCA","CTTA",2.2107896483546,11,5,12,37,2.94317471065411,4.42044309158785,7.97986338144292,101,"ENSG00000079974.19"
"155","ENSG00000005810.20_241022",241014,241022,9,"ENSG00000005810.20",0,NA,"UVVVVVVVV",1,8,0.902691511387163,68,74,92,95,115,121,133,136,"ATGAAGA","ATGA","TTGACTA","ATGA",2.33609524695913,18,20,12,59,1.90240198973438,4.36909257569882,7.97985862124747,101,"ENSG00000079974.19"
"17595","ENSG00000154556.20_253364",253356,253364,9,"ENSG00000154556.20",1,8,"VVVVVVVMV",0,8,0.884057971014493,82,88,133,136,143,149,158,161,"ATGATTC","TTAA","ATGAAAA","CTGA",2.36634820881848,45,7,9,70,1.99883276850584,4.44362187349059,7.97985375754856,101,"ENSG00000079974.19"
"33406","ENSG00000229642.1_43749",43741,43749,9,"ENSG00000229642.1",1,6,"VVVVVMVVV",0,8,0.902691511387163,63,69,86,89,97,103,133,136,"ATGAGGA","CTTA","GTGGTTA","CTGG",2.34117529767177,17,8,30,64,1.86821273099178,4.3690120122009,7.97977805774955,101,"ENSG00000079974.19"
"7395","ENSG00000113946.4_47418",47410,47418,9,"ENSG00000113946.4",1,8,"VVVVVVVMV",0,8,0.884057971014493,97,103,133,136,142,148,162,165,"GTGATGT","TTAA","ATTTTGT","CTGA",2.38128984417296,30,6,14,59,1.89869945480909,4.4434912706572,7.97972315471517,101,"ENSG00000079974.19"
"29513","ENSG00000198108.4_151477",151469,151477,9,"ENSG00000198108.4",1,1,"MVVVVUVVV",1,7,0.82815734989648,114,120,133,136,150,156,198,201,"ATGATGC","TTGG","TTGATGT","CTGA",2.55541786839815,13,14,42,78,1.63213905406688,4.6670645441803,7.97969394376622,101,"ENSG00000079974.19"
"3572","ENSG00000086015.23_235823",235815,235823,9,"ENSG00000086015.23",1,8,"VVVVVVVMV",0,8,0.884057971014493,115,121,133,136,167,173,188,191,"AGGCTGA","TTAA","CTGAGGA","CTGA",2.38711736806241,12,31,15,67,1.85969593166343,4.44345292968654,7.97968481374451,101,"ENSG00000079974.19"
"15022","ENSG00000146648.21_33208",33200,33208,9,"ENSG00000146648.21",0,NA,"VVUVVVVVV",1,8,0.883643892339545,81,87,101,104,107,113,133,136,"ATGAGAA","CTGG","ATTCTGG","CTGA",2.33926090934206,14,3,20,46,2.18529762519007,4.44509258853428,7.97966815789246,101,"ENSG00000079974.19"
"9187","ENSG00000123104.12_23301",23293,23301,9,"ENSG00000123104.12",1,6,"VVVVVMUVV",1,7,0.788819875776397,110,116,133,136,140,146,155,158,"ATTATGA","AAGA","CTGAAAA","CTGA",2.49913932787845,17,4,9,39,2.63618549034849,4.82427858571787,7.97955808882346,101,"ENSG00000079974.19"
"35017","ENSG00000234710.3_56375",56367,56375,9,"ENSG00000234710.3",1,1,"MVUVVVVVV",1,7,0.789648033126294,77,83,97,100,107,113,133,136,"GTGATTA","CAGA","TTGATTG","CTGA",2.52038107816457,14,7,20,50,2.4810605553237,4.8209002691052,7.97949240161038,101,"ENSG00000079974.19"
"2377","ENSG00000073910.23_262878",262870,262878,9,"ENSG00000073910.23",1,1,"MVVVVVUVV",1,7,0.792132505175983,114,120,133,136,146,152,165,168,"AAGTTGA","CAGA","ATGAGGG","CTGA",2.46368297215453,13,10,13,45,2.8189809746876,4.81088353059612,7.97941355130006,101,"ENSG00000079974.19"
"41567","ENSG00000259245.2_98579",98571,98579,9,"ENSG00000259245.2",1,7,"VVVVVVMVV",0,8,0.885300207039338,90,96,133,136,144,150,189,192,"CTCATGA","CTGC","CAGATGA","CTGA",2.51052413415236,37,8,39,93,1.01589363637324,4.43818029934725,7.9793811275046,101,"ENSG00000079974.19"
"22557","ENSG00000170820.12_85754",85746,85754,9,"ENSG00000170820.12",1,6,"VVVVVMVVV",0,8,0.902691511387163,116,122,133,136,147,153,165,168,"GCAATGT","CAGG","TTGATCA","CTGA",2.20410604842711,11,11,12,43,2.78034280521069,4.36859578201452,7.97936182756318,101,"ENSG00000079974.19"
"9922","ENSG00000128512.24_221021",221013,221021,9,"ENSG00000128512.24",1,1,"MVVVVVUVV",1,7,0.792132505175983,115,121,133,136,143,149,158,161,"GTGGTGA","TTTA","GTGATCC","CTGA",2.42477411857913,12,7,9,37,3.07762537929755,4.81069654245626,7.9792265631602,101,"ENSG00000079974.19"
"26001","ENSG00000183117.20_694846",694838,694846,9,"ENSG00000183117.20",1,7,"VVVVVVMVV",0,8,0.885300207039338,109,115,133,136,138,144,190,193,"AAGATAA","CTCA","CTGATGT","CTGA",2.48318671917318,18,2,46,75,1.19751147521619,4.43802240075935,7.9792232289167,101,"ENSG00000079974.19"
"14262","ENSG00000144642.22_6899",6891,6899,9,"ENSG00000144642.22",0,NA,"UVVVVUVVV",2,7,0.824844720496894,68,74,94,97,106,112,133,136,"ATGACAA","CTGA","TTGCTCA","CTGA",2.52268871950638,20,9,21,59,1.90122195874861,4.67978668886445,7.97916557085203,101,"ENSG00000079974.19"
"44788","ENSG00000283563.1_232512",232504,232512,9,"ENSG00000283563.1",0,NA,"UVVVVUVVV",2,7,0.824844720496894,68,74,94,97,106,112,133,136,"ATGACAA","CTGA","TTGCTCA","CTGA",2.52268871950638,20,9,21,59,1.90122195874861,4.67978668886445,7.97916557085203,101,"ENSG00000079974.19"
"12298","ENSG00000137821.12_142754",142746,142754,9,"ENSG00000137821.12",0,NA,"UVVVVVVVV",1,8,0.902691511387163,95,101,108,111,115,121,133,136,"GTGATGT","TTCA","GAGAGGA","ATGA",2.22141298011509,7,4,12,32,2.66413775433196,4.36838940544146,7.97915545099012,101,"ENSG00000079974.19"
"19040","ENSG00000160305.18_79411",79403,79411,9,"ENSG00000160305.18",1,8,"VVVVVVVMV",0,8,0.884057971014493,87,93,105,108,112,118,133,136,"TTGATGT","CTCA","TTGATTT","TTGA",2.26253165555653,12,4,15,40,2.68813347869659,4.44291946226837,7.97915134632634,101,"ENSG00000079974.19"
"9318","ENSG00000124151.19_123754",123746,123754,9,"ENSG00000124151.19",1,3,"VVMVVVVVV",0,8,0.882815734989648,114,120,133,136,177,183,196,199,"AATATGA","CTTA","GTAAAAA","CTGA",2.38061375253454,13,41,13,76,1.92077148183775,4.447882458017,7.97914539797559,101,"ENSG00000079974.19"
"31568","ENSG00000224116.7_66806",66798,66806,9,"ENSG00000224116.7",1,8,"VVVVVUVMV",1,7,0.806211180124224,109,115,133,136,138,144,154,157,"TTGAAGA","CTGA","ATATTTA","CTGA",2.51706265854775,18,2,10,39,2.2363636083945,4.75419533301154,7.97904005350844,101,"ENSG00000079974.19"
"11875","ENSG00000136267.14_210732",210724,210732,9,"ENSG00000136267.14",1,8,"VVVVVVVMV",0,8,0.884057971014493,114,120,133,136,149,155,174,177,"GTGATAA","ATGT","ATTTTAA","CTGA",2.32590326921293,13,13,19,54,2.26513622539741,4.44278950503756,7.97902138909553,101,"ENSG00000079974.19"
"37237","ENSG00000246225.7_73409",73401,73409,9,"ENSG00000246225.7",0,NA,"VVVVUVVVV",1,8,0.889855072463768,108,114,133,136,144,150,202,205,"TTGATGT","CATA","CTGAACA","CTGA",2.41700725941222,19,8,52,88,1.56501781691972,4.41959988658363,7.9790201764387,101,"ENSG00000079974.19"
"44973","ENSG00000284645.1_3379",3371,3379,9,"ENSG00000284645.1",1,3,"VVMVVVVVV",0,8,0.882815734989648,90,96,109,112,115,121,133,136,"AGGATGT","CTGA","GAACTGA","CTAA",2.25861043285069,13,3,12,37,2.73340942431075,4.4477030774955,7.97896601745409,101,"ENSG00000079974.19"
"34263","ENSG00000232310.10_85821",85813,85821,9,"ENSG00000232310.10",1,1,"MVVVVVVVV",0,8,0.90600414078675,107,113,133,136,143,149,161,164,"AGCAGGA","ATGG","ATGATGC","CTGA",2.24540726964359,20,7,12,48,2.45025438910794,4.35490904668297,7.97892560982997,101,"ENSG00000079974.19"
"5963","ENSG00000107362.14_39383",39375,39383,9,"ENSG00000107362.14",1,2,"VMVVVVVVV",0,8,0.884057971014493,35,41,61,64,112,118,133,136,"CTGATGG","CTGG","GTGCTTC","CTGA",2.46928854194997,20,48,15,92,1.30884946566602,4.44269326966645,7.97892515372442,101,"ENSG00000079974.19"
"32532","ENSG00000227115.10_28168",28160,28168,9,"ENSG00000227115.10",1,8,"VVVVVVVMV",0,8,0.884057971014493,110,116,133,136,150,156,178,181,"ATGAAGA","CCAA","GAGATTT","CTGA",2.39780780935615,17,14,22,62,1.78536845676771,4.44268846311884,7.97892034717681,101,"ENSG00000079974.19"
"19453","ENSG00000163046.16_87458",87450,87458,9,"ENSG00000163046.16",1,1,"MVVVVVVVV",0,8,0.90600414078675,108,114,133,136,167,173,181,184,"ATAATGA","CTCC","GGCAGGA","CTGA",2.37302621314549,19,31,8,67,1.59943306879691,4.35490195577505,7.97891851892205,101,"ENSG00000079974.19"
"30930","ENSG00000214803.3_43780",43772,43780,9,"ENSG00000214803.3",1,1,"MVVVVVVVV",0,8,0.90600414078675,112,118,133,136,144,150,194,197,"GAGTTGA","GAGA","CTGATGC","CTGA",2.32716070309974,15,8,44,76,1.90518763378861,4.35489808028005,7.97891464342704,101,"ENSG00000079974.19"
"7531","ENSG00000114670.14_168016",168008,168016,9,"ENSG00000114670.14",1,1,"MVVVVVUVV",1,7,0.792132505175983,108,114,133,136,167,173,184,187,"ATCAAGA","CTGA","GTGATGT","CTGA",2.64544967956665,19,31,11,70,1.60506975096246,4.81035023701837,7.9788802577223,101,"ENSG00000079974.19"
"14833","ENSG00000145934.17_774496",774488,774496,9,"ENSG00000145934.17",0,NA,"VVVVVVUVV",1,8,0.886128364389234,114,120,133,136,169,175,224,227,"ATATTGA","GTGA","ATGATAA","CTGA",2.5064019713465,13,33,49,104,1.02794155741802,4.43432200826535,7.97883546582228,101,"ENSG00000079974.19"
"44315","ENSG00000280780.4_129669",129661,129669,9,"ENSG00000280780.4",1,6,"VVVVVMVVV",0,8,0.902691511387163,33,39,55,58,78,84,133,136,"ATCATGG","CTGA","CTGATGA","CTCA",2.45296076854276,16,20,49,94,1.11903303357074,4.36802620596396,7.97879225151261,101,"ENSG00000079974.19"
"20545","ENSG00000165071.15_31992",31984,31992,9,"ENSG00000165071.15",1,1,"MVVVVUVVV",1,7,0.82815734989648,97,103,133,136,165,171,179,182,"ATGTTGA","TTGA","GTGAGGT","CTGA",2.63684821532647,30,29,8,76,1.08501614055342,4.66600106068248,7.9786304602684,101,"ENSG00000079974.19"
"38682","ENSG00000250888.1_6120",6112,6120,9,"ENSG00000250888.1",0,NA,"VVVUVUVVV",2,7,0.802898550724638,86,92,103,106,111,117,133,136,"ATGATAA","CAAA","ATCAGGA","CTGA",2.45686009328582,11,5,16,41,2.68895975093365,4.76700675987645,7.978600962775,101,"ENSG00000079974.19"
"45860","ENSG00000285987.1_327956",327948,327956,9,"ENSG00000285987.1",1,2,"VMVVVVVVV",0,8,0.884057971014493,115,121,133,136,184,190,207,210,"AAGAGGA","TTGA","GTAAAGT","CTGA",2.41053977915565,12,48,17,86,1.69913784851928,4.44235076072257,7.97858264478055,101,"ENSG00000079974.19"
"35161","ENSG00000235160.3_26941",26933,26941,9,"ENSG00000235160.3",1,7,"VVVVVVMVV",0,8,0.885300207039338,85,91,133,136,153,159,173,176,"TTGATGA","TTGG","ATGCTTT","CTGA",2.46735889817175,42,17,14,82,1.30020180087927,4.43731528050606,7.97851610866342,101,"ENSG00000079974.19"
"13488","ENSG00000141564.16_53472",53464,53472,9,"ENSG00000141564.16",1,1,"MVVUVVVVV",1,7,0.786749482401656,114,120,133,136,147,153,169,172,"GTGATGA","CACA","GTCTAGA","CTGA",2.51028074484771,13,11,16,49,2.59044008268446,4.83141126208397,7.97840919169059,101,"ENSG00000079974.19"
"11091","ENSG00000133835.18_128162",128154,128162,9,"ENSG00000133835.18",0,NA,"UVVVVVVVV",1,8,0.902691511387163,105,111,133,136,147,153,163,166,"TTGCTGA","CCGT","GTTGGGA","CTGA",2.29471592210907,22,11,10,52,2.17238007204125,4.36762155485877,7.97838760040742,101,"ENSG00000079974.19"
"26869","ENSG00000185056.10_29559",29551,29559,9,"ENSG00000185056.10",1,3,"VVMVVVVVV",0,8,0.882815734989648,116,122,133,136,181,187,198,201,"GTGAAAA","CTCA","ATGGGGA","CTGA",2.37379204971544,11,45,11,76,1.96317474763225,4.44711376976712,7.97837670972572,101,"ENSG00000079974.19"
"34091","ENSG00000231898.9_10163",10155,10163,9,"ENSG00000231898.9",1,2,"VMVVVVVVV",0,8,0.884057971014493,87,93,103,106,109,115,133,136,"ATGATTA","GTGA","ATAATGG","CTAA",2.3218258447549,10,3,18,40,2.28936489566091,4.44205096517339,7.97828284923136,101,"ENSG00000079974.19"
"29561","ENSG00000198231.14_23405",23397,23405,9,"ENSG00000198231.14",1,6,"VVVVVMVVV",0,8,0.902691511387163,112,118,133,136,142,148,156,159,"GTGCAGA","TTGG","ATCATTT","CTGA",2.18047240644007,15,6,8,38,2.93326392823231,4.3674366594582,7.97820270500685,101,"ENSG00000079974.19"
"2231","ENSG00000072042.13_15428",15420,15428,9,"ENSG00000072042.13",1,6,"VVUVVMVVV",1,7,0.786335403726708,116,122,133,136,147,153,166,169,"ATGAAGA","CAGT","ATGCAGA","CTGA",2.4890589087033,11,11,13,44,2.73771762998642,4.83286092200211,7.97820253690894,101,"ENSG00000079974.19"
"41045","ENSG00000258466.5_10002",9994,10002,9,"ENSG00000258466.5",1,6,"VVUVVMVVV",1,7,0.786335403726708,116,122,133,136,147,153,166,169,"ATGAAGA","CAGT","ATGCAGA","CTGA",2.4890589087033,11,11,13,44,2.73771762998642,4.83286092200211,7.97820253690894,101,"ENSG00000079974.19"
"14959","ENSG00000146376.11_115863",115855,115863,9,"ENSG00000146376.11",1,1,"MVVVVVVVV",0,8,0.90600414078675,107,113,133,136,151,157,165,168,"AGGAAGA","CTTG","ATGCTGC","CTGA",2.30881696956891,20,15,8,52,2.02462489935834,4.35418450745443,7.97820107060143,101,"ENSG00000079974.19"
"44450","ENSG00000282278.1_212114",212106,212114,9,"ENSG00000282278.1",0,NA,"VVVVVVUVV",1,8,0.886128364389234,86,92,133,136,143,149,168,171,"GTGATGA","CTAA","ATGGTAA","TTGA",2.4237336961116,41,7,19,76,1.57627625297034,4.43362522342859,7.97813868098552,101,"ENSG00000079974.19"
"35835","ENSG00000237352.6_158691",158683,158691,9,"ENSG00000237352.6",1,2,"VMVVVVVVV",0,8,0.884057971014493,95,101,109,112,114,120,133,136,"ATCATGT","CTCA","GTGATGC","CTGT",2.30033590630517,8,2,13,32,2.43204887041017,4.44190539477782,7.97813727883579,101,"ENSG00000079974.19"
"9939","ENSG00000128567.17_43718",43710,43718,9,"ENSG00000128567.17",0,NA,"VVVVUVVVV",1,8,0.889855072463768,108,114,133,136,153,159,168,171,"ATGATGC","CTGT","AAGAAGA","CTGT",2.3506658950096,19,17,9,54,2.0036684465068,4.41869360330937,7.97811389316444,101,"ENSG00000079974.19"
"18909","ENSG00000159216.19_690308",690300,690308,9,"ENSG00000159216.19",1,2,"VMVVVVVVV",0,8,0.884057971014493,109,115,133,136,155,161,172,175,"TTGATGG","AGGA","GGGAAGT","CTGA",2.36888396909668,18,19,11,57,1.97485967659882,4.44185486764417,7.97808675170214,101,"ENSG00000079974.19"
"14285","ENSG00000144645.16_208792",208784,208792,9,"ENSG00000144645.16",1,1,"MVVVVVVVV",0,8,0.90600414078675,111,117,133,136,143,149,205,208,"GTGAAAA","CAAA","GTGATTA","CTGA",2.33665050031247,16,7,56,88,1.83843225566438,4.35402556443687,7.97804212758387,101,"ENSG00000079974.19"
"3805","ENSG00000089123.16_231520",231512,231520,9,"ENSG00000089123.16",1,1,"MVVVVVVVV",0,8,0.90600414078675,68,74,90,93,113,119,133,136,"CTGATGA","GTGA","ATTTTCA","ATGA",2.31432899271963,16,20,14,59,1.98724138064853,4.35402533302818,7.97804189617518,101,"ENSG00000079974.19"
"41876","ENSG00000259905.7_111479",111471,111479,9,"ENSG00000259905.7",0,NA,"VVVVUVVVV",1,8,0.889855072463768,87,93,133,136,147,153,168,171,"GTGACTA","CTAA","GTGAAGC","CTGA",2.40311872072312,40,11,15,75,1.65363415085981,4.41860640558681,7.97802669544188,101,"ENSG00000079974.19"
"42114","ENSG00000260780.1_6522",6514,6522,9,"ENSG00000260780.1",0,NA,"VVVVUVVVV",1,8,0.889855072463768,87,93,133,136,147,153,168,171,"GTGACTA","CTAA","GTGAAGC","CTGA",2.40311872072312,40,11,15,75,1.65363415085981,4.41860640558681,7.97802669544188,101,"ENSG00000079974.19"
"10117","ENSG00000129450.9_5315",5307,5315,9,"ENSG00000129450.9",0,NA,"VVVVVVUVV",1,8,0.886128364389234,86,92,107,110,116,122,133,136,"GTGATGA","ATGA","GTGCAGA","CACA",2.22461659419608,15,6,11,41,2.90323199383234,4.43350232211822,7.97801577967515,101,"ENSG00000079974.19"
"22392","ENSG00000170456.16_188282",188274,188282,9,"ENSG00000170456.16",1,2,"VMVVVVUVV",1,7,0.770186335403727,106,112,133,136,142,148,186,189,"ATGATGA","CTGC","GTATTGA","CTGA",2.72472452897203,21,6,38,74,1.42384800416756,4.8971695493286,7.97791489094351,101,"ENSG00000079974.19"
"38172","ENSG00000249738.10_46505",46497,46505,9,"ENSG00000249738.10",1,8,"VVVVVUVMV",1,7,0.806211180124224,88,94,133,136,156,162,171,174,"CTGATGA","CTAA","GTGGGGA","CTGA",2.66002776676634,39,20,9,77,1.27873156303702,4.75306250203648,7.97790722253338,101,"ENSG00000079974.19"
"22762","ENSG00000171365.17_83587",83579,83587,9,"ENSG00000171365.17",0,NA,"UVVVVVVVV",1,8,0.902691511387163,111,117,133,136,180,186,210,213,"GTGGTGA","GTTA","GTGAAGT","CTGA",2.44702902758701,16,44,24,93,1.15500391803294,4.36713269215325,7.9778987377019,101,"ENSG00000079974.19"
"2846","ENSG00000078328.23_70332",70324,70332,9,"ENSG00000078328.23",0,NA,"UVVVVVVVV",1,8,0.902691511387163,115,121,133,136,139,145,161,164,"GTGTAGA","TGGA","TTGATCC","CTGA",2.24633875427478,12,3,16,40,2.49267898359531,4.36706766969012,7.97783371523878,101,"ENSG00000079974.19"
"30967","ENSG00000214944.10_311660",311652,311660,9,"ENSG00000214944.10",0,NA,"UVVVVVVVV",1,8,0.902691511387163,102,108,133,136,152,158,170,173,"ATGATGA","TGGA","TTGAGAA","CTGT",2.37740414236425,25,16,12,62,1.61843582983471,4.36694919473243,7.97771524028108,101,"ENSG00000079974.19"
"29531","ENSG00000198162.12_130173",130165,130173,9,"ENSG00000198162.12",1,6,"VVVVVMVVV",0,8,0.902691511387163,70,76,98,101,106,112,133,136,"ATGGTGA","CTGA","ATTTTTA","CAGA",2.36077210625662,22,5,21,57,1.7287772931016,4.36681450036977,7.97758054591843,101,"ENSG00000079974.19"
"532","ENSG00000017427.17_53088",53080,53088,9,"ENSG00000017427.17",0,NA,"VVUVVVVVV",1,8,0.883643892339545,110,116,133,136,143,149,180,183,"GTGAAGA","ATGC","ATTATTA","CTGA",2.38645731329462,17,7,31,64,1.86213649711704,4.44296297977028,7.97753854912846,101,"ENSG00000079974.19"
"42997","ENSG00000267575.9_38976",38968,38976,9,"ENSG00000267575.9",0,NA,"UVVVVVVVV",1,8,0.902691511387163,78,84,102,105,113,119,133,136,"GTGCTGA","ATGA","GTGGTAG","CTTA",2.24122834532618,18,8,14,49,2.52554291813936,4.36676630507847,7.97753235062712,101,"ENSG00000079974.19"
"3570","ENSG00000085999.13_7003",6995,7003,9,"ENSG00000085999.13",0,NA,"UVVVVVVVV",1,8,0.902691511387163,103,109,133,136,150,156,188,191,"ATGGTGA","CAAA","GTGGTGG","CTGA",2.48035853880262,24,14,32,79,0.931224257358915,4.36673696234409,7.97750300789274,101,"ENSG00000079974.19"
"31650","ENSG00000224286.6_5208",5200,5208,9,"ENSG00000224286.6",1,8,"VVVUVVVMV",1,7,0.764803312629399,114,120,133,136,144,150,161,164,"ATGATGA","CTGA","ACCATAA","ATGA",2.50205115830116,13,8,11,41,2.99220180982414,4.9181357162913,7.9773489668089,101,"ENSG00000079974.19"
"24607","ENSG00000177138.17_172665",172657,172665,9,"ENSG00000177138.17",1,6,"UVVVVMVVV",1,7,0.805383022774327,86,92,107,110,114,120,133,136,"AGAATGA","CAGA","AAGAGGA","CTGA",2.4497867982813,15,4,13,41,2.69053742222015,4.75561235269053,7.97714444378784,101,"ENSG00000079974.19"
"19634","ENSG00000163535.18_62761",62753,62761,9,"ENSG00000163535.18",0,NA,"VVVVUVVVV",1,8,0.889855072463768,108,114,133,136,147,153,168,171,"ATGATTC","TAGA","GTCAAAA","CTGA",2.31625656131991,19,11,15,54,2.22910902447281,4.41770485831806,7.97712514817313,101,"ENSG00000079974.19"
"5544","ENSG00000105784.16_71687",71679,71687,9,"ENSG00000105784.16",1,8,"VVVVVVVMV",0,8,0.884057971014493,56,62,82,85,115,121,133,136,"TTGATGT","CTGA","ATCATGA","CTTA",2.43959952302842,20,30,12,71,1.49949192630653,4.440872186624,7.97710407068197,101,"ENSG00000079974.19"
"8061","ENSG00000116688.18_14724",14716,14724,9,"ENSG00000116688.18",1,7,"VVVVVUMVV",1,7,0.807453416149068,110,116,133,136,143,149,158,161,"GTGTTTA","CTGA","GAGCAGA","CTGA",2.43271406330466,17,7,9,42,2.77102650663001,4.7472800654986,7.97709373009487,101,"ENSG00000079974.19"
"13053","ENSG00000139973.18_124358",124350,124358,9,"ENSG00000139973.18",1,8,"UVVVVVVMV",1,7,0.786749482401656,84,90,102,105,107,113,133,136,"ATGAGGA","CTGC","ATGATTT","CTGA",2.58989307834356,12,2,20,43,2.05417945151228,4.830033326784,7.97703125639062,101,"ENSG00000079974.19"
"11477","ENSG00000135074.16_46644",46636,46644,9,"ENSG00000135074.16",1,8,"VVVVVVVMV",0,8,0.884057971014493,113,119,133,136,155,161,178,181,"ATGACAA","CTGA","ATGCTGA","ATGA",2.36680068861835,14,19,17,59,1.98423313516299,4.44072609815466,7.97695798221263,101,"ENSG00000079974.19"
"31513","ENSG00000223935.3_41114",41106,41114,9,"ENSG00000223935.3",1,1,"MVVVVVVVV",0,8,0.90600414078675,98,104,133,136,166,172,184,187,"ATCATGT","TTGG","GTGATAA","CTGA",2.45159829812216,29,30,12,80,1.06775204854391,4.35293517567291,7.9769517388199,101,"ENSG00000079974.19"
"8368","ENSG00000118473.23_179028",179020,179028,9,"ENSG00000118473.23",1,2,"VMVVVVVVV",0,8,0.884057971014493,63,69,84,87,98,104,133,136,"GTGACAA","CTGA","AGTTTGA","CTGA",2.3803605232791,15,11,29,64,1.89351338373746,4.44064588473287,7.97687776879084,101,"ENSG00000079974.19"
"26224","ENSG00000183715.14_116686",116678,116686,9,"ENSG00000183715.14",0,NA,"VVVUVVVVV",1,8,0.880745341614907,112,118,133,136,146,152,160,163,"ATCACGG","TGGA","ATCATGA","CTGA",2.25154251793611,15,10,8,42,2.8052555133981,4.45388474157638,7.976866108036,101,"ENSG00000079974.19"
"20426","ENSG00000164808.17_219099",219091,219099,9,"ENSG00000164808.17",1,1,"MVVVVVVVV",0,8,0.90600414078675,94,100,133,136,150,156,168,171,"ATGATGT","TTGA","AAGGTGA","TTGA",2.37201078126599,33,14,12,68,1.59776610013984,4.35279282714494,7.97680939029194,101,"ENSG00000079974.19"
"4516","ENSG00000100813.15_12701",12693,12701,9,"ENSG00000100813.15",1,2,"UMVVVVVVV",1,7,0.786749482401656,104,110,133,136,149,155,187,190,"ATGATGA","CCGA","ATGGTGG","CTGA",2.73919415739269,23,13,32,77,1.05756607007477,4.82971511317317,7.9767130427798,101,"ENSG00000079974.19"
"3889","ENSG00000090376.11_16163",16155,16163,9,"ENSG00000090376.11",1,1,"MVVVVVVVV",0,8,0.90600414078675,101,107,133,136,147,153,165,168,"TTGATGT","TTTA","ACAAAGA","CTGA",2.32260082231179,26,11,12,58,1.92672753353608,4.35268325390367,7.97669981705067,101,"ENSG00000079974.19"
"10990","ENSG00000133424.22_178849",178841,178849,9,"ENSG00000133424.22",1,8,"VVVVVVVMV",0,8,0.884057971014493,115,121,133,136,137,143,154,157,"GGCATGA","CAAA","ATGAGAA","CTGA",2.28628655573981,12,1,11,33,2.51988511000256,4.44044887040032,7.97668075445829,101,"ENSG00000079974.19"
"30397","ENSG00000204904.7_7611",7603,7611,9,"ENSG00000204904.7",1,1,"MVVVVVVVV",0,8,0.90600414078675,115,121,133,136,142,148,168,171,"CTTAGGA","GTAA","ATGAACA","CTGA",2.2361201170062,12,6,20,47,2.50314091347921,4.35265209004681,7.9766686531938,101,"ENSG00000079974.19"
"44258","ENSG00000280194.1_461",453,461,9,"ENSG00000280194.1",0,NA,"VVUVVVVVV",1,8,0.883643892339545,110,116,133,136,137,143,162,165,"CTGAAGT","GGGA","GTGATGA","CTGA",2.41614827284988,17,1,19,46,1.6600965322254,4.44193792113949,7.97651349049767,101,"ENSG00000079974.19"
"14575","ENSG00000145390.12_7762",7754,7762,9,"ENSG00000145390.12",1,8,"VVVVVVVMV",0,8,0.884057971014493,82,88,133,136,148,154,175,178,"TTGCTGA","GTGA","GTATTGA","CTGA",2.48019957143424,45,12,21,87,1.22644021403003,4.44027600589791,7.97650788995588,101,"ENSG00000079974.19"
"26710","ENSG00000184903.10_848359",848351,848359,9,"ENSG00000184903.10",1,8,"VVVVVVVMV",0,8,0.884057971014493,103,109,133,136,154,160,169,172,"GTGATCA","TTCA","TTCATGA","CTGA",2.42573496454028,24,18,9,60,1.58937931659379,4.44023643671558,7.97646832077355,101,"ENSG00000079974.19"
"15731","ENSG00000149289.11_4774",4766,4774,9,"ENSG00000149289.11",0,NA,"VVVVVVUVV",1,8,0.886128364389234,115,121,133,136,139,145,154,157,"ATGTAGA","GTGA","TTGGTGA","CTGT",2.22290850365006,12,3,9,33,2.90790712619639,4.43182428763252,7.97633774518946,101,"ENSG00000079974.19"
"24940","ENSG00000178764.8_51325",51317,51325,9,"ENSG00000178764.8",1,1,"MVVVVVVVV",0,8,0.90600414078675,115,121,133,136,150,156,171,174,"GGGATAA","CGCA","ACGAAGA","CTGA",2.2452621824954,12,14,15,50,2.44081365521485,4.35230705129605,7.97632361444304,101,"ENSG00000079974.19"
"23371","ENSG00000172817.4_169483",169475,169483,9,"ENSG00000172817.4",0,NA,"VVVVUVVVV",1,8,0.889855072463768,69,75,104,107,111,117,133,136,"ATGATTA","CTGA","GTATAGA","CTGG",2.40189708939709,29,4,16,58,1.65485410115968,4.41687534095174,7.97629563080681,101,"ENSG00000079974.19"
"11773","ENSG00000136011.15_28019",28011,28019,9,"ENSG00000136011.15",1,8,"VVVVVUVMV",1,7,0.806211180124224,107,113,133,136,144,150,164,167,"GTGATGA","AGGA","AGGGAGA","CTGA",2.4985372859633,20,8,14,51,2.34882965321937,4.75143622324367,7.97628094374057,101,"ENSG00000079974.19"
"37132","ENSG00000245552.9_23195",23187,23195,9,"ENSG00000245552.9",0,NA,"VVVVVVUVV",1,8,0.886128364389234,112,118,133,136,181,187,197,200,"ATGCTTA","TTAA","CTGATGT","CTGA",2.37216977226619,15,45,10,79,1.91206386146996,4.4316322524778,7.97614571003474,101,"ENSG00000079974.19"
"29930","ENSG00000198881.10_4754",4746,4754,9,"ENSG00000198881.10",1,3,"VVMVVVVVV",0,8,0.882815734989648,19,25,36,39,82,88,133,136,"GTGATCC","CTGA","TTGAGGG","CTGA",2.51894764824811,11,43,45,108,0.986226751481278,4.44480276828383,7.97606570824242,101,"ENSG00000079974.19"
"22213","ENSG00000169946.14_629264",629256,629264,9,"ENSG00000169946.14",1,6,"VVVVVMVVV",0,8,0.902691511387163,91,97,133,136,143,149,160,163,"TTGATAA","CTGA","GTGAGCC","CAGA",2.32039339170933,36,7,11,63,1.99183046753584,4.36527993639952,7.97604598194817,101,"ENSG00000079974.19"
"29735","ENSG00000198648.12_248541",248533,248541,9,"ENSG00000198648.12",0,NA,"VVVUVVVVV",1,8,0.880745341614907,83,89,133,136,140,146,157,160,"AGGATGG","ATTA","ATAATGA","CTGA",2.39815540456393,44,4,11,68,1.82384417629809,4.45288671834774,7.97586808480737,101,"ENSG00000079974.19"
"37508","ENSG00000248359.2_41538",41530,41538,9,"ENSG00000248359.2",1,1,"MVVVVVVVV",0,8,0.90600414078675,111,117,133,136,183,189,198,201,"ATTATAT","GTGA","ATGATTC","CTGA",2.33536620154353,16,47,9,81,1.8382082986587,4.35182907723723,7.97584564038423,101,"ENSG00000079974.19"
"13965","ENSG00000144043.13_21034",21026,21034,9,"ENSG00000144043.13",1,8,"VVVUVVVMV",1,7,0.764803312629399,114,120,133,136,143,149,158,161,"GAGATGA","GAGA","TTGAAGA","CTGA",2.49185337080272,13,7,9,38,3.05406504890221,4.91660521356343,7.97581846408102,101,"ENSG00000079974.19"
"41342","ENSG00000258881.6_21497",21489,21497,9,"ENSG00000258881.6",1,8,"VVVUVVVMV",1,7,0.764803312629399,114,120,133,136,143,149,158,161,"GAGATGA","GAGA","TTGAAGA","CTGA",2.49185337080272,13,7,9,38,3.05406504890221,4.91660521356343,7.97581846408102,101,"ENSG00000079974.19"
"17620","ENSG00000154645.14_78350",78342,78350,9,"ENSG00000154645.14",0,NA,"VVVUVVVVV",1,8,0.880745341614907,112,118,133,136,139,145,155,158,"ATTATGG","TTGG","ATTCTAA","CTGA",2.26829295899686,15,3,10,37,2.68918365767444,4.45278417941338,7.97576554587301,101,"ENSG00000079974.19"
"27130","ENSG00000185621.11_38481",38473,38481,9,"ENSG00000185621.11",0,NA,"VVUVUVVVV",2,7,0.773498964803312,106,112,133,136,144,150,160,163,"AAGATGA","GTGA","ATCATTA","CTGA",2.56931532798119,21,8,10,48,2.39825338698382,4.88175556004794,7.97575141926119,101,"ENSG00000079974.19"
"31643","ENSG00000224245.1_15942",15934,15942,9,"ENSG00000224245.1",0,NA,"VVUVUVVVV",2,7,0.773498964803312,106,112,133,136,144,150,160,163,"AAGATGA","GTGA","ATCATTA","CTGA",2.56931532798119,21,8,10,48,2.39825338698382,4.88175556004794,7.97575141926119,101,"ENSG00000079974.19"
"22433","ENSG00000170571.12_34761",34753,34761,9,"ENSG00000170571.12",0,NA,"VVUVVVVVV",1,8,0.883643892339545,95,101,133,136,143,149,170,173,"GTGCTGG","CTCA","CTGATTA","CTGA",2.4421446074602,32,7,21,69,1.4836902441365,4.44116357346779,7.97573914282597,101,"ENSG00000079974.19"
"34022","ENSG00000231752.9_40041",40033,40041,9,"ENSG00000231752.9",0,NA,"VVUVVVVVV",1,8,0.883643892339545,95,101,133,136,143,149,170,173,"GTGCTGG","CTCA","CTGATTA","CTGA",2.4421446074602,32,7,21,69,1.4836902441365,4.44116357346779,7.97573914282597,101,"ENSG00000079974.19"
"48466","ENSG00000291141.1_40283",40275,40283,9,"ENSG00000291141.1",0,NA,"VVUVVVVVV",1,8,0.883643892339545,95,101,133,136,143,149,170,173,"GTGCTGG","CTCA","CTGATTA","CTGA",2.4421446074602,32,7,21,69,1.4836902441365,4.44116357346779,7.97573914282597,101,"ENSG00000079974.19"
"15641","ENSG00000148948.8_773728",773720,773728,9,"ENSG00000148948.8",1,8,"UVVVVVVMV",1,7,0.786749482401656,112,118,133,136,161,167,188,191,"ATGATGA","CTGT","GGGATAT","CTGA",2.67318893126543,15,25,21,70,1.4936921846006,4.82873793159254,7.97573586119916,101,"ENSG00000079974.19"
"40463","ENSG00000256389.2_211870",211862,211870,9,"ENSG00000256389.2",1,1,"MVUVVVVVV",1,7,0.789648033126294,40,46,60,63,111,117,133,136,"ATGATGA","GTGT","ATGTTGT","CTGA",2.63169756114061,14,48,16,87,1.7237957579478,4.81711154138797,7.97570367389315,101,"ENSG00000079974.19"
"24914","ENSG00000178568.15_897473",897465,897473,9,"ENSG00000178568.15",1,1,"MVVVVVVVV",0,8,0.90600414078675,103,109,133,136,168,174,195,198,"ATGATGA","AAGA","TTGATGA","ATGA",2.50384288275402,24,32,21,86,0.713608691199783,4.35147364405665,7.97549020720365,101,"ENSG00000079974.19"
"10524","ENSG00000131386.20_11932",11924,11932,9,"ENSG00000131386.20",1,1,"MVVVVVVVV",0,8,0.90600414078675,70,76,108,111,115,121,133,136,"CTGATGA","ATGA","ATTAGGC","ATGA",2.33793165905931,32,4,12,57,1.81919954849881,4.35135265222355,7.97536921537055,101,"ENSG00000079974.19"
"8763","ENSG00000120645.12_15630",15622,15630,9,"ENSG00000120645.12",0,NA,"UVVVVUVVV",2,7,0.824844720496894,113,119,133,136,148,154,178,181,"GGGAGGA","CTGA","ATAAAGA","CTGA",2.49906003833756,14,12,24,59,2.04354389595951,4.67598603788581,7.97536491987339,101,"ENSG00000079974.19"
"13212","ENSG00000140575.13_81600",81592,81600,9,"ENSG00000140575.13",1,8,"VVVVVVVMV",0,8,0.884057971014493,89,95,133,136,142,148,158,161,"ATTATAA","CAGA","GAAAGGA","CTGA",2.36543224259647,38,6,10,63,1.98673077640097,4.43906976509435,7.97530164915232,101,"ENSG00000079974.19"
"37603","ENSG00000248515.2_57750",57742,57750,9,"ENSG00000248515.2",1,6,"VVVVVMVVV",0,8,0.902691511387163,111,117,133,136,137,143,191,194,"ATGATAT","CATA","GTGATAA","CTGA",2.44360930694317,16,1,48,74,1.16741300112691,4.36453542852034,7.975301474069,101,"ENSG00000079974.19"
"5602","ENSG00000105967.16_65609",65601,65609,9,"ENSG00000105967.16",1,8,"UVVVVVVMV",1,7,0.786749482401656,116,122,133,136,146,152,163,166,"ATAATGA","ATCA","CTGTTGG","CTGA",2.46445014255049,11,10,11,41,2.88295945323706,4.82815676756008,7.97515469716671,101,"ENSG00000079974.19"
"14722","ENSG00000145779.8_58002",57994,58002,9,"ENSG00000145779.8",0,NA,"VVVVUVVVV",1,8,0.889855072463768,109,115,133,136,137,143,159,162,"ATGAGGA","CAGG","AAGTTCA","CTGA",2.38553712664718,18,1,16,44,1.75927914309846,4.41571499685325,7.97513528670832,101,"ENSG00000079974.19"
"39084","ENSG00000251598.2_350636",350628,350636,9,"ENSG00000251598.2",1,1,"MVVVVVVVV",0,8,0.90600414078675,112,118,133,136,138,144,158,161,"ATTATGC","GTGA","ATCATGA","CTGG",2.25972074530748,15,2,14,40,2.3391894489668,4.35099860442083,7.97501516756783,101,"ENSG00000079974.19"
"21780","ENSG00000168952.16_150746",150738,150746,9,"ENSG00000168952.16",1,8,"VVVVVVVMV",0,8,0.884057971014493,114,120,133,136,148,154,165,168,"TTGGTGA","CTCC","GGCATGG","CTGA",2.25025988868765,13,12,11,45,2.75327200458812,4.43875114895979,7.97498303301776,101,"ENSG00000079974.19"
"23110","ENSG00000172264.19_1007325",1007317,1007325,9,"ENSG00000172264.19",1,8,"VVVVVVVMV",0,8,0.884057971014493,108,114,133,136,144,150,176,179,"ATGGTCA","AAGA","ATGATAA","CTGA",2.39326787553337,19,8,26,62,1.79979584486444,4.43872875377173,7.9749606378297,101,"ENSG00000079974.19"
"2516","ENSG00000075391.18_83524",83516,83524,9,"ENSG00000075391.18",1,8,"VVVVVVVMV",0,8,0.884057971014493,112,118,133,136,183,189,210,213,"GGGATTA","CTGG","ATGAAGA","CTGA",2.45750713280617,15,47,21,92,1.37151680791066,4.43872442332129,7.97495630737926,101,"ENSG00000079974.19"
"15336","ENSG00000147862.18_230127",230119,230127,9,"ENSG00000147862.18",1,1,"MVVVVUVVV",1,7,0.82815734989648,83,89,133,136,140,146,162,165,"GTGAAGA","CAGA","ATGAATA","CTGA",2.55783232175113,44,4,16,73,1.59661608810192,4.6622078916107,7.97483729119662,101,"ENSG00000079974.19"
"11256","ENSG00000134369.16_112457",112449,112457,9,"ENSG00000134369.16",1,7,"VVVVVVMVV",0,8,0.885300207039338,116,122,133,136,173,179,192,195,"ATGCAGA","TTGA","GAGATTC","CTGA",2.37405502119727,11,37,13,70,1.90736777214186,4.43360031169758,7.97480113985493,101,"ENSG00000079974.19"
"7813","ENSG00000115808.12_88343",88335,88343,9,"ENSG00000115808.12",1,8,"VVVVVVVMV",0,8,0.884057971014493,113,119,133,136,141,147,159,162,"GTTAAGA","ATAA","TTTAGGA","CTGA",2.23011935537663,14,5,12,40,2.88653824664236,4.43850015395497,7.97473203801294,101,"ENSG00000079974.19"
"34359","ENSG00000232849.2_20154",20146,20154,9,"ENSG00000232849.2",1,1,"MVVVVVVVV",0,8,0.90600414078675,114,120,133,136,146,152,164,167,"ATGAGGA","CAGT","GGGTAGA","ATGA",2.18128839150045,13,10,12,44,2.86058706384062,4.3506274184609,7.9746439816079,101,"ENSG00000079974.19"
"8622","ENSG00000119899.13_28865",28857,28865,9,"ENSG00000119899.13",0,NA,"UVVVVVVVV",1,8,0.902691511387163,113,119,133,136,147,153,207,210,"AAGATGT","CATA","CAGAAGA","CTGA",2.34832598330549,14,11,54,88,1.79993274919345,4.36385982614084,7.9746258716895,101,"ENSG00000079974.19"
"38760","ENSG00000251002.10_214755",214747,214755,9,"ENSG00000251002.10",0,NA,"VVUVVUVVV",2,7,0.805797101449275,80,86,101,104,111,117,133,136,"ACGATGG","CTGC","ATAATGT","CTGA",2.45022353715452,15,7,16,47,2.67077226658261,4.75139896190319,7.97458736770029,101,"ENSG00000079974.19"
"5231","ENSG00000104044.16_81811",81803,81811,9,"ENSG00000104044.16",0,NA,"VVVVVVUVV",1,8,0.886128364389234,100,106,133,136,158,164,182,185,"AGGATGT","CAGC","GTGATGA","CTGA",2.51667972403755,27,22,18,76,0.94227638822182,4.4300353037847,7.97454876134163,101,"ENSG00000079974.19"
"2267","ENSG00000072315.4_85089",85081,85089,9,"ENSG00000072315.4",1,1,"MVVVVVVVV",0,8,0.90600414078675,82,88,100,103,112,118,133,136,"TTAATGA","CAGA","GAGACAA","ATGA",2.19421097533162,12,9,15,45,2.77385574891908,4.35048222944914,7.97449879259614,101,"ENSG00000079974.19"
"18955","ENSG00000159579.14_22111",22103,22111,9,"ENSG00000159579.14",1,8,"VVVVVVVMV",0,8,0.884057971014493,115,121,133,136,139,145,153,156,"ATAACAA","CTTA","GTATGGA","CTGA",2.22226120671066,12,3,8,32,2.93775089458213,4.43820640149663,7.9744382855546,101,"ENSG00000079974.19"
"29148","ENSG00000197321.16_196980",196972,196980,9,"ENSG00000197321.16",1,1,"MVVVVUVVV",1,7,0.82815734989648,105,111,133,136,141,147,164,167,"ATGATGG","GTTA","TTGAAGG","CTGA",2.50204926924716,22,5,17,53,1.96626260398844,4.66164776640904,7.97427716599496,101,"ENSG00000079974.19"
"8475","ENSG00000119121.22_156075",156067,156075,9,"ENSG00000119121.22",1,1,"MVVVVUVVV",1,7,0.82815734989648,115,121,133,136,139,145,153,156,"AAGGTGG","GTGA","GTGAGGG","CTGA",2.35630255117828,12,3,8,32,2.93775089458213,4.66160864227599,7.97423804186192,101,"ENSG00000079974.19"
"16688","ENSG00000152078.10_65714",65706,65714,9,"ENSG00000152078.10",1,8,"VVVUVVVMV",1,7,0.764803312629399,50,56,70,73,106,112,133,136,"ATGTTGA","CTGA","GTGGAGA","CTGA",2.73099989986458,14,33,21,77,1.45339544480717,4.91501536097609,7.97422861149369,101,"ENSG00000079974.19"
"43304","ENSG00000271092.5_65146",65138,65146,9,"ENSG00000271092.5",1,8,"VVVUVVVMV",1,7,0.764803312629399,50,56,70,73,106,112,133,136,"ATGTTGA","CTGA","GTGGAGA","CTGA",2.73099989986458,14,33,21,77,1.45339544480717,4.91501536097609,7.97422861149369,101,"ENSG00000079974.19"
"9847","ENSG00000127914.19_119624",119616,119624,9,"ENSG00000127914.19",1,7,"VVVVVVMVV",0,8,0.885300207039338,18,24,63,66,114,120,133,136,"GTGATGA","TTGA","GTGCTGA","CAGA",2.52139294741994,39,48,13,109,0.922640795180199,4.43298177782829,7.97418260598564,101,"ENSG00000079974.19"
"40646","ENSG00000257259.3_95801",95793,95801,9,"ENSG00000257259.3",1,2,"VMVVVVVVV",0,8,0.884057971014493,111,117,133,136,145,151,172,175,"GTGAAGG","GAGA","GTGGTAA","CTGA",2.3254288967521,16,9,21,55,2.24881259893554,4.43791797765406,7.97414986171203,101,"ENSG00000079974.19"
"9686","ENSG00000126217.22_6110",6102,6110,9,"ENSG00000126217.22",1,5,"UVVVMVVVV",1,7,0.789233954451346,116,122,133,136,151,157,166,169,"AGGACGT","CTGA","GGGATGA","CTGA",2.50990386999561,11,15,9,44,2.5359501775769,4.81716066105358,7.97409647885896,101,"ENSG00000079974.19"
"29809","ENSG00000198743.7_14736",14728,14736,9,"ENSG00000198743.7",1,8,"VVVVVUVMV",1,7,0.806211180124224,114,120,133,136,143,149,176,179,"AGAATGA","TTGA","ATGGTGA","CTGA",2.51965400982952,13,7,27,56,2.19918658332961,4.74921999554826,7.97406471604516,101,"ENSG00000079974.19"
"36959","ENSG00000243927.6_15090",15082,15090,9,"ENSG00000243927.6",1,8,"VVVVVUVMV",1,7,0.806211180124224,114,120,133,136,143,149,176,179,"AGAATGA","TTGA","ATGGTGA","CTGA",2.51965400982952,13,7,27,56,2.19918658332961,4.74921999554826,7.97406471604516,101,"ENSG00000079974.19"
"43593","ENSG00000272657.1_14722",14714,14722,9,"ENSG00000272657.1",1,8,"VVVVVUVMV",1,7,0.806211180124224,114,120,133,136,143,149,176,179,"AGAATGA","TTGA","ATGGTGA","CTGA",2.51965400982952,13,7,27,56,2.19918658332961,4.74921999554826,7.97406471604516,101,"ENSG00000079974.19"
"36679","ENSG00000242593.8_163074",163066,163074,9,"ENSG00000242593.8",1,2,"VMVVVUVVV",1,7,0.806211180124223,111,117,133,136,139,145,190,193,"ATGATCA","CTGC","GTGAGGT","CTGA",2.61760883441367,16,3,45,73,1.54610607633616,4.74920790977349,7.97405263027039,101,"ENSG00000079974.19"
"3272","ENSG00000082805.21_448020",448012,448020,9,"ENSG00000082805.21",1,1,"MVVVVVVVV",0,8,0.90600414078675,107,113,133,136,140,146,162,165,"CTGAAGA","CAAA","ATTTTGT","CTGA",2.29684369015015,20,4,16,49,2.08785028724688,4.35003538872864,7.97405195187564,101,"ENSG00000079974.19"
"42910","ENSG00000267322.4_15980",15972,15980,9,"ENSG00000267322.4",1,2,"VMVVVVVVV",0,8,0.884057971014493,107,113,133,136,143,149,158,161,"ATGATGA","CACA","ATCACAA","CTCA",2.2884378503414,20,7,9,45,2.49500504206971,4.43781434441976,7.97404622847773,101,"ENSG00000079974.19"
"41599","ENSG00000259345.7_330509",330501,330509,9,"ENSG00000259345.7",0,NA,"VVUUVVVVV",2,7,0.764389233954451,87,93,107,110,115,121,133,136,"AAGATGA","CAGA","ACGTTGC","CTGA",2.51688915337104,14,5,12,40,2.88653824664236,4.91644981727899,7.97400675309679,101,"ENSG00000079974.19"
"25656","ENSG00000182389.20_132303",132295,132303,9,"ENSG00000182389.20",1,6,"VVVVVMVVV",0,8,0.902691511387163,70,76,90,93,100,106,133,136,"ATAATGA","TTGG","TTGAAGA","CTTA",2.2928073192337,14,7,27,57,2.16744747749553,4.36320740143005,7.9739734469787,101,"ENSG00000079974.19"
"44642","ENSG00000283228.1_7085",7077,7085,9,"ENSG00000283228.1",1,6,"VVVVVMVVV",0,8,0.902691511387163,70,76,90,93,100,106,133,136,"ATAATGA","TTGG","TTGAAGA","CTTA",2.2928073192337,14,7,27,57,2.16744747749553,4.36320740143005,7.9739734469787,101,"ENSG00000079974.19"
"33843","ENSG00000231304.2_262505",262497,262505,9,"ENSG00000231304.2",1,1,"MVVVVVVVV",0,8,0.90600414078675,115,121,133,136,141,147,180,183,"TTGTTGT","TAGA","GTGTTGT","CTGA",2.30884534806008,12,5,33,59,2.00751060953173,4.34995323248306,7.97396979563006,101,"ENSG00000079974.19"
"46697","ENSG00000287069.1_114563",114555,114563,9,"ENSG00000287069.1",1,8,"VVVVVVVMV",0,8,0.884057971014493,115,121,133,136,139,145,154,157,"TTGATTG","AGGA","GTGTGTA","CTGA",2.22643984227755,12,3,9,33,2.90790712619639,4.43770985201168,7.97394173606965,101,"ENSG00000079974.19"
"3229","ENSG00000082482.14_51024",51016,51024,9,"ENSG00000082482.14",0,NA,"UVVVVVVVV",1,8,0.902691511387163,109,115,133,136,141,147,190,193,"AGGATGT","CAGT","CTGCAGA","CTGA",2.37646169389852,18,5,43,75,1.60897840532676,4.36301409116256,7.97378013671121,101,"ENSG00000079974.19"
"18906","ENSG00000159216.19_553570",553562,553570,9,"ENSG00000159216.19",1,8,"VVUVVVVMV",1,7,0.767701863354037,82,88,104,107,113,119,133,136,"ATGACTA","CTGA","AAGATGT","CTGA",2.53690794932194,16,6,14,45,2.69908304135735,4.90295067587591,7.97375812929205,101,"ENSG00000079974.19"
"44688","ENSG00000283380.1_374872",374864,374872,9,"ENSG00000283380.1",1,7,"VVVVVVMVV",0,8,0.885300207039338,113,119,133,136,146,152,164,167,"ATGCTAA","GTCA","AAGAAAA","CTGA",2.23559161828867,14,10,12,45,2.82619369388064,4.43253445395127,7.97373528210862,101,"ENSG00000079974.19"
"47649","ENSG00000288828.1_78863",78855,78863,9,"ENSG00000288828.1",0,NA,"UVVVVUVVV",2,7,0.824844720496894,89,95,110,113,116,122,133,136,"GTGATGA","CTGC","TTGTTGG","CTGT",2.40617770340112,15,3,11,38,2.65595836413498,4.67428576336894,7.97366464535652,101,"ENSG00000079974.19"
"41322","ENSG00000258841.1_189",181,189,9,"ENSG00000258841.1",1,8,"VVVVVVVMV",0,8,0.884057971014493,113,119,133,136,150,156,169,172,"CTGCTGA","CTTT","GTCTTGG","CTGA",2.28646852713095,14,14,13,50,2.50658604070126,4.4374273887269,7.97365927278487,101,"ENSG00000079974.19"
"6956","ENSG00000112339.15_137459",137451,137459,9,"ENSG00000112339.15",1,6,"VVVVVMUVV",1,7,0.788819875776397,115,121,133,136,141,147,165,168,"ATGATAA","CTCA","ATAAAAA","CTGA",2.50455907512122,12,5,18,44,2.57637255898621,4.81835826494859,7.97363776805418,101,"ENSG00000079974.19"
"8313","ENSG00000118197.14_16528",16520,16528,9,"ENSG00000118197.14",1,1,"MVVUVVVVV",1,7,0.786749482401656,94,100,133,136,151,157,167,170,"AGGATGA","CAGA","CTGATGG","CTGA",2.66034268099888,33,15,10,67,1.57070557511193,4.82658086210944,7.97357879171607,101,"ENSG00000079974.19"
"26503","ENSG00000184305.16_755309",755301,755309,9,"ENSG00000184305.16",1,2,"VMVVVUVVV",1,7,0.806211180124223,83,89,133,136,159,165,182,185,"ATAATGA","CTGA","ATGATTT","CTGA",2.71849817133647,44,23,17,93,0.871121328408334,4.74861061766287,7.97345533815977,101,"ENSG00000079974.19"
"12103","ENSG00000137252.10_8251",8243,8251,9,"ENSG00000137252.10",1,6,"UVVVVMVVV",1,7,0.805383022774327,48,54,63,66,116,122,133,136,"ATGCTGC","CTGT","ATGATGA","CTGA",2.57770235656441,9,50,11,79,1.82286508669148,4.75188686594688,7.97341895704419,101,"ENSG00000079974.19"
"35598","ENSG00000236449.2_108919",108911,108919,9,"ENSG00000236449.2",0,NA,"VVVVUVVVV",1,8,0.889855072463768,107,113,133,136,141,147,195,198,"GTGATCC","CTGT","TTGCTGA","CTGA",2.43453522816219,20,5,48,82,1.42566972332939,4.41397614443599,7.97339643429107,101,"ENSG00000079974.19"
"16355","ENSG00000151388.11_155077",155069,155077,9,"ENSG00000151388.11",1,1,"MVVVVVUVV",1,7,0.792132505175983,102,108,133,136,145,151,172,175,"ATGATGG","ATGA","ATGCAGA","CTGA",2.64550667377309,25,9,21,64,1.58262699421874,4.80483453817649,7.97336455888043,101,"ENSG00000079974.19"
"13574","ENSG00000142192.21_64336",64328,64336,9,"ENSG00000142192.21",1,8,"VVVVVVVMV",0,8,0.884057971014493,82,88,133,136,142,148,165,168,"ATGGTGA","TTGA","TTGAAGA","GTGA",2.41002051824362,45,6,17,77,1.68166641329087,4.43711746706208,7.97334935112005,101,"ENSG00000079974.19"
"39913","ENSG00000254434.1_5636",5628,5636,9,"ENSG00000254434.1",1,2,"VMVVVVVVV",0,8,0.884057971014493,78,84,95,98,107,113,133,136,"AAAATAA","CAGA","TTGAGAA","CTGA",2.29578477888364,11,9,20,49,2.44298661979725,4.43705461975537,7.97328650381334,101,"ENSG00000079974.19"
"39215","ENSG00000253311.3_94523",94515,94523,9,"ENSG00000253311.3",0,NA,"UVVVVUVVV",2,7,0.824844720496894,91,97,133,136,138,144,152,155,"TTGATGA","CAGC","CTGATGG","CTGA",2.57760914763899,36,2,8,55,1.51149865234682,4.67388990915168,7.97326879113926,101,"ENSG00000079974.19"
"35790","ENSG00000237136.8_23759",23751,23759,9,"ENSG00000237136.8",1,2,"VMVVVVVVV",0,8,0.884057971014493,42,48,60,63,73,79,133,136,"ATGTCGA","CTCA","TAGACGA","CTGA",2.3773176510048,12,10,54,85,1.89929386346861,4.43701955087515,7.97325143493312,101,"ENSG00000079974.19"
"26639","ENSG00000184672.12_542145",542137,542145,9,"ENSG00000184672.12",1,5,"VVVVMVVVV",0,8,0.886542443064182,114,120,133,136,165,171,225,228,"ATCATGG","CTAA","ATTATGA","CTGA",2.49754582690481,13,29,54,105,1.05790133422663,4.42705171173134,7.97322148398807,101,"ENSG00000079974.19"
"8956","ENSG00000121898.13_72779",72771,72779,9,"ENSG00000121898.13",1,1,"MVVVVUVVV",1,7,0.82815734989648,106,112,133,136,143,149,163,166,"AGGATGA","AAGA","ATGAATC","CTGA",2.45410938261915,21,7,14,51,2.28162795213386,4.66058929239871,7.97321869198463,101,"ENSG00000079974.19"
"5648","ENSG00000106069.25_11867",11859,11867,9,"ENSG00000106069.25",1,6,"VVVVVMUVV",1,7,0.788819875776397,85,91,133,136,152,158,169,172,"ATGATGT","ATGA","GTGGGGA","CTGA",2.66946705352475,42,16,11,78,1.47511907232727,4.8178915239564,7.97317102706199,101,"ENSG00000079974.19"
"45161","ENSG00000285162.1_36096",36088,36096,9,"ENSG00000285162.1",1,6,"VVVVVMUVV",1,7,0.788819875776397,85,91,133,136,152,158,169,172,"ATGATGT","ATGA","GTGGGGA","CTGA",2.66946705352475,42,16,11,78,1.47511907232727,4.8178915239564,7.97317102706199,101,"ENSG00000079974.19"
"23422","ENSG00000172943.21_105105",105097,105105,9,"ENSG00000172943.21",1,2,"VMVVVVVVV",0,8,0.884057971014493,116,122,133,136,179,185,196,199,"TTGGTGT","CTCA","CTGAGGG","CTGA",2.36745192783632,11,43,11,74,1.96454849393081,4.43689033654324,7.97312222060121,101,"ENSG00000079974.19"
"46610","ENSG00000286918.1_13455",13447,13455,9,"ENSG00000286918.1",1,2,"VMVVVVVVV",0,8,0.884057971014493,114,120,133,136,148,154,173,176,"ATGATCT","ATTA","TTTATTA","CTGA",2.31158445861799,13,12,19,53,2.33691292363537,4.43686899527215,7.97310087933012,101,"ENSG00000079974.19"
"5253","ENSG00000104129.10_3779",3771,3779,9,"ENSG00000104129.10",1,6,"UVVVVMVVV",1,7,0.805383022774327,102,108,133,136,139,145,153,156,"ATGGTGA","CTGT","ATGTTCA","CTGA",2.57211861474214,25,3,8,45,1.85881036801081,4.75156694990626,7.97309904100357,101,"ENSG00000079974.19"
"1961","ENSG00000068305.19_34061",34053,34061,9,"ENSG00000068305.19",1,1,"MVVVVUVVV",1,7,0.82815734989648,112,118,133,136,166,172,184,187,"ATGATTA","ATCA","TTGTTGA","CTGA",2.508490952503,15,30,12,66,1.91858817079803,4.66046529687117,7.97309469645709,101,"ENSG00000079974.19"
"25170","ENSG00000179909.16_12425",12417,12425,9,"ENSG00000179909.16",0,NA,"UVVVVVUVV",2,7,0.788819875776397,96,102,111,114,116,122,133,136,"GTGATGA","TTGG","AAGGGGA","CTGA",2.49182651151551,9,2,11,31,2.65896743063402,4.81778604351769,7.97306554662327,101,"ENSG00000079974.19"
"7187","ENSG00000113269.14_144085",144077,144085,9,"ENSG00000113269.14",1,1,"MVVVVVUVV",1,7,0.792132505175983,112,118,133,136,138,144,153,156,"ATGATGC","AGGA","CTGTTGC","CTGA",2.49793945365675,15,2,9,35,2.56498500700451,4.80447867451238,7.97300869521631,101,"ENSG00000079974.19"
"27657","ENSG00000187079.20_152737",152729,152737,9,"ENSG00000187079.20",1,8,"VVVVVVUMV",1,7,0.770186335403727,116,122,133,136,142,148,163,166,"GAGATGA","TTGA","ATTATCA","CTGA",2.51537411463792,11,6,15,41,2.79987486950126,4.89225890843852,7.97300425005343,101,"ENSG00000079974.19"
"20957","ENSG00000166037.11_17720",17712,17720,9,"ENSG00000166037.11",1,1,"MVVVVVVVV",0,8,0.90600414078675,90,96,133,136,163,169,186,189,"ATGAAGC","ATGA","ATGAGAA","CTGA",2.49094914120523,37,27,17,90,0.789568045899194,4.34897391348352,7.97299047663052,101,"ENSG00000079974.19"
"41531","ENSG00000259199.2_76340",76332,76340,9,"ENSG00000259199.2",0,NA,"VVVVVVUVV",1,8,0.886128364389234,110,116,133,136,140,146,168,171,"ATGTTGA","CTAT","AGGGTAA","CTGA",2.35698455551522,17,4,22,52,2.0006381594317,4.4284671323833,7.97298058994023,101,"ENSG00000079974.19"
"32037","ENSG00000225689.2_60942",60934,60942,9,"ENSG00000225689.2",0,NA,"VVUVVVVVV",1,8,0.883643892339545,105,111,133,136,149,155,164,167,"ATTATAA","CTGT","GAGCTGG","CTGA",2.35846777265093,22,13,9,53,2.02996492276055,4.43827085177501,7.97284642113319,101,"ENSG00000079974.19"
"24972","ENSG00000178921.14_3262",3254,3262,9,"ENSG00000178921.14",1,2,"VMVVVVUVV",1,7,0.770186335403727,113,119,133,136,156,162,181,184,"AGGATGA","TTGA","GTCATGA","CTGA",2.66264232497953,14,20,19,62,1.81717102624228,4.89202996485978,7.97277530647469,101,"ENSG00000079974.19"
"29376","ENSG00000197880.10_16750",16742,16750,9,"ENSG00000197880.10",1,8,"VVVVVVVMV",0,8,0.884057971014493,55,61,69,72,85,91,133,136,"AGGATGA","CTGA","CAGAGGA","GTGA",2.44607369098481,8,13,42,72,1.43897136227921,4.43653232554449,7.97276420960246,101,"ENSG00000079974.19"
"32632","ENSG00000227398.6_47469",47461,47469,9,"ENSG00000227398.6",1,8,"VVVVVVVMV",0,8,0.884057971014493,79,85,104,107,115,121,133,136,"AGGAAGA","CTGA","ATTCTGA","CTAA",2.28340706257851,19,8,12,48,2.52337101971498,4.43652119255959,7.97275307661756,101,"ENSG00000079974.19"
"35048","ENSG00000234810.4_207666",207658,207666,9,"ENSG00000234810.4",1,8,"VVVVVVVMV",0,8,0.884057971014493,114,120,133,136,186,192,202,205,"GAGATTA","CTTA","GTCTTGA","CTGA",2.36242963687336,13,50,10,82,1.99643675670062,4.43649191729742,7.97272380135539,101,"ENSG00000079974.19"
"43854","ENSG00000274461.2_167732",167724,167732,9,"ENSG00000274461.2",1,6,"VVVVVMVVV",0,8,0.902691511387163,113,119,133,136,144,150,190,193,"CTCATCA","CTAA","GAGATAA","CTGA",2.32151341879098,14,8,40,71,1.97099535797442,4.3619378708119,7.97270391636056,101,"ENSG00000079974.19"
"36215","ENSG00000238755.3_342361",342353,342361,9,"ENSG00000238755.3",0,NA,"UVVVVVVVV",1,8,0.902691511387163,99,105,133,136,139,145,177,180,"ATGATGT","CTGC","TTGATGA","ATGA",2.48676657971821,28,3,32,72,0.869236178282814,4.36192001076771,7.97268605631637,101,"ENSG00000079974.19"
"14848","ENSG00000145975.15_18803",18795,18803,9,"ENSG00000145975.15",0,NA,"VVVVVVUVV",1,8,0.886128364389234,99,105,133,136,141,147,172,175,"TTGATGT","CTGC","ATGTCTA","CTGA",2.46445677400817,28,5,25,67,1.28248442523868,4.42804906298995,7.97256252054689,101,"ENSG00000079974.19"
"35319","ENSG00000235703.7_254226",254218,254226,9,"ENSG00000235703.7",1,8,"VVVVVVVMV",0,8,0.884057971014493,105,111,133,136,141,147,200,203,"ATTATGA","TTTA","TTGAGAA","CTGA",2.47126347799853,22,5,53,89,1.26970091206996,4.43619769134837,7.97242957540635,101,"ENSG00000079974.19"
"20871","ENSG00000165923.17_34449",34441,34449,9,"ENSG00000165923.17",1,2,"VMVVVVVVV",0,8,0.884057971014493,115,121,133,136,150,156,183,186,"AACATGA","CAGT","ATGATTA","CTGA",2.38773348527352,12,14,27,62,1.82650132378544,4.43618113973556,7.97241302379353,101,"ENSG00000079974.19"
"13699","ENSG00000143198.13_17773",17765,17773,9,"ENSG00000143198.13",1,7,"VVVVVVMVV",0,8,0.885300207039338,82,88,133,136,157,163,175,178,"AGGATGA","GGGA","GGGATGG","CTGA",2.47920885239556,45,21,12,87,1.19672165934144,4.43119516882795,7.9723959969853,101,"ENSG00000079974.19"
"9689","ENSG00000126218.12_13418",13410,13418,9,"ENSG00000126218.12",1,2,"VMVVVVVVV",0,8,0.884057971014493,61,67,75,78,83,89,133,136,"ATTATTA","CAGA","CAGATAA","CTGA",2.41090147241203,8,5,44,66,1.6716151560434,4.43607290969756,7.97230479375553,101,"ENSG00000079974.19"
"16834","ENSG00000152402.11_292456",292448,292456,9,"ENSG00000152402.11",1,7,"VVVVVVMVV",0,8,0.885300207039338,104,110,133,136,140,146,173,176,"TTGATGC","CTTA","TTCATAA","CTGA",2.46147072100619,23,4,27,63,1.31432259185659,4.43103184964112,7.97223267779847,101,"ENSG00000079974.19"
"7646","ENSG00000115252.19_155140",155132,155140,9,"ENSG00000115252.19",1,3,"VVMVVVVVV",0,8,0.882815734989648,92,98,133,136,170,176,186,189,"TTGATGA","ATAA","CTGTTAA","CTGA",2.50966526508309,35,34,10,88,1.03276518938418,4.44096673915119,7.97222967910979,101,"ENSG00000079974.19"
"8613","ENSG00000119778.15_24594",24586,24594,9,"ENSG00000119778.15",1,3,"VVMVVVVVV",0,8,0.882815734989648,112,118,133,136,143,149,158,161,"ATCATTA","TTGA","ATGAAAA","TTGA",2.22339670317943,15,7,9,40,2.94121729565198,4.44096549587872,7.97222843583731,101,"ENSG00000079974.19"
"27502","ENSG00000186329.9_53113",53105,53113,9,"ENSG00000186329.9",1,7,"UVVVVVMVV",1,7,0.787991718426501,50,56,65,68,75,81,133,136,"ATGAGGA","CTGT","GTGAGAA","CTGA",2.61648248063696,9,7,52,77,1.83775404352748,4.82024264527681,7.97220951898282,101,"ENSG00000079974.19"
"33096","ENSG00000228669.2_59061",59053,59061,9,"ENSG00000228669.2",1,1,"MVVVVVVVV",0,8,0.90600414078675,92,98,106,109,115,121,133,136,"ATGTTGA","CACA","TTAAAGA","CTTA",2.18820584866158,8,6,12,35,2.80463758214713,4.34816914330608,7.97218570645308,101,"ENSG00000079974.19"
"2504","ENSG00000075340.23_31624",31616,31624,9,"ENSG00000075340.23",1,6,"VVVVVMVVV",0,8,0.902691511387163,93,99,133,136,144,150,174,177,"GTTATGT","CTGT","GTCATGT","CTGA",2.41995598766552,34,8,24,75,1.31260191182326,4.36141045739834,7.972176502947,101,"ENSG00000079974.19"
"37536","ENSG00000248397.1_13181",13173,13181,9,"ENSG00000248397.1",1,2,"VMVVVUVVV",1,7,0.806211180124223,73,79,97,100,108,114,133,136,"ATGAAGA","CTGT","AAGAAAA","CTGA",2.51414199397882,18,8,19,54,2.22835046462863,4.74732427278852,7.97216899328541,101,"ENSG00000079974.19"
"23864","ENSG00000174469.23_1787838",1787830,1787838,9,"ENSG00000174469.23",1,1,"MVVVVUVVV",1,7,0.82815734989648,112,118,133,136,148,154,169,172,"ACGATAA","CTGG","CTGACAA","CTGA",2.42175342302723,15,12,15,51,2.49290068452352,4.65948087617627,7.97211027576219,101,"ENSG00000079974.19"
"14741","ENSG00000145808.10_181054",181046,181054,9,"ENSG00000145808.10",0,NA,"UVVVVVVVV",1,8,0.902691511387163,115,121,133,136,183,189,197,200,"ATACTGA","CTGA","GTCAAGA","ATGA",2.31950905374071,12,47,8,76,1.98197419281925,4.36134197110599,7.97210801665464,101,"ENSG00000079974.19"
"34800","ENSG00000234170.6_97913",97905,97913,9,"ENSG00000234170.6",0,NA,"VVVVVUUVV",2,7,0.808281573498965,91,97,112,115,116,122,133,136,"GTGCTGG","CAGA","ATGAGGA","CTGA",2.49485936069904,15,1,11,36,2.32352610950047,4.73898046187352,7.97210675586938,101,"ENSG00000079974.19"
"26338","ENSG00000183876.9_14708",14700,14708,9,"ENSG00000183876.9",1,8,"VVVVVVVMV",0,8,0.884057971014493,112,118,133,136,167,173,217,220,"GTGATGG","CTAA","CTCATGC","CTGA",2.51735952733778,15,31,44,99,0.961095958829753,4.43587320193706,7.97210508599503,101,"ENSG00000079974.19"
"6264","ENSG00000109111.15_12463",12455,12463,9,"ENSG00000109111.15",1,8,"VVVVVVVMV",0,8,0.884057971014493,32,38,50,53,78,84,133,136,"ATGATGA","TTGA","AAGAGGA","CTGG",2.49241926140784,12,25,49,95,1.12718359716825,4.43582800163846,7.97205988569644,101,"ENSG00000079974.19"
"23537","ENSG00000173198.6_34016",34008,34016,9,"ENSG00000173198.6",1,1,"MVVVVVVVV",0,8,0.90600414078675,89,95,133,136,163,169,186,189,"ATGAAGC","ATGA","ATGTGGA","CTGA",2.49052684390793,38,27,17,91,0.788277983566936,4.34794756907162,7.97196413221862,101,"ENSG00000079974.19"
"43140","ENSG00000269113.4_16475",16467,16475,9,"ENSG00000269113.4",0,NA,"VVUVUVVVV",2,7,0.773498964803312,113,119,133,136,152,158,166,169,"GTGATGA","AGGA","GAGCTGA","CTGA",2.56145958326059,14,16,8,47,2.4354623016931,4.8779648808576,7.97196074007085,101,"ENSG00000079974.19"
"38607","ENSG00000250592.1_2950",2942,2950,9,"ENSG00000250592.1",1,1,"MVUVVVVVV",1,7,0.789648033126294,116,122,133,136,143,149,163,166,"GTGAAGG","CTGA","AAGCAGA","CTGA",2.45745943323352,11,7,14,41,2.87032262606336,4.8133463785717,7.97193851107688,101,"ENSG00000079974.19"
"47783","ENSG00000289315.2_11635",11627,11635,9,"ENSG00000289315.2",1,2,"VMVVVVVVV",0,8,0.884057971014493,84,90,133,136,169,175,183,186,"CTGATGA","TTCA","CTGGTAA","CTGA",2.50994468149082,43,33,8,93,1.00986124421672,4.43570644687222,7.97193833093019,101,"ENSG00000079974.19"
"17712","ENSG00000154928.19_392516",392508,392516,9,"ENSG00000154928.19",1,8,"VVVVVVVMV",0,8,0.884057971014493,67,73,85,88,110,116,133,136,"CTGAAGA","CTCA","ACCATGT","CTGA",2.37621496928285,12,22,17,60,1.90127163593349,4.43567619112146,7.97190807517943,101,"ENSG00000079974.19"
"474","ENSG00000012983.12_38795",38787,38795,9,"ENSG00000012983.12",0,NA,"UVVVVVVVV",1,8,0.902691511387163,57,63,74,77,102,108,133,136,"ATGATGA","CTGA","GTTATGA","CTTT",2.41089527027027,11,25,25,70,1.37176269657283,4.36109945792699,7.97186550347564,101,"ENSG00000079974.19"
"13398","ENSG00000141349.10_3917",3909,3917,9,"ENSG00000141349.10",1,1,"MVVVVVVVV",0,8,0.90600414078675,84,90,98,101,107,113,133,136,"ATCAGGA","CTGA","GTGACCT","CTCA",2.27213258900472,8,6,20,43,2.24372122116408,4.34781795363222,7.97183451677922,101,"ENSG00000079974.19"
"21495","ENSG00000168032.10_28014",28006,28014,9,"ENSG00000168032.10",1,6,"VVVVVMVVV",0,8,0.902691511387163,80,86,96,99,108,114,133,136,"TTGAAGA","CAGA","ATGACCA","CTCA",2.24943010416027,10,9,19,47,2.44794063374668,4.36103533203712,7.97180137758577,101,"ENSG00000079974.19"
"5597","ENSG00000105963.15_14622",14614,14622,9,"ENSG00000105963.15",1,2,"VMVVVVVVV",0,8,0.884057971014493,70,76,87,90,98,104,133,136,"ATGGTGA","TTGA","ATGTTAA","CTGT",2.34477558581118,11,8,29,57,2.1103799199347,4.43555428966898,7.97178617372695,101,"ENSG00000079974.19"
"36360","ENSG00000240230.6_34764",34756,34764,9,"ENSG00000240230.6",1,2,"VMVVVVVVV",0,8,0.884057971014493,70,76,87,90,98,104,133,136,"ATGGTGA","TTGA","ATGTTAA","CTGT",2.34477558581118,11,8,29,57,2.1103799199347,4.43555428966898,7.97178617372695,101,"ENSG00000079974.19"
"38266","ENSG00000249859.14_102533",102525,102533,9,"ENSG00000249859.14",1,5,"VVVVMVVVV",0,8,0.886542443064182,83,89,106,109,114,120,133,136,"ATGAAGA","CTGG","GTATTCA","TTGA",2.26318440673173,17,5,13,44,2.61427522123416,4.42554281652809,7.97171258878481,101,"ENSG00000079974.19"
"32544","ENSG00000227155.7_5413",5405,5413,9,"ENSG00000227155.7",0,NA,"VVVVUVVVV",1,8,0.889855072463768,76,82,96,99,108,114,133,136,"ATGATTA","CTGT","GAGCAGA","CAGA",2.27383722722623,14,9,19,51,2.49023352917344,4.41228709433708,7.97170738419215,101,"ENSG00000079974.19"
"39805","ENSG00000254237.6_66798",66790,66798,9,"ENSG00000254237.6",1,8,"VVVVVVVMV",0,8,0.884057971014493,92,98,106,109,114,120,133,136,"ATTATGT","CTGA","AGAAAGA","CTGT",2.25426175841887,8,5,13,35,2.71335586697867,4.43544189744278,7.97167378150075,101,"ENSG00000079974.19"
"33709","ENSG00000230864.1_13767",13759,13767,9,"ENSG00000230864.1",1,6,"VVVVVMUVV",1,7,0.788819875776397,87,93,99,102,115,121,133,136,"ATGATGA","CTGA","TTCACGA","CGGA",2.56391771235521,6,13,12,40,2.17277370137395,4.81638961260218,7.97166911570777,101,"ENSG00000079974.19"
"30019","ENSG00000198947.18_958111",958103,958111,9,"ENSG00000198947.18",1,1,"MVVVVUVVV",1,7,0.82815734989648,102,108,133,136,144,150,161,164,"TTGATGA","ATGC","TTTATTA","CTGA",2.47373933994017,25,8,11,53,2.14432957147092,4.65898129276802,7.97161069235394,101,"ENSG00000079974.19"
"36306","ENSG00000239828.9_76819",76811,76819,9,"ENSG00000239828.9",1,3,"VVMVVVVVV",0,8,0.882815734989648,114,120,133,136,143,149,164,167,"GTAATAA","TTTA","ATTTTGA","CTGA",2.24097316872313,13,7,15,44,2.82140405818526,4.44030629575153,7.97156923571012,101,"ENSG00000079974.19"
"6282","ENSG00000109184.15_15468",15460,15468,9,"ENSG00000109184.15",1,6,"VVUVVMVVV",1,7,0.786335403726708,78,84,92,95,103,109,133,136,"AAGATGA","ATGA","GAGATTA","CTGA",2.59080650783439,8,8,24,49,2.03277591252173,4.82620482452108,7.97154643942791,101,"ENSG00000079974.19"
"41334","ENSG00000258859.1_88110",88102,88110,9,"ENSG00000258859.1",1,1,"MVVVVVVVV",0,8,0.90600414078675,114,120,133,136,152,158,177,180,"CTTTTGA","GTGC","GTGATGC","CTGA",2.29955594776174,13,16,19,57,2.05952815740842,4.34747528562167,7.97149184876867,101,"ENSG00000079974.19"
"8259","ENSG00000117640.18_4563",4555,4563,9,"ENSG00000117640.18",0,NA,"UVUVVVVVV",2,7,0.786335403726708,84,90,104,107,113,119,133,136,"ATGGTGG","CTGG","CTGAAGT","CTGA",2.47095239926176,14,6,14,43,2.83144750097253,4.82611587401273,7.97145748891957,101,"ENSG00000079974.19"
"40130","ENSG00000255054.3_11733",11725,11733,9,"ENSG00000255054.3",0,NA,"UVUVVVVVV",2,7,0.786335403726708,84,90,104,107,113,119,133,136,"ATGGTGG","CTGG","CTGAAGT","CTGA",2.47095239926176,14,6,14,43,2.83144750097253,4.82611587401273,7.97145748891957,101,"ENSG00000079974.19"
"43868","ENSG00000274775.3_65707",65699,65707,9,"ENSG00000274775.3",1,1,"MVVUVVVVV",1,7,0.786749482401656,112,118,133,136,139,145,161,164,"CTGATGA","TTCA","ATGATAT","CTGA",2.53739400581515,15,3,16,43,2.38126857839063,4.82430715428957,7.9713050838962,101,"ENSG00000079974.19"
"37894","ENSG00000249061.1_84255",84247,84255,9,"ENSG00000249061.1",1,8,"VVVVVVVMV",0,8,0.884057971014493,115,121,133,136,173,179,187,190,"TTGAGGA","ATCA","GAGTTGA","CTGA",2.36197673804154,12,37,8,66,1.99373055695833,4.43506053597548,7.97129242003345,101,"ENSG00000079974.19"
"4536","ENSG00000100982.12_5049",5041,5049,9,"ENSG00000100982.12",1,8,"VVVVVVUMV",1,7,0.770186335403727,63,69,94,97,104,110,133,136,"ATGAGGA","CTGA","CTGGGGA","CTGA",2.70469557639856,25,7,23,64,1.53042871791103,4.89043314014202,7.97117848175693,101,"ENSG00000079974.19"
"46351","ENSG00000286481.2_849996",849988,849996,9,"ENSG00000286481.2",1,7,"VVVVVVMVV",0,8,0.885300207039338,115,121,133,136,176,182,193,196,"TTGGGGA","CAGA","ATGAGGC","CTGA",2.35895920286655,12,40,11,72,1.99330434252316,4.42992475707503,7.97112558523238,101,"ENSG00000079974.19"
"42575","ENSG00000264515.7_142180",142172,142180,9,"ENSG00000264515.7",1,5,"VVVVMVVVV",0,8,0.886542443064182,59,65,79,82,86,92,133,136,"TTGATTT","CAGA","ATAAAGA","CTGA",2.38217124915772,14,4,41,68,1.8184103564737,4.42488800438129,7.97105777663802,101,"ENSG00000079974.19"
"15108","ENSG00000147050.17_66470",66462,66470,9,"ENSG00000147050.17",1,3,"VVMVVVVVV",0,8,0.882815734989648,116,122,133,136,140,146,154,157,"ACCATGA","TTCA","AGCATCA","CTGA",2.2064750487494,11,4,8,32,3.04928404403719,4.43977942559163,7.97104236555022,101,"ENSG00000079974.19"
"40205","ENSG00000255248.11_270232",270224,270232,9,"ENSG00000255248.11",1,3,"VVMVVVVVV",0,8,0.882815734989648,90,96,106,109,116,122,133,136,"TTGTTGA","CTAA","GGGCTGA","ATGA",2.21626381081775,10,7,11,37,2.98392688917998,4.43975474032457,7.97101768028316,101,"ENSG00000079974.19"
"9340","ENSG00000124194.17_32882",32874,32882,9,"ENSG00000124194.17",1,2,"VMVVVUVVV",1,7,0.806211180124223,66,72,91,94,105,111,133,136,"ATGAGCA","CTGA","GTGTTGG","CTGA",2.57477582778615,19,11,22,61,1.81950379872809,4.74616899599227,7.97101371648916,101,"ENSG00000079974.19"
"44126","ENSG00000278530.5_66260",66252,66260,9,"ENSG00000278530.5",1,8,"VVVVVVVMV",0,8,0.884057971014493,109,115,133,136,164,170,178,181,"GTGTAGA","CTGG","GTGTAGA","CTGA",2.40286359106401,18,28,8,63,1.71983886244146,4.43473236738371,7.97096425144168,101,"ENSG00000079974.19"
"17790","ENSG00000155085.16_98251",98243,98251,9,"ENSG00000155085.16",0,NA,"UVVVVVVVV",1,8,0.902691511387163,112,118,133,136,145,151,171,174,"AAGAAGA","CAGA","TTGAGGA","CTTA",2.25956760218481,15,9,20,53,2.37662620236675,4.36010255423303,7.97086859978169,101,"ENSG00000079974.19"
"32366","ENSG00000226846.2_13511",13503,13511,9,"ENSG00000226846.2",0,NA,"VVVVVVUVV",1,8,0.886128364389234,116,122,133,136,185,191,200,203,"GTGATCA","TTAA","AGTATGA","CTGA",2.35962244635877,11,49,9,78,1.9744810417719,4.42632433770759,7.97083779526453,101,"ENSG00000079974.19"
"31462","ENSG00000223786.1_460698",460690,460698,9,"ENSG00000223786.1",1,1,"MVVVVVVVV",0,8,0.90600414078675,94,100,133,136,161,167,182,185,"ATATTGA","AAGA","ATGATGA","CTGA",2.46438101187013,33,25,15,82,0.957960688193358,4.34679185849856,7.97080842164556,101,"ENSG00000079974.19"
"6218","ENSG00000108684.15_391880",391872,391880,9,"ENSG00000108684.15",1,1,"MVVVVVUVV",1,7,0.792132505175983,115,121,133,136,147,153,162,165,"GTGATGG","GTAA","GTGCTTA","CTGA",2.45264180586161,12,11,9,41,2.85804558259554,4.80224773875156,7.97077775945549,101,"ENSG00000079974.19"
"44338","ENSG00000281016.1_50164",50156,50164,9,"ENSG00000281016.1",1,5,"VVVVMVVVV",0,8,0.886542443064182,114,120,133,136,152,158,183,186,"AAGATGG","GTGC","TTGATCA","CTGA",2.39113455883576,13,16,25,63,1.75729249462899,4.42454738838352,7.97071716064025,101,"ENSG00000079974.19"
"10502","ENSG00000131374.15_388643",388635,388643,9,"ENSG00000131374.15",1,7,"VVVVVVMVV",0,8,0.885300207039338,67,73,83,86,98,104,133,136,"ATGATCA","ATGA","TTGGTGA","CTCA",2.38244613254454,10,12,29,60,1.83408675534811,4.42926524307793,7.97046607123528,101,"ENSG00000079974.19"
"31269","ENSG00000221866.10_295842",295834,295842,9,"ENSG00000221866.10",1,1,"MVVVVUVVV",1,7,0.82815734989648,65,71,85,88,110,116,133,136,"AAGATTA","TTGA","ATGATGC","CTGA",2.51483588674878,14,22,17,62,1.86501814913626,4.65764768186536,7.97027708145128,101,"ENSG00000079974.19"
"15818","ENSG00000149742.10_1321",1313,1321,9,"ENSG00000149742.10",1,5,"VVVVMVVVV",0,8,0.886542443064182,86,92,102,105,116,122,133,136,"ATCATGC","TTGA","CTGAGGG","TTGA",2.23980669335663,10,11,11,41,2.76434709247797,4.42409792871387,7.9702677009706,101,"ENSG00000079974.19"
"9306","ENSG00000124003.13_33139",33131,33139,9,"ENSG00000124003.13",1,3,"UVMVVVVVV",1,7,0.785507246376811,110,116,133,136,147,153,169,172,"ATGATAA","ATGA","TTCATCA","CTGA",2.54462023687747,17,11,16,53,2.34877699722068,4.82822797743429,7.97025696294154,101,"ENSG00000079974.19"
"24917","ENSG00000178568.15_994504",994496,994504,9,"ENSG00000178568.15",1,8,"VVVVVVVMV",0,8,0.884057971014493,116,122,133,136,143,149,160,163,"ATGATTG","CTTA","GTCATAA","TTGA",2.20735254537138,11,7,11,38,3.0203974279366,4.43402026593645,7.97025214999442,101,"ENSG00000079974.19"
"10051","ENSG00000128918.15_504433",504425,504433,9,"ENSG00000128918.15",1,2,"VMVVVVVVV",0,8,0.884057971014493,85,91,109,112,115,121,133,136,"ATGTTGA","GTGA","ATTGTGA","CAGA",2.30886784441158,18,3,12,42,2.34270310926573,4.43378885133573,7.9700207353937,101,"ENSG00000079974.19"
"20502","ENSG00000164985.15_44414",44406,44414,9,"ENSG00000164985.15",1,2,"VMVVVVVVV",0,8,0.884057971014493,116,122,133,136,140,146,155,158,"AAGAAGA","TTTA","ACAGTGA","CTGA",2.20734793268964,11,4,9,33,3.01944027565145,4.43377329006226,7.97000517412023,101,"ENSG00000079974.19"
"1721","ENSG00000065609.15_21279",21271,21279,9,"ENSG00000065609.15",1,1,"MVVVVVVVV",0,8,0.90600414078675,111,117,133,136,148,154,163,166,"ATTTTGT","AGGA","TTGTAGA","CTGA",2.2166194184663,16,12,9,46,2.6064885571107,4.34598783672151,7.97000439986851,101,"ENSG00000079974.19"
"20662","ENSG00000165259.14_20762",20754,20762,9,"ENSG00000165259.14",0,NA,"UVVVVVVVV",1,8,0.902691511387163,108,114,133,136,152,158,172,175,"ATCCTGA","AAGA","GAGATTA","CTGA",2.32501157892272,19,16,14,58,1.93681228826782,4.35922237027148,7.96998841582014,101,"ENSG00000079974.19"
"18065","ENSG00000156103.16_268383",268375,268383,9,"ENSG00000156103.16",1,1,"MVVVVVVVV",0,8,0.90600414078675,101,107,133,136,162,168,180,183,"GGGATGA","CAGC","GTTAGGA","CTGA",2.42812752725714,26,26,12,73,1.19600505200756,4.34588047509712,7.96989703824412,101,"ENSG00000079974.19"
"33925","ENSG00000231519.1_5370",5362,5370,9,"ENSG00000231519.1",1,7,"VVVVVVMVV",0,8,0.885300207039338,73,79,91,94,101,107,133,136,"ATGAAGA","CAGA","GTGACTT","ATGA",2.3217218114147,12,7,26,54,2.23657598565914,4.42868034877263,7.96988117692998,101,"ENSG00000079974.19"
"19004","ENSG00000160145.16_691438",691430,691438,9,"ENSG00000160145.16",1,8,"VVVVVVVMV",0,8,0.884057971014493,104,110,133,136,158,164,179,182,"ATGAAGA","ATCA","TTGAGGG","CTGA",2.46612800690037,23,22,15,69,1.29363568254897,4.4336222654712,7.96985414952917,101,"ENSG00000079974.19"
"42040","ENSG00000260391.2_1019",1011,1019,9,"ENSG00000260391.2",1,8,"VVVVVVVMV",0,8,0.884057971014493,104,110,133,136,158,164,179,182,"ATGAAGA","ATCA","TTGAGGG","CTGA",2.46612800690037,23,22,15,69,1.29363568254897,4.4336222654712,7.96985414952917,101,"ENSG00000079974.19"
"16145","ENSG00000150961.15_56898",56890,56898,9,"ENSG00000150961.15",1,1,"MVVVVVVVV",0,8,0.90600414078675,87,93,133,136,182,188,199,202,"TTAATGA","ATGA","GTGTTTG","CTGA",2.45906703635868,40,46,11,106,0.989400102144471,4.34579508613391,7.96981164928091,101,"ENSG00000079974.19"
"36708","ENSG00000242759.10_112319",112311,112319,9,"ENSG00000242759.10",1,1,"MVUVVVVVV",1,7,0.789648033126294,87,93,107,110,115,121,133,136,"ATGGTGA","CTGA","CTGAATA","CAGA",2.45367751166203,14,5,12,40,2.88653824664236,4.81109708109731,7.96968921360248,101,"ENSG00000079974.19"
"41146","ENSG00000258583.7_281023",281015,281023,9,"ENSG00000258583.7",1,7,"VVVVVVMVV",0,8,0.885300207039338,69,75,88,91,99,105,133,136,"GTGATTA","CAGA","TTGATAA","CTCA",2.33357485229584,13,8,28,58,2.15675520512419,4.42848022177412,7.96968104993147,101,"ENSG00000079974.19"
"11873","ENSG00000136267.14_133969",133961,133969,9,"ENSG00000136267.14",1,8,"VVVVVVVMV",0,8,0.884057971014493,116,122,133,136,138,144,157,160,"AAGAGGA","ATGC","GTGCTTG","CTGA",2.27740566725902,11,2,13,35,2.55080787024825,4.43337807966044,7.96960996371841,101,"ENSG00000079974.19"
"30959","ENSG00000214942.6_44755",44747,44755,9,"ENSG00000214942.6",1,8,"VVVVVVVMV",0,8,0.884057971014493,95,101,108,111,114,120,133,136,"ATGATGA","CTGA","TACATGA","CTTT",2.28673986486486,7,3,13,32,2.48831666262982,4.43331227376556,7.96954415782353,101,"ENSG00000079974.19"
"26000","ENSG00000183117.20_679869",679861,679869,9,"ENSG00000183117.20",0,NA,"VVVVUVVVV",1,8,0.889855072463768,84,90,100,103,115,121,133,136,"TGGATGA","ATGA","GCGATGG","CTGT",2.24766451546648,10,12,12,43,2.65560349243988,4.41000839888743,7.9694286887425,101,"ENSG00000079974.19"
"2033","ENSG00000069248.12_48322",48314,48322,9,"ENSG00000069248.12",1,5,"UVVVMVVVV",1,7,0.789233954451346,114,120,133,136,144,150,161,164,"AAGGTGA","CTGG","ATGGAGA","CTGA",2.43863399007982,13,8,11,41,2.99220180982414,4.8124404359224,7.96937625372778,101,"ENSG00000079974.19"
"47438","ENSG00000288105.1_13237",13229,13237,9,"ENSG00000288105.1",1,2,"VMVVVVVVV",0,8,0.884057971014493,102,108,133,136,148,154,183,186,"ATGAAGT","CAGA","CTGAGGC","CTGA",2.4968912752883,25,12,29,75,1.08659342165536,4.43313381422767,7.96936569828564,101,"ENSG00000079974.19"
"13011","ENSG00000139915.21_191702",191694,191702,9,"ENSG00000139915.21",1,2,"UMVVVVVVV",1,7,0.786749482401656,32,38,50,53,71,77,133,136,"ATGAGGA","CTGA","CTCAAGA","CTGA",2.68738138720937,12,18,56,95,1.37349499196582,4.82234272667374,7.96934065628036,101,"ENSG00000079974.19"
"46787","ENSG00000287172.1_214321",214313,214321,9,"ENSG00000287172.1",1,2,"VMVVVVVVV",0,8,0.884057971014493,91,97,133,136,147,153,165,168,"ATGACGG","ATTA","GTGAAGC","CTGA",2.38997022794412,36,11,12,68,1.79923634592145,4.43309279972057,7.96932468377854,101,"ENSG00000079974.19"
"30372","ENSG00000204764.14_133803",133795,133803,9,"ENSG00000204764.14",0,NA,"UVVVVVVVV",1,8,0.902691511387163,81,87,103,106,114,120,133,136,"ATGATGA","ATGA","TTACTGA","TTGT",2.20294261860869,16,8,13,46,2.74777226283164,4.35851409672239,7.96928014227104,101,"ENSG00000079974.19"
"2976","ENSG00000079841.20_376450",376442,376450,9,"ENSG00000079841.20",1,8,"VVVVVVVMV",0,8,0.884057971014493,88,94,106,109,115,121,133,136,"GTTATGA","CTGA","GAGATGA","ACGA",2.21180029522919,12,6,12,39,2.98682487368228,4.43304004380256,7.96927192786053,101,"ENSG00000079974.19"
"32322","ENSG00000226733.4_24132",24124,24132,9,"ENSG00000226733.4",1,8,"VVVVVVVMV",0,8,0.884057971014493,106,112,133,136,142,148,161,164,"ATTATGC","CAGG","GTGTCAA","CTGA",2.3127124494647,21,6,13,49,2.31393326161263,4.433004064511,7.96923594856897,101,"ENSG00000079974.19"
"42286","ENSG00000261517.2_56981",56973,56981,9,"ENSG00000261517.2",1,3,"VVMVVVVVV",0,8,0.882815734989648,107,113,133,136,139,145,158,161,"CTGTTCA","ATGA","CTGAGGC","CTGA",2.34532213849681,20,3,13,45,2.11638884151183,4.43796744120597,7.96923038116456,101,"ENSG00000079974.19"
"33094","ENSG00000228659.1_30053",30045,30053,9,"ENSG00000228659.1",1,3,"VVMVVVVVV",0,8,0.882815734989648,112,118,133,136,182,188,206,209,"GCCATGA","CTGG","GGGATGA","CTGA",2.43061898407169,15,46,18,88,1.5476766946619,4.43795081378497,7.96921375374356,101,"ENSG00000079974.19"
"7409","ENSG00000114054.14_83489",83481,83489,9,"ENSG00000114054.14",0,NA,"VVVVUUVVV",2,7,0.812008281573499,108,114,133,136,165,171,183,186,"ATGGTGA","CTGC","GTGTTAA","CTGA",2.59324880704332,19,29,12,69,1.5961721372116,4.7211243793751,7.9691575056691,101,"ENSG00000079974.19"
"7026","ENSG00000112531.17_42599",42591,42599,9,"ENSG00000112531.17",1,8,"VVVVVVVMV",0,8,0.884057971014493,109,115,133,136,151,157,173,176,"AAGTTGA","TTGA","ATTACAA","CTGA",2.36294207559465,18,15,16,58,1.97868526960411,4.43290811005877,7.96913999411674,101,"ENSG00000079974.19"
"13969","ENSG00000144061.14_47384",47376,47384,9,"ENSG00000144061.14",1,2,"VMVVVVVVV",0,8,0.884057971014493,91,97,133,136,143,149,202,205,"GAGATGA","ACGA","GTGATGG","CTGA",2.50861841494574,36,7,53,105,1.00735461805872,4.43286934609091,7.96910123014888,101,"ENSG00000079974.19"
"24016","ENSG00000174876.17_6996",6988,6996,9,"ENSG00000174876.17",0,NA,"VVUUVVVVV",2,7,0.764389233954451,109,115,133,136,143,149,172,175,"ATGATGA","ATAA","ATGAAGG","CTGA",2.64309958816764,18,7,23,57,2.02502601078186,4.91142248297487,7.96897941879267,101,"ENSG00000079974.19"
"27970","ENSG00000187733.7_11326",11318,11326,9,"ENSG00000187733.7",0,NA,"VVUUVVVVV",2,7,0.764389233954451,109,115,133,136,143,149,172,175,"ATGATGA","ATAA","ATGAAGG","CTGA",2.64309958816764,18,7,23,57,2.02502601078186,4.91142248297487,7.96897941879267,101,"ENSG00000079974.19"
"36030","ENSG00000237763.10_6751",6743,6751,9,"ENSG00000237763.10",0,NA,"VVUUVVVVV",2,7,0.764389233954451,109,115,133,136,143,149,172,175,"ATGATGA","ATAA","ATGAAGG","CTGA",2.64309958816764,18,7,23,57,2.02502601078186,4.91142248297487,7.96897941879267,101,"ENSG00000079974.19"
"36901","ENSG00000243480.8_6293",6285,6293,9,"ENSG00000243480.8",0,NA,"VVUUVVVVV",2,7,0.764389233954451,109,115,133,136,143,149,172,175,"ATGATGA","ATAA","ATGAAGG","CTGA",2.64309958816764,18,7,23,57,2.02502601078186,4.91142248297487,7.96897941879267,101,"ENSG00000079974.19"
"23041","ENSG00000172020.13_47587",47579,47587,9,"ENSG00000172020.13",1,3,"VVMVVVUVV",1,7,0.768944099378882,107,113,133,136,155,161,173,176,"ATGATAA","TTGA","ATGATGT","CTGA",2.67021536423261,20,19,12,60,1.77114114600227,4.89314422688826,7.96892062440378,101,"ENSG00000079974.19"
"3955","ENSG00000091409.16_31535",31527,31535,9,"ENSG00000091409.16",0,NA,"VVUVVVVVV",1,8,0.883643892339545,108,114,133,136,152,158,174,177,"ATTAGGA","CAGT","TTGAAGA","CTGA",2.38688889067893,19,16,16,60,1.82397765643241,4.43414256523965,7.96871813459783,101,"ENSG00000079974.19"
"21257","ENSG00000166922.9_50946",50938,50946,9,"ENSG00000166922.9",1,3,"VVMVVVVVV",0,8,0.882815734989648,83,89,133,136,141,147,190,193,"CAGATGA","ATGA","GTGACCA","CTGA",2.52101152318848,44,5,43,101,0.943038595653786,4.43744552089425,7.96870846085285,101,"ENSG00000079974.19"
"47659","ENSG00000288864.1_78762",78754,78762,9,"ENSG00000288864.1",1,3,"VVMVVVVVV",0,8,0.882815734989648,83,89,133,136,141,147,190,193,"CAGATGA","ATGA","GTGACCA","CTGA",2.52101152318848,44,5,43,101,0.943038595653786,4.43744552089425,7.96870846085285,101,"ENSG00000079974.19"
"2816","ENSG00000078328.23_1819805",1819797,1819805,9,"ENSG00000078328.23",1,1,"MVUVVVVVV",1,7,0.789648033126294,116,122,133,136,138,144,152,155,"ATGCTGT","ATGA","TAGAAGA","CTGA",2.45803826411431,11,2,8,30,2.85352026603319,4.81011050669881,7.96870263920399,101,"ENSG00000079974.19"
"2740","ENSG00000077943.8_84387",84379,84387,9,"ENSG00000077943.8",1,1,"MVVVVVUVV",1,7,0.792132505175983,83,89,106,109,116,122,133,136,"TTGAGGA","ATGA","GTGGAAA","CTGA",2.46764619817752,17,7,11,44,2.74945851448307,4.80010829224996,7.9686383129539,101,"ENSG00000079974.19"
"19775","ENSG00000163660.12_3411",3403,3411,9,"ENSG00000163660.12",1,2,"VMVVVVVVV",0,8,0.884057971014493,99,105,133,136,144,150,159,162,"TTGATGT","TGGA","ATAATAT","CTGA",2.34994285458186,28,8,9,54,2.06331956261017,4.43240131495564,7.96863319901361,101,"ENSG00000079974.19"
"16704","ENSG00000152127.9_206900",206892,206900,9,"ENSG00000152127.9",0,NA,"UVVVUVVVV",2,7,0.792546583850932,89,95,106,109,115,121,133,136,"ATGATGT","TTGA","GTGAGGG","CAGA",2.43258027933549,11,6,12,38,2.97649584985615,4.79842442802318,7.96861076342691,101,"ENSG00000079974.19"
"14047","ENSG00000144290.17_306534",306526,306534,9,"ENSG00000144290.17",0,NA,"VVVUVVVVV",1,8,0.880745341614907,69,75,88,91,97,103,133,136,"TAGATTA","TTGA","ATGTTAA","CTGA",2.35141845555612,13,6,30,58,2.1060038015787,4.44553170965487,7.9685130761145,101,"ENSG00000079974.19"
"44504","ENSG00000282890.1_105651",105643,105651,9,"ENSG00000282890.1",1,8,"VVVVVVVMV",0,8,0.884057971014493,50,56,65,68,115,121,133,136,"TTGATGT","CTGA","CTGACAA","CTGT",2.38994942650333,9,47,12,77,1.79599285961823,4.43224725907677,7.96847914313474,101,"ENSG00000079974.19"
"29934","ENSG00000198898.15_43942",43934,43942,9,"ENSG00000198898.15",1,8,"VVVVVVVMV",0,8,0.884057971014493,46,52,68,71,111,117,133,136,"GTGCTTA","CAGA","GTGAAGC","CTGA",2.41874958605142,16,40,16,81,1.60383230914721,4.43220738737251,7.96843927143048,101,"ENSG00000079974.19"
"3446","ENSG00000084072.17_7324",7316,7324,9,"ENSG00000084072.17",1,8,"VVVVUVVMV",1,7,0.773913043478261,112,118,133,136,148,154,203,206,"GGGATGA","CTGA","GTGGTGG","CTGA",2.67189824572279,15,12,49,85,1.67841746821616,4.87276810992535,7.96842028383839,101,"ENSG00000079974.19"
"6209","ENSG00000108684.15_1074913",1074905,1074913,9,"ENSG00000108684.15",0,NA,"VVVVUVVVV",1,8,0.889855072463768,78,84,98,101,109,115,133,136,"GTGTTGC","AGGA","GTGCACA","CTGA",2.25721926540216,14,8,18,49,2.58779318571819,4.40898040543314,7.96840069528822,101,"ENSG00000079974.19"
"44268","ENSG00000280349.1_268",260,268,9,"ENSG00000280349.1",0,NA,"VVVVUVVVV",1,8,0.889855072463768,78,84,98,101,109,115,133,136,"GTGTTGC","AGGA","GTGCACA","CTGA",2.25721926540216,14,8,18,49,2.58779318571819,4.40898040543314,7.96840069528822,101,"ENSG00000079974.19"
"9273","ENSG00000123607.16_34756",34748,34756,9,"ENSG00000123607.16",1,2,"VMVVVVVVV",0,8,0.884057971014493,92,98,133,136,141,147,156,159,"AGGAGGA","ATGT","TTGGTGA","CTGA",2.36847900258568,35,5,9,58,1.93868041641021,4.43213510841201,7.96836699246998,101,"ENSG00000079974.19"
"46449","ENSG00000286685.3_26078",26070,26078,9,"ENSG00000286685.3",1,8,"UVVVVVVMV",1,7,0.786749482401656,113,119,133,136,151,157,169,172,"ATGATTA","GTGA","GGGATTC","CTGA",2.52130098954254,14,15,12,50,2.47654932043076,4.82130564601193,7.96830357561855,101,"ENSG00000079974.19"
"12655","ENSG00000138759.20_394322",394314,394322,9,"ENSG00000138759.20",1,7,"VVVVVVMVV",0,8,0.885300207039338,112,118,133,136,141,147,157,160,"TAGATTA","GTGT","GCGAGGA","CTGA",2.2233825660997,15,5,10,39,2.88571763744857,4.42706701952831,7.96826784768566,101,"ENSG00000079974.19"
"48021","ENSG00000290092.1_708",700,708,9,"ENSG00000290092.1",1,5,"VVVVMVVVV",0,8,0.886542443064182,115,121,133,136,179,185,194,197,"GGGATGT","ATTA","GTGAAGG","CTGA",2.35284502052075,12,43,9,73,2.00274681512093,4.42209507131482,7.96826484357154,101,"ENSG00000079974.19"
"29163","ENSG00000197360.9_68708",68700,68708,9,"ENSG00000197360.9",1,1,"MVVVVVVVV",0,8,0.90600414078675,112,118,133,136,152,158,214,217,"AAAATGA","CTGG","GTGACTG","CTGA",2.39671599145311,15,16,56,96,1.39869690369225,4.34420087834491,7.9682174414919,101,"ENSG00000079974.19"
"10394","ENSG00000130783.14_5102",5094,5102,9,"ENSG00000130783.14",1,1,"MVVVVVVVV",0,8,0.90600414078675,114,120,133,136,180,186,194,197,"CAGATGC","CTGG","GTCAGGC","CTGA",2.3096691042342,13,44,8,74,1.9789830527142,4.34419427023555,7.96821083338255,101,"ENSG00000079974.19"
"11837","ENSG00000136160.17_73513",73505,73513,9,"ENSG00000136160.17",0,NA,"VVUVVVVVV",1,8,0.883643892339545,87,93,104,107,114,120,133,136,"ATGATGA","CAGA","ATCCTGA","CTTC",2.22111623904881,11,7,13,40,2.92704015889572,4.43362043813861,7.96819600749679,101,"ENSG00000079974.19"
"35033","ENSG00000234758.1_9257",9249,9257,9,"ENSG00000234758.1",1,2,"VMVVVVVVV",0,8,0.884057971014493,110,116,133,136,166,172,182,185,"TTCATGA","GAGA","GTCATGT","CTGA",2.38827162215217,17,30,10,66,1.8060188821403,4.43195742412202,7.96818930817999,101,"ENSG00000079974.19"
"40614","ENSG00000257165.5_24654",24646,24654,9,"ENSG00000257165.5",1,1,"MVVVVVVVV",0,8,0.90600414078675,85,91,133,136,146,152,166,169,"AAGATGT","CTTC","ATTAAGA","CTGA",2.34095454349897,42,10,14,75,1.77025956387183,4.34415579679958,7.96817235994658,101,"ENSG00000079974.19"
"16196","ENSG00000151090.20_57753",57745,57753,9,"ENSG00000151090.20",1,6,"VVVVVMVVV",0,8,0.902691511387163,114,120,133,136,186,192,214,217,"ATTAGGA","CTTG","GTGAAGA","CTGA",2.40382253662149,13,50,22,94,1.40410770662359,4.35739782102505,7.9681638665737,101,"ENSG00000079974.19"
"38571","ENSG00000250453.2_52320",52312,52320,9,"ENSG00000250453.2",1,1,"MVVVVVVVV",0,8,0.90600414078675,103,109,133,136,139,145,165,168,"TTGATGG","CTAT","ATGACAA","CTGA",2.39116530471891,24,3,20,56,1.43530047615516,4.34410062690364,7.96811719005064,101,"ENSG00000079974.19"
"41822","ENSG00000259786.7_35195",35187,35195,9,"ENSG00000259786.7",1,1,"MVVVVVVVV",0,8,0.90600414078675,103,109,133,136,139,145,165,168,"TTGATGG","CTAT","ATGACAA","CTGA",2.39116530471891,24,3,20,56,1.43530047615516,4.34410062690364,7.96811719005064,101,"ENSG00000079974.19"
"39482","ENSG00000253649.5_3806",3798,3806,9,"ENSG00000253649.5",1,1,"MVVVVVVVV",0,8,0.90600414078675,112,118,133,136,173,179,219,222,"ATAATCA","CTTA","GTGAAAA","CTGA",2.46492300886214,15,37,40,101,0.943496689751355,4.34407918720808,7.96809575035508,101,"ENSG00000079974.19"
"21419","ENSG00000167522.17_196189",196181,196189,9,"ENSG00000167522.17",0,NA,"UVVVVVVVV",1,8,0.902691511387163,113,119,133,136,157,163,192,195,"GTCAGGA","CTGT","GTGAAAA","CTGA",2.4116745499116,14,21,29,73,1.35125034034322,4.35727016827181,7.96803621382046,101,"ENSG00000079974.19"
"7972","ENSG00000116183.11_130982",130974,130982,9,"ENSG00000116183.11",1,8,"VVVVVVVMV",0,8,0.884057971014493,113,119,133,136,140,146,157,160,"CTGAGGA","AGGA","GTGAGGA","CTTA",2.23196781139497,14,4,11,38,2.84726313322388,4.43176213563092,7.96799401968889,101,"ENSG00000079974.19"
"10882","ENSG00000133030.22_48210",48202,48210,9,"ENSG00000133030.22",1,1,"MVVVVVVVV",0,8,0.90600414078675,108,114,133,136,167,173,183,186,"GTGATCA","ATCA","GTGTTTG","CTGA",2.36348443177973,19,31,10,69,1.61926543080212,4.34395707733342,7.96797364048042,101,"ENSG00000079974.19"
"5212","ENSG00000103994.18_78245",78237,78245,9,"ENSG00000103994.18",1,6,"VVVVVMVVV",0,8,0.902691511387163,58,64,78,81,90,96,133,136,"AGAATGA","CTGA","ATGTTTA","GTGA",2.32166645691588,14,9,37,69,1.95104153825371,4.35720447942323,7.96797052497189,101,"ENSG00000079974.19"
"32885","ENSG00000228221.6_253078",253070,253078,9,"ENSG00000228221.6",1,1,"MVVVVVVVV",0,8,0.90600414078675,45,51,65,68,73,79,133,136,"GTGCTGA","CTAA","TTGAAGA","CTGC",2.32189105534981,14,5,54,82,1.89627325704302,4.34388673984377,7.96790330299077,101,"ENSG00000079974.19"
"8541","ENSG00000119487.17_8266",8258,8266,9,"ENSG00000119487.17",1,5,"VVVVMVVVV",0,8,0.886542443064182,115,121,133,136,146,152,160,163,"AATATGA","ATGA","GTGGTCA","GTGA",2.21451149542986,12,10,8,39,2.92332041146315,4.42168259524888,7.96785236750561,101,"ENSG00000079974.19"
"30811","ENSG00000213904.11_245039",245031,245039,9,"ENSG00000213904.11",1,1,"MVVVVVVVV",0,8,0.90600414078675,112,118,133,136,141,147,156,159,"TGGATGT","CGGT","GGAATGG","CTGA",2.17137477720033,15,5,9,38,2.89939127144395,4.34380577986154,7.96782234300853,101,"ENSG00000079974.19"
"31022","ENSG00000215262.8_25086",25078,25086,9,"ENSG00000215262.8",1,7,"VVVVVVMVV",0,8,0.885300207039338,111,117,133,136,146,152,185,188,"TTGATGG","CGCA","GAGATAA","CTGA",2.38414375328637,16,10,33,68,1.81202667680296,4.4265795913447,7.96778041950205,101,"ENSG00000079974.19"
"25919","ENSG00000183098.11_380826",380818,380826,9,"ENSG00000183098.11",1,1,"MVVVVVVVV",0,8,0.90600414078675,111,117,133,136,150,156,169,172,"ATGATGG","TTAA","AGGAAGA","CTGG",2.24923536335127,16,14,13,52,2.38010254964894,4.34375124299769,7.96776780614469,101,"ENSG00000079974.19"
"9321","ENSG00000124155.19_17207",17199,17207,9,"ENSG00000124155.19",1,3,"VVMVVUVVV",1,7,0.804968944099379,116,122,133,136,142,148,156,159,"ATGATCA","GTGG","ATACTGT","CTGA",2.38290878705718,11,6,8,34,3.10547079730643,4.74788234442191,7.96775812081942,101,"ENSG00000079974.19"
"10093","ENSG00000129159.9_108879",108871,108879,9,"ENSG00000129159.9",1,6,"VVVVVMVVV",0,8,0.902691511387163,56,62,75,78,112,118,133,136,"CTGAAGA","CTGA","GTGTATA","ATGA",2.33866531744972,13,34,15,71,1.83681906284453,4.356980294794,7.96774634034266,101,"ENSG00000079974.19"
"34137","ENSG00000231937.1_10370",10362,10370,9,"ENSG00000231937.1",1,2,"VMVVVVVVV",0,8,0.884057971014493,89,95,104,107,114,120,133,136,"AGGATTA","CTGT","CTGATCA","TTGA",2.23653133326896,9,7,13,38,2.81520535628665,4.43135356118659,7.96758544524456,101,"ENSG00000079974.19"
"33232","ENSG00000229127.2_2568",2560,2568,9,"ENSG00000229127.2",1,1,"MVVVVVUVV",1,7,0.792132505175983,105,111,133,136,141,147,156,159,"AAGATGA","GGGA","TTGAAGA","CTGA",2.53845802747042,22,5,9,45,2.27313569314105,4.79904730240263,7.96757732310656,101,"ENSG00000079974.19"
"43066","ENSG00000267922.1_91199",91191,91199,9,"ENSG00000267922.1",0,NA,"UVVUVVVVV",2,7,0.78343685300207,90,96,133,136,168,174,184,187,"ATGATGA","ATGA","TTGTGGA","CTGA",2.74435791783648,37,32,10,88,1.03953661316463,4.83381401635197,7.96756142836025,101,"ENSG00000079974.19"
"19624","ENSG00000163513.19_54848",54840,54848,9,"ENSG00000163513.19",0,NA,"VVVVVVUVV",1,8,0.886128364389234,107,113,133,136,141,147,163,166,"AGGAGGA","CAGT","GGGATGC","CTGA",2.32665624271692,20,5,16,50,2.18111372367942,4.42303883544806,7.96755229300499,101,"ENSG00000079974.19"
"7950","ENSG00000116128.12_9432",9424,9432,9,"ENSG00000116128.12",0,NA,"VVUVVVVVV",1,8,0.883643892339545,81,87,102,105,116,122,133,136,"GGGATCA","CTGA","CTGATAT","CTCA",2.24959794691733,15,11,11,46,2.73446683986213,4.43294662149441,7.96752219085259,101,"ENSG00000079974.19"
"588","ENSG00000020577.14_56343",56335,56343,9,"ENSG00000020577.14",1,7,"VVUVVVMVV",1,7,0.768944099378882,51,57,65,68,78,84,133,136,"ATTATGA","CAGA","GTGATGT","CTGA",2.69016992355548,8,10,49,76,1.63238382678874,4.89171249595631,7.96748889347184,101,"ENSG00000079974.19"
"17936","ENSG00000155875.15_124580",124572,124580,9,"ENSG00000155875.15",0,NA,"VVUVVVVVV",1,8,0.883643892339545,108,114,133,136,185,191,204,207,"ATATTGA","CTGT","ATGATCT","CTGA",2.43518700246649,19,49,13,90,1.49706461243333,4.43291115721914,7.96748672657732,101,"ENSG00000079974.19"
"1373","ENSG00000054523.20_72035",72027,72035,9,"ENSG00000054523.20",1,2,"VMVVVVVVV",0,8,0.884057971014493,109,115,133,136,153,159,183,186,"AGGAAGA","CTAA","ATGGAGA","CTGA",2.44750225607569,18,17,24,68,1.40829672732624,4.43124460862437,7.96747649268234,101,"ENSG00000079974.19"
"46197","ENSG00000286271.3_50629",50621,50629,9,"ENSG00000286271.3",1,1,"MVVVVVVVV",0,8,0.90600414078675,90,96,133,136,165,171,186,189,"ATGAAGC","ATGA","TTGAAAA","CTGA",2.47363495201604,37,29,15,90,0.88271924969423,4.34340473245029,7.96742129559729,101,"ENSG00000079974.19"
"36759","ENSG00000242880.2_182784",182776,182784,9,"ENSG00000242880.2",1,8,"UVVVVVVMV",1,7,0.786749482401656,110,116,133,136,142,148,161,164,"CTGATGA","GTGC","TGGAGGA","CTGA",2.49266114717428,17,6,13,45,2.6639508472496,4.82042295710287,7.96742088670949,101,"ENSG00000079974.19"
"11878","ENSG00000136267.14_525614",525606,525614,9,"ENSG00000136267.14",1,1,"MVVVVVVVV",0,8,0.90600414078675,80,86,98,101,108,114,133,136,"ATTAGGA","CTAA","TTGCTGA","CAGA",2.21929957023252,12,7,19,47,2.57820166525888,4.34338303336892,7.96739959651592,101,"ENSG00000079974.19"
"35167","ENSG00000235166.8_186264",186256,186264,9,"ENSG00000235166.8",0,NA,"UVVVVVVVV",1,8,0.902691511387163,80,86,101,104,114,120,133,136,"ATGAGGG","TTGA","TTCAGGA","CAGA",2.2045316921986,15,10,13,47,2.72958867563711,4.35661665590694,7.96738270145559,101,"ENSG00000079974.19"
"33584","ENSG00000230426.5_439983",439975,439983,9,"ENSG00000230426.5",1,8,"VVVVVVVMV",0,8,0.884057971014493,114,120,133,136,153,159,208,211,"ATGAGGA","CCCA","TTGACAA","CTGA",2.44463919257418,13,17,49,88,1.42684388563431,4.43110962569888,7.96734150975685,101,"ENSG00000079974.19"
"20876","ENSG00000165959.12_105761",105753,105761,9,"ENSG00000165959.12",0,NA,"VVUVVVVVV",1,8,0.883643892339545,114,120,133,136,138,144,158,161,"GTGCTGA","CTGC","CTCATGA","CAGA",2.29184712827639,13,2,14,38,2.45203720221703,4.43275451434824,7.96733008370642,101,"ENSG00000079974.19"
"24788","ENSG00000178031.18_227943",227935,227943,9,"ENSG00000178031.18",0,NA,"UVVVVVVVV",1,8,0.902691511387163,112,118,133,136,150,156,174,177,"CTAAGGA","CAGT","GAGATGA","CTGA",2.28866677124121,15,14,18,56,2.16834432199952,4.35653069923523,7.96729674478389,101,"ENSG00000079974.19"
"21825","ENSG00000169084.15_126816",126808,126816,9,"ENSG00000169084.15",1,2,"VMVVVVVVV",0,8,0.884057971014493,102,108,133,136,165,171,184,187,"TTGGTGA","CAGA","GGGATGC","CTGA",2.48576700484637,25,29,13,76,1.15218728945698,4.43099183044152,7.96722371449949,101,"ENSG00000079974.19"
"21830","ENSG00000169084.15_PAR_Y_126816",126808,126816,9,"ENSG00000169084.15_PAR_Y",1,2,"VMVVVVVVV",0,8,0.884057971014493,102,108,133,136,165,171,184,187,"TTGGTGA","CAGA","GGGATGC","CTGA",2.48576700484637,25,29,13,76,1.15218728945698,4.43099183044152,7.96722371449949,101,"ENSG00000079974.19"
"40745","ENSG00000257523.3_22786",22778,22786,9,"ENSG00000257523.3",1,7,"UVVVVVMVV",1,7,0.787991718426501,107,113,133,136,152,158,184,187,"GTGATGA","ATTA","GTGATGA","CTGA",2.70683714558512,20,16,26,71,1.21536107905512,4.81523551240565,7.96720238611165,101,"ENSG00000079974.19"
"5387","ENSG00000104408.11_152487",152479,152487,9,"ENSG00000104408.11",1,1,"MVVVVVVVV",0,8,0.90600414078675,114,120,133,136,149,155,166,169,"ATGAAGA","CAGT","TGGAAGA","ATGA",2.2039479048423,13,13,11,46,2.67966633841436,4.34316309267409,7.96717965582109,101,"ENSG00000079974.19"
"35833","ENSG00000237352.6_131124",131116,131124,9,"ENSG00000237352.6",1,8,"VVVVVVVMV",0,8,0.884057971014493,112,118,133,136,149,155,164,167,"AAGATTA","CCTA","CAGGTGA","CTGA",2.26760063914197,15,13,9,46,2.60637481336811,4.43092810191198,7.96715998596995,101,"ENSG00000079974.19"
"10103","ENSG00000129195.16_6910",6902,6910,9,"ENSG00000129195.16",1,2,"VMVVVVVVV",0,8,0.884057971014493,109,115,133,136,145,151,170,173,"ATCAAGA","TTTA","ATGCTGT","CTGA",2.32966960819365,18,9,19,55,2.19224701547607,4.43084443419177,7.96707631824974,101,"ENSG00000079974.19"
"3793","ENSG00000089094.20_87811",87803,87811,9,"ENSG00000089094.20",1,2,"VMVVVVVVV",0,8,0.884057971014493,93,99,133,136,145,151,183,186,"CTGATTT","CTGA","ATGGTGG","CTGA",2.50045448368269,34,9,32,84,1.05313065143004,4.43070680232867,7.96693868638664,101,"ENSG00000079974.19"
"46175","ENSG00000286251.2_190831",190823,190831,9,"ENSG00000286251.2",1,6,"VVVVVMVVV",0,8,0.902691511387163,85,91,133,136,160,166,174,177,"GTGCTGT","CTCA","GTGAAGG","CTGA",2.4445678250497,42,24,8,83,1.12756539218546,4.35617105646253,7.96693710201118,101,"ENSG00000079974.19"
"28751","ENSG00000196437.12_56769",56761,56769,9,"ENSG00000196437.12",1,2,"VMVVVUVVV",1,7,0.806211180124223,108,114,133,136,137,143,152,155,"ATGATCA","ATGA","ATGTGGG","CTGA",2.55109357462948,19,1,9,38,1.9609927945182,4.74207082301202,7.96691554350891,101,"ENSG00000079974.19"
"7369","ENSG00000113719.17_6622",6614,6622,9,"ENSG00000113719.17",1,6,"VVVVVMVVV",0,8,0.902691511387163,112,118,133,136,142,148,203,206,"TTCATTA","CTGG","ATGATTG","CTGA",2.32955969436562,15,6,55,85,1.89399484784192,4.35609820256984,7.96686424811849,101,"ENSG00000079974.19"
"28204","ENSG00000188452.15_73339",73331,73339,9,"ENSG00000188452.15",0,NA,"VVUVVVVVV",1,8,0.883643892339545,112,118,133,136,146,152,168,171,"ATGTTGA","ATAA","ATGATCA","CTAA",2.27428650540674,15,10,16,50,2.56698142449996,4.43222286513622,7.9667984344944,101,"ENSG00000079974.19"
"22489","ENSG00000170624.14_652739",652731,652739,9,"ENSG00000170624.14",1,7,"VVVVVVMVV",0,8,0.885300207039338,114,120,133,136,142,148,167,170,"AGGAGGA","CCTA","TTAATTA","CTGA",2.27170738350101,13,6,19,47,2.55748080673387,4.42554917418515,7.9667500023425,101,"ENSG00000079974.19"
"20722","ENSG00000165416.15_20388",20380,20388,9,"ENSG00000165416.15",1,2,"VMVVVVVVV",0,8,0.884057971014493,108,114,133,136,147,153,166,169,"ATGTTAA","CTGA","GTGCTAA","CTGC",2.30859088685924,19,11,13,52,2.33134028705301,4.43048654986198,7.96671843391995,101,"ENSG00000079974.19"
"23502","ENSG00000173077.16_122779",122771,122779,9,"ENSG00000173077.16",1,2,"VMVVVVVVV",0,8,0.884057971014493,85,91,133,136,145,151,165,168,"GTGATGA","CAGC","ATGATGG","CAGA",2.38486512970862,42,9,14,74,1.82262494949386,4.43043145355449,7.96666333761246,101,"ENSG00000079974.19"
"16929","ENSG00000152782.18_39912",39904,39912,9,"ENSG00000152782.18",1,3,"VVMVVVVVV",0,8,0.882815734989648,86,92,102,105,116,122,133,136,"AGGATGG","TTGA","ATGGTGG","ATGA",2.24658548246053,10,11,11,41,2.76434709247797,4.43539591055371,7.9666588505123,101,"ENSG00000079974.19"
"39879","ENSG00000254394.2_228918",228910,228918,9,"ENSG00000254394.2",1,7,"VVVVVVMVV",0,8,0.885300207039338,115,121,133,136,142,148,163,166,"AATGTGA","GTGA","GAGAACA","CTGA",2.23248450677537,12,6,15,42,2.81847126751759,4.42542532817168,7.96662615632903,101,"ENSG00000079974.19"
"11881","ENSG00000136267.14_616488",616480,616488,9,"ENSG00000136267.14",1,1,"MVVVVVVVV",0,8,0.90600414078675,74,80,89,92,101,107,133,136,"TTGAAGA","CTGA","AGGAAGT","ATGA",2.3020530060381,9,9,26,53,2.02334790784864,4.34259198702566,7.96660855017266,101,"ENSG00000079974.19"
"23002","ENSG00000171914.17_341915",341907,341915,9,"ENSG00000171914.17",1,5,"VVUVMVVVV",1,7,0.770186335403727,114,120,133,136,141,147,162,165,"ATGGTGA","AAGA","GTGAGAA","CTGA",2.51727546198362,13,5,15,42,2.7615897979202,4.88585655278608,7.96660189440099,101,"ENSG00000079974.19"
"19820","ENSG00000163749.18_66836",66828,66836,9,"ENSG00000163749.18",1,2,"VMVVVVVVV",0,8,0.884057971014493,71,77,91,94,103,109,133,136,"ATGATTA","GTGA","ATAATGT","CTGT",2.32396749533405,14,9,24,56,2.22830231433488,4.4303547374738,7.96658662153177,101,"ENSG00000079974.19"
"14560","ENSG00000145362.21_84557",84549,84557,9,"ENSG00000145362.21",0,NA,"UVVVVUVVV",2,7,0.824844720496894,107,113,133,136,140,146,160,163,"TTGATTA","CTTA","ATGCTTA","CTGA",2.46997627136953,20,4,14,47,2.20225582410093,4.66719107497446,7.96656995696203,101,"ENSG00000079974.19"
"34908","ENSG00000234377.8_352994",352986,352994,9,"ENSG00000234377.8",1,6,"VVVVUMVVV",1,7,0.792546583850932,75,81,94,97,111,117,133,136,"ATGGTGA","CCAA","CTGAAGA","CTGA",2.52124051120055,13,14,16,52,2.37723020157233,4.79637506906066,7.96656140446439,101,"ENSG00000079974.19"
"33934","ENSG00000231535.8_57079",57071,57079,9,"ENSG00000231535.8",1,1,"MVVVVVVVV",0,8,0.90600414078675,110,116,133,136,143,149,174,177,"ATTAAGA","ATCA","GTGTAGT","CTGA",2.3013134481638,17,7,25,58,2.02801733899417,4.34252674835487,7.96654331150187,101,"ENSG00000079974.19"
"3246","ENSG00000082701.17_201057",201049,201057,9,"ENSG00000082701.17",1,2,"VMVVVVVVV",0,8,0.884057971014493,95,101,133,136,142,148,158,161,"GTGATGA","CTCA","ATAAGGG","ATGA",2.35709404247844,32,6,10,57,2.00715883768404,4.43027978021841,7.96651166427638,101,"ENSG00000079974.19"
"34095","ENSG00000231901.1_50898",50890,50898,9,"ENSG00000231901.1",1,2,"VMVVVUVVV",1,7,0.806211180124223,107,113,133,136,143,149,192,195,"AAGATGA","CTGT","GTGAGGG","CTGA",2.61972198072279,20,7,43,79,1.50153782690117,4.74158775792995,7.96643247842684,101,"ENSG00000079974.19"
"34874","ENSG00000234323.10_573340",573332,573340,9,"ENSG00000234323.10",1,1,"MVVVVVVVV",0,8,0.90600414078675,110,116,133,136,141,147,157,160,"AATATGG","CAAA","GGGTTGA","CTGA",2.19884002090222,17,5,10,41,2.71060051602179,4.34238349717581,7.96640006032281,101,"ENSG00000079974.19"
"27042","ENSG00000185477.5_22144",22136,22144,9,"ENSG00000185477.5",1,1,"MVVVVVVVV",0,8,0.90600414078675,88,94,133,136,142,148,179,182,"ATTATGG","GTGA","GTGACAG","CTGA",2.44146444869683,39,6,31,85,1.09309594978383,4.34238140194067,7.96639796508767,101,"ENSG00000079974.19"
"30673","ENSG00000206417.8_2174",2166,2174,9,"ENSG00000206417.8",0,NA,"VVUVVVVVV",1,8,0.883643892339545,51,57,69,72,114,120,133,136,"GTGAGGG","CTGG","GTGGACA","CTGA",2.37045428514553,12,42,13,76,1.92418297289279,4.43180288513241,7.96637845449059,101,"ENSG00000079974.19"
"38599","ENSG00000250546.6_347483",347475,347483,9,"ENSG00000250546.6",0,NA,"VVVVVVUVV",1,8,0.886128364389234,109,115,133,136,147,153,175,178,"TTGAGGA","TTGG","TTGAGCA","CTGA",2.36673352862436,18,11,22,60,1.9090183507935,4.42181046873897,7.96632392629591,101,"ENSG00000079974.19"
"25986","ENSG00000183117.20_2003894",2003886,2003894,9,"ENSG00000183117.20",1,6,"VVUVVMVVV",1,7,0.786335403726708,111,117,133,136,145,151,164,167,"ATGATGT","TTGC","GATATGA","CTGA",2.48600292606813,16,9,13,47,2.71037359831085,4.82093160969126,7.9662732245981,101,"ENSG00000079974.19"
"2347","ENSG00000073670.14_1873",1865,1873,9,"ENSG00000073670.14",1,7,"VVVVVVMVV",0,8,0.885300207039338,111,117,133,136,164,170,185,188,"CTAATGT","CTTA","GTGGTGC","CTGA",2.39568055716556,16,28,15,68,1.72834476561083,4.42488712001198,7.96608794816933,101,"ENSG00000079974.19"
"6928","ENSG00000112297.18_104565",104557,104565,9,"ENSG00000112297.18",1,6,"VVVVVMVVV",0,8,0.902691511387163,73,79,95,98,103,109,133,136,"TTATTGA","CTGG","TAGAAGA","CTGA",2.30070459985685,16,5,24,54,2.08325632293145,4.35532174716095,7.9660877927096,101,"ENSG00000079974.19"
"15233","ENSG00000147481.17_11751",11743,11751,9,"ENSG00000147481.17",1,8,"VVVVVVVMV",0,8,0.884057971014493,86,92,103,106,116,122,133,136,"AGGAAGA","CAGA","GTGACAA","CTGC",2.22541495220647,11,10,11,41,2.88295945323706,4.42976478365338,7.96599666771135,101,"ENSG00000079974.19"
"25344","ENSG00000181007.9_17093",17085,17093,9,"ENSG00000181007.9",0,NA,"VVVVUVVVV",1,8,0.889855072463768,112,118,133,136,142,148,176,179,"GTTAGGA","GTTA","ATGATGT","CTGA",2.33375738879931,15,6,28,58,2.0677853891324,4.40654199528195,7.96596228513703,101,"ENSG00000079974.19"
"35677","ENSG00000236719.5_14202",14194,14202,9,"ENSG00000236719.5",1,2,"VMVVVVVVV",0,8,0.884057971014493,95,101,133,136,151,157,167,170,"GTGATGC","CTAA","ATGATGA","CTGC",2.42122151892913,32,15,10,66,1.57718416037938,4.42966523831005,7.96589712236802,101,"ENSG00000079974.19"
"40792","ENSG00000257657.3_92806",92798,92806,9,"ENSG00000257657.3",1,8,"VVVVVVVMV",0,8,0.884057971014493,75,81,96,99,114,120,133,136,"GTAAGGA","CTAA","AGGGAGA","CTGA",2.30038424886594,15,15,13,52,2.38271534722955,4.42965258491728,7.96588446897526,101,"ENSG00000079974.19"
"18362","ENSG00000157168.20_1081573",1081565,1081573,9,"ENSG00000157168.20",1,3,"VVMVVVVVV",0,8,0.882815734989648,100,106,112,115,116,122,133,136,"AGGATGA","CTGT","GCCATGA","CTGT",2.30275079792592,6,1,11,27,2.38680535906654,4.43461933630984,7.96588227626843,101,"ENSG00000079974.19"
"6821","ENSG00000111961.19_35623",35615,35623,9,"ENSG00000111961.19",1,6,"VVVVVMUVV",1,7,0.788819875776397,85,91,102,105,115,121,133,136,"TTTCTGA","CTGA","GTCAAGA","CTGA",2.45907232876843,11,10,12,42,2.84848743502195,4.8105757400362,7.96585524314179,101,"ENSG00000079974.19"
"37846","ENSG00000248973.3_322287",322279,322287,9,"ENSG00000248973.3",0,NA,"UVVVVVVVV",1,8,0.902691511387163,92,98,133,136,187,193,205,208,"TTAATGA","ATGA","GTGGGGC","CTGA",2.46793527960192,35,51,12,107,0.967433351035525,4.35508380376208,7.96584984931073,101,"ENSG00000079974.19"
"34512","ENSG00000233290.4_175105",175097,175105,9,"ENSG00000233290.4",1,1,"MVVVVVVVV",0,8,0.90600414078675,112,118,133,136,148,154,163,166,"TTGAGGA","TGGA","ATGTTGA","TTGA",2.20309951729988,15,12,9,45,2.67998047954187,4.34182764871859,7.96584421186559,101,"ENSG00000079974.19"
"37476","ENSG00000248296.1_12416",12408,12416,9,"ENSG00000248296.1",1,8,"VVVVVVVMV",0,8,0.884057971014493,19,25,63,66,73,79,133,136,"GTTATGA","CTGA","TTGATGA","CTTA",2.50716709059599,38,7,54,108,1.00398271139811,4.42960749550951,7.96583937956748,101,"ENSG00000079974.19"
"26346","ENSG00000183914.15_113580",113572,113580,9,"ENSG00000183914.15",1,1,"MVVVVVVVV",0,8,0.90600414078675,112,118,133,136,153,159,214,217,"GGGAAGA","CCGG","GTGATGA","CTGA",2.40433834459624,15,17,55,96,1.33835799733785,4.34182007366152,7.96583663680852,101,"ENSG00000079974.19"
"24804","ENSG00000178031.18_801556",801548,801556,9,"ENSG00000178031.18",1,8,"VVVVVVVMV",0,8,0.884057971014493,78,84,96,99,110,116,133,136,"ATGTTGA","CTCA","TTAATAA","CTAA",2.2776289435896,12,11,17,49,2.53406394811461,4.42956422634466,7.96579611040263,101,"ENSG00000079974.19"
"20793","ENSG00000165671.22_80521",80513,80521,9,"ENSG00000165671.22",1,1,"MVVVVUVVV",1,7,0.82815734989648,20,26,41,44,86,92,133,136,"GTGCTGA","CTGA","GGGAAGA","CTGA",2.65215517652444,15,42,41,107,0.931259029072505,4.65307338480886,7.96570278439478,101,"ENSG00000079974.19"
"30710","ENSG00000206579.9_58705",58697,58705,9,"ENSG00000206579.9",1,1,"MVVVVVVVV",0,8,0.90600414078675,114,120,133,136,152,158,169,172,"GTTTTGC","CAGA","CTAATGT","CTGA",2.23431086892922,13,16,11,49,2.47123372674381,4.34165987990132,7.96567644304832,101,"ENSG00000079974.19"
"25826","ENSG00000182901.18_81275",81267,81275,9,"ENSG00000182901.18",1,8,"VVVVVVVMV",0,8,0.884057971014493,113,119,133,136,147,153,178,181,"GTTAAGA","TTAA","GTGATAA","CTGA",2.34684623948853,14,11,25,59,2.07201898779407,4.42941514609606,7.96564703015403,101,"ENSG00000079974.19"
"45878","ENSG00000286016.1_73409",73401,73409,9,"ENSG00000286016.1",1,2,"VMVVVVVVV",0,8,0.884057971014493,70,76,92,95,112,118,133,136,"ATGGTGA","TTGA","CTGAGTA","CAGA",2.34516771901582,16,17,15,57,2.08310214693543,4.42938840176022,7.96562028581819,101,"ENSG00000079974.19"
"28359","ENSG00000188825.16_11281",11273,11281,9,"ENSG00000188825.16",1,8,"VVVUVVVMV",1,7,0.764803312629399,84,90,133,136,149,155,165,168,"ATGATAA","CTGA","GTCGTGA","CTGA",2.6896204271491,43,13,10,75,1.69460825088843,4.90635277463727,7.96556602515487,101,"ENSG00000079974.19"
"35883","ENSG00000237413.5_32621",32613,32621,9,"ENSG00000237413.5",0,NA,"VVVVVVUVV",1,8,0.886128364389234,112,118,133,136,149,155,166,169,"ATGATGA","ATGG","AAATTGA","CTAA",2.26389862478919,15,13,11,48,2.59124703897076,4.42097613439134,7.96548959194828,101,"ENSG00000079974.19"
"30877","ENSG00000214376.6_16563",16555,16563,9,"ENSG00000214376.6",1,8,"UVVVVUVMV",2,6,0.708902691511387,112,118,133,136,168,174,184,187,"ATGATGA","CTGG","CTGATGG","CTGA",2.78616112201062,15,32,10,66,1.94466364256016,5.12976778065774,7.96537854670329,101,"ENSG00000079974.19"
"11425","ENSG00000134897.14_36160",36152,36160,9,"ENSG00000134897.14",1,5,"VVVVMVVVV",0,8,0.886542443064182,83,89,101,104,115,121,133,136,"ATGAGGC","TTGA","TTGAGGC","GTGA",2.23122186911813,12,11,12,44,2.80200557223349,4.41920450825526,7.96537428051199,101,"ENSG00000079974.19"
"43230","ENSG00000270181.3_36169",36161,36169,9,"ENSG00000270181.3",1,5,"VVVVMVVVV",0,8,0.886542443064182,83,89,101,104,115,121,133,136,"ATGAGGC","TTGA","TTGAGGC","GTGA",2.23122186911813,12,11,12,44,2.80200557223349,4.41920450825526,7.96537428051199,101,"ENSG00000079974.19"
"3710","ENSG00000088387.22_195472",195464,195472,9,"ENSG00000088387.22",1,7,"VVVVVVMVV",0,8,0.885300207039338,45,51,65,68,116,122,133,136,"CTGAAGA","CTGA","ATGCTGG","CTCA",2.36180117652308,14,48,11,82,1.95102377773042,4.42409123863774,7.96529206679509,101,"ENSG00000079974.19"
"40657","ENSG00000257261.7_52383",52375,52383,9,"ENSG00000257261.7",1,1,"MVVVVVVVV",0,8,0.90600414078675,114,120,133,136,183,189,241,244,"ATGGAGA","CTGT","GTGCAGA","CTGA",2.45487910988795,13,47,52,121,0.998936698017304,4.34119935765091,7.96521592079791,101,"ENSG00000079974.19"
"31799","ENSG00000224897.9_110239",110231,110239,9,"ENSG00000224897.9",1,1,"MVVVVVVVV",0,8,0.90600414078675,71,77,85,88,91,97,133,136,"TTGAAGA","CTGA","GTGACAA","TTGA",2.3832849075825,8,3,36,56,1.4761047606778,4.34116770280695,7.96518426595395,101,"ENSG00000079974.19"
"17252","ENSG00000153707.19_599497",599489,599497,9,"ENSG00000153707.19",1,2,"UMVVVVVVV",1,7,0.786749482401656,78,84,98,101,112,118,133,136,"ATGATCT","CTGA","GAAATTA","CTGA",2.49831438707585,14,11,15,49,2.61728620527664,4.81817886311225,7.96517679271888,101,"ENSG00000079974.19"
"10407","ENSG00000130948.10_42350",42342,42350,9,"ENSG00000130948.10",0,NA,"VVVUVVVVV",1,8,0.880745341614907,74,80,90,93,110,116,133,136,"CTGATGA","CAGA","GCGAGGT","CTCA",2.35851840691256,10,17,17,53,2.04520733826944,4.4421658460883,7.96514721254792,101,"ENSG00000079974.19"
"45245","ENSG00000285269.2_92232",92224,92232,9,"ENSG00000285269.2",0,NA,"VVVUVVVVV",1,8,0.880745341614907,74,80,90,93,110,116,133,136,"CTGATGA","CAGA","GCGAGGT","CTCA",2.35851840691256,10,17,17,53,2.04520733826944,4.4421658460883,7.96514721254792,101,"ENSG00000079974.19"
"46759","ENSG00000287149.1_114124",114116,114124,9,"ENSG00000287149.1",1,1,"MVVVVVVVV",0,8,0.90600414078675,114,120,133,136,141,147,167,170,"ATGAAGA","CAGT","GTCAGGA","ATGA",2.23773168862608,13,5,20,47,2.44625944388182,4.34111767534726,7.96513423849426,101,"ENSG00000079974.19"
"33190","ENSG00000228980.4_211038",211030,211038,9,"ENSG00000228980.4",0,NA,"UVVVVVUVV",2,7,0.788819875776397,107,113,133,136,144,150,160,163,"CTAATGA","GTGA","GTGCTTA","CTGA",2.51388411386305,20,8,10,47,2.47974673934051,4.80974354127355,7.96502304437914,101,"ENSG00000079974.19"
"45757","ENSG00000285876.1_232515",232507,232515,9,"ENSG00000285876.1",1,1,"MVVVVVVVV",0,8,0.90600414078675,114,120,133,136,137,143,154,157,"TCTATGA","CTTA","AGAAGGA","CTGA",2.23352703764392,13,1,11,34,2.47381083798089,4.3409977722351,7.9650143353821,101,"ENSG00000079974.19"
"25721","ENSG00000182628.13_37894",37886,37894,9,"ENSG00000182628.13",0,NA,"UVVVVUVVV",2,7,0.824844720496894,109,115,133,136,146,152,164,167,"AAAATGA","CAGA","GATATGA","CTGA",2.42077583822102,18,10,12,49,2.5238215176267,4.66558177644172,7.96496065842929,101,"ENSG00000079974.19"
"885","ENSG00000038945.15_78617",78609,78617,9,"ENSG00000038945.15",0,NA,"VVUVVVVVV",1,8,0.883643892339545,106,112,133,136,142,148,193,196,"GTGGTGT","GTGA","CAGATGA","CTGA",2.4480739825426,21,6,45,81,1.40097798182215,4.4303677996932,7.96494336905138,101,"ENSG00000079974.19"
"29497","ENSG00000198104.4_7450",7442,7450,9,"ENSG00000198104.4",1,8,"VVVVVUVMV",1,7,0.806211180124224,115,121,133,136,149,155,163,166,"ATCATCA","CTGC","GTGTTCA","CTGA",2.44026423505072,12,13,8,42,2.69187352034321,4.74007543850367,7.96492015900057,101,"ENSG00000079974.19"
"29505","ENSG00000198104.4_8266",8258,8266,9,"ENSG00000198104.4",1,8,"VVVVVUVMV",1,7,0.806211180124224,115,121,133,136,149,155,163,166,"ATCATCA","CTGC","GTGTTCA","CTGA",2.44026423505072,12,13,8,42,2.69187352034321,4.74007543850367,7.96492015900057,101,"ENSG00000079974.19"
"29510","ENSG00000198104.4_8878",8870,8878,9,"ENSG00000198104.4",1,8,"VVVVVUVMV",1,7,0.806211180124224,115,121,133,136,149,155,163,166,"ATCATCA","CTGC","GTGTTCA","CTGA",2.44026423505072,12,13,8,42,2.69187352034321,4.74007543850367,7.96492015900057,101,"ENSG00000079974.19"
"3447","ENSG00000084090.14_1327",1319,1327,9,"ENSG00000084090.14",0,NA,"VVVVVVUVV",1,8,0.886128364389234,103,109,133,136,141,147,167,170,"ATGCTGT","CAGT","TTGATTA","CTGA",2.40232673280828,24,5,20,58,1.66585826424899,4.42034245407605,7.96485591163299,101,"ENSG00000079974.19"
"23612","ENSG00000173406.16_334894",334886,334894,9,"ENSG00000173406.16",0,NA,"VVVUVVVVV",1,8,0.880745341614907,111,117,133,136,141,147,157,160,"GTGATGT","TTGA","GGAATCA","ATGA",2.24473446727809,16,5,10,40,2.8024502429619,4.44183667287063,7.96481803933026,101,"ENSG00000079974.19"
"17401","ENSG00000154080.14_43397",43389,43397,9,"ENSG00000154080.14",1,2,"VMVVVVVVV",0,8,0.884057971014493,101,107,133,136,148,154,175,178,"ATAATGA","TAGA","ATGTATA","CTGA",2.45314853665799,26,12,21,68,1.3597496675579,4.42851831131946,7.96475019537743,101,"ENSG00000079974.19"
"30510","ENSG00000205403.15_8192",8184,8192,9,"ENSG00000205403.15",1,2,"VMVVVVVVV",0,8,0.884057971014493,114,120,133,136,186,192,213,216,"TTGTTGA","GTCA","ATGAAGA","CTGA",2.4385804221949,13,50,21,93,1.45681046368218,4.42850331957872,7.96473520363669,101,"ENSG00000079974.19"
"45290","ENSG00000285330.1_8041",8033,8041,9,"ENSG00000285330.1",1,2,"VMVVVVVVV",0,8,0.884057971014493,114,120,133,136,186,192,213,216,"TTGTTGA","GTCA","ATGAAGA","CTGA",2.4385804221949,13,50,21,93,1.45681046368218,4.42850331957872,7.96473520363669,101,"ENSG00000079974.19"
"12893","ENSG00000139364.11_155477",155469,155477,9,"ENSG00000139364.11",1,1,"MVUVVVVVV",1,7,0.789648033126294,103,109,133,136,142,148,172,175,"TTGATGA","CTTA","GTGGGGA","CTGA",2.65633931710758,24,6,24,63,1.51562093157538,4.80613742807314,7.96472956057832,101,"ENSG00000079974.19"
"45502","ENSG00000285664.2_39754",39746,39754,9,"ENSG00000285664.2",1,2,"UMVVVVVVV",1,7,0.786749482401656,85,91,106,109,116,122,133,136,"GTAATAA","CTGA","TTATTGA","CTGA",2.45371269955559,15,7,11,42,2.91266155369768,4.8176865543504,7.96468448395703,101,"ENSG00000079974.19"
"47128","ENSG00000287702.1_24635",24627,24635,9,"ENSG00000287702.1",1,1,"MVVVVVVVV",0,8,0.90600414078675,101,107,133,136,142,148,166,169,"TTGTTGA","GAGA","GTGTCAA","CTGA",2.34137963489321,26,6,18,59,1.75343738775826,4.34065873842825,7.96467530157524,101,"ENSG00000079974.19"
"14844","ENSG00000145949.12_52544",52536,52544,9,"ENSG00000145949.12",1,8,"VVVUVVVMV",1,7,0.764803312629399,78,84,100,103,113,119,133,136,"ATGCTGA","CAGA","ATGTAGC","CTGA",2.5519171793681,16,10,14,49,2.60866090854085,4.90536052608205,7.96457377659964,101,"ENSG00000079974.19"
"6229","ENSG00000108684.15_578825",578817,578825,9,"ENSG00000108684.15",0,NA,"VVVVVVUVV",1,8,0.886128364389234,88,94,133,136,142,148,172,175,"CTGATGG","CAGA","AAGATTT","CTGA",2.45703082115032,39,6,24,78,1.29972201833963,4.41998187316877,7.96449533072571,101,"ENSG00000079974.19"
"8612","ENSG00000119778.15_137817",137809,137817,9,"ENSG00000119778.15",0,NA,"VVVUVVVVV",1,8,0.880745341614907,115,121,133,136,155,161,176,179,"TGGATGA","TTTA","GTGGACA","CTGA",2.34389718262765,12,19,15,55,2.1400283242119,4.44150238543239,7.96448375189201,101,"ENSG00000079974.19"
"8377","ENSG00000118491.10_72",64,72,9,"ENSG00000118491.10",1,2,"VMVVVVVVV",0,8,0.884057971014493,42,48,74,77,81,87,101,104,"ATGATGT","GTGA","CTGTTGC","CAGA",2.38051086401904,26,4,14,53,1.84287439592772,4.42823670568034,7.96446858973831,101,"ENSG00000079974.19"
"44255","ENSG00000280148.1_7190",7182,7190,9,"ENSG00000280148.1",1,2,"VMVVVVVVV",0,8,0.884057971014493,101,107,133,136,140,146,160,163,"ATGATGT","GTGA","CTGTTGC","CAGA",2.38051086401904,26,4,14,53,1.84287439592772,4.42823670568034,7.96446858973831,101,"ENSG00000079974.19"
"732","ENSG00000029363.17_1788",1780,1788,9,"ENSG00000029363.17",0,NA,"UVVVVVVVV",1,8,0.902691511387163,109,115,133,136,145,151,167,170,"TTGAAGA","CTAC","AGGCTCA","CTGA",2.2558160200131,18,9,16,52,2.37574389218883,4.3536293397357,7.96439538528435,101,"ENSG00000079974.19"
"3191","ENSG00000082074.19_47901",47893,47901,9,"ENSG00000082074.19",1,3,"VVMVVUVVV",1,7,0.804968944099379,115,121,133,136,138,144,155,158,"ATGAAGA","ATCA","ACGATGC","CTGA",2.44501314203551,12,2,11,34,2.67787429758514,4.7444904777888,7.96436625418632,101,"ENSG00000079974.19"
"4274","ENSG00000100014.20_32417",32409,32417,9,"ENSG00000100014.20",1,1,"MVVVVUVVV",1,7,0.82815734989648,102,108,133,136,143,149,175,178,"ATGAGGA","CTAA","ATGCTGG","CTGA",2.57978859808107,25,7,26,67,1.4080929690698,4.65167090573589,7.96430030532181,101,"ENSG00000079974.19"
"41122","ENSG00000258555.6_32336",32328,32336,9,"ENSG00000258555.6",1,1,"MVVVVUVVV",1,7,0.82815734989648,102,108,133,136,143,149,175,178,"ATGAGGA","CTAA","ATGCTGG","CTGA",2.57978859808107,25,7,26,67,1.4080929690698,4.65167090573589,7.96430030532181,101,"ENSG00000079974.19"
"27932","ENSG00000187672.15_924016",924008,924016,9,"ENSG00000187672.15",1,8,"VVVVVUVMV",1,7,0.806211180124224,97,103,133,136,141,147,157,160,"TTGATGA","CTTA","GCCAGGA","CTGA",2.54738661440488,30,5,10,54,1.97507828177788,4.73941392778593,7.96425864828283,101,"ENSG00000079974.19"
"35432","ENSG00000236040.1_1552",1544,1552,9,"ENSG00000236040.1",1,8,"VVVVVVVMV",0,8,0.884057971014493,93,99,133,136,140,146,198,201,"ATGAGGC","CAGA","TTGATGT","CTGA",2.52908511123787,34,4,52,99,0.851471761368758,4.4280097924053,7.96424167646327,101,"ENSG00000079974.19"
"34354","ENSG00000232825.3_82129",82121,82129,9,"ENSG00000232825.3",1,2,"UMVVVVVVV",1,7,0.786749482401656,115,121,133,136,155,161,178,181,"AGAATGA","TTGA","ATGATGA","CTGA",2.58722157739708,12,19,17,57,2.02050287913843,4.81716168211308,7.9641596117197,101,"ENSG00000079974.19"
"45510","ENSG00000285677.2_10427",10419,10427,9,"ENSG00000285677.2",1,6,"VVVVVMVVV",0,8,0.902691511387163,115,121,133,136,147,153,163,166,"ATAATGA","CTAC","ATTATTA","TTGA",2.18411567372846,12,11,10,42,2.85263932279037,4.35335262024503,7.96411866579368,101,"ENSG00000079974.19"
"5939","ENSG00000107282.9_106556",106548,106556,9,"ENSG00000107282.9",1,8,"VVVVVVVMV",0,8,0.884057971014493,116,122,133,136,152,158,176,179,"ATTCTGA","AAGA","GTAAGGA","CTGA",2.34176459252206,11,16,18,54,2.09958612615639,4.42783751907587,7.96406940313384,101,"ENSG00000079974.19"
"48078","ENSG00000290376.1_96068",96060,96068,9,"ENSG00000290376.1",1,1,"MVVVVVVVV",0,8,0.90600414078675,111,117,133,136,155,161,178,181,"ATTATGA","CAGT","GTGAAGA","CAGA",2.32520127760083,16,19,17,61,1.85823040228483,4.33989306323926,7.96390962638626,101,"ENSG00000079974.19"
"36981","ENSG00000244040.7_128356",128348,128356,9,"ENSG00000244040.7",1,1,"MVVVVVVVV",0,8,0.90600414078675,101,107,133,136,145,151,194,197,"CTGATGG","GTGG","GTGAATA","CTGA",2.43962149614947,26,9,43,87,1.09538999750522,4.33988332629209,7.96389988943909,101,"ENSG00000079974.19"
"47020","ENSG00000287523.1_24566",24558,24566,9,"ENSG00000287523.1",1,2,"VMVUVVVVV",1,7,0.764803312629399,51,57,98,101,110,116,133,136,"CTGATGA","TTGA","GTGAAGG","CTGA",2.69542833081599,41,9,17,76,1.64919970337586,4.90468047720395,7.96389372772155,101,"ENSG00000079974.19"
"12524","ENSG00000138449.11_21370",21362,21370,9,"ENSG00000138449.11",1,2,"VMVVVVVVV",0,8,0.884057971014493,114,120,133,136,146,152,167,170,"CTGATGA","TTTA","CTAATAA","ATGA",2.24949975093091,13,10,15,47,2.71370021310854,4.42759130482864,7.96382318888661,101,"ENSG00000079974.19"
"41648","ENSG00000259430.2_54992",54984,54992,9,"ENSG00000259430.2",1,8,"VVVVVVVMV",0,8,0.884057971014493,69,75,87,90,105,111,133,136,"AGGATGG","CTGA","GTAAAGA","ATGA",2.3622743291608,12,15,22,58,1.96155795686657,4.4275133711513,7.96374525520928,101,"ENSG00000079974.19"
"17740","ENSG00000155011.9_10667",10659,10667,9,"ENSG00000155011.9",1,2,"VMVVVVVVV",0,8,0.884057971014493,116,122,133,136,143,149,165,168,"GTGAGAG","CTGG","TTGAGTA","CTGA",2.24461863121354,11,7,16,43,2.74570764219225,4.42745796257064,7.96368984662861,101,"ENSG00000079974.19"
"41940","ENSG00000260088.1_13865",13857,13865,9,"ENSG00000260088.1",1,8,"VVVVVVVMV",0,8,0.884057971014493,114,120,133,136,154,160,172,175,"AAAATGA","AAGA","GTGTTCT","CTGA",2.3074479452467,13,18,12,52,2.32673044223487,4.42742918596988,7.96366107002785,101,"ENSG00000079974.19"
"46065","ENSG00000286152.1_61582",61574,61582,9,"ENSG00000286152.1",1,1,"MVVVVVVVV",0,8,0.90600414078675,30,36,49,52,80,86,133,136,"ACGATGA","CTGA","TTGCTGC","GTGA",2.44268398776713,13,28,47,97,1.07383129022691,4.33959780216861,7.96361436531561,101,"ENSG00000079974.19"
"5606","ENSG00000105971.15_65566",65558,65566,9,"ENSG00000105971.15",0,NA,"UVVVVVVVV",1,8,0.902691511387163,63,69,83,86,107,113,133,136,"CTAATGA","CTAG","TTGACGT","CTGA",2.35387624930262,14,21,20,64,1.71866506543251,4.35279334852916,7.96355939407781,101,"ENSG00000079974.19"
"171","ENSG00000005981.13_657",649,657,9,"ENSG00000005981.13",1,8,"VVVVVVVMV",0,8,0.884057971014493,115,121,133,136,140,146,190,193,"ATAAGGG","CTAA","CTGAGGA","CTGA",2.37933417400279,12,4,44,69,1.84696203958218,4.42729746656686,7.96352935062483,101,"ENSG00000079974.19"
"2245","ENSG00000072135.13_797",789,797,9,"ENSG00000072135.13",0,NA,"VVVVVVUVV",1,8,0.886128364389234,89,95,103,106,114,120,133,136,"ATGACCA","CTAA","ATGATGT","CTTA",2.24685884341966,8,8,13,38,2.69671035235211,4.41894232712079,7.96345578467773,101,"ENSG00000079974.19"
"18301","ENSG00000156958.15_86469",86461,86469,9,"ENSG00000156958.15",1,2,"VMVVVVVVV",0,8,0.884057971014493,109,115,133,136,160,166,190,193,"GTGATTT","CAGA","GAGATGA","CTGA",2.48729764628526,18,24,24,75,1.12689096497857,4.42721881838675,7.96345070244472,101,"ENSG00000079974.19"
"37378","ENSG00000247950.9_15169",15161,15169,9,"ENSG00000247950.9",1,1,"MVVVVVVVV",0,8,0.90600414078675,108,114,133,136,182,188,204,207,"ATGACAA","TAGA","ATGTTGA","CTGA",2.40303165239546,19,46,16,90,1.33750741723982,4.33942960830239,7.96344617144939,101,"ENSG00000079974.19"
"7973","ENSG00000116183.11_167280",167272,167280,9,"ENSG00000116183.11",1,8,"VVUVVVVMV",1,7,0.767701863354037,109,115,133,136,141,147,159,162,"ATGATGG","AGGA","ATAATGA","CTGA",2.55088248137042,18,5,12,44,2.56456802442776,4.89261280839097,7.96342026180712,101,"ENSG00000079974.19"
"45968","ENSG00000286084.3_13267",13259,13267,9,"ENSG00000286084.3",1,1,"MVVVVVVVV",0,8,0.90600414078675,112,118,133,136,178,184,199,202,"GAGAAGA","ATGA","ATGTACA","CTGA",2.34390772567184,15,42,15,81,1.73149811748095,4.33938740548998,7.96340396863697,101,"ENSG00000079974.19"
"10371","ENSG00000130684.14_19944",19936,19944,9,"ENSG00000130684.14",1,8,"VVVVVVVMV",0,8,0.884057971014493,79,85,106,109,112,118,133,136,"CTGATCA","CTGA","GTCAAGA","CTAA",2.36685741925134,21,3,15,48,1.92961472757608,4.42716604731292,7.96339793137089,101,"ENSG00000079974.19"
"13850","ENSG00000143674.11_3298",3290,3298,9,"ENSG00000143674.11",1,1,"MVVVVVVVV",0,8,0.90600414078675,112,118,133,136,149,155,176,179,"ATTATTA","ATAA","ATAATAA","CTGA",2.29403347017951,15,13,21,58,2.06391495686817,4.33936785618289,7.96338441932988,101,"ENSG00000079974.19"
"41759","ENSG00000259675.4_32763",32755,32763,9,"ENSG00000259675.4",1,1,"MVVVVUVVV",1,7,0.82815734989648,112,118,133,136,153,159,176,179,"AGGATGA","CATA","CTGAGGG","CTGA",2.48516699686668,15,17,17,58,2.03519851134808,4.65074462261483,7.96337402220075,101,"ENSG00000079974.19"
"35350","ENSG00000235779.8_8998",8990,8998,9,"ENSG00000235779.8",0,NA,"UVVVVUVVV",2,7,0.824844720496894,116,122,133,136,142,148,168,171,"ATGTTTT","ATGA","GTGAGGA","CTGA",2.42651944819182,11,6,20,46,2.47913190750884,4.66398205719692,7.96336093918449,101,"ENSG00000079974.19"
"5857","ENSG00000107077.19_84870",84862,84870,9,"ENSG00000107077.19",1,8,"VVVVVVVMV",0,8,0.884057971014493,35,41,55,58,79,85,133,136,"ATGATGA","CTCA","ATGGTCA","ATGA",2.47535129275977,14,21,48,92,1.20616294563746,4.42712622434232,7.96335810840029,101,"ENSG00000079974.19"
"8987","ENSG00000121964.15_161239",161231,161239,9,"ENSG00000121964.15",0,NA,"UVUVVVVVV",2,7,0.786335403726708,112,118,133,136,176,182,191,194,"ATAATGA","CAGA","TTGAAGC","CTGA",2.60346576173664,15,40,9,73,1.91548211594021,4.81798013187945,7.96332174678628,101,"ENSG00000079974.19"
"33259","ENSG00000229140.12_946135",946127,946135,9,"ENSG00000229140.12",1,1,"MVVVVVVVV",0,8,0.90600414078675,92,98,133,136,141,147,156,159,"ATGAGAA","CTAG","ATGAGTA","CTGA",2.31274920129484,35,5,9,58,1.93868041641021,4.33925210626062,7.96326866940761,101,"ENSG00000079974.19"
"29446","ENSG00000198001.16_20765",20757,20765,9,"ENSG00000198001.16",1,1,"MVVVVUVVV",1,7,0.82815734989648,71,77,94,97,110,116,133,136,"ATAATGG","CTGG","ATGATTC","CTGA",2.4683080492837,17,13,17,56,2.14676816337927,4.65053878965098,7.9631681892369,101,"ENSG00000079974.19"
"25258","ENSG00000180263.14_6988",6980,6988,9,"ENSG00000180263.14",1,8,"VVVVVVVMV",0,8,0.884057971014493,82,88,100,103,112,118,133,136,"GTGATGA","TTGA","AGGATGA","ATAA",2.24008261923462,12,9,15,45,2.77385574891908,4.42693496928746,7.96316685334543,101,"ENSG00000079974.19"
"12773","ENSG00000139116.19_19876",19868,19876,9,"ENSG00000139116.19",0,NA,"VVVVUVVVV",1,8,0.889855072463768,108,114,133,136,144,150,188,191,"ATGATTT","GTGG","TTGTTGA","CTGA",2.40317935534954,19,8,38,74,1.5937096862542,4.40372634714611,7.96314663700118,101,"ENSG00000079974.19"
"41536","ENSG00000259200.2_194224",194216,194224,9,"ENSG00000259200.2",0,NA,"UVVVVVVVV",1,8,0.902691511387163,87,93,133,136,143,149,193,196,"GTGATGC","CTTC","GTGAAAA","CTGA",2.45981826872738,40,7,44,100,1.01057929208588,4.3523419375671,7.96310798311575,101,"ENSG00000079974.19"
"21795","ENSG00000168959.15_435870",435862,435870,9,"ENSG00000168959.15",1,6,"VVVVVMVVV",0,8,0.902691511387163,85,91,106,109,111,117,133,136,"ATGTTGG","CTGA","GAGAGAA","CAGA",2.27980188939191,15,2,16,42,2.21065308429479,4.35233308672689,7.96309913227554,101,"ENSG00000079974.19"
"7604","ENSG00000115159.16_104426",104418,104426,9,"ENSG00000115159.16",0,NA,"UVVVVVVVV",1,8,0.902691511387163,100,106,133,136,155,161,170,173,"AGGTTGA","GTGT","ATGAGGA","CTGA",2.39778538944175,27,19,9,64,1.42400904652113,4.35231124403319,7.96307728958185,101,"ENSG00000079974.19"
"15654","ENSG00000149084.13_140270",140262,140270,9,"ENSG00000149084.13",1,2,"VMVVVVVVV",0,8,0.884057971014493,114,120,133,136,143,149,178,181,"CAGATGA","CATA","GTGTTTC","CTGA",2.33441848459294,13,7,29,58,2.14454649301031,4.42683409757415,7.96306598163212,101,"ENSG00000079974.19"
"44669","ENSG00000283341.4_242061",242053,242061,9,"ENSG00000283341.4",1,2,"VMVVVVVVV",0,8,0.884057971014493,114,120,133,136,143,149,178,181,"CAGATGA","CATA","GTGTTTC","CTGA",2.33441848459294,13,7,29,58,2.14454649301031,4.42683409757415,7.96306598163212,101,"ENSG00000079974.19"
"6158","ENSG00000108239.9_131399",131391,131399,9,"ENSG00000108239.9",0,NA,"UVVVVVVVV",1,8,0.902691511387163,63,69,101,104,114,120,133,136,"TTGAAGA","ATGA","GTGATAA","ATGA",2.33526227522593,32,10,13,64,1.84070998413911,4.352281288078,7.96304733362665,101,"ENSG00000079974.19"
"20825","ENSG00000165733.8_34655",34647,34655,9,"ENSG00000165733.8",1,8,"VVVVVUVMV",1,7,0.806211180124224,115,121,133,136,139,145,162,165,"ATGATGA","CATA","TTGATGA","CAGA",2.47948905877762,12,3,17,41,2.42281833002045,4.73818634713448,7.96303106763138,101,"ENSG00000079974.19"
"35807","ENSG00000237238.4_844",836,844,9,"ENSG00000237238.4",1,8,"VVVVVUVMV",1,7,0.806211180124224,115,121,133,136,139,145,162,165,"ATGATGA","CATA","TTGATGA","CAGA",2.47948905877762,12,3,17,41,2.42281833002045,4.73818634713448,7.96303106763138,101,"ENSG00000079974.19"
"41205","ENSG00000258684.2_847",839,847,9,"ENSG00000258684.2",1,8,"VVVVVUVMV",1,7,0.806211180124224,115,121,133,136,139,145,162,165,"ATGATGA","CATA","TTGATGA","CAGA",2.47948905877762,12,3,17,41,2.42281833002045,4.73818634713448,7.96303106763138,101,"ENSG00000079974.19"
"41297","ENSG00000258780.1_847",839,847,9,"ENSG00000258780.1",1,8,"VVVVVUVMV",1,7,0.806211180124224,115,121,133,136,139,145,162,165,"ATGATGA","CATA","TTGATGA","CAGA",2.47948905877762,12,3,17,41,2.42281833002045,4.73818634713448,7.96303106763138,101,"ENSG00000079974.19"
"43610","ENSG00000272779.1_846",838,846,9,"ENSG00000272779.1",1,8,"VVVVVUVMV",1,7,0.806211180124224,115,121,133,136,139,145,162,165,"ATGATGA","CATA","TTGATGA","CAGA",2.47948905877762,12,3,17,41,2.42281833002045,4.73818634713448,7.96303106763138,101,"ENSG00000079974.19"
"46036","ENSG00000286129.1_5946",5938,5946,9,"ENSG00000286129.1",1,8,"VVVVVUVMV",1,7,0.806211180124224,115,121,133,136,139,145,162,165,"ATGATGA","CATA","TTGATGA","CAGA",2.47948905877762,12,3,17,41,2.42281833002045,4.73818634713448,7.96303106763138,101,"ENSG00000079974.19"
"46071","ENSG00000286156.4_846",838,846,9,"ENSG00000286156.4",1,8,"VVVVVUVMV",1,7,0.806211180124224,115,121,133,136,139,145,162,165,"ATGATGA","CATA","TTGATGA","CAGA",2.47948905877762,12,3,17,41,2.42281833002045,4.73818634713448,7.96303106763138,101,"ENSG00000079974.19"
"47964","ENSG00000289843.1_841",833,841,9,"ENSG00000289843.1",1,8,"VVVVVUVMV",1,7,0.806211180124224,115,121,133,136,139,145,162,165,"ATGATGA","CATA","TTGATGA","CAGA",2.47948905877762,12,3,17,41,2.42281833002045,4.73818634713448,7.96303106763138,101,"ENSG00000079974.19"
"48153","ENSG00000290549.1_5950",5942,5950,9,"ENSG00000290549.1",1,8,"VVVVVUVMV",1,7,0.806211180124224,115,121,133,136,139,145,162,165,"ATGATGA","CATA","TTGATGA","CAGA",2.47948905877762,12,3,17,41,2.42281833002045,4.73818634713448,7.96303106763138,101,"ENSG00000079974.19"
"48468","ENSG00000291142.1_5985",5977,5985,9,"ENSG00000291142.1",1,8,"VVVVVUVMV",1,7,0.806211180124224,115,121,133,136,139,145,162,165,"ATGATGA","CATA","TTGATGA","CAGA",2.47948905877762,12,3,17,41,2.42281833002045,4.73818634713448,7.96303106763138,101,"ENSG00000079974.19"
"48546","ENSG00000291264.1_5928",5920,5928,9,"ENSG00000291264.1",1,8,"VVVVVUVMV",1,7,0.806211180124224,115,121,133,136,139,145,162,165,"ATGATGA","CATA","TTGATGA","CAGA",2.47948905877762,12,3,17,41,2.42281833002045,4.73818634713448,7.96303106763138,101,"ENSG00000079974.19"
"42701","ENSG00000265944.1_14202",14194,14202,9,"ENSG00000265944.1",1,8,"VVVVVVVMV",0,8,0.884057971014493,79,85,101,104,116,122,133,136,"ATGCTGG","CTGA","GAGATTT","CTGT",2.26730201285821,16,12,11,48,2.59136078271335,4.42667688377535,7.96290876783332,101,"ENSG00000079974.19"
"11622","ENSG00000135541.22_110449",110441,110449,9,"ENSG00000135541.22",1,8,"VVVVVVVMV",0,8,0.884057971014493,115,121,133,136,141,147,162,165,"ATTATGG","CTAG","AGGGTCA","CTGA",2.24007144900126,12,5,15,41,2.77288109657987,4.42667268914707,7.96290457320504,101,"ENSG00000079974.19"
"3273","ENSG00000082805.21_78079",78071,78079,9,"ENSG00000082805.21",1,7,"VVVVVVMVV",0,8,0.885300207039338,115,121,133,136,142,148,176,179,"AAAATGA","CTTG","ATGAAAA","CTGA",2.32922611813172,12,6,28,55,2.15851611547114,4.42167255908732,7.96287338724468,101,"ENSG00000079974.19"
"43409","ENSG00000271860.9_13267",13259,13267,9,"ENSG00000271860.9",1,8,"VVVVVVVMV",0,8,0.884057971014493,115,121,133,136,187,193,224,227,"AAGAGGA","CAGA","ATAATGA","CTGA",2.48974351355338,12,51,31,103,1.10805997976043,4.42658751752907,7.96281940158704,101,"ENSG00000079974.19"
"41254","ENSG00000258744.3_59280",59272,59280,9,"ENSG00000258744.3",1,7,"VVVVVUMVV",1,7,0.807453416149068,108,114,133,136,152,158,212,215,"ATGATGA","CAGC","GAGATGA","CTGA",2.67979347072354,19,16,54,98,1.06645755470012,4.73293683988093,7.9627505044772,101,"ENSG00000079974.19"
"36868","ENSG00000243295.2_356089",356081,356089,9,"ENSG00000243295.2",0,NA,"VVVUVVVVV",1,8,0.880745341614907,109,115,133,136,145,151,181,184,"ATGAAGA","CTTT","GTTAAAA","CTGA",2.40231090444122,18,9,30,66,1.74352339620158,4.43973235645243,7.96271372291205,101,"ENSG00000079974.19"
"42275","ENSG00000261451.1_302",294,302,9,"ENSG00000261451.1",1,2,"VMVVVVVVV",0,8,0.884057971014493,113,119,133,136,142,148,157,160,"TTGATAA","CTGG","CAGAGGA","CTCA",2.20494978399022,14,6,9,38,3.00615666399917,4.42645547265017,7.96268735670814,101,"ENSG00000079974.19"
"21117","ENSG00000166450.13_29887",29879,29887,9,"ENSG00000166450.13",0,NA,"UVVVVVVVV",1,8,0.902691511387163,87,93,100,103,110,116,133,136,"ATGATTA","TTTA","GTGTGGA","TTGA",2.25977169949127,7,7,17,40,2.34247600482201,4.35190516702429,7.96267121257294,101,"ENSG00000079974.19"
"44488","ENSG00000282728.1_28401",28393,28401,9,"ENSG00000282728.1",0,NA,"VVVVVVUVV",1,8,0.886128364389234,115,121,133,136,150,156,175,178,"AGGAAGA","TGGA","TTGTTAA","CTGA",2.32113335745241,12,14,19,54,2.19831680019697,4.41813479580326,7.96264825336019,101,"ENSG00000079974.19"
"12270","ENSG00000137766.18_475375",475367,475375,9,"ENSG00000137766.18",0,NA,"UVVVVVVVV",1,8,0.902691511387163,112,118,133,136,180,186,196,199,"ATAATGC","CTTG","ATCAGGA","CTGA",2.3242264996,15,44,10,78,1.91268265852628,4.35188149729823,7.96264754284688,101,"ENSG00000079974.19"
"17907","ENSG00000155816.21_174986",174978,174986,9,"ENSG00000155816.21",1,1,"MVVVVVVVV",0,8,0.90600414078675,116,122,133,136,143,149,205,208,"ATGAACA","GTGT","CTGTTGG","CTGA",2.30683560497132,11,7,56,83,1.9753192655649,4.33855582467676,7.96257238782376,101,"ENSG00000079974.19"
"38919","ENSG00000251301.8_10478",10470,10478,9,"ENSG00000251301.8",0,NA,"VVVVUVVVV",1,8,0.889855072463768,114,120,133,136,141,147,155,158,"ACAATGG","TTGT","TTTAAGA","CTGA",2.18604118300305,13,5,8,35,3.03887925885067,4.40312178638442,7.96254207623949,101,"ENSG00000079974.19"
"9610","ENSG00000125835.20_537",529,537,9,"ENSG00000125835.20",0,NA,"VVUVVVVVV",1,8,0.883643892339545,112,118,133,136,138,144,156,159,"AGGGGGA","CAGA","TTGCGGA","CTGA",2.28888348141468,15,2,12,38,2.45259901227958,4.42795555542769,7.96253112478587,101,"ENSG00000079974.19"
"40486","ENSG00000256566.1_38591",38583,38591,9,"ENSG00000256566.1",0,NA,"VVUVVVVVV",1,8,0.883643892339545,112,118,133,136,138,144,156,159,"AGGGGGA","CAGA","TTGCGGA","CTGA",2.28888348141468,15,2,12,38,2.45259901227958,4.42795555542769,7.96253112478587,101,"ENSG00000079974.19"
"15897","ENSG00000150275.20_1225266",1225258,1225266,9,"ENSG00000150275.20",1,2,"VMVVVVVVV",0,8,0.884057971014493,113,119,133,136,146,152,164,167,"GTAATTA","CTGA","ATCATAA","ATGA",2.23180741199663,14,10,12,45,2.82619369388064,4.42622744346455,7.96245932752252,101,"ENSG00000079974.19"
"15898","ENSG00000150275.20_1228002",1227994,1228002,9,"ENSG00000150275.20",1,1,"MVVVVVVVV",0,8,0.90600414078675,113,119,133,136,146,152,164,167,"AGCATTA","AAGA","TTGCTGT","CTGA",2.17908416995058,14,10,12,45,2.82619369388064,4.3383553733878,7.9623719365348,101,"ENSG00000079974.19"
"28439","ENSG00000189108.13_708104",708096,708104,9,"ENSG00000189108.13",1,8,"VVVVVVVMV",0,8,0.884057971014493,113,119,133,136,140,146,188,191,"ATGGTGC","AGGA","GTGAGGC","CTGA",2.38335562361994,14,4,42,69,1.8153434094804,4.42609522507,7.96232710912797,101,"ENSG00000079974.19"
"19920","ENSG00000164011.18_1172",1164,1172,9,"ENSG00000164011.18",1,7,"VVVVVVMVV",0,8,0.885300207039338,114,120,133,136,144,150,166,169,"AGTATAA","CTGA","GTGATGG","CTGC",2.24093868101896,13,8,16,46,2.74489991475503,4.42112278038702,7.96232360854437,101,"ENSG00000079974.19"
"1276","ENSG00000051108.15_6062",6054,6062,9,"ENSG00000051108.15",0,NA,"VVVVUVVVV",1,8,0.889855072463768,95,101,133,136,141,147,188,191,"GTGATGT","CAAA","AAGATGA","CTGA",2.49596655154366,32,5,41,87,0.971677145540738,4.40286353895794,7.96228382881302,101,"ENSG00000079974.19"
"30017","ENSG00000198947.18_874868",874860,874868,9,"ENSG00000198947.18",1,7,"UVVVVVMVV",1,7,0.787991718426501,111,117,133,136,145,151,189,192,"ATGATGA","ATCA","GTAATGC","CTGA",2.61335061986267,16,9,38,72,1.81870475278025,4.81026055463284,7.96222742833884,101,"ENSG00000079974.19"
"33710","ENSG00000230864.1_32546",32538,32546,9,"ENSG00000230864.1",1,7,"VVVVVVMVV",0,8,0.885300207039338,94,100,133,136,179,185,196,199,"ACGATGT","TTGA","CTGAGGC","CTGA",2.50159148717984,33,43,11,96,1.00674350991066,4.42100502277739,7.96220585093474,101,"ENSG00000079974.19"
"7551","ENSG00000114805.18_159170",159162,159170,9,"ENSG00000114805.18",1,1,"MVVVVVVVV",0,8,0.90600414078675,97,103,133,136,183,189,201,204,"TTGATGA","TTTA","GTTATCG","CTGA",2.45239033527218,30,47,12,98,1.00337923915315,4.33816203524192,7.96217859838892,101,"ENSG00000079974.19"
"14450","ENSG00000145012.14_400056",400048,400056,9,"ENSG00000145012.14",0,NA,"UVVVVVVVV",1,8,0.902691511387163,111,117,133,136,146,152,176,179,"ATAATGT","CAGG","ATTAAGC","CTGA",2.30333399240849,16,10,24,59,2.04990014480548,4.35136502354886,7.96213106909751,101,"ENSG00000079974.19"
"46947","ENSG00000287394.1_46859",46851,46859,9,"ENSG00000287394.1",1,7,"VVVVVVMVV",0,8,0.885300207039338,113,119,133,136,144,150,166,169,"ATGCAAA","CTAA","CTCAAGA","CTGA",2.24575799240482,14,8,16,47,2.71183369767137,4.42088841175921,7.96208923991656,101,"ENSG00000079974.19"
"6552","ENSG00000110693.19_551762",551754,551762,9,"ENSG00000110693.19",1,3,"VVMVVVVVV",0,8,0.882815734989648,66,72,86,89,96,102,133,136,"ATAATGA","CAGA","GGGTTGA","CTAA",2.34782507640845,14,7,31,61,2.07103075935578,4.43079948385303,7.96206242381162,101,"ENSG00000079974.19"
"38242","ENSG00000249816.8_7716",7708,7716,9,"ENSG00000249816.8",1,7,"VVVVVVMVV",0,8,0.885300207039338,115,121,133,136,141,147,157,160,"GTGCTGA","CTGT","GGGATTC","CTGG",2.19738802670879,12,5,10,36,3.03415759690402,4.420852777074,7.96205360523135,101,"ENSG00000079974.19"
"14641","ENSG00000145526.12_984826",984818,984826,9,"ENSG00000145526.12",1,1,"MVVVVVVVV",0,8,0.90600414078675,114,120,133,136,143,149,171,174,"TTAAAGA","CATA","GTGATTC","CTGA",2.24222773615219,13,7,22,51,2.40368439608716,4.33796732594211,7.96198388908911,101,"ENSG00000079974.19"
"13344","ENSG00000141027.23_160079",160071,160079,9,"ENSG00000141027.23",0,NA,"VVVVVVUVV",1,8,0.886128364389234,116,122,133,136,174,180,192,195,"ATAATGA","CAGA","ATGATCC","ATGA",2.35889529841617,11,38,12,70,1.94388330203286,4.41746298953517,7.9619764470921,101,"ENSG00000079974.19"
"28521","ENSG00000196083.10_134456",134448,134456,9,"ENSG00000196083.10",1,6,"VVVVVMVVV",0,8,0.902691511387163,109,115,133,136,142,148,157,160,"GTCATTT","GTGA","ACGAAGG","CTGA",2.21077449180274,18,6,9,42,2.66619820572753,4.35117370443645,7.9619397499851,101,"ENSG00000079974.19"
"40344","ENSG00000255628.1_9346",9338,9346,9,"ENSG00000255628.1",1,1,"MVVVVVVVV",0,8,0.90600414078675,89,95,133,136,143,149,162,165,"GTGAAGG","CTTC","GTGAAAA","CTGA",2.31444071050578,38,7,13,67,1.9220817060978,4.33792161070075,7.96193817384775,101,"ENSG00000079974.19"
"40686","ENSG00000257322.7_194319",194311,194319,9,"ENSG00000257322.7",1,3,"VVMVVVVVV",0,8,0.882815734989648,51,57,97,100,111,117,133,136,"ATGAAGG","CTGA","GTGGTGA","TTGA",2.41913487849554,40,11,16,76,1.5950698027317,4.43065891484216,7.96192185480075,101,"ENSG00000079974.19"
"1668","ENSG00000064933.19_64317",64309,64317,9,"ENSG00000064933.19",0,NA,"VVVVVVUVV",1,8,0.886128364389234,43,49,74,77,109,115,133,136,"ATAAAGA","CTGA","GTGCACA","CTGA",2.52397826107688,25,32,18,84,0.843102741813094,4.41740612058141,7.96191957813835,101,"ENSG00000079974.19"
"9330","ENSG00000124177.16_54423",54415,54423,9,"ENSG00000124177.16",0,NA,"UVVVVVUVV",2,7,0.788819875776397,116,122,133,136,142,148,161,164,"GTAATGA","CTTG","CTGGTGA","CTGA",2.44560135893357,11,6,13,39,2.9225369314352,4.80663649774808,7.96191600085367,101,"ENSG00000079974.19"
"22665","ENSG00000171094.18_253227",253219,253227,9,"ENSG00000171094.18",1,1,"MVVVVVVVV",0,8,0.90600414078675,110,116,133,136,143,149,187,190,"ATGTTTT","CTCA","CTAATGA","CTGA",2.3349380161653,17,7,38,71,1.78521271450812,4.33786653890254,7.96188310204953,101,"ENSG00000079974.19"
"26445","ENSG00000184261.5_40331",40323,40331,9,"ENSG00000184261.5",1,8,"VVVVVVVMV",0,8,0.884057971014493,113,119,133,136,147,153,162,165,"AACATGA","GTGA","GTGAAAA","CTCA",2.23388071896573,14,11,9,43,2.81000361935371,4.42563543644799,7.96186732050596,101,"ENSG00000079974.19"
"42308","ENSG00000261615.7_13711",13703,13711,9,"ENSG00000261615.7",0,NA,"UVVVVVVVV",1,8,0.902691511387163,83,89,133,136,150,156,173,176,"GGCATGA","CTCA","ATCATGA","CTGA",2.41253283487251,44,14,17,84,1.32078670975111,4.35108473555862,7.96185078110728,101,"ENSG00000079974.19"
"26976","ENSG00000185352.9_198032",198024,198032,9,"ENSG00000185352.9",1,5,"VVVVMVVVV",0,8,0.886542443064182,100,106,133,136,172,178,188,191,"AAGGTGA","CTAA","CTGATGT","CTGA",2.4815354843463,27,36,10,82,1.11903949121693,4.41565234671474,7.96182211897146,101,"ENSG00000079974.19"
"11044","ENSG00000133739.16_19632",19624,19632,9,"ENSG00000133739.16",1,1,"MVVVVVVVV",0,8,0.90600414078675,83,89,133,136,143,149,171,174,"AAGAGGA","ATTA","CTGAAGA","CTGA",2.39144126496562,44,7,22,82,1.40795308541499,4.33772371296311,7.96174027611011,101,"ENSG00000079974.19"
"16041","ENSG00000150672.19_1297563",1297555,1297563,9,"ENSG00000150672.19",1,2,"VMVVVVVVV",0,8,0.884057971014493,110,116,133,136,144,150,158,161,"AGGATGA","GGGA","CTGAGGT","CTGG",2.24441155509826,17,8,8,42,2.7391952019519,4.42548472565174,7.96171660970971,101,"ENSG00000079974.19"
"20292","ENSG00000164619.10_136572",136564,136572,9,"ENSG00000164619.10",1,8,"VVVVVVVMV",0,8,0.884057971014493,114,120,133,136,146,152,169,172,"AACATGA","CTGG","GTGATGC","CTAA",2.26634740029036,13,10,17,49,2.59264543972174,4.42540702708104,7.96163891113901,101,"ENSG00000079974.19"
"20265","ENSG00000164574.16_209938",209930,209938,9,"ENSG00000164574.16",0,NA,"VVUVVVVVV",1,8,0.883643892339545,102,108,133,136,143,149,177,180,"ATAATTA","ATGA","ATGCTGT","CTGA",2.45428020559708,25,7,28,69,1.34627594308588,4.42703599509993,7.96161156445811,101,"ENSG00000079974.19"
"29639","ENSG00000198521.12_11366",11358,11366,9,"ENSG00000198521.12",1,6,"VVVVVMVVV",0,8,0.902691511387163,64,70,94,97,105,111,133,136,"ATTATGA","CAGA","GTGACCA","CTCA",2.36865085984891,24,8,22,63,1.61222712883918,4.35080821529132,7.96157426083997,101,"ENSG00000079974.19"
"23960","ENSG00000174501.15_31755",31747,31755,9,"ENSG00000174501.15",1,5,"VVVVMVVVV",0,8,0.886542443064182,86,92,133,136,147,153,166,169,"CTGATCA","ATAA","ATGAGAA","CTGA",2.3859524224769,41,11,13,74,1.75521461976132,4.41539102573516,7.96156079799189,101,"ENSG00000079974.19"
"25985","ENSG00000183117.20_1978626",1978618,1978626,9,"ENSG00000183117.20",1,1,"MVVVVVVVV",0,8,0.90600414078675,112,118,133,136,142,148,168,171,"GGGATGA","AGGA","GAGATGA","ATGA",2.24091285918749,15,6,20,50,2.41045577384085,4.3374687087727,7.9614852719197,101,"ENSG00000079974.19"
"8510","ENSG00000119335.18_12619",12611,12619,9,"ENSG00000119335.18",1,6,"VVVVVMVVV",0,8,0.902691511387163,93,99,133,136,140,146,154,157,"ATGGTGA","CTCA","GTGACCA","CTGG",2.33591225036775,34,4,8,55,1.83006531996883,4.35070341393845,7.96146945948711,101,"ENSG00000079974.19"
"4910","ENSG00000102313.9_24988",24980,24988,9,"ENSG00000102313.9",1,2,"VMVVVVVVV",0,8,0.884057971014493,113,119,133,136,141,147,157,160,"CTGAGGA","CAGA","CTTGTGA","CTCA",2.21186263195977,14,5,10,38,2.95516023325629,4.42522777824702,7.96145966230499,101,"ENSG00000079974.19"
"34581","ENSG00000233491.8_152712",152704,152712,9,"ENSG00000233491.8",1,7,"VVVVVVMVV",0,8,0.885300207039338,112,118,133,136,147,153,162,165,"ATGCTAT","CAGC","GTGAATA","CTGA",2.23934424415046,15,11,9,44,2.75189476674267,4.4202140986031,7.96141492676045,101,"ENSG00000079974.19"
"14543","ENSG00000145362.21_113881",113873,113881,9,"ENSG00000145362.21",1,2,"UMVVVVVVV",1,7,0.786749482401656,114,120,133,136,141,147,162,165,"ATCATGA","GAGA","CTGTTTA","CTGA",2.47440864793942,13,5,15,42,2.7615897979202,4.81441186271242,7.96140979231905,101,"ENSG00000079974.19"
"23570","ENSG00000173262.12_40200",40192,40200,9,"ENSG00000173262.12",1,8,"VVVVVVVMV",0,8,0.884057971014493,114,120,133,136,139,145,156,159,"AGCAAGA","CAGA","AAGAAAA","CTGA",2.23738019840337,13,3,11,36,2.78483965074055,4.42517691002408,7.96140879408205,101,"ENSG00000079974.19"
"4199","ENSG00000099139.14_58253",58245,58253,9,"ENSG00000099139.14",1,6,"VVUVVMVVV",1,7,0.786335403726708,76,82,99,102,112,118,133,136,"ATGATCA","CAGA","GAGCTTA","CTGA",2.51898365259856,17,10,15,51,2.47077564839222,4.81599999976233,7.96134161466916,101,"ENSG00000079974.19"
"15499","ENSG00000148498.17_510848",510840,510848,9,"ENSG00000148498.17",1,8,"VVVVVVVMV",0,8,0.884057971014493,108,114,133,136,155,161,180,183,"ATTGTGA","CTCA","ATGCAGA","CTGA",2.43376661055009,19,19,19,66,1.47485356109387,4.42499107452362,7.96122295858159,101,"ENSG00000079974.19"
"44351","ENSG00000281131.1_22154",22146,22154,9,"ENSG00000281131.1",1,7,"VVVVVVMVV",0,8,0.885300207039338,68,74,87,90,98,104,133,136,"ATGATTA","CAGA","TTGACAA","CTCA",2.33232196744204,13,8,29,59,2.1311853990133,4.41999962882339,7.96120045698074,101,"ENSG00000079974.19"
"42959","ENSG00000267439.1_6340",6332,6340,9,"ENSG00000267439.1",1,6,"VVVVVMVVV",0,8,0.902691511387163,68,74,85,88,100,106,133,136,"ATTATGA","CTGT","ATCATGT","CTCA",2.31861206557905,11,12,27,59,1.94419800259401,4.35040294328025,7.96116898882891,101,"ENSG00000079974.19"
"6815","ENSG00000111961.19_141658",141650,141658,9,"ENSG00000111961.19",1,2,"VMVVVVVVV",0,8,0.884057971014493,53,59,103,106,112,118,133,136,"ATGATGA","CTCC","ATGAAGT","TTGA",2.38477056111404,44,6,15,74,1.80123264333332,4.42492576269006,7.96115764674803,101,"ENSG00000079974.19"
"17782","ENSG00000155052.15_845587",845579,845587,9,"ENSG00000155052.15",1,1,"MVVVVUVVV",1,7,0.82815734989648,60,66,72,75,83,89,133,136,"AGGAGGA","CTGA","CTGTGGA","CTGA",2.56664161294322,6,8,44,67,1.48311169678419,4.64851394576808,7.961143345354,101,"ENSG00000079974.19"
"773","ENSG00000033122.21_6366",6358,6366,9,"ENSG00000033122.21",1,1,"MVVVVVVVV",0,8,0.90600414078675,105,111,133,136,141,147,157,160,"ATCATGA","ATGG","GTGAAAA","CAGA",2.26138510650732,22,5,10,46,2.27257857298657,4.33711982075885,7.96113638390585,101,"ENSG00000079974.19"
"3648","ENSG00000087258.16_142694",142686,142694,9,"ENSG00000087258.16",0,NA,"VVVUVVVVV",1,8,0.880745341614907,13,19,61,64,73,79,133,136,"ACAATGA","CTGA","CAGGTGA","CTGA",2.52004436952831,42,9,54,114,0.95228979661628,4.43814639836793,7.96112776482756,101,"ENSG00000079974.19"
"34732","ENSG00000233902.1_279",271,279,9,"ENSG00000233902.1",1,1,"MVUVVVVVV",1,7,0.789648033126294,108,114,133,136,142,148,189,192,"ATCATGA","CTGA","GTTGGGA","CTGA",2.64486823847489,19,6,41,75,1.57742167601374,4.80246914979492,7.9610612823001,101,"ENSG00000079974.19"
"20290","ENSG00000164619.10_111046",111038,111046,9,"ENSG00000164619.10",1,7,"VVVVVVMVV",0,8,0.885300207039338,82,88,101,104,113,119,133,136,"ATAATAA","TTGA","CAGATGA","CTTA",2.22836121896677,13,9,14,45,2.82358264695618,4.41983102668366,7.96103185484101,101,"ENSG00000079974.19"
"17328","ENSG00000153930.13_264401",264393,264401,9,"ENSG00000153930.13",1,6,"VVVVVMVVV",0,8,0.902691511387163,112,118,133,136,184,190,202,205,"GTGCTGA","GGGA","AGGCTGT","CTGA",2.32980650588885,15,48,12,84,1.86889773768632,4.35023527756967,7.96100132311832,101,"ENSG00000079974.19"
"29270","ENSG00000197584.13_31615",31607,31615,9,"ENSG00000197584.13",1,5,"VVVVMVVVV",0,8,0.886542443064182,40,46,61,64,73,79,133,136,"GTGAGGA","CTGA","ATGAATT","ATGA",2.36973948441838,15,9,54,87,1.86099570270189,4.41481473303944,7.96098450529617,101,"ENSG00000079974.19"
"13460","ENSG00000141458.13_23296",23288,23296,9,"ENSG00000141458.13",1,1,"MVVVVVVVV",0,8,0.90600414078675,110,116,133,136,141,147,162,165,"ATGTTGT","ATGA","TTGATAC","ATGA",2.22599784142022,17,5,15,46,2.50766730677879,4.33691322906172,7.96092979220872,101,"ENSG00000079974.19"
"2546","ENSG00000075651.17_56456",56448,56456,9,"ENSG00000075651.17",1,8,"VVVVVVVMV",0,8,0.884057971014493,98,104,133,136,145,151,159,162,"ATGAAGG","GGGA","TTGAGGG","CTGA",2.3564085534198,29,9,8,55,1.98935101493076,4.42468534276569,7.96091722682366,101,"ENSG00000079974.19"
"13844","ENSG00000143669.16_13900",13892,13900,9,"ENSG00000143669.16",1,1,"MVVVVUVVV",1,7,0.82815734989648,112,118,133,136,141,147,200,203,"GTGATGG","ACGA","TTGAGGA","CTGA",2.51264290520876,15,5,53,82,1.84212534870238,4.64826951252353,7.96089891210945,101,"ENSG00000079974.19"
"29763","ENSG00000198682.13_86881",86873,86881,9,"ENSG00000198682.13",1,6,"VVVVVMVVV",0,8,0.902691511387163,115,121,133,136,141,147,167,170,"CTCATGC","TTAA","GTAATCA","CTGA",2.24222707595308,12,5,20,46,2.45213813458746,4.35007966023533,7.96084570578398,101,"ENSG00000079974.19"
"39699","ENSG00000254101.8_242710",242702,242710,9,"ENSG00000254101.8",0,NA,"VVVUVVVVV",1,8,0.880745341614907,114,120,133,136,145,151,171,174,"GTTATGC","TTGT","GAGATGG","CTGA",2.29324211187829,13,9,20,51,2.46308116229681,4.43784047703803,7.96082184349765,101,"ENSG00000079974.19"
"20896","ENSG00000165973.19_135237",135229,135237,9,"ENSG00000165973.19",1,2,"VMVVVVVVV",0,8,0.884057971014493,108,114,133,136,179,185,193,196,"TGGATGA","ATTA","TTGTTGA","CTGA",2.42058246067791,19,43,8,79,1.5609789554188,4.42454883998456,7.96078072404253,101,"ENSG00000079974.19"
"46334","ENSG00000286481.2_660463",660455,660463,9,"ENSG00000286481.2",1,3,"VVMVVUVVV",1,7,0.804968944099379,115,121,133,136,169,175,183,186,"ATGATGC","AGGA","GTGAGGG","CTGA",2.54312526446756,12,33,8,62,2.00944053944233,4.74090224230652,7.96077801870403,101,"ENSG00000079974.19"
"8950","ENSG00000121895.8_49023",49015,49023,9,"ENSG00000121895.8",1,1,"MVVVVVVVV",0,8,0.90600414078675,112,118,133,136,139,145,153,156,"ATAAGTA","CGGA","AGCAAGA","CTGA",2.19372677986459,15,3,8,35,2.72215482649544,4.33675000639818,7.96076656954518,101,"ENSG00000079974.19"
"13230","ENSG00000140718.21_128280",128272,128280,9,"ENSG00000140718.21",1,3,"VVMVVVVVV",0,8,0.882815734989648,109,115,133,136,153,159,167,170,"CTGGAGA","CTGG","GTGATTG","CTGA",2.34645158625751,18,17,8,52,2.07491197268096,4.42948063693275,7.96074357689135,101,"ENSG00000079974.19"
"34107","ENSG00000231918.1_1208855",1208847,1208855,9,"ENSG00000231918.1",1,1,"MVVVVVVVV",0,8,0.90600414078675,87,93,133,136,183,189,204,207,"ATGATCA","CATA","ATGAGCA","CTGA",2.47894310360151,40,47,15,111,0.820322235045458,4.33665239809721,7.96066896124421,101,"ENSG00000079974.19"
"30327","ENSG00000204603.7_2952",2944,2952,9,"ENSG00000204603.7",1,8,"VVVVVVUMV",1,7,0.770186335403727,110,116,133,136,147,153,197,200,"GTGATGA","CACA","ATGATGA","CTGA",2.68806790700988,17,11,44,81,1.5991830167016,4.87990893252519,7.9606542741401,101,"ENSG00000079974.19"
"22103","ENSG00000169851.16_360099",360091,360099,9,"ENSG00000169851.16",0,NA,"UVVVVVVVV",1,8,0.902691511387163,95,101,133,136,180,186,198,201,"GTGATTA","ATTA","TTGATGT","CTGA",2.46219707282005,32,44,12,97,0.98475562230682,4.34985069361012,7.96061673915877,101,"ENSG00000079974.19"
"26342","ENSG00000183878.16_2207",2199,2207,9,"ENSG00000183878.16",0,NA,"VVVUVVVVV",1,8,0.880745341614907,74,80,98,101,112,118,133,136,"GGGAAGA","CGGA","AGGAATA","CTGA",2.31476427819567,18,11,15,53,2.31870320381342,4.4376162646128,7.96059763107243,101,"ENSG00000079974.19"
"21705","ENSG00000168702.18_939888",939880,939888,9,"ENSG00000168702.18",0,NA,"UVVVVUVVV",2,7,0.824844720496894,113,119,133,136,144,150,165,168,"ATGATGA","ATGG","ATGATAG","CTAA",2.38087497614054,14,8,15,46,2.77174603734722,4.66106146957104,7.96044035155862,101,"ENSG00000079974.19"
"34769","ENSG00000234062.11_11340",11332,11340,9,"ENSG00000234062.11",1,3,"VVMVVVVVV",0,8,0.882815734989648,108,114,133,136,145,151,204,207,"ATAATAC","CTGA","GTCATGG","CTGA",2.4281993267085,19,9,53,90,1.52863621902734,4.42915793260434,7.96042087256293,101,"ENSG00000079974.19"
"48385","ENSG00000291054.1_60854",60846,60854,9,"ENSG00000291054.1",1,3,"VVMVVVVVV",0,8,0.882815734989648,108,114,133,136,145,151,204,207,"ATAATAC","CTGA","GTCATGG","CTGA",2.4281993267085,19,9,53,90,1.52863621902734,4.42915793260434,7.96042087256293,101,"ENSG00000079974.19"
"47336","ENSG00000288016.3_120991",120983,120991,9,"ENSG00000288016.3",1,8,"VVVVVVVMV",0,8,0.884057971014493,110,116,133,136,142,148,156,159,"GGGTTGA","AAGA","ATGTAAA","CTGA",2.24168311328347,17,6,8,40,2.75207265296066,4.42415668537929,7.96038856943726,101,"ENSG00000079974.19"
"31742","ENSG00000224609.8_55394",55386,55394,9,"ENSG00000224609.8",1,5,"VVVVMVVVV",0,8,0.886542443064182,116,122,133,136,145,151,159,162,"GTGAAGA","CAGA","ATAGTGG","CTGT",2.20087044916426,11,9,8,37,2.98438640412829,4.41421401630584,7.96038378856257,101,"ENSG00000079974.19"
"23747","ENSG00000173821.20_34768",34760,34768,9,"ENSG00000173821.20",1,8,"VVVVVVVMV",0,8,0.884057971014493,69,75,93,96,105,111,133,136,"GTGAAGA","CTGA","GTGGTAC","CGGA",2.35080271397645,18,9,22,58,2.02450861332465,4.42413167662525,7.96036356068322,101,"ENSG00000079974.19"
"3646","ENSG00000087258.16_121745",121737,121745,9,"ENSG00000087258.16",1,1,"MVVVVVVVV",0,8,0.90600414078675,109,115,133,136,167,173,184,187,"ATGATGT","GTGT","GTGATGC","CAGA",2.3476187142034,18,31,11,69,1.69458145592544,4.33634322098702,7.96035978413402,101,"ENSG00000079974.19"
"16058","ENSG00000150672.19_1711241",1711233,1711241,9,"ENSG00000150672.19",1,1,"MVVVVVVVV",0,8,0.90600414078675,116,122,133,136,181,187,221,224,"ATGATAA","ATGG","CTCAGGA","CTGA",2.44564622375296,11,45,34,99,1.04105325307333,4.3363403528566,7.9603569160036,101,"ENSG00000079974.19"
"19282","ENSG00000162643.13_88636",88628,88636,9,"ENSG00000162643.13",0,NA,"VVVUVVUVV",2,7,0.766873706004141,95,101,107,110,116,122,133,136,"ATGATGA","TTGA","GTGTTAA","ATGA",2.52867650079008,6,6,11,32,2.71359043012036,4.89285844218022,7.96035326619679,101,"ENSG00000079974.19"
"27371","ENSG00000186094.18_1052173",1052165,1052173,9,"ENSG00000186094.18",1,3,"VVMVVVVVV",0,8,0.882815734989648,113,119,133,136,147,153,162,165,"TTTATGT","CTGA","TTGATTC","TTGA",2.23590344884783,14,11,9,43,2.81000361935371,4.42900665291814,7.96026959287674,101,"ENSG00000079974.19"
"4845","ENSG00000102053.13_273111",273103,273111,9,"ENSG00000102053.13",0,NA,"VVVVUVVVV",1,8,0.889855072463768,113,119,133,136,144,150,175,178,"CTGATTT","GTGA","AAGACAA","CTGA",2.30693608653085,14,8,25,56,2.22358893636574,4.40079071164285,7.96021100149792,101,"ENSG00000079974.19"
"18650","ENSG00000158006.14_5566",5558,5566,9,"ENSG00000158006.14",0,NA,"VVVVVVUVV",1,8,0.886128364389234,116,122,133,136,165,171,195,198,"ATAATAT","CTAA","ATGATGA","CTGA",2.44691872882932,11,29,24,73,1.34991364836108,4.41567629347246,7.9601897510294,101,"ENSG00000079974.19"
"33197","ENSG00000228999.4_233728",233720,233728,9,"ENSG00000228999.4",0,NA,"VVVVVVUVV",1,8,0.886128364389234,114,120,133,136,144,150,164,167,"GTGTTGA","CTAA","ATGGATA","ATGA",2.22003885659394,13,8,14,44,2.86230846435328,4.41564187707822,7.96015533463515,101,"ENSG00000079974.19"
"27712","ENSG00000187231.14_123498",123490,123498,9,"ENSG00000187231.14",1,1,"MVVVUVVVV",1,7,0.795859213250517,116,122,133,136,137,143,153,156,"AGGATGA","ATTA","GAGACGA","CTGA",2.47420259457328,11,1,10,31,2.61218004069733,4.77671600112979,7.96015285413186,101,"ENSG00000079974.19"
"47831","ENSG00000289450.2_76307",76299,76307,9,"ENSG00000289450.2",1,8,"VVVVVVVMV",0,8,0.884057971014493,81,87,108,111,114,120,133,136,"AAGATGT","CTGA","ATGTTCA","CCGA",2.34926042838887,21,3,13,46,2.03392248954825,4.42391466970184,7.96014655375982,101,"ENSG00000079974.19"
"47608","ENSG00000288714.1_629180",629172,629180,9,"ENSG00000288714.1",1,2,"UMVVVVVVV",1,7,0.786749482401656,80,86,97,100,112,118,133,136,"ATGTTGT","CTAA","ATAATGA","CTGA",2.50375273291103,11,12,15,47,2.56052258120655,4.81305186682002,7.96004979642664,101,"ENSG00000079974.19"
"39230","ENSG00000253322.1_177220",177212,177220,9,"ENSG00000253322.1",0,NA,"VVVVUVVVV",1,8,0.889855072463768,93,99,133,136,147,153,168,171,"ATGATGT","CTGG","GTGGTCA","ATGA",2.39068628086491,34,11,15,69,1.66431264613273,4.40055529630803,7.9599755861631,101,"ENSG00000079974.19"
"42158","ENSG00000260947.1_1420",1412,1420,9,"ENSG00000260947.1",1,1,"MVVVVUVVV",1,7,0.82815734989648,83,89,133,136,145,151,162,165,"AAGATGA","AGGA","ATGTGGA","CTGA",2.49787150462091,44,9,11,73,1.93668261338955,4.64728982771557,7.95991922730149,101,"ENSG00000079974.19"
"25821","ENSG00000182901.18_444696",444688,444696,9,"ENSG00000182901.18",0,NA,"VVVVUVVVV",1,8,0.889855072463768,79,85,99,102,110,116,133,136,"ATTATGT","GTGA","ATGATTG","CAGA",2.24272333230949,14,8,17,48,2.64998840369942,4.40036932144068,7.95978961129575,101,"ENSG00000079974.19"
"13958","ENSG00000144036.16_8939",8931,8939,9,"ENSG00000144036.16",1,1,"MVVVVVVVV",0,8,0.90600414078675,42,48,61,64,71,77,133,136,"ATGATGA","CTGA","GTTATAT","GTGG",2.30203305984556,13,7,56,85,1.99614556471243,4.33575815758737,7.95977472073437,101,"ENSG00000079974.19"
"18310","ENSG00000157036.13_34368",34360,34368,9,"ENSG00000157036.13",1,7,"VVVVVVMVV",0,8,0.885300207039338,33,39,55,58,96,102,133,136,"TTGATGA","CTGA","TTGAATA","TTGA",2.50770346649074,16,38,31,94,0.956179004968973,4.41855052872681,7.95975135688415,101,"ENSG00000079974.19"
"5347","ENSG00000104361.10_64559",64551,64559,9,"ENSG00000104361.10",1,6,"VVVVVMVVV",0,8,0.902691511387163,103,109,133,136,142,148,204,207,"GTGAGGA","TTTA","GTGCTTA","CTGA",2.42901974123071,24,6,56,95,1.20239413695335,4.34896476962286,7.95973081517151,101,"ENSG00000079974.19"
"42021","ENSG00000260364.1_176691",176683,176691,9,"ENSG00000260364.1",1,6,"VVVVVMVVV",0,8,0.902691511387163,114,120,133,136,149,155,165,168,"GTAATGT","CTTT","AAGCTAA","CTGA",2.20495114171448,13,13,10,45,2.69577346056746,4.34886193466601,7.95962798021466,101,"ENSG00000079974.19"
"1169","ENSG00000048540.16_36695",36687,36695,9,"ENSG00000048540.16",0,NA,"VVVVVVUVV",1,8,0.886128364389234,92,98,106,109,116,122,133,136,"TTGATGT","GTGA","ATCAGGT","CTGC",2.22176886718932,8,7,11,35,2.84853916022757,4.41508290203909,7.95959635959603,101,"ENSG00000079974.19"
"47820","ENSG00000289426.1_18827",18819,18827,9,"ENSG00000289426.1",1,8,"VVVVVVVMV",0,8,0.884057971014493,45,51,63,66,116,122,133,136,"ATAATCA","CTTA","ATCTGGA","CTGA",2.35597030615944,12,50,11,82,1.98677179355651,4.42331012532153,7.9595420093795,101,"ENSG00000079974.19"
"27910","ENSG00000187672.15_315754",315746,315754,9,"ENSG00000187672.15",1,8,"VVVVVVVMV",0,8,0.884057971014493,112,118,133,136,138,144,153,156,"ATTTTGC","CCCA","GTGATGT","CTGA",2.26919955039142,15,2,9,35,2.56498500700451,4.4232455024035,7.95947738646147,101,"ENSG00000079974.19"
"40920","ENSG00000258081.4_629606",629598,629606,9,"ENSG00000258081.4",1,8,"UVVVVVVMV",1,7,0.786749482401656,114,120,133,136,144,150,159,162,"ATGATGC","AAGA","ATTATAC","CTGA",2.43361231754066,13,8,9,39,3.02568388418325,4.81244150028024,7.95943942988687,101,"ENSG00000079974.19"
"27883","ENSG00000187546.14_75953",75945,75953,9,"ENSG00000187546.14",1,8,"VVVVVVVMV",0,8,0.884057971014493,113,119,133,136,163,169,179,182,"ATGCTGC","GTGC","CTGAAGC","CTGA",2.34619253009213,14,27,10,60,2.05144686977321,4.42318260093018,7.95941448498815,101,"ENSG00000079974.19"
"9614","ENSG00000125846.17_5891",5883,5891,9,"ENSG00000125846.17",1,1,"MVVVVVVVV",0,8,0.90600414078675,95,101,133,136,158,164,182,185,"GTGATCA","ATAA","ATGTTGA","CTGA",2.47178069738201,32,22,18,81,0.863031153175695,4.3353922839306,7.9594088470776,101,"ENSG00000079974.19"
"27099","ENSG00000185565.12_257903",257895,257903,9,"ENSG00000185565.12",1,8,"VVVVVVVMV",0,8,0.884057971014493,81,87,97,100,108,114,133,136,"ATCCTGA","TTGA","ATGAAGA","GTGA",2.28110122977731,10,8,19,46,2.48533929826746,4.42317020752905,7.95940209158702,101,"ENSG00000079974.19"
"19780","ENSG00000163683.12_14743",14735,14743,9,"ENSG00000163683.12",0,NA,"UVVVVVVVV",1,8,0.902691511387163,109,115,133,136,149,155,166,169,"GTTTTGA","TTGT","TTGAACA","CTGA",2.25711736460102,18,13,11,51,2.34675564061494,4.34855118448877,7.95931723003743,101,"ENSG00000079974.19"
"23802","ENSG00000174197.19_122610",122602,122610,9,"ENSG00000174197.19",1,2,"VMVVVVVVV",0,8,0.884057971014493,92,98,133,136,156,162,170,173,"CAGATGA","CTAA","TTGCTGG","CTGA",2.46382432973721,35,20,8,72,1.26679910322392,4.42307365870133,7.9593055427593,101,"ENSG00000079974.19"
"25512","ENSG00000182050.14_441668",441660,441668,9,"ENSG00000182050.14",1,6,"UVVVVMVVV",1,7,0.805383022774327,67,73,85,88,115,121,133,136,"ATGATGA","CTGA","ATTAATA","CTAA",2.53574444980695,12,27,12,60,2.04578871345169,4.73768792804117,7.95922001913848,101,"ENSG00000079974.19"
"11132","ENSG00000134020.8_69651",69643,69651,9,"ENSG00000134020.8",1,3,"VVMUVVVVV",1,7,0.763561076604555,111,117,133,136,140,146,154,157,"ATGAAGA","CTAA","TTTATAA","CTGA",2.53276905736887,16,4,8,37,2.73466088871978,4.90494698446139,7.95919129087961,101,"ENSG00000079974.19"
"36715","ENSG00000242759.10_426033",426025,426033,9,"ENSG00000242759.10",1,1,"MVVVVVVVV",0,8,0.90600414078675,114,120,133,136,180,186,200,203,"ATGAGGA","CTGT","TTGCTGT","CTTA",2.32057273160222,13,44,14,80,1.87021376816018,4.33517466137707,7.95919122452407,101,"ENSG00000079974.19"
"29539","ENSG00000198185.12_4592",4584,4592,9,"ENSG00000198185.12",1,2,"VMVVVVUVV",1,7,0.770186335403727,33,39,53,56,71,77,133,136,"GTGATAA","CTGA","GTCATGA","CTGA",2.69931925794884,14,15,56,94,1.51829476425255,4.87843912097788,7.95918446259279,101,"ENSG00000079974.19"
"2680","ENSG00000077264.16_27942",27934,27942,9,"ENSG00000077264.16",1,2,"VMVVVUVVV",1,7,0.806211180124223,114,120,133,136,151,157,165,168,"GTGATGA","GTGC","GCTCTGA","CTGA",2.46024617883614,13,15,8,45,2.53562321786192,4.73431610252572,7.95916082302262,101,"ENSG00000079974.19"
"34578","ENSG00000233452.9_86464",86456,86464,9,"ENSG00000233452.9",1,8,"VVVVVUVMV",1,7,0.806211180124224,79,85,93,96,103,109,133,136,"ATGATGA","ATGA","GTGTTGT","ATGA",2.53357123829981,8,7,24,48,2.04677423483544,4.73431228920854,7.95915700970543,101,"ENSG00000079974.19"
"24993","ENSG00000179083.7_38066",38058,38066,9,"ENSG00000179083.7",0,NA,"UVVVVVVVV",1,8,0.902691511387163,113,119,133,136,137,143,173,176,"ATGTTGG","CTGC","ATGACCC","CTGA",2.39656913071915,14,1,30,54,1.41628248301999,4.34835250528692,7.95911855083557,101,"ENSG00000079974.19"
"6215","ENSG00000108684.15_325139",325131,325139,9,"ENSG00000108684.15",1,8,"VVVVVVVMV",0,8,0.884057971014493,104,110,133,136,145,151,200,203,"CTGATCA","CTTA","CTGTTGC","CTGA",2.46970417720409,23,9,49,90,1.22669745329002,4.42284799199599,7.95907987605396,101,"ENSG00000079974.19"
"44213","ENSG00000279668.4_229275",229267,229275,9,"ENSG00000279668.4",1,8,"VVVVVVVMV",0,8,0.884057971014493,104,110,133,136,145,151,200,203,"CTGATCA","CTTA","CTGTTGC","CTGA",2.46970417720409,23,9,49,90,1.22669745329002,4.42284799199599,7.95907987605396,101,"ENSG00000079974.19"
"4641","ENSG00000101452.15_28025",28017,28025,9,"ENSG00000101452.15",1,2,"VMVVVVVVV",0,8,0.884057971014493,87,93,133,136,151,157,167,170,"ATGATGG","CCTA","AGGGAGA","CTGA",2.42040371568358,40,15,10,74,1.55524234869535,4.4228167799798,7.95904866403778,101,"ENSG00000079974.19"
"34851","ENSG00000234273.1_58255",58247,58255,9,"ENSG00000234273.1",1,2,"UMVVVVVVV",1,7,0.786749482401656,113,119,133,136,151,157,176,179,"ATAATAA","CTGA","TGGATGA","CTGA",2.57323684172881,14,15,19,57,2.09299317110656,4.81197636232466,7.95897429193129,101,"ENSG00000079974.19"
"42704","ENSG00000265944.1_72293",72285,72293,9,"ENSG00000265944.1",1,1,"MVVVVVVVV",0,8,0.90600414078675,88,94,133,136,140,146,157,160,"AAAATGA","CAAA","ATGATTC","CTGA",2.32711885990353,39,4,11,63,1.82557376187791,4.33492487364203,7.95894143678903,101,"ENSG00000079974.19"
"10033","ENSG00000128881.18_35472",35464,35472,9,"ENSG00000128881.18",1,1,"MVVVVVVVV",0,8,0.90600414078675,116,122,133,136,157,163,181,184,"TTGGAGA","CTGC","GAGATGT","CTGA",2.32357160072621,11,21,18,59,1.84921573136412,4.33492326738471,7.95893983053171,101,"ENSG00000079974.19"
"47557","ENSG00000288692.1_45779",45771,45779,9,"ENSG00000288692.1",0,NA,"VVVVUVVVV",1,8,0.889855072463768,94,100,133,136,144,150,166,169,"TTGGTGA","TTGC","ATGATTT","CTGA",2.3753756372585,33,8,16,66,1.76206138453001,4.39947474156334,7.95889503141841,101,"ENSG00000079974.19"
"17257","ENSG00000153707.19_750502",750494,750502,9,"ENSG00000153707.19",1,8,"VVVVVVVMV",0,8,0.884057971014493,107,113,133,136,157,163,210,213,"GGGATGA","TTGA","AGGAAGA","CTGA",2.5435404801036,20,21,47,97,0.733596040847677,4.42263314371792,7.95886502777589,101,"ENSG00000079974.19"
"38049","ENSG00000249417.1_34194",34186,34194,9,"ENSG00000249417.1",1,3,"VVMVVVVVV",0,8,0.882815734989648,113,119,133,136,159,165,179,182,"CTGGTGC","CACA","CTGATGA","CTGA",2.35528720596656,14,23,14,60,2.00832594184434,4.42756016207202,7.95882310203061,101,"ENSG00000079974.19"
"37879","ENSG00000249022.2_10376",10368,10376,9,"ENSG00000249022.2",0,NA,"UVVVVVVVV",1,8,0.902691511387163,114,120,133,136,170,176,185,188,"ATGGAGA","CAGC","GAGATTA","CTGA",2.30607824394065,13,34,9,65,2.0183244718393,4.34804485786091,7.95881090340957,101,"ENSG00000079974.19"
"33043","ENSG00000228566.2_47240",47232,47240,9,"ENSG00000228566.2",1,1,"MVVVVVVVV",0,8,0.90600414078675,108,114,133,136,149,155,210,213,"AAGATGA","CAGC","ATAAAGG","CTGA",2.41011030396468,19,13,55,96,1.27174402379861,4.33478651255746,7.95880307570446,101,"ENSG00000079974.19"
"48352","ENSG00000291025.1_22016",22008,22016,9,"ENSG00000291025.1",1,1,"MVVVVVVVV",0,8,0.90600414078675,61,67,82,85,96,102,133,136,"ATGGTGC","CTGA","GAGATTA","ATGA",2.32308859702782,15,11,31,66,1.85173090648945,4.33474705500206,7.95876361814906,101,"ENSG00000079974.19"
"27963","ENSG00000187720.15_426151",426143,426151,9,"ENSG00000187720.15",1,1,"MVVVVVVVV",0,8,0.90600414078675,116,122,133,136,171,177,231,234,"GAGATGA","GTGA","ATTACTA","CTGA",2.45148037499716,11,35,54,109,0.995694924539675,4.33472435613018,7.95874091927718,101,"ENSG00000079974.19"
"12419","ENSG00000138138.14_45422",45414,45422,9,"ENSG00000138138.14",1,1,"MVVVVVVVV",0,8,0.90600414078675,111,117,133,136,158,164,177,180,"GCTATGA","CAGA","AAGTTTA","CTGA",2.30673589849301,16,22,13,60,1.96052011857995,4.33468986046667,7.95870642361367,101,"ENSG00000079974.19"
"25238","ENSG00000180182.11_45547",45539,45547,9,"ENSG00000180182.11",0,NA,"VVVUVVVVV",1,8,0.880745341614907,105,111,133,136,185,191,214,217,"AGGATAA","CAGA","TTGATGA","CTGA",2.55688878382365,22,49,23,103,0.696875964890762,4.43570029759544,7.95868166405507,101,"ENSG00000079974.19"
"31376","ENSG00000223642.7_3618",3610,3618,9,"ENSG00000223642.7",1,7,"VVVVVVMVV",0,8,0.885300207039338,112,118,133,136,147,153,171,174,"GTGAAGG","TTAA","GTAATGG","CTGA",2.29329941902657,15,11,18,53,2.38079644647152,4.41736480999549,7.95856563815284,101,"ENSG00000079974.19"
"3198","ENSG00000082175.16_93427",93419,93427,9,"ENSG00000082175.16",1,1,"MVVVVVVVV",0,8,0.90600414078675,65,71,87,90,108,114,133,136,"ATCAGGA","CTGA","ATGAAAA","TTGA",2.33276241525955,16,18,19,62,1.78591922410816,4.33441716479295,7.95843372793995,101,"ENSG00000079974.19"
"46838","ENSG00000287277.1_158558",158550,158558,9,"ENSG00000287277.1",0,NA,"UVVVVVVVV",1,8,0.902691511387163,115,121,133,136,144,150,164,167,"TCAATGA","CTCT","CTCATGT","CTGA",2.17794708514078,12,8,14,43,2.87053339400649,4.34754515706959,7.95831120261824,101,"ENSG00000079974.19"
"31122","ENSG00000215864.6_9306",9298,9306,9,"ENSG00000215864.6",0,NA,"VVVVVVUVV",1,8,0.886128364389234,96,102,133,136,154,160,173,176,"ATGCTGA","ATCA","GGGATCA","CTGA",2.44964142504682,31,18,13,71,1.32397377053412,4.4137291510449,7.95824260860183,101,"ENSG00000079974.19"
"37685","ENSG00000248673.2_106168",106160,106168,9,"ENSG00000248673.2",1,7,"VVVVVVMVV",0,8,0.885300207039338,80,86,102,105,116,122,133,136,"TTGAGGA","CAGA","GTCATGT","CTGG",2.25099235722768,16,11,11,47,2.66153838573431,4.41703852514638,7.95823935330373,101,"ENSG00000079974.19"
"44002","ENSG00000276644.5_130886",130878,130886,9,"ENSG00000276644.5",0,NA,"UVVVVVVVV",1,8,0.902691511387163,82,88,101,104,109,115,133,136,"ATTATGC","GTGA","ATGCTGC","CTTA",2.22310153681327,13,5,18,45,2.56916671540426,4.34746090687319,7.95822695242184,101,"ENSG00000079974.19"
"27597","ENSG00000186635.15_98727",98719,98727,9,"ENSG00000186635.15",1,1,"MVVVVVUVV",1,7,0.792132505175983,110,116,133,136,143,149,157,160,"ATGAGGA","CTTT","ATGTTGC","CTGA",2.45988787758585,17,7,8,41,2.75930899248065,4.78964037742992,7.95817039813385,101,"ENSG00000079974.19"
"35864","ENSG00000237356.7_619205",619197,619205,9,"ENSG00000237356.7",1,8,"VVVVVVVMV",0,8,0.884057971014493,90,96,108,111,116,122,133,136,"GTGATGA","TTGA","GAGAAGA","CTCT",2.20370472348172,12,5,11,37,2.99624312688554,4.42190198752425,7.95813387158222,101,"ENSG00000079974.19"
"47405","ENSG00000288088.1_200041",200033,200041,9,"ENSG00000288088.1",1,8,"UVVVVVVMV",1,7,0.786749482401656,108,114,133,136,140,146,157,160,"ATGATGA","CAGA","ATGAGGT","CTGG",2.52474799580557,19,4,11,43,2.41276054848068,4.81110346346278,7.95810139306941,101,"ENSG00000079974.19"
"1194","ENSG00000049192.15_204710",204702,204710,9,"ENSG00000049192.15",1,8,"VVVVVVVMV",0,8,0.884057971014493,112,118,133,136,142,148,165,168,"AGAATGA","ATTA","GTATTGC","CTGA",2.26406900915299,15,6,17,47,2.59367527348776,4.42186716696026,7.95809905101823,101,"ENSG00000079974.19"
"38090","ENSG00000249491.1_1740",1732,1740,9,"ENSG00000249491.1",0,NA,"UVVVUVVVV",2,7,0.792546583850932,84,90,100,103,110,116,133,136,"ATGAACA","CTGA","GAGGTGC","CTGA",2.47834750329016,10,7,17,43,2.62930063847044,4.78790433176788,7.95809066717161,101,"ENSG00000079974.19"
"25193","ENSG00000179915.25_432625",432617,432625,9,"ENSG00000179915.25",1,1,"MVVVVVVVV",0,8,0.90600414078675,66,72,82,85,109,115,133,136,"GTGCTCA","CTGG","GTGAAAT","CTGA",2.34513641478752,10,24,18,61,1.70203355833127,4.33406908089535,7.95808564404235,101,"ENSG00000079974.19"
"28450","ENSG00000189157.14_64102",64094,64102,9,"ENSG00000189157.14",1,8,"VVVVVVVMV",0,8,0.884057971014493,83,89,133,136,138,144,159,162,"AAGATGA","AAGA","TAGACGA","CTGA",2.4517031522886,44,2,15,70,1.34264237263637,4.4218325136401,7.95806439769807,101,"ENSG00000079974.19"
"43571","ENSG00000272414.6_26421",26413,26421,9,"ENSG00000272414.6",1,8,"VVVVVVVMV",0,8,0.884057971014493,83,89,133,136,138,144,159,162,"AAGATGA","AAGA","TAGACGA","CTGA",2.4517031522886,44,2,15,70,1.34264237263637,4.4218325136401,7.95806439769807,101,"ENSG00000079974.19"
"12821","ENSG00000139173.10_176947",176939,176947,9,"ENSG00000139173.10",1,1,"MVVVVUVVV",1,7,0.82815734989648,111,117,133,136,153,159,201,204,"ATGATGT","GTGC","GTGATGC","CTGA",2.59525107831926,16,17,42,84,1.27976364536611,4.64535937520695,7.95798877479288,101,"ENSG00000079974.19"
"8407","ENSG00000118689.15_88480",88472,88480,9,"ENSG00000118689.15",1,1,"MVVVVVVVV",0,8,0.90600414078675,114,120,133,136,145,151,199,202,"AAGAGGA","ATAA","CTGCTGC","CTGA",2.30784172753707,13,9,48,79,1.95003565591614,4.33391179320749,7.95792835635449,101,"ENSG00000079974.19"
"41827","ENSG00000259786.7_77888",77880,77888,9,"ENSG00000259786.7",1,1,"MVVVVVVVV",0,8,0.90600414078675,108,114,133,136,144,150,169,172,"GATATGA","ATTA","GTGGTAA","CTGA",2.27951847414374,19,8,19,55,2.13878600102379,4.33389395716219,7.95791052030919,101,"ENSG00000079974.19"
"43054","ENSG00000267761.3_32041",32033,32041,9,"ENSG00000267761.3",1,8,"VVVVVUVMV",1,7,0.806211180124224,115,121,133,136,139,145,154,157,"ATGAATA","CTCA","CTGCTTA","CTGA",2.40365028656909,12,3,9,33,2.90790712619639,4.73306059249757,7.95790531299447,101,"ENSG00000079974.19"
"29666","ENSG00000198589.15_181895",181887,181895,9,"ENSG00000198589.15",1,3,"VVMVVVVVV",0,8,0.882815734989648,9,15,23,26,75,81,133,136,"ATGATGA","GTGA","TTGATAA","ATGA",2.54586384223039,8,49,52,118,0.73380460969303,4.42655755614058,7.95782049609917,101,"ENSG00000079974.19"
"19330","ENSG00000162761.14_53710",53702,53710,9,"ENSG00000162761.14",1,1,"MVVVVVVVV",0,8,0.90600414078675,114,120,133,136,180,186,238,241,"AAGATGA","TAGA","GTGTTCC","CTGA",2.45018679315726,13,44,52,118,1.00047625551767,4.33376371914151,7.95778028228851,101,"ENSG00000079974.19"
"15091","ENSG00000147044.23_244104",244096,244104,9,"ENSG00000147044.23",1,1,"MVVVVVVVV",0,8,0.90600414078675,87,93,133,136,141,147,176,179,"CTGATAT","ATGA","CTGATCA","CTGA",2.43794114467659,40,5,29,83,1.08189160137208,4.33370814147067,7.95772470461767,101,"ENSG00000079974.19"
"31313","ENSG00000222042.2_90022",90014,90022,9,"ENSG00000222042.2",1,8,"VVVVVVVMV",0,8,0.884057971014493,114,120,133,136,138,144,152,155,"AAGTAGA","ATGC","ATGATGT","CTGA",2.23925764803302,13,2,8,32,2.75757226228217,4.42148914562558,7.95772102968355,101,"ENSG00000079974.19"
"8689","ENSG00000120254.16_30809",30801,30809,9,"ENSG00000120254.16",1,8,"VVVVVVVMV",0,8,0.884057971014493,115,121,133,136,160,166,175,178,"GAGATGG","CTGG","GTACTTA","CTGA",2.33104175820433,12,24,9,54,2.1455524974828,4.42145772137792,7.95768960543589,101,"ENSG00000079974.19"
"6456","ENSG00000109929.10_7425",7417,7425,9,"ENSG00000109929.10",1,2,"VMVVUVVVV",1,7,0.773913043478261,100,106,133,136,147,153,168,171,"ATGGTGA","CTGA","TTTATAA","CTGA",2.65399725104427,27,11,15,62,1.75482329280454,4.86203457494158,7.95768674885463,101,"ENSG00000079974.19"
"45091","ENSG00000284999.1_47184",47176,47184,9,"ENSG00000284999.1",1,3,"UVMVVVVVV",1,7,0.785507246376811,68,74,101,104,114,120,133,136,"ATGATAA","TTGA","ATGTTGC","CTGA",2.60138090477315,27,10,13,59,1.91996613939546,4.81562637613746,7.9576553616447,101,"ENSG00000079974.19"
"3135","ENSG00000081479.15_49634",49626,49634,9,"ENSG00000081479.15",1,1,"MVVVVVVVV",0,8,0.90600414078675,90,96,133,136,165,171,186,189,"ATGAAGT","ATGA","GTGAAAC","CTGA",2.46776808921111,37,29,15,90,0.88271924969423,4.3336266277754,7.9576431909224,101,"ENSG00000079974.19"
"2012","ENSG00000069020.19_254276",254268,254276,9,"ENSG00000069020.19",0,NA,"VVVVUVVVV",1,8,0.889855072463768,114,120,133,136,145,151,206,209,"ATAAGGT","CAGA","ATGTTTA","CTGA",2.34686844679643,13,9,55,86,1.94691399125507,4.39817590914115,7.95759619899623,101,"ENSG00000079974.19"
"17940","ENSG00000155875.15_98039",98031,98039,9,"ENSG00000155875.15",1,5,"VVVVMUVVV",1,7,0.808695652173913,31,37,47,50,92,98,133,136,"GTGATGA","TTGA","TTGGAGA","CTGA",2.68708430842381,10,42,35,96,0.977321766612721,4.72280428902619,7.95758689772184,101,"ENSG00000079974.19"
"43428","ENSG00000271860.9_83110",83102,83110,9,"ENSG00000271860.9",1,8,"VVVVVVVMV",0,8,0.884057971014493,32,38,55,58,107,113,133,136,"ATGATTG","CTTA","CTGAGAA","CTGA",2.46190732336366,17,49,20,95,1.27252404451358,4.42130988340116,7.95754176745913,101,"ENSG00000079974.19"
"27998","ENSG00000187871.2_14521",14513,14521,9,"ENSG00000187871.2",1,1,"MVVVVVVVV",0,8,0.90600414078675,116,122,133,136,165,171,186,189,"AAAAAGA","ATGA","ATGAAAA","CTGA",2.32213274188424,11,29,15,64,1.85315334787354,4.33350957344213,7.95752613658913,101,"ENSG00000079974.19"
"19635","ENSG00000163536.13_31324",31316,31324,9,"ENSG00000163536.13",1,7,"VVVVVVMVV",0,8,0.885300207039338,110,116,133,136,181,187,201,204,"GTGAGGA","GAGA","GTGAATG","CTGA",2.40542130314933,17,45,14,85,1.62898575538561,4.41628194409528,7.95748277225263,101,"ENSG00000079974.19"
"10879","ENSG00000133027.18_32633",32625,32633,9,"ENSG00000133027.18",0,NA,"VVVVUVVVV",1,8,0.889855072463768,111,117,133,136,146,152,163,166,"ATGGGGG","GCGA","GTGAGCA","CTGA",2.22992612740405,16,10,11,46,2.72599856804707,4.39804318768519,7.95746347754026,101,"ENSG00000079974.19"
"24509","ENSG00000176658.17_71308",71300,71308,9,"ENSG00000176658.17",0,NA,"VVVVVVUVV",1,8,0.886128364389234,91,97,108,111,114,120,133,136,"TTGAAGT","CTGA","ATAAAGA","CTAA",2.24311894674567,11,3,13,36,2.69737098893804,4.41287432514395,7.95738778270089,101,"ENSG00000079974.19"
"40534","ENSG00000256916.1_9769",9761,9769,9,"ENSG00000256916.1",0,NA,"UVVVVVVVV",1,8,0.902691511387163,61,67,110,113,114,120,133,136,"ATGATAA","CTGA","CGGATGG","CTTA",2.42116000243867,43,1,13,66,1.24527203902201,4.34658468048662,7.95735072603527,101,"ENSG00000079974.19"
"423","ENSG00000011201.12_8134",8126,8134,9,"ENSG00000011201.12",1,1,"MVVVVVVVV",0,8,0.90600414078675,111,117,133,136,176,182,190,193,"CTGATGA","TTCA","TTGTTGA","ATGA",2.32618502898117,16,40,8,73,1.825423539709,4.3333309332292,7.9573474963762,101,"ENSG00000079974.19"
"5030","ENSG00000102780.17_158263",158255,158263,9,"ENSG00000102780.17",1,7,"VVVVVVMVV",0,8,0.885300207039338,97,103,133,136,170,176,186,189,"ATGATAA","TTGT","ATGAGAA","CTGA",2.48951916036291,30,34,10,83,1.06768875737554,4.41612078994874,7.95732161810609,101,"ENSG00000079974.19"
"37521","ENSG00000248363.5_14969",14961,14969,9,"ENSG00000248363.5",1,1,"MVVVVVVVV",0,8,0.90600414078675,116,122,133,136,181,187,200,203,"CAGATCA","ATGA","ATGAAAT","CTGA",2.31550055835986,11,45,13,78,1.89653238467417,4.33330069343497,7.95731725658197,101,"ENSG00000079974.19"
"1855","ENSG00000066651.20_196854",196846,196854,9,"ENSG00000066651.20",1,7,"UVVVVVMVV",1,7,0.787991718426501,57,63,78,81,89,95,133,136,"ATGATAA","CTGT","TTTATGA","CTGA",2.59422827733345,15,8,38,70,1.92633590247614,4.80529777117478,7.95726464488079,101,"ENSG00000079974.19"
"45573","ENSG00000285713.1_469123",469115,469123,9,"ENSG00000285713.1",1,5,"VVVVMVUVV",1,7,0.772670807453416,70,76,88,91,115,121,133,136,"ATGATGA","CTGA","TTGAAAA","CTGT",2.60418677606178,12,24,12,57,2.10489271676695,4.86653447262803,7.95721770244169,101,"ENSG00000079974.19"
"45659","ENSG00000285783.1_241902",241894,241902,9,"ENSG00000285783.1",1,5,"VVVVMVUVV",1,7,0.772670807453416,70,76,88,91,115,121,133,136,"ATGATGA","CTGA","TTGAAAA","CTGT",2.60418677606178,12,24,12,57,2.10489271676695,4.86653447262803,7.95721770244169,101,"ENSG00000079974.19"
"32503","ENSG00000227088.2_9697",9689,9697,9,"ENSG00000227088.2",1,1,"MVVVVVVVV",0,8,0.90600414078675,116,122,133,136,172,178,189,192,"TTATTGA","GTTA","GTGATGT","CTGA",2.30336628845408,11,36,11,67,1.97692522905417,4.33317512135368,7.95719168450068,101,"ENSG00000079974.19"
"15673","ENSG00000149177.15_87392",87384,87392,9,"ENSG00000149177.15",1,8,"VVVVVVVMV",0,8,0.884057971014493,114,120,133,136,141,147,162,165,"GAGAGGC","ATGA","GTGGAAA","CTGA",2.23828840001238,13,5,15,42,2.7615897979202,4.42087811616735,7.95711000022532,101,"ENSG00000079974.19"
"45027","ENSG00000284770.2_83703",83695,83703,9,"ENSG00000284770.2",1,8,"VVVVVUVMV",1,7,0.806211180124224,100,106,133,136,147,153,163,166,"GTGATCA","CTGA","GCCTTGA","CTGA",2.54869800110626,27,11,10,57,1.93771279365636,4.73225820025785,7.95710292075475,101,"ENSG00000079974.19"
"32457","ENSG00000227033.1_16777",16769,16777,9,"ENSG00000227033.1",1,7,"UVVVVVMVV",1,7,0.787991718426501,110,116,133,136,145,151,201,204,"ATGATGA","CACA","CTGAAAA","CTGA",2.62684880593986,17,9,50,85,1.70803322391847,4.80508964921271,7.95705652291872,101,"ENSG00000079974.19"
"17447","ENSG00000154162.15_876664",876656,876664,9,"ENSG00000154162.15",1,8,"VVVVVVVMV",0,8,0.884057971014493,114,120,133,136,140,146,155,158,"CTGTTGT","GTTA","GTAAAAA","CTGA",2.20790713178507,13,4,9,35,2.9636559347714,4.42075920333462,7.95699108739259,101,"ENSG00000079974.19"
"23742","ENSG00000173821.20_102058",102050,102058,9,"ENSG00000173821.20",1,8,"VVVVVVVMV",0,8,0.884057971014493,105,111,133,136,144,150,168,171,"ATGATGT","CAGA","GTGACCT","CAGA",2.3584900948143,22,8,18,57,1.95971072476118,4.42074450588079,7.95697638993876,101,"ENSG00000079974.19"
"1773","ENSG00000066032.19_1179027",1179019,1179027,9,"ENSG00000066032.19",1,8,"VVVVVVVMV",0,8,0.884057971014493,109,115,133,136,148,154,173,176,"ATGATTC","TTGG","TTGAAGG","CTGA",2.35131833617362,18,12,19,58,2.00746311715129,4.42072967291052,7.95696155696849,101,"ENSG00000079974.19"
"25925","ENSG00000183098.11_645439",645431,645439,9,"ENSG00000183098.11",1,2,"VMVVVVVVV",0,8,0.884057971014493,55,61,76,79,85,91,133,136,"CTGATGC","TTGA","GTGATAA","CTTA",2.36638985054471,15,6,42,72,1.90698096385415,4.42072832520473,7.9569602092627,101,"ENSG00000079974.19"
"16231","ENSG00000151164.19_9403",9395,9403,9,"ENSG00000151164.19",1,7,"UVVVVVMVV",1,7,0.787991718426501,111,117,133,136,149,155,166,169,"ATGTTGA","CTGT","GTCCTGG","CTGA",2.50511788518407,16,13,11,49,2.51902144510395,4.80495183658276,7.95691871028877,101,"ENSG00000079974.19"
"33549","ENSG00000230262.8_51993",51985,51993,9,"ENSG00000230262.8",1,1,"MVVVVVVVV",0,8,0.90600414078675,103,109,133,136,142,148,164,167,"ACGATGT","TGGA","AGGCAGA","CTGA",2.30561594342582,24,6,16,55,1.96038095476352,4.33278847773391,7.95680504088091,101,"ENSG00000079974.19"
"26788","ENSG00000185019.17_19775",19767,19775,9,"ENSG00000185019.17",1,2,"VMVVVVVVV",0,8,0.884057971014493,106,112,133,136,139,145,153,156,"GTGCTGA","TTGT","ATCTTGT","CTGA",2.33507755838691,21,3,8,41,2.11500193526329,4.42054641446066,7.95677829851864,101,"ENSG00000079974.19"
"34773","ENSG00000234127.9_23857",23849,23857,9,"ENSG00000234127.9",1,1,"MVVVUVVVV",1,7,0.795859213250517,93,99,107,110,113,119,133,136,"ATGAGGA","ATAA","ATGAAGG","CTGA",2.49348773213377,8,3,14,34,2.47006763566635,4.7733297958062,7.95676664880827,101,"ENSG00000079974.19"
"33998","ENSG00000231689.3_64512",64504,64512,9,"ENSG00000231689.3",1,1,"MVVVVVVVV",0,8,0.90600414078675,110,116,133,136,146,152,177,180,"ATGATAG","CAAA","ATGAAAG","CTGA",2.31071155192512,17,10,25,61,1.92623253858795,4.33274405452219,7.95676061766919,101,"ENSG00000079974.19"
"6352","ENSG00000109458.9_79149",79141,79149,9,"ENSG00000109458.9",1,8,"VVVVVVVMV",0,8,0.884057971014493,87,93,103,106,111,117,133,136,"ATAATGT","ATAA","AACTTGA","CTGA",2.25587919248968,10,5,16,40,2.6424134007867,4.42040200434614,7.95663388840411,101,"ENSG00000079974.19"
"34157","ENSG00000232006.9_135801",135793,135801,9,"ENSG00000232006.9",1,8,"VVVVVVVMV",0,8,0.884057971014493,114,120,133,136,177,183,192,195,"TTGCTGA","TAGA","GCTATGA","CTGA",2.35220279336706,13,41,9,72,2.00025517169908,4.42040178186988,7.95663366592785,101,"ENSG00000079974.19"
"13478","ENSG00000141564.16_11643",11635,11643,9,"ENSG00000141564.16",1,5,"VVVVMUVVV",1,7,0.808695652173913,109,115,133,136,142,148,157,160,"AGGTTGA","ATGA","CTGGTGC","CTGA",2.43316534073221,18,6,9,42,2.66619820572753,4.7218251193189,7.95660772801455,101,"ENSG00000079974.19"
"35970","ENSG00000237515.9_287943",287935,287943,9,"ENSG00000237515.9",0,NA,"UVVVVVVVV",1,8,0.902691511387163,114,120,133,136,142,148,168,171,"GATATGA","TTTA","TTAATGT","CTGA",2.23281630420159,13,6,20,48,2.49767175407711,4.34577844552192,7.95654449107058,101,"ENSG00000079974.19"
"7020","ENSG00000112530.12_568528",568520,568528,9,"ENSG00000112530.12",0,NA,"VVVVUVVVV",1,8,0.889855072463768,80,86,98,101,109,115,133,136,"GTGCTGT","TTCA","GTTAGAA","CTGA",2.24441951888997,12,8,18,47,2.62562570194296,4.39710562363569,7.95652591349076,101,"ENSG00000079974.19"
"42426","ENSG00000262801.6_293477",293469,293477,9,"ENSG00000262801.6",1,5,"VVVVMVVVV",0,8,0.886542443064182,95,101,133,136,143,149,196,199,"TTGATGA","TGGA","TAGATGG","CTGA",2.49197898916387,32,7,47,95,1.02823045154794,4.4103559281601,7.95652570041682,101,"ENSG00000079974.19"
"29498","ENSG00000198104.4_7518",7510,7518,9,"ENSG00000198104.4",1,8,"VVVVVUVMV",1,7,0.806211180124224,115,121,133,136,149,155,163,166,"ATCATCA","CTGC","GTGCTCA","CTGA",2.43519666748316,12,13,8,42,2.69187352034321,4.73162949255773,7.95647421305462,101,"ENSG00000079974.19"
"29500","ENSG00000198104.4_7722",7714,7722,9,"ENSG00000198104.4",1,8,"VVVVVUVMV",1,7,0.806211180124224,115,121,133,136,149,155,163,166,"ATCATCA","CTGC","GTGCTCA","CTGA",2.43519666748316,12,13,8,42,2.69187352034321,4.73162949255773,7.95647421305462,101,"ENSG00000079974.19"
"29501","ENSG00000198104.4_7790",7782,7790,9,"ENSG00000198104.4",1,8,"VVVVVUVMV",1,7,0.806211180124224,115,121,133,136,149,155,163,166,"ATCATCA","CTGC","GTGCTCA","CTGA",2.43519666748316,12,13,8,42,2.69187352034321,4.73162949255773,7.95647421305462,101,"ENSG00000079974.19"
"29503","ENSG00000198104.4_8062",8054,8062,9,"ENSG00000198104.4",1,8,"VVVVVUVMV",1,7,0.806211180124224,115,121,133,136,149,155,163,166,"ATCATCA","CTGC","GTGCTCA","CTGA",2.43519666748316,12,13,8,42,2.69187352034321,4.73162949255773,7.95647421305462,101,"ENSG00000079974.19"
"29504","ENSG00000198104.4_8130",8122,8130,9,"ENSG00000198104.4",1,8,"VVVVVUVMV",1,7,0.806211180124224,115,121,133,136,149,155,163,166,"ATCATCA","CTGC","GTGCTCA","CTGA",2.43519666748316,12,13,8,42,2.69187352034321,4.73162949255773,7.95647421305462,101,"ENSG00000079974.19"
"29506","ENSG00000198104.4_8470",8462,8470,9,"ENSG00000198104.4",1,8,"VVVVVUVMV",1,7,0.806211180124224,115,121,133,136,149,155,163,166,"ATCATCA","CTGC","GTGCTCA","CTGA",2.43519666748316,12,13,8,42,2.69187352034321,4.73162949255773,7.95647421305462,101,"ENSG00000079974.19"
"29508","ENSG00000198104.4_8674",8666,8674,9,"ENSG00000198104.4",1,8,"VVVVVUVMV",1,7,0.806211180124224,115,121,133,136,149,155,163,166,"ATCATCA","CTGC","GTGCTCA","CTGA",2.43519666748316,12,13,8,42,2.69187352034321,4.73162949255773,7.95647421305462,101,"ENSG00000079974.19"
"29509","ENSG00000198104.4_8810",8802,8810,9,"ENSG00000198104.4",1,8,"VVVVVUVMV",1,7,0.806211180124224,115,121,133,136,149,155,163,166,"ATCATCA","CTGC","GTGCTCA","CTGA",2.43519666748316,12,13,8,42,2.69187352034321,4.73162949255773,7.95647421305462,101,"ENSG00000079974.19"
"27887","ENSG00000187555.17_58043",58035,58043,9,"ENSG00000187555.17",1,7,"VVVVVVMVV",0,8,0.885300207039338,85,91,105,108,114,120,133,136,"TTCATGA","CTCA","TTGGGGA","CTAA",2.21642444560185,14,6,13,42,2.88424365300399,4.41510165592074,7.95630248407809,101,"ENSG00000079974.19"
"17586","ENSG00000154511.12_93070",93062,93070,9,"ENSG00000154511.12",1,8,"VVVVVVVMV",0,8,0.884057971014493,90,96,133,136,150,156,187,190,"GTGATGA","TTTA","GTGAATG","CTGA",2.54189173239972,37,14,31,91,0.734320404820365,4.42006632187129,7.95629820592926,101,"ENSG00000079974.19"
"1712","ENSG00000065534.20_22157",22149,22157,9,"ENSG00000065534.20",0,NA,"VVVVUVVVV",1,8,0.889855072463768,112,118,133,136,141,147,200,203,"ATGAAGT","AGGA","GAGCTGA","CTGA",2.36174186978141,15,5,53,82,1.84212534870238,4.39676778681128,7.95618807666635,101,"ENSG00000079974.19"
"28338","ENSG00000188730.5_38364",38356,38364,9,"ENSG00000188730.5",1,1,"MVVVVVVVV",0,8,0.90600414078675,88,94,106,109,113,119,133,136,"ATGTAGT","CTGA","CTGTTTA","ATGA",2.18619095927009,12,4,14,39,2.75407800779817,4.33217110073302,7.95618766388002,101,"ENSG00000079974.19"
"1375","ENSG00000054611.14_154942",154934,154942,9,"ENSG00000054611.14",1,1,"MVVVVUVVV",1,7,0.82815734989648,108,114,133,136,137,143,158,161,"AGGATGA","CGGG","TTGAGGA","CTGA",2.52687823642289,19,1,15,44,1.72833180380125,4.64354667832179,7.95617607790771,101,"ENSG00000079974.19"
"39709","ENSG00000254101.8_491766",491758,491766,9,"ENSG00000254101.8",0,NA,"UVVVVVVVV",1,8,0.902691511387163,54,60,74,77,91,97,133,136,"GAAATGA","CGGA","AAGATAA","CTGA",2.36262275108281,14,14,36,73,1.63081858573364,4.34540923157143,7.95617527712008,101,"ENSG00000079974.19"
"33810","ENSG00000231204.7_88848",88840,88848,9,"ENSG00000231204.7",1,8,"VVVVVVVMV",0,8,0.884057971014493,104,110,133,136,137,143,156,159,"GTCATGA","CAGG","CTGAAAA","CTGA",2.42366875465839,23,1,13,46,1.52195597264523,4.41993691759196,7.95616880164994,101,"ENSG00000079974.19"
"34412","ENSG00000233005.2_185339",185331,185339,9,"ENSG00000233005.2",1,8,"VVVVVVVMV",0,8,0.884057971014493,104,110,133,136,137,143,156,159,"GTCATGA","CAGG","CTGAAAA","CTGA",2.42366875465839,23,1,13,46,1.52195597264523,4.41993691759196,7.95616880164994,101,"ENSG00000079974.19"
"39043","ENSG00000251557.4_91144",91136,91144,9,"ENSG00000251557.4",1,6,"VVVVVMVVV",0,8,0.902691511387163,104,110,133,136,140,146,154,157,"GTGAAAA","CTCA","AAGTGGA","CTGA",2.29228867133706,23,4,8,44,2.09961898987853,4.34538586636473,7.95615191191338,101,"ENSG00000079974.19"
"7331","ENSG00000113580.15_1336",1328,1336,9,"ENSG00000113580.15",0,NA,"UVVVVVVVV",1,8,0.902691511387163,111,117,133,136,171,177,194,197,"ATAATGT","CTAT","GTGATAG","CTGA",2.37389939510782,16,35,17,77,1.55541428829276,4.34535256391955,7.9561186094682,101,"ENSG00000079974.19"
"45495","ENSG00000285639.1_9351",9343,9351,9,"ENSG00000285639.1",1,8,"VVVVVVVMV",0,8,0.884057971014493,114,120,133,136,153,159,173,176,"ATGAACA","CAGT","GGGATCA","CTGA",2.30761888982062,13,17,14,53,2.29526258567457,4.41984712945302,7.95607901351099,101,"ENSG00000079974.19"
"13985","ENSG00000144218.21_406919",406911,406919,9,"ENSG00000144218.21",1,1,"MVVVVVVVV",0,8,0.90600414078675,107,113,133,136,147,153,168,171,"GTGATGA","AAGA","GAGAGTA","CTAA",2.27780932938389,20,11,15,55,2.14258642665929,4.3319954889713,7.95601205211829,101,"ENSG00000079974.19"
"18518","ENSG00000157554.20_125826",125818,125826,9,"ENSG00000157554.20",1,8,"VVVVVVVMV",0,8,0.884057971014493,111,117,133,136,144,150,170,173,"AGGATGA","CCAA","GTGTTGA","CTTA",2.30067819631484,16,8,20,53,2.34109641275972,4.41973776371466,7.95596964777263,101,"ENSG00000079974.19"
"29158","ENSG00000197360.9_28109",28101,28109,9,"ENSG00000197360.9",1,8,"VVUVVVVMV",1,7,0.767701863354037,83,89,107,110,116,122,133,136,"AGGAGGA","CAGA","ATGAGGA","CTGA",2.53437947361365,18,6,11,44,2.64463021358059,4.88512334275123,7.95593079616738,101,"ENSG00000079974.19"
"6618","ENSG00000111110.12_105292",105284,105292,9,"ENSG00000111110.12",1,2,"VMVVVVVVV",0,8,0.884057971014493,114,120,133,136,165,171,187,190,"GTGATCT","GTCA","GTGATGG","CTGA",2.37943346869588,13,29,16,67,1.81541467180224,4.41957611577703,7.955807999835,101,"ENSG00000079974.19"
"47794","ENSG00000289349.1_27711",27703,27711,9,"ENSG00000289349.1",1,6,"VVVVVMVVV",0,8,0.902691511387163,17,23,67,70,76,82,133,136,"CTGATGA","CTGA","GGGAATA","CTTA",2.45904188794097,44,6,51,110,0.986162525500982,4.34494377794353,7.95570982349218,101,"ENSG00000079974.19"
"6124","ENSG00000108039.18_58404",58396,58404,9,"ENSG00000108039.18",1,3,"VVMVVVVVV",0,8,0.882815734989648,112,118,133,136,141,147,162,165,"GTTTTGT","CTGG","AGGAAGA","CTGA",2.25463753773474,15,5,15,44,2.666730280727,4.42441179973966,7.95567473969825,101,"ENSG00000079974.19"
"2898","ENSG00000079134.13_8284",8276,8284,9,"ENSG00000079134.13",1,5,"UVVVMVVVV",1,7,0.789233954451346,112,118,133,136,143,149,157,160,"TTGAAGA","CTGA","GTGATAA","CTTA",2.43905831491841,15,7,8,39,2.93442611390744,4.79870372000754,7.95563953781292,101,"ENSG00000079974.19"
"33671","ENSG00000230645.2_153872",153864,153872,9,"ENSG00000230645.2",0,NA,"VVVUVVVVV",1,8,0.880745341614907,102,108,133,136,144,150,162,165,"GTTATGA","ATCA","GTTTTAA","CTGA",2.34210313516908,25,8,12,54,2.1165356608423,4.43263914049238,7.955620506952,101,"ENSG00000079974.19"
"4801","ENSG00000101935.13_4577",4569,4577,9,"ENSG00000101935.13",1,3,"UVMVVVVVV",1,7,0.785507246376811,114,120,133,136,144,150,167,170,"ATGATGA","CAGA","TTGGTGT","CAGA",2.4857458239909,13,8,17,47,2.68264508947955,4.81357097902138,7.95559996452863,101,"ENSG00000079974.19"
"10941","ENSG00000133136.6_4631",4623,4631,9,"ENSG00000133136.6",1,3,"UVMVVVVVV",1,7,0.785507246376811,114,120,133,136,144,150,167,170,"ATGATGA","CAGA","TTGGTGT","CAGA",2.4857458239909,13,8,17,47,2.68264508947955,4.81357097902138,7.95559996452863,101,"ENSG00000079974.19"
"45822","ENSG00000285939.2_676791",676783,676791,9,"ENSG00000285939.2",0,NA,"VVVVVVUVV",1,8,0.886128364389234,74,80,94,97,116,122,133,136,"ATGAAAA","CTGA","CTGTGGA","CTCA",2.305760507237,14,19,11,53,2.2725783412354,4.41107876403718,7.95559222159411,101,"ENSG00000079974.19"
"42523","ENSG00000263863.1_17721",17713,17721,9,"ENSG00000263863.1",0,NA,"UVVVVVVVV",1,8,0.902691511387163,111,117,133,136,145,151,182,185,"GTAATTA","ATGA","ATAAAAA","CTGA",2.32250944180223,16,9,31,65,1.89562820847133,4.34475612178821,7.95552216733687,101,"ENSG00000079974.19"
"26929","ENSG00000185305.12_96143",96135,96143,9,"ENSG00000185305.12",1,8,"VVVVVVVMV",0,8,0.884057971014493,90,96,133,136,141,147,184,187,"ATGCTGA","TTGC","GTGAAAA","CTGA",2.50571500096943,37,5,37,88,0.972363018300009,4.41928242285738,7.95551430691535,101,"ENSG00000079974.19"
"28203","ENSG00000188452.15_63315",63307,63315,9,"ENSG00000188452.15",0,NA,"UVVVVVVVV",1,8,0.902691511387163,111,117,133,136,140,146,166,169,"TTGATCT","GTGT","ATGAAAA","CTGA",2.27782762513192,16,4,20,49,2.19326110438874,4.34469465131705,7.9554606968657,101,"ENSG00000079974.19"
"45011","ENSG00000284707.2_7676",7668,7676,9,"ENSG00000284707.2",1,5,"VVVVMVVVV",0,8,0.886542443064182,82,88,95,98,108,114,133,136,"GTGTTGA","ATGA","CTGGTGA","CTTA",2.33188338595255,7,10,19,45,2.09126320784813,4.40928811188295,7.95545788413968,101,"ENSG00000079974.19"
"22174","ENSG00000169933.17_396498",396490,396498,9,"ENSG00000169933.17",1,3,"UVMVVVVVV",1,7,0.785507246376811,109,115,133,136,168,174,183,186,"ATGATGG","TTGA","TTGTAGA","CTGA",2.63301058491201,18,32,9,68,1.70019462667728,4.81339963152267,7.95542861702991,101,"ENSG00000079974.19"
"32171","ENSG00000226240.2_16965",16957,16965,9,"ENSG00000226240.2",1,8,"UVVVVVVMV",1,7,0.786749482401656,115,121,133,136,145,151,164,167,"ATGATGA","TTGA","GTTTGGA","ATGA",2.45266298727657,12,9,13,43,2.88224643401867,4.80833325396561,7.95533118357224,101,"ENSG00000079974.19"
"44358","ENSG00000281167.1_1585",1577,1585,9,"ENSG00000281167.1",1,8,"UVVVVVVMV",1,7,0.786749482401656,115,121,133,136,145,151,164,167,"ATGATGA","TTGA","GTTTGGA","ATGA",2.45266298727657,12,9,13,43,2.88224643401867,4.80833325396561,7.95533118357224,101,"ENSG00000079974.19"
"2143","ENSG00000070729.14_54594",54586,54594,9,"ENSG00000070729.14",0,NA,"UVVVVVVVV",1,8,0.902691511387163,109,115,133,136,144,150,165,168,"TTAAAGA","AAGA","TTGGAGA","CTGA",2.2360856624452,18,8,15,50,2.47084731964651,4.34452126732029,7.95528731286894,101,"ENSG00000079974.19"
"13010","ENSG00000139910.20_98042",98034,98042,9,"ENSG00000139910.20",1,2,"VMVVVVVVV",0,8,0.884057971014493,88,94,133,136,146,152,188,191,"AGGATGA","TGGA","ATGAAAA","CTGA",2.50974110554984,39,10,36,94,0.94447362545881,4.41902024894776,7.95525213300573,101,"ENSG00000079974.19"
"6234","ENSG00000108684.15_761643",761635,761643,9,"ENSG00000108684.15",1,8,"VVVVVVVMV",0,8,0.884057971014493,86,92,106,109,115,121,133,136,"TTGATGG","CTAA","TTAATCA","CTCA",2.21191339082799,14,6,12,41,2.92993519723474,4.41900611735534,7.95523800141331,101,"ENSG00000079974.19"
"41627","ENSG00000259380.6_12472",12464,12472,9,"ENSG00000259380.6",1,8,"VVVVVVVMV",0,8,0.884057971014493,113,119,133,136,139,145,157,160,"GAGAAGA","TTGA","GTGAAGA","ATGA",2.24900333565247,14,3,12,38,2.68266156753738,4.41900428463845,7.95523616869643,101,"ENSG00000079974.19"
"19550","ENSG00000163288.14_115005",114997,115005,9,"ENSG00000163288.14",0,NA,"UVVVVVVVV",1,8,0.902691511387163,88,94,133,136,179,185,194,197,"ATGAGGA","ATAA","TTGACAA","CTGA",2.45590327267431,39,43,9,100,1.00475726829801,4.34436143819835,7.955127483747,101,"ENSG00000079974.19"
"16988","ENSG00000152936.11_148631",148623,148631,9,"ENSG00000152936.11",1,1,"MVVVVVVVV",0,8,0.90600414078675,116,122,133,136,179,185,197,200,"TGGAAGA","CTGC","TTAAAGA","CTGA",2.30812511595633,11,43,12,75,1.93683707484926,4.33108446197286,7.95510102511986,101,"ENSG00000079974.19"
"38737","ENSG00000250958.1_30777",30769,30777,9,"ENSG00000250958.1",1,1,"MVVVVVVVV",0,8,0.90600414078675,69,75,87,90,92,98,133,136,"ATGATGA","CTGA","ATGCTAA","GTAA",2.36184845559846,12,2,35,58,1.57839707049934,4.33101336028893,7.95502992343593,101,"ENSG00000079974.19"
"34717","ENSG00000233891.8_216508",216500,216508,9,"ENSG00000233891.8",1,8,"UVVVVVVMV",1,7,0.786749482401656,114,120,133,136,142,148,167,170,"GTGACGA","CTGC","ATAATGG","CTGA",2.50119097645338,13,6,19,47,2.55748080673387,4.80802182910577,7.95501975871239,101,"ENSG00000079974.19"
"43493","ENSG00000271955.2_583312",583304,583312,9,"ENSG00000271955.2",1,8,"UVVVVVVMV",1,7,0.786749482401656,114,120,133,136,142,148,167,170,"GTGACGA","CTGC","ATAATGG","CTGA",2.50119097645338,13,6,19,47,2.55748080673387,4.80802182910577,7.95501975871239,101,"ENSG00000079974.19"
"38098","ENSG00000249534.2_86325",86317,86325,9,"ENSG00000249534.2",1,1,"MVVVVVVVV",0,8,0.90600414078675,110,116,133,136,140,146,157,160,"AATATGG","CAAA","ATGATTG","CTGA",2.20813056144276,17,4,11,41,2.60270341598938,4.33089345640194,7.95491001954894,101,"ENSG00000079974.19"
"18265","ENSG00000156709.15_22944",22936,22944,9,"ENSG00000156709.15",1,3,"VVMVVVVVV",0,8,0.882815734989648,108,114,133,136,148,154,168,171,"GGGAAGA","CTGT","GTTCAGA","CTGA",2.32201996943133,19,12,14,54,2.21412747889105,4.42356515210832,7.95482809206691,101,"ENSG00000079974.19"
"1753","ENSG00000065882.18_70484",70476,70484,9,"ENSG00000065882.18",1,6,"VVVVVMVVV",0,8,0.902691511387163,100,106,133,136,152,158,172,175,"TTTATGT","TTGA","CTGGTGT","CTGA",2.38701600176146,27,16,14,66,1.46264441903984,4.34402110769573,7.95478715324438,101,"ENSG00000079974.19"
"37049","ENSG00000244694.8_107069",107061,107069,9,"ENSG00000244694.8",0,NA,"VVUVVVVVV",1,8,0.883643892339545,115,121,133,136,143,149,160,163,"GTTCTGA","TTGA","ATGATCA","CTCA",2.19751446413779,12,7,11,39,3.03072645176272,4.420205719837,7.95478128919518,101,"ENSG00000079974.19"
"198","ENSG00000006468.15_34746",34738,34746,9,"ENSG00000006468.15",1,1,"MVVVVVVVV",0,8,0.90600414078675,87,93,133,136,148,154,163,166,"TTGATGT","TTGT","ATTATTG","CTGA",2.33354989716888,40,12,9,70,1.76590002226739,4.33072483418164,7.95474139732864,101,"ENSG00000079974.19"
"16080","ENSG00000150672.19_2144132",2144124,2144132,9,"ENSG00000150672.19",1,1,"MVVVVVVVV",0,8,0.90600414078675,114,120,133,136,180,186,201,204,"ATGACAA","CTTC","GTGAGCA","CTGA",2.32603824002189,13,44,15,81,1.81595617134713,4.33071944287326,7.95473600602026,101,"ENSG00000079974.19"
"26914","ENSG00000185274.12_404432",404424,404432,9,"ENSG00000185274.12",1,8,"VVVVVUVMV",1,7,0.806211180124224,87,93,106,109,115,121,133,136,"ATGGCGA","ATGA","ATGCAAA","CTGA",2.39231873150831,13,6,12,40,2.97060724261778,4.72984969650163,7.95469441699852,101,"ENSG00000079974.19"
"29455","ENSG00000198010.13_391911",391903,391911,9,"ENSG00000198010.13",1,3,"VVMVVVVVV",0,8,0.882815734989648,113,119,133,136,144,150,194,197,"ATGAAGT","GGGA","TTGATAT","CTGA",2.36009866290119,14,8,44,75,1.95960225590434,4.42339833547807,7.95466127543666,101,"ENSG00000079974.19"
"44676","ENSG00000283352.1_16929",16921,16929,9,"ENSG00000283352.1",0,NA,"UVVVVVVVV",1,8,0.902691511387163,109,115,133,136,142,148,161,164,"ATGAGGA","AAGA","CTAAGGA","CAGA",2.22027229119891,18,6,13,46,2.57340124586314,4.34380413013064,7.95457017567929,101,"ENSG00000079974.19"
"6071","ENSG00000107897.20_56294",56286,56294,9,"ENSG00000107897.20",1,8,"VVVVVVVMV",0,8,0.884057971014493,113,119,133,136,153,159,172,175,"ATAAATA","TTGA","TTGAGGT","CTGA",2.30427434161154,14,17,13,53,2.31130807312388,4.41828425430021,7.95451613835818,101,"ENSG00000079974.19"
"38608","ENSG00000250602.6_17573",17565,17573,9,"ENSG00000250602.6",1,5,"VVVVMUVVV",1,7,0.808695652173913,107,113,133,136,141,147,158,161,"AGGATGA","GTGG","GGGATAA","CTGA",2.46979146410614,20,5,11,45,2.4136227896577,4.71972480425799,7.95450741295364,101,"ENSG00000079974.19"
"4911","ENSG00000102313.9_2959",2951,2959,9,"ENSG00000102313.9",1,8,"VVVVVVVMV",0,8,0.884057971014493,86,92,105,108,116,122,133,136,"ATTATGA","TTAA","AGGATAA","CTAA",2.20212460659315,13,8,11,41,2.99220180982414,4.41825813011129,7.95449001416926,101,"ENSG00000079974.19"
"14863","ENSG00000145990.11_70028",70020,70028,9,"ENSG00000145990.11",0,NA,"VVVVUVVVV",1,8,0.889855072463768,80,86,103,106,115,121,133,136,"CTGATGT","CTGA","GTGATGC","CTTT",2.23707090779912,17,9,12,47,2.66640863594683,4.39505367198524,7.95447396184031,101,"ENSG00000079974.19"
"23640","ENSG00000173452.14_5016",5008,5016,9,"ENSG00000173452.14",1,3,"VVMVVVVVV",0,8,0.882815734989648,116,122,133,136,147,153,163,166,"CTATTGA","TTGG","GTCATGT","CTGA",2.22880711862226,11,11,10,41,2.83404292477404,4.42318926223061,7.95445220218921,101,"ENSG00000079974.19"
"38441","ENSG00000250156.3_18923",18915,18923,9,"ENSG00000250156.3",1,1,"MVVVVVVVV",0,8,0.90600414078675,66,72,89,92,102,108,133,136,"CAGAGGA","CTGG","AAGCTGA","CTGA",2.30931773619361,17,10,25,61,1.92623253858795,4.33042102830301,7.95443759145,101,"ENSG00000079974.19"
"16163","ENSG00000151023.17_8620",8612,8620,9,"ENSG00000151023.17",1,2,"VMVVVVVVV",0,8,0.884057971014493,112,118,133,136,144,150,175,178,"ATTATGG","CGAA","TTGTTAA","CTGA",2.32550235080419,15,8,25,57,2.16915343395185,4.41812560982828,7.95435749388625,101,"ENSG00000079974.19"
"41213","ENSG00000258700.6_218089",218081,218089,9,"ENSG00000258700.6",1,8,"VVUVVVVMV",1,7,0.767701863354037,112,118,133,136,141,147,161,164,"ATCATGT","CTGA","GGTAAGA","CTGA",2.52141318497396,15,5,14,43,2.7246821084173,4.88352583539427,7.95433328881042,101,"ENSG00000079974.19"
"18669","ENSG00000158019.21_438433",438425,438433,9,"ENSG00000158019.21",1,8,"VVVVVVVMV",0,8,0.884057971014493,111,117,133,136,144,150,179,182,"CAGAAGA","GTGA","ATGTTGG","CTGA",2.35483151415678,16,8,29,62,1.97346274313589,4.41808487604527,7.95431676010325,101,"ENSG00000079974.19"
"38197","ENSG00000249776.5_88981",88973,88981,9,"ENSG00000249776.5",1,1,"MVVVVVVVV",0,8,0.90600414078675,114,120,133,136,138,144,153,156,"GTGATGC","TTCA","TTGGAGA","TTGA",2.18900160932929,13,2,9,33,2.72772849389642,4.33026813902292,7.95428470216992,101,"ENSG00000079974.19"
"14138","ENSG00000144455.14_244689",244681,244689,9,"ENSG00000144455.14",0,NA,"VVVUVUVVV",2,7,0.802898550724638,104,110,133,136,139,145,154,157,"ATGATGA","AGGA","AAGGTGT","CTGA",2.54838237408247,23,3,9,44,1.9812069565565,4.74260569594324,7.95419989884179,101,"ENSG00000079974.19"
"11917","ENSG00000136531.19_106006",105998,106006,9,"ENSG00000136531.19",1,3,"UVMVVVVVV",1,7,0.785507246376811,114,120,133,136,141,147,162,165,"ATGAGGA","ATCA","TTGAGGT","CTGA",2.47302930436933,13,5,15,42,2.7615897979202,4.81211295676227,7.95414194226952,101,"ENSG00000079974.19"
"39865","ENSG00000254365.1_3691",3683,3691,9,"ENSG00000254365.1",1,8,"UVVVVVVMV",1,7,0.786749482401656,83,89,99,102,111,117,133,136,"ATGGTGG","CAGA","ATGAACA","CTGA",2.48867778657022,10,9,16,44,2.63710937770285,4.80707365537608,7.9540715849827,101,"ENSG00000079974.19"
"893","ENSG00000039139.11_296988",296980,296988,9,"ENSG00000039139.11",0,NA,"VVVUVVVVV",1,8,0.880745341614907,94,100,109,112,114,120,133,136,"TTGATTA","TTGA","GTGCAGA","ATGA",2.28531494277829,9,2,13,33,2.48886880128086,4.43107543828404,7.95405680474367,101,"ENSG00000079974.19"
"9666","ENSG00000126016.17_50954",50946,50954,9,"ENSG00000126016.17",1,1,"MVVVVVVVV",0,8,0.90600414078675,110,116,133,136,148,154,172,175,"ATCATCA","AGGA","GAGAAAA","CTGA",2.2744795125936,17,12,18,56,2.15691228300745,4.33002725840786,7.95404382155486,101,"ENSG00000079974.19"
"37093","ENSG00000245275.9_46834",46826,46834,9,"ENSG00000245275.9",0,NA,"VVVVVVUVV",1,8,0.886128364389234,77,83,91,94,98,104,133,136,"GTGATGT","ATGA","CTGTTGA","CTTA",2.38790140556002,8,4,29,50,1.71860462046305,4.40948683104913,7.95400028860606,101,"ENSG00000079974.19"
"20153","ENSG00000164330.17_335019",335011,335019,9,"ENSG00000164330.17",1,1,"MVVVVUVVV",1,7,0.82815734989648,116,122,133,136,149,155,178,181,"ATGAGGT","GTGA","ATGGTCA","CTGA",2.48062753115119,11,13,23,56,2.02765316246161,4.64129250920073,7.95392190878665,101,"ENSG00000079974.19"
"18819","ENSG00000158571.11_61189",61181,61189,9,"ENSG00000158571.11",0,NA,"UVVVVVVVV",1,8,0.902691511387163,100,106,133,136,141,147,172,175,"ATGATGA","TAGA","TTCATGA","CTGC",2.40978308732924,27,5,25,66,1.3071587109989,4.34309482329845,7.95386086884711,101,"ENSG00000079974.19"
"41256","ENSG00000258747.2_21927",21919,21927,9,"ENSG00000258747.2",1,2,"VMVVVVUVV",1,7,0.770186335403727,79,85,97,100,110,116,133,136,"CTGATGA","CTAA","ACCAGGA","CTGA",2.53418317217174,12,10,17,48,2.59782127016637,4.87309393782783,7.95383927944274,101,"ENSG00000079974.19"
"13839","ENSG00000143643.13_50239",50231,50239,9,"ENSG00000143643.13",1,8,"VVVVVVVMV",0,8,0.884057971014493,110,116,133,136,141,147,157,160,"ATTGGGA","CAGA","GTGCTTC","CTGA",2.24396410234966,17,5,10,41,2.71060051602179,4.41759029958821,7.95382218364618,101,"ENSG00000079974.19"
"14207","ENSG00000144619.15_251497",251489,251497,9,"ENSG00000144619.15",1,2,"VMVVVVVVV",0,8,0.884057971014493,114,120,133,136,149,155,166,169,"TTTAAGA","AGGA","GTGATTG","CTGA",2.24860344686661,13,13,11,46,2.67966633841436,4.41758899604795,7.95382088010592,101,"ENSG00000079974.19"
"19986","ENSG00000164122.9_43032",43024,43032,9,"ENSG00000164122.9",1,5,"UVVVMVVVV",1,7,0.789233954451346,48,54,63,66,74,80,133,136,"CTGATGT","TTGA","GTAATGA","CTGA",2.60449016920696,9,8,53,79,1.82406992742653,4.7968344305349,7.95377024834028,101,"ENSG00000079974.19"
"39016","ENSG00000251471.1_10678",10670,10678,9,"ENSG00000251471.1",1,8,"VVVVUVVMV",1,7,0.773913043478261,91,97,133,136,146,152,165,168,"ATGATGA","GGGA","ATGCAGA","CTGA",2.64133376179684,36,10,13,68,1.82341759195751,4.85807733431745,7.95372950823049,101,"ENSG00000079974.19"
"32267","ENSG00000226571.2_187471",187463,187471,9,"ENSG00000226571.2",1,1,"MVVVVUVVV",1,7,0.82815734989648,113,119,133,136,137,143,152,155,"ATGCTGA","TGGA","GTTATCT","CTGA",2.4101838471623,14,1,9,33,2.49647750791415,4.64109245558237,7.95372185516829,101,"ENSG00000079974.19"
"1829","ENSG00000066382.17_110085",110077,110085,9,"ENSG00000066382.17",1,2,"VMVVVVVVV",0,8,0.884057971014493,115,121,133,136,150,156,165,168,"CTGATTG","CAGC","TTGAAAA","CTGA",2.25594973681673,12,14,9,44,2.63027484009447,4.4174849380515,7.95371682210947,101,"ENSG00000079974.19"
"37249","ENSG00000246316.8_179175",179167,179175,9,"ENSG00000246316.8",1,2,"VMVVVVVVV",0,8,0.884057971014493,104,110,133,136,150,156,170,173,"AAGTTGA","CTAA","CTTTTGA","CTGA",2.38539624127472,23,14,14,60,1.76713996892794,4.41744539435652,7.95367727841449,101,"ENSG00000079974.19"
"19256","ENSG00000162621.7_27166",27158,27166,9,"ENSG00000162621.7",1,8,"VVVVVVVMV",0,8,0.884057971014493,105,111,133,136,144,150,176,179,"AGAATGA","CTGG","GTGTAAA","CTGA",2.41643641097284,22,8,26,65,1.55999569938309,4.41739294313383,7.95362482719181,101,"ENSG00000079974.19"
"22719","ENSG00000171189.18_360579",360571,360579,9,"ENSG00000171189.18",0,NA,"VVUVVVVVV",1,8,0.883643892339545,51,57,77,80,83,89,133,136,"GTGATGA","CAGA","GTGAGCA","CTAA",2.4713737088447,20,3,44,76,1.20031229003763,4.41903425391724,7.95360982327542,101,"ENSG00000079974.19"
"39549","ENSG00000253773.5_554545",554537,554545,9,"ENSG00000253773.5",1,2,"VMVVVVVVV",0,8,0.884057971014493,112,118,133,136,148,154,171,174,"ATGAGTA","CAGT","CAGATGT","CTGA",2.29439445773151,15,12,17,53,2.37310739038926,4.41726761048317,7.95349949454114,101,"ENSG00000079974.19"
"40972","ENSG00000258216.7_321518",321510,321518,9,"ENSG00000258216.7",1,1,"MVVVVUVVV",1,7,0.82815734989648,112,118,133,136,184,190,203,206,"ATGATAA","TAGA","ATGTAGA","CTGA",2.50999714382196,15,48,13,85,1.8299667933514,4.64082027137446,7.95344967096038,101,"ENSG00000079974.19"
"42972","ENSG00000267489.5_102794",102786,102794,9,"ENSG00000267489.5",1,1,"MVVVVVVVV",0,8,0.90600414078675,115,121,133,136,143,149,172,175,"GTGTGGA","GTCA","CTGCTGT","CTGA",2.24375712545073,12,7,23,51,2.35931571239066,4.32942413718222,7.95344070032922,101,"ENSG00000079974.19"
"8008","ENSG00000116406.20_61543",61535,61543,9,"ENSG00000116406.20",1,1,"MVVVVVVVV",0,8,0.90600414078675,99,105,133,136,146,152,170,173,"ATAAAGA","CATA","GTGGAGA","CTGA",2.35581408626377,28,10,18,65,1.61223813055533,4.32941634307845,7.95343290622545,101,"ENSG00000079974.19"
"12846","ENSG00000139218.18_39742",39734,39742,9,"ENSG00000139218.18",1,2,"VMVVVVVVV",0,8,0.884057971014493,113,119,133,136,148,154,168,171,"GAAATGT","CTTA","CTGTTAA","CTGA",2.25996755720371,14,12,14,49,2.60230465969489,4.41718876026324,7.95342064432121,101,"ENSG00000079974.19"
"15278","ENSG00000147526.20_79258",79250,79258,9,"ENSG00000147526.20",1,1,"MVVVVVVVV",0,8,0.90600414078675,111,117,133,136,147,153,168,171,"GTCTAGA","CTGT","GAGAGGA","CTGA",2.22403328744236,16,11,15,51,2.49055936472019,4.32936198691731,7.95337855006431,101,"ENSG00000079974.19"
"15075","ENSG00000147010.19_182610",182602,182610,9,"ENSG00000147010.19",1,7,"VVVVVVMVV",0,8,0.885300207039338,98,104,133,136,141,147,175,178,"ATTATGA","ATCA","CTGAATA","CTGA",2.47260700707203,29,5,28,71,1.16457916199312,4.41215646895167,7.95335729710902,101,"ENSG00000079974.19"
"2803","ENSG00000078328.23_1193385",1193377,1193385,9,"ENSG00000078328.23",0,NA,"VVVVVVUVV",1,8,0.886128364389234,85,91,133,136,138,144,155,158,"TTGATGC","GTCA","GTGTTGT","CTGA",2.41853962893163,42,2,11,64,1.51165519504095,4.40881318031296,7.95332663786989,101,"ENSG00000079974.19"
"12279","ENSG00000137770.14_84800",84792,84800,9,"ENSG00000137770.14",0,NA,"UVUVVVVVV",2,7,0.786335403726708,68,74,89,92,103,109,133,136,"AAAATGA","CTAA","GTGATGA","CTGA",2.57601951274661,15,11,24,59,2.05836841662053,4.80795795873282,7.95329957363966,101,"ENSG00000079974.19"
"4114","ENSG00000095383.20_28693",28685,28693,9,"ENSG00000095383.20",1,1,"MVVVVUVVV",1,7,0.82815734989648,115,121,133,136,149,155,166,169,"CAGATGA","CCCA","TTCATGA","CTGA",2.38146208639249,12,13,11,45,2.68610849742335,4.64063060167665,7.95326000126258,101,"ENSG00000079974.19"
"42396","ENSG00000262231.2_10652",10644,10652,9,"ENSG00000262231.2",1,1,"MVVVVVUVV",1,7,0.792132505175983,113,119,133,136,148,154,162,165,"ATGATAC","CAGA","TTGAGCA","CTGA",2.46248969171813,14,12,8,43,2.72228636292583,4.78472107692835,7.95325109763228,101,"ENSG00000079974.19"
"15706","ENSG00000149256.16_469851",469843,469851,9,"ENSG00000149256.16",1,1,"MVVVVVVVV",0,8,0.90600414078675,91,97,133,136,147,153,169,172,"CTCATGA","CTTG","ATGATCC","CTGA",2.35751139441012,36,11,16,72,1.59971967881742,4.32911557705455,7.95313214020155,101,"ENSG00000079974.19"
"5624","ENSG00000106018.14_103161",103153,103161,9,"ENSG00000106018.14",1,7,"VVVVVVMVV",0,8,0.885300207039338,115,121,133,136,180,186,199,202,"CCCATGA","GTGA","ATGACGG","CTGA",2.35877673054466,12,44,13,78,1.92250817959152,4.41192159580564,7.95312242396299,101,"ENSG00000079974.19"
"32223","ENSG00000226383.7_241350",241342,241350,9,"ENSG00000226383.7",1,8,"VVVVVVVMV",0,8,0.884057971014493,107,113,133,136,172,178,190,193,"AAGAGGA","TTGA","AGGATAA","CTGA",2.43038775212863,20,36,12,77,1.46481111413737,4.41684903208205,7.95308091614002,101,"ENSG00000079974.19"
"16943","ENSG00000152818.20_457307",457299,457307,9,"ENSG00000152818.20",1,1,"MVVVVVVVV",0,8,0.90600414078675,112,118,133,136,150,156,202,205,"GTTATAA","ATGA","CTCAAGA","CTGA",2.36670045488659,15,14,46,84,1.53824152335162,4.32906113898222,7.95307770212922,101,"ENSG00000079974.19"
"1348","ENSG00000054282.16_154877",154869,154877,9,"ENSG00000054282.16",1,1,"MVVVVVVVV",0,8,0.90600414078675,116,122,133,136,184,190,202,205,"ATAATTG","ATGA","TTGTTCA","CTGA",2.30728706964178,11,48,12,80,1.93420428542241,4.32902952075857,7.95304608390557,101,"ENSG00000079974.19"
"35559","ENSG00000236306.3_1735",1727,1735,9,"ENSG00000236306.3",1,1,"MVVVVVVVV",0,8,0.90600414078675,48,54,70,73,115,121,133,136,"GACATGC","CTGA","TTAATCA","CTGA",2.32726192803601,16,42,12,79,1.80086990905926,4.32898735732483,7.95300392047183,101,"ENSG00000079974.19"
"34840","ENSG00000234264.1_29929",29921,29929,9,"ENSG00000234264.1",0,NA,"UVVVVVVVV",1,8,0.902691511387163,106,112,133,136,160,166,188,191,"ATGATAA","CAGA","CTGATGA","CTTA",2.46068840364965,21,24,22,76,0.964123792730413,4.34217828759868,7.95294433314733,101,"ENSG00000079974.19"
"18251","ENSG00000156687.11_270586",270578,270586,9,"ENSG00000156687.11",1,8,"VVVVVVVMV",0,8,0.884057971014493,77,83,100,103,112,118,133,136,"GTCATTA","TTGC","TTGAAGT","CTGA",2.27149646256511,17,9,15,50,2.52343478820882,4.41668613466072,7.95291801871869,101,"ENSG00000079974.19"
"47257","ENSG00000287912.2_40300",40292,40300,9,"ENSG00000287912.2",1,2,"VMVVVVVVV",0,8,0.884057971014493,105,111,133,136,144,150,168,171,"ATTATGT","ATGT","CTGATTC","CTGA",2.35605088551306,22,8,18,57,1.95971072476118,4.4166791570454,7.95291104110337,101,"ENSG00000079974.19"
"34999","ENSG00000234663.7_302373",302365,302373,9,"ENSG00000234663.7",1,1,"MVVVVVUVV",1,7,0.792132505175983,111,117,133,136,141,147,156,159,"ATGATGT","CTTG","TTCCTGA","CTGA",2.44867903302615,16,5,9,39,2.81278283517189,4.78432743050323,7.95285745120716,101,"ENSG00000079974.19"
"40363","ENSG00000255745.2_18804",18796,18804,9,"ENSG00000255745.2",1,8,"VVVVVVVMV",0,8,0.884057971014493,114,120,133,136,143,149,157,160,"ATTGTTA","TTGA","AATAGGA","CTGA",2.19177607013965,13,7,8,37,3.05461656648853,4.41661425852155,7.95284614257952,101,"ENSG00000079974.19"
"42735","ENSG00000266153.1_6723",6715,6723,9,"ENSG00000266153.1",0,NA,"VVVVVVUVV",1,8,0.886128364389234,114,120,133,136,139,145,158,161,"CACATGA","ATTA","TTCATGA","CTGA",2.24366015861226,13,3,13,38,2.67544884834434,4.40829580977319,7.95280926733012,101,"ENSG00000079974.19"
"22071","ENSG00000169760.18_809822",809814,809822,9,"ENSG00000169760.18",1,2,"VMVVVVVVV",0,8,0.884057971014493,111,117,133,136,142,148,184,187,"CAGATGA","CCCA","ATGACAA","CTGA",2.37006005936546,16,6,36,67,1.86579838054909,4.41654969407971,7.95278157813768,101,"ENSG00000079974.19"
"26773","ENSG00000185008.19_734166",734158,734166,9,"ENSG00000185008.19",1,1,"MVVVVVVVV",0,8,0.90600414078675,79,85,100,103,113,119,133,136,"ATGGTGG","CTCA","ATCAAGA","CAGA",2.19510275340859,15,10,14,48,2.68088650240767,4.32872621461624,7.95274277776324,101,"ENSG00000079974.19"
"37611","ENSG00000248538.10_113220",113212,113220,9,"ENSG00000248538.10",1,3,"VVMVVUVVV",1,7,0.804968944099379,86,92,104,107,114,120,133,136,"ACCATGA","CAGA","GGGAGGC","CTGA",2.39810500003987,12,7,13,41,2.94344333656671,4.73270250087479,7.9525782772723,101,"ENSG00000079974.19"
"25175","ENSG00000179915.25_1120496",1120488,1120496,9,"ENSG00000179915.25",1,7,"VVVVVUMVV",1,7,0.807453416149068,87,93,102,105,115,121,133,136,"ATCATGA","CAGA","ATGATGT","CTTA",2.42480445821868,9,10,12,40,2.72565214616319,4.7227538002386,7.95256746483487,101,"ENSG00000079974.19"
"8931","ENSG00000121749.16_87431",87423,87431,9,"ENSG00000121749.16",0,NA,"UVVVVVVVV",1,8,0.902691511387163,116,122,133,136,153,159,178,181,"ATTTTTA","ATGA","ATGTAGA","CTGA",2.30830183484806,11,17,19,56,1.97821154284372,4.3417226104577,7.95248865600635,101,"ENSG00000079974.19"
"20206","ENSG00000164418.22_7260",7252,7260,9,"ENSG00000164418.22",1,8,"VVVVVVVMV",0,8,0.884057971014493,85,91,133,136,165,171,182,185,"AGGATGT","TAGA","GTGAAGA","CTGA",2.49256702404093,42,29,11,91,1.04780380783419,4.41622932536009,7.95246120941806,101,"ENSG00000079974.19"
"22560","ENSG00000170832.13_229034",229026,229034,9,"ENSG00000170832.13",1,7,"VVVVVVMVV",0,8,0.885300207039338,110,116,133,136,145,151,165,168,"ATAATCA","GTTA","ATGGTAT","CTGA",2.26000258468327,17,9,14,49,2.57813038670168,4.41120357114754,7.95240439930489,101,"ENSG00000079974.19"
"34870","ENSG00000234323.10_431701",431693,431701,9,"ENSG00000234323.10",1,7,"VVVVVVMVV",0,8,0.885300207039338,115,121,133,136,139,145,156,159,"GAGAGGA","AAGA","ATGGTAG","CTGA",2.22395228921664,12,3,11,35,2.81845516435072,4.41120093978208,7.95240176793943,101,"ENSG00000079974.19"
"4990","ENSG00000102580.15_92874",92866,92874,9,"ENSG00000102580.15",0,NA,"UVVVVVVVV",1,8,0.902691511387163,97,103,133,136,143,149,159,162,"ATTATGA","CTAA","AGGATCA","CTGC",2.29841794171041,30,7,10,56,2.04353305248552,4.34157983263873,7.95234587818739,101,"ENSG00000079974.19"
"251","ENSG00000007001.13_45101",45093,45101,9,"ENSG00000007001.13",1,1,"MVVVVUVVV",1,7,0.82815734989648,13,19,34,37,88,94,133,136,"ATTATGA","CTAA","ATGTTGA","CTGA",2.64355548997296,15,51,39,114,0.935157945606869,4.63971530302331,7.95234470260924,101,"ENSG00000079974.19"
"14727","ENSG00000145781.9_194711",194703,194711,9,"ENSG00000145781.9",1,3,"VVMVVVVVV",0,8,0.882815734989648,114,120,133,136,143,149,160,163,"TTGATGT","CACA","GTGAAAA","CTAA",2.20046739267484,13,7,11,40,3.01450882069823,4.42107285963263,7.95233579959122,101,"ENSG00000079974.19"
"18520","ENSG00000157554.20_28397",28389,28397,9,"ENSG00000157554.20",1,1,"MVVVVVVVV",0,8,0.90600414078675,84,90,133,136,186,192,209,212,"ATGAAGA","ATGC","GTGTTAA","CTGA",2.49204564465703,43,50,17,119,0.699059977276231,4.32817440208077,7.95219096522777,101,"ENSG00000079974.19"
"32680","ENSG00000227543.5_11419",11411,11419,9,"ENSG00000227543.5",0,NA,"VVVUVVVVV",1,8,0.880745341614907,114,120,133,136,141,147,167,170,"AGCCTGA","CTGG","GTAAAGA","CTGA",2.29058376978189,13,5,20,47,2.44625944388182,4.42920447727361,7.95218584373324,101,"ENSG00000079974.19"
"9561","ENSG00000125450.11_26274",26266,26274,9,"ENSG00000125450.11",1,8,"VVVVVUVMV",1,7,0.806211180124224,112,118,133,136,152,158,170,173,"CTGAACA","CTGA","GTGAGCA","CTGA",2.48287684296859,15,16,12,52,2.35646305272445,4.72724383479542,7.95208855529232,101,"ENSG00000079974.19"
"45882","ENSG00000286021.3_298897",298889,298897,9,"ENSG00000286021.3",1,8,"UVVVVVVMV",1,7,0.786749482401656,89,95,133,136,143,149,187,190,"ATAATGA","ATGA","ATGATGA","CTGA",2.72805879187566,38,7,38,92,1.03327221786133,4.80508270759143,7.95208063719806,101,"ENSG00000079974.19"
"17798","ENSG00000155093.19_537402",537394,537402,9,"ENSG00000155093.19",0,NA,"VVUVVVVVV",1,8,0.883643892339545,110,116,133,136,159,165,178,181,"CAGATGG","TTGA","CTGGTAA","CTGA",2.37334662269644,17,23,13,62,1.84719410093737,4.41737622972841,7.95195179908659,101,"ENSG00000079974.19"
"30945","ENSG00000214866.9_65755",65747,65755,9,"ENSG00000214866.9",1,6,"VVVVVMVVV",0,8,0.902691511387163,98,104,110,113,116,122,133,136,"GTGATTT","CAGA","GTGACGT","CCGA",2.21238210574472,6,3,11,29,2.61485576578733,4.34101745102137,7.95178349657002,101,"ENSG00000079974.19"
"3775","ENSG00000089012.14_14555",14547,14555,9,"ENSG00000089012.14",1,1,"MVVVVVVVV",0,8,0.90600414078675,110,116,133,136,140,146,157,160,"AATATGG","CACA","ATGATTG","CTGA",2.2062532147594,17,4,11,41,2.60270341598938,4.32776454526302,7.95178110841002,101,"ENSG00000079974.19"
"26873","ENSG00000185104.21_17493",17485,17493,9,"ENSG00000185104.21",1,2,"UMVVVVVVV",1,7,0.786749482401656,68,74,85,88,97,103,133,136,"ATGATGT","CTGT","ATGGGAA","CTGA",2.57507171560235,11,9,30,59,2.05195589561553,4.80477516657446,7.95177309618109,101,"ENSG00000079974.19"
"28386","ENSG00000188994.14_112302",112294,112302,9,"ENSG00000188994.14",1,1,"MVVVVVVVV",0,8,0.90600414078675,75,81,98,101,109,115,133,136,"ATTATGA","ATGA","AAAATCA","ATGA",2.23995600388755,17,8,18,52,2.37797578627502,4.32775395304801,7.95177051619501,101,"ENSG00000079974.19"
"12742","ENSG00000138823.14_26605",26597,26605,9,"ENSG00000138823.14",1,8,"VVVVVVVMV",0,8,0.884057971014493,102,108,133,136,159,165,183,186,"GTGATGC","CAGA","GGGATAC","CTGA",2.50216268996338,25,23,18,75,0.980945499587904,4.41550752483594,7.95173940889392,101,"ENSG00000079974.19"
"39880","ENSG00000254394.2_232547",232539,232547,9,"ENSG00000254394.2",1,1,"MVVVVVVVV",0,8,0.90600414078675,111,117,133,136,152,158,170,173,"ATGATGT","CTAC","GTAATGT","GTGA",2.25390231375593,16,16,12,53,2.28475512965969,4.3276926386748,7.9517092018218,101,"ENSG00000079974.19"
"12802","ENSG00000139146.14_7428",7420,7428,9,"ENSG00000139146.14",1,1,"MVVVVVVVV",0,8,0.90600414078675,116,122,133,136,180,186,239,242,"TTGGTGA","TTGT","GTGTTGA","CTGA",2.4496846341465,11,44,53,117,0.979319031053934,4.32763748134099,7.95165404448799,101,"ENSG00000079974.19"
"23725","ENSG00000173699.17_30718",30710,30718,9,"ENSG00000173699.17",1,1,"MVVVVVVVV",0,8,0.90600414078675,112,118,133,136,164,170,178,181,"ACCATGT","CTGG","ATTTTGA","CTGA",2.30211037004129,15,28,8,60,1.96295893111735,4.32759034951482,7.95160691266182,101,"ENSG00000079974.19"
"22124","ENSG00000169855.21_992336",992328,992336,9,"ENSG00000169855.21",1,8,"VVVVVVUMV",1,7,0.770186335403727,67,73,84,87,95,101,133,136,"ATGTTTA","CTGA","CTGAAGA","CTGA",2.61473820547788,11,8,32,60,2.05177784119006,4.87084146942732,7.95158681104223,101,"ENSG00000079974.19"
"24835","ENSG00000178175.12_7989",7981,7989,9,"ENSG00000178175.12",0,NA,"UVVVVVUVV",2,7,0.788819875776397,84,90,99,102,112,118,133,136,"CTGAAGT","TTGA","GTGAGGA","CTGA",2.49316282651494,9,10,15,43,2.56395303285887,4.79625963573961,7.9515391388452,101,"ENSG00000079974.19"
"13340","ENSG00000140995.17_13682",13674,13682,9,"ENSG00000140995.17",1,1,"MVVVVVVVV",0,8,0.90600414078675,112,118,133,136,142,148,175,178,"ACGTTAA","CTGG","GTGCTCA","CTGA",2.28197629586479,15,6,27,57,2.09684269601269,4.32750450044448,7.95152106359148,101,"ENSG00000079974.19"
"32009","ENSG00000225579.2_28156",28148,28156,9,"ENSG00000225579.2",1,1,"MVVVVVVVV",0,8,0.90600414078675,95,101,133,136,138,144,158,161,"CTGATGA","CTCA","CTGCAGA","CTAA",2.38350635637642,32,2,14,57,1.41996681066937,4.32750229662804,7.95151885977504,101,"ENSG00000079974.19"
"34665","ENSG00000233723.11_477678",477670,477678,9,"ENSG00000233723.11",0,NA,"VVVUVVUVV",2,7,0.766873706004141,103,109,133,136,169,175,194,197,"ATGATGA","TTGA","GTAATGA","CTGA",2.80703074789433,24,33,19,85,0.822520866126207,4.88401479635543,7.95150962037199,101,"ENSG00000079974.19"
"3997","ENSG00000091656.19_27737",27729,27737,9,"ENSG00000091656.19",1,5,"VVVVMVVVV",0,8,0.886542443064182,36,42,55,58,75,81,133,136,"ATGATGA","CTTA","GTCTAGA","CTAA",2.42940322513422,13,17,52,91,1.4253030412035,4.40533113552457,7.9515009077813,101,"ENSG00000079974.19"
"11095","ENSG00000133863.9_38932",38924,38932,9,"ENSG00000133863.9",1,1,"MVVVVVVVV",0,8,0.90600414078675,114,120,133,136,170,176,188,191,"GTTTTGT","CTGG","TTGATCA","CTGA",2.29982334854555,13,34,12,68,1.97777137699961,4.32748175849249,7.95149832163949,101,"ENSG00000079974.19"
"19693","ENSG00000163617.11_60797",60789,60797,9,"ENSG00000163617.11",0,NA,"UVVVVVVVV",1,8,0.902691511387163,116,122,133,136,148,154,185,188,"GCGATTA","AAGA","CTGGTGA","CTGA",2.32726492392262,11,12,31,63,1.8477994109085,4.3407247259315,7.95149077148015,101,"ENSG00000079974.19"
"7438","ENSG00000114251.15_22622",22614,22622,9,"ENSG00000114251.15",1,8,"VVVVVVVMV",0,8,0.884057971014493,67,73,86,89,103,109,133,136,"ATAATGA","CTCA","GTGAGCA","CTAA",2.35929951235879,13,14,24,60,1.93221300727217,4.41521910574937,7.95145098980734,101,"ENSG00000079974.19"
"21552","ENSG00000168309.18_34301",34293,34301,9,"ENSG00000168309.18",1,6,"VVVVVMVVV",0,8,0.902691511387163,42,48,69,72,78,84,133,136,"ATGGTGA","CAGA","GGGATGA","CTGT",2.3948408066954,21,6,49,85,1.3966969792644,4.34057558930843,7.95134163485708,101,"ENSG00000079974.19"
"41218","ENSG00000258700.6_386680",386672,386680,9,"ENSG00000258700.6",1,8,"VVVUVVVMV",1,7,0.764803312629399,72,78,94,97,106,112,133,136,"CTGATGA","CTGA","ATGAAGA","GTGA",2.59794753465912,16,9,21,55,2.24881259893554,4.89211570749908,7.95132895801668,101,"ENSG00000079974.19"
"28552","ENSG00000196104.11_143181",143173,143181,9,"ENSG00000196104.11",0,NA,"UVVVVVVVV",1,8,0.902691511387163,101,107,133,136,145,151,164,167,"ATGATGA","GTGT","GTATTAA","CTAA",2.30384403797459,26,9,13,57,2.00328708113753,4.34056183357537,7.95132787912402,101,"ENSG00000079974.19"
"13467","ENSG00000141506.15_27282",27274,27282,9,"ENSG00000141506.15",1,2,"VMUVVVVVV",1,7,0.767701863354037,66,72,87,90,96,102,133,136,"GCGATGA","CAGA","GTGATGG","CTGA",2.62822275452689,15,6,31,61,2.00042597787294,4.88047775201304,7.95128520542919,101,"ENSG00000079974.19"
"47085","ENSG00000287621.1_6449",6441,6449,9,"ENSG00000287621.1",1,1,"MVVVVVVVV",0,8,0.90600414078675,47,53,66,69,75,81,133,136,"GTGAGGA","CTGA","GTGATGA","TAGA",2.29921583576973,13,6,52,80,1.98093989173191,4.32726136588253,7.95127792902953,101,"ENSG00000079974.19"
"9866","ENSG00000127947.16_85173",85165,85173,9,"ENSG00000127947.16",0,NA,"VVVVUVVVV",1,8,0.889855072463768,116,122,133,136,140,146,198,201,"GTAATAA","CTTA","ATTAAGA","CTGA",2.36299647488286,11,4,52,76,1.81406138400579,4.39184280413954,7.95126309399461,101,"ENSG00000079974.19"
"18584","ENSG00000157703.16_73739",73731,73739,9,"ENSG00000157703.16",0,NA,"UVVVVVVVV",1,8,0.902691511387163,112,118,133,136,187,193,203,206,"GTAAAGT","TTGA","ATGAAGT","CTGA",2.31775954302679,15,51,10,85,1.91012078079483,4.34046276691003,7.95122881245868,101,"ENSG00000079974.19"
"28928","ENSG00000196730.13_12052",12044,12052,9,"ENSG00000196730.13",1,8,"VVVVVVVMV",0,8,0.884057971014493,71,77,93,96,106,112,133,136,"ATGCTGA","CAGA","CTTAGGA","CTAA",2.31950284539127,16,10,21,56,2.19641383076227,4.41494153334268,7.95117341740065,101,"ENSG00000079974.19"
"47621","ENSG00000288723.1_107962",107954,107962,9,"ENSG00000288723.1",1,7,"VVVVUVMVV",1,7,0.775155279503105,88,94,105,108,116,122,133,136,"ATGATGC","AAGA","GTCCAGA","CTGA",2.46148393916228,11,8,11,39,2.99201626321764,4.85047729774154,7.95109841575396,101,"ENSG00000079974.19"
"31936","ENSG00000225325.1_58884",58876,58884,9,"ENSG00000225325.1",1,1,"MVVVVUVVV",1,7,0.82815734989648,89,95,133,136,146,152,163,166,"ACGATGA","GTAA","GTGCAGA","CTGA",2.5000127146144,38,10,11,68,1.88695476133004,4.63842654802317,7.95105594760909,101,"ENSG00000079974.19"
"34129","ENSG00000231918.1_791572",791564,791572,9,"ENSG00000231918.1",1,7,"VVVVVVMVV",0,8,0.885300207039338,110,116,133,136,177,183,198,201,"GTGAGGA","AAGA","GTGAATG","CTGA",2.40917599651603,17,41,15,82,1.5781409562992,4.40982856660152,7.95102939475887,101,"ENSG00000079974.19"
"14234","ENSG00000144642.22_1054446",1054438,1054446,9,"ENSG00000144642.22",0,NA,"UVVVVVUVV",2,7,0.788819875776397,48,54,64,67,75,81,133,136,"TTGATGA","TTTA","ATGATGG","CTGA",2.59132614608299,10,8,52,79,1.9074503913489,4.79573950797554,7.95101901108113,101,"ENSG00000079974.19"
"44784","ENSG00000283563.1_1280059",1280051,1280059,9,"ENSG00000283563.1",0,NA,"UVVVVVUVV",2,7,0.788819875776397,48,54,64,67,75,81,133,136,"TTGATGA","TTTA","ATGATGG","CTGA",2.59132614608299,10,8,52,79,1.9074503913489,4.79573950797554,7.95101901108113,101,"ENSG00000079974.19"
"4658","ENSG00000101489.20_126451",126443,126451,9,"ENSG00000101489.20",1,8,"VVVVVVVMV",0,8,0.884057971014493,116,122,133,136,171,177,195,198,"ATGATCA","CTCC","ATGTAAA","CTGA",2.40425356346688,11,35,18,73,1.63075121471229,4.41477707612287,7.95100896018084,101,"ENSG00000079974.19"
"29416","ENSG00000197959.15_473193",473185,473193,9,"ENSG00000197959.15",0,NA,"VVVVVVUVV",1,8,0.886128364389234,103,109,133,136,151,157,177,180,"AAGATGT","CTGT","AGGATTA","CTGA",2.45065881911376,24,15,20,68,1.28824710871756,4.40649314236899,7.95100659992593,101,"ENSG00000079974.19"
"47548","ENSG00000288692.1_106081",106073,106081,9,"ENSG00000288692.1",1,1,"MVVVVVVVV",0,8,0.90600414078675,97,103,133,136,174,180,190,193,"GTGATAA","TTGT","GTGATAG","CTGA",2.43798488305455,30,38,10,87,1.05462703226928,4.32696489649157,7.95098145963857,101,"ENSG00000079974.19"
"38280","ENSG00000249881.1_43045",43037,43045,9,"ENSG00000249881.1",1,1,"MVVVVVVVV",0,8,0.90600414078675,111,117,133,136,148,154,165,168,"ATCTTGC","GGGA","ATGAGCA","CTGA",2.20746843917005,16,12,11,48,2.59136078271335,4.32695426096176,7.95097082410875,101,"ENSG00000079974.19"
"37651","ENSG00000248636.7_10648",10640,10648,9,"ENSG00000248636.7",1,8,"VVVVVVVMV",0,8,0.884057971014493,104,110,133,136,151,157,180,183,"AGGATGA","TTTA","AGGAGGA","CTGA",2.47099704625274,23,15,23,70,1.18553873472185,4.4147130941017,7.95094497815967,101,"ENSG00000079974.19"
"4591","ENSG00000101230.6_27671",27663,27671,9,"ENSG00000101230.6",0,NA,"UVVVVUVVV",2,7,0.824844720496894,88,94,102,105,111,117,133,136,"ATGATGT","TTGA","ATGAAAA","CTGT",2.41318476775248,8,6,16,39,2.51825975201164,4.6515395509237,7.95091843291128,101,"ENSG00000079974.19"
"20071","ENSG00000164199.18_613193",613185,613193,9,"ENSG00000164199.18",1,1,"MVVVVVVVV",0,8,0.90600414078675,53,59,71,74,78,84,133,136,"CTGATTT","CTGA","CTGAAGA","CTCA",2.31998271727343,12,4,49,74,1.84095922750712,4.32687766899916,7.95089423214616,101,"ENSG00000079974.19"
"29249","ENSG00000197563.11_212026",212018,212026,9,"ENSG00000197563.11",1,2,"VMVVVUVVV",1,7,0.806211180124223,111,117,133,136,157,163,216,219,"GTCATGA","CTGA","GTGATTT","CTGA",2.67399274495031,16,21,53,99,1.07752746881011,4.72603644211972,7.95088116261661,101,"ENSG00000079974.19"
"28614","ENSG00000196233.14_62483",62475,62483,9,"ENSG00000196233.14",0,NA,"UVVVVVVVV",1,8,0.902691511387163,104,110,133,136,174,180,194,197,"ATGATGT","ATGA","TTGATTA","CTGT",2.43074842418112,23,38,14,84,1.15544534412731,4.34010870966703,7.95087475521568,101,"ENSG00000079974.19"
"6961","ENSG00000112365.6_16049",16041,16049,9,"ENSG00000112365.6",1,1,"MVVVVVVVV",0,8,0.90600414078675,102,108,133,136,139,145,165,168,"ATAATGA","ATGC","ATTCTGG","CTGA",2.3877495370639,25,3,20,57,1.38902795437883,4.32683955036788,7.95085611351488,101,"ENSG00000079974.19"
"31983","ENSG00000225535.7_94188",94180,94188,9,"ENSG00000225535.7",1,8,"VVVVVUVMV",1,7,0.806211180124224,39,45,59,62,111,117,133,136,"ATGATGA","CTTA","GTGAGGA","CTTA",2.57705645872495,14,49,16,88,1.72351977408503,4.72597404139617,7.95081876189307,101,"ENSG00000079974.19"
"43905","ENSG00000275186.1_653",645,653,9,"ENSG00000275186.1",1,8,"VVVVVVVMV",0,8,0.884057971014493,103,109,133,136,147,153,163,166,"ATGATGA","AAGA","GTCAGGG","CTAA",2.34074563371927,24,11,10,54,2.05316613434392,4.41453425645143,7.95076614050941,101,"ENSG00000079974.19"
"22892","ENSG00000171714.13_294046",294038,294046,9,"ENSG00000171714.13",1,5,"VVVUMVVVV",1,7,0.767287784679089,91,97,133,136,144,150,160,163,"ATGATGA","TGGA","GTAATGG","CTGA",2.63005858251869,36,8,10,63,1.99267293881088,4.8815992055672,7.95075034428356,101,"ENSG00000079974.19"
"2967","ENSG00000079819.20_221099",221091,221099,9,"ENSG00000079819.20",1,2,"VMVVVUVVV",1,7,0.806211180124223,93,99,133,136,139,145,157,160,"GTAATGA","ATGA","TTGATTA","CTGA",2.58488600105379,34,3,12,58,1.67103336579888,4.72590167653937,7.95074639703626,101,"ENSG00000079974.19"
"30691","ENSG00000206561.14_54455",54447,54455,9,"ENSG00000206561.14",1,6,"VVVVVMVVV",0,8,0.902691511387163,106,112,133,136,138,144,154,157,"AAGATGA","ATGA","ATGAGTT","CTCA",2.31109487656026,21,2,10,42,1.95242585596718,4.33993125825889,7.95069730380754,101,"ENSG00000079974.19"
"16821","ENSG00000152377.14_366304",366296,366304,9,"ENSG00000152377.14",1,2,"VMVUVVVVV",1,7,0.764803312629399,110,116,133,136,147,153,165,168,"GTGTTGA","CTTA","GTGAAAA","CTGA",2.55243183031592,17,11,12,49,2.54934746839704,4.89138991762579,7.95060316814339,101,"ENSG00000079974.19"
"33948","ENSG00000231607.15_127324",127316,127324,9,"ENSG00000231607.15",1,6,"VVVVVMVVV",0,8,0.902691511387163,111,117,133,136,138,144,154,157,"ATAAGGT","GTGT","ATGAAAA","CTGA",2.23760179591526,16,2,10,37,2.44195526195229,4.33982514201351,7.95059118756216,101,"ENSG00000079974.19"
"22880","ENSG00000171643.14_44951",44943,44951,9,"ENSG00000171643.14",1,8,"VVVVVVVMV",0,8,0.884057971014493,116,122,133,136,144,150,163,166,"ATAATCA","CTAT","ATTTTTA","CTGA",2.21287388918552,11,8,13,41,2.90473314802163,4.41430643564794,7.95053831970591,101,"ENSG00000079974.19"
"22296","ENSG00000170242.19_100927",100919,100927,9,"ENSG00000170242.19",1,7,"VVVVVUMVV",1,7,0.807453416149068,58,64,101,104,111,117,133,136,"ATGATGA","CTGA","ATGTAGG","CCGA",2.56798986486486,37,7,16,69,1.76278601917393,4.72067961290159,7.95049327749786,101,"ENSG00000079974.19"
"22516","ENSG00000170703.16_54642",54634,54642,9,"ENSG00000170703.16",1,7,"VVVVVVMVV",0,8,0.885300207039338,110,116,133,136,185,191,216,219,"ATGATTT","CTCA","ATGAGGT","CTGA",2.49118473792235,17,49,25,100,1.02919013641179,4.40927209730686,7.95047292546421,101,"ENSG00000079974.19"
"15092","ENSG00000147044.23_254946",254938,254946,9,"ENSG00000147044.23",1,2,"VMVVVVVVV",0,8,0.884057971014493,111,117,133,136,140,146,159,162,"ATGTTGC","TTTA","ATATTTA","CTGA",2.25666879995775,16,4,13,42,2.61219636013829,4.41416375663083,7.9503956406888,101,"ENSG00000079974.19"
"27083","ENSG00000185532.20_652457",652449,652457,9,"ENSG00000185532.20",1,2,"VMVVVUVVV",1,7,0.806211180124223,96,102,133,136,148,154,166,169,"TTGATGC","CAGA","CTGCTGA","CTGA",2.57186737391692,31,12,12,64,1.75596615282437,4.72543716140096,7.95028188189785,101,"ENSG00000079974.19"
"16558","ENSG00000151789.13_541800",541792,541800,9,"ENSG00000151789.13",1,1,"MVVVVUVVV",1,7,0.82815734989648,84,90,102,105,116,122,133,136,"ATGAGAA","TGGA","ATGAAGT","CTGA",2.35756715363391,12,11,11,43,2.83341122144213,4.63763139475039,7.95026079433631,101,"ENSG00000079974.19"
"33400","ENSG00000229618.3_817151",817143,817151,9,"ENSG00000229618.3",0,NA,"UVVVVVVVV",1,8,0.902691511387163,109,115,133,136,147,153,192,195,"ATGACAA","ATGA","AGGAAAA","CTGA",2.37473244815368,18,11,39,77,1.52637767092889,4.33948183132168,7.95024787687033,101,"ENSG00000079974.19"
"2508","ENSG00000075391.18_274243",274235,274243,9,"ENSG00000075391.18",1,6,"VVVVVMVVV",0,8,0.902691511387163,91,97,111,114,116,122,133,136,"TTGTTGT","CTGA","CTAATGT","CTTA",2.2170521255957,14,2,11,36,2.57747349206256,4.33945524900848,7.95022129455713,101,"ENSG00000079974.19"
"39463","ENSG00000253634.3_124968",124960,124968,9,"ENSG00000253634.3",1,2,"VMVVVVVVV",0,8,0.884057971014493,91,97,103,106,115,121,133,136,"ATGTTGA","CTAA","TTCCTGA","CTAA",2.27359412811079,6,9,12,36,2.4986479710447,4.4139855396125,7.95021742367047,101,"ENSG00000079974.19"
"4041","ENSG00000092421.17_108415",108407,108415,9,"ENSG00000092421.17",1,5,"VVVVMVVVV",0,8,0.886542443064182,46,52,72,75,90,96,133,136,"AAGATGG","TTGA","CTGATTT","CTGA",2.48030376950451,20,15,37,81,1.08080214747803,4.40404015271035,7.95020992496708,101,"ENSG00000079974.19"
"21034","ENSG00000166265.13_64111",64103,64111,9,"ENSG00000166265.13",0,NA,"VVVUVVVVV",1,8,0.880745341614907,60,66,108,111,114,120,133,136,"TTGATGT","CTGA","GGGAGGA","ATGA",2.41323610604001,42,3,13,67,1.62066013843731,4.42722521134267,7.9502065778023,101,"ENSG00000079974.19"
"11187","ENSG00000134198.10_39469",39461,39469,9,"ENSG00000134198.10",1,5,"VVVVMVVVV",0,8,0.886542443064182,114,120,133,136,144,150,167,170,"TTAATGG","GTAA","GAGATCA","CTGA",2.24000006655702,13,8,17,47,2.68264508947955,4.40399471663159,7.95016448888832,101,"ENSG00000079974.19"
"7178","ENSG00000113194.13_43108",43100,43108,9,"ENSG00000113194.13",1,2,"VMVVVVVVV",0,8,0.884057971014493,112,118,133,136,141,147,192,195,"AGAATGA","TTAA","ATAATGA","CTGA",2.37109838286338,15,5,45,74,1.8482781225532,4.41390016874393,7.9501320528019,101,"ENSG00000079974.19"
"5397","ENSG00000104419.17_14656",14648,14656,9,"ENSG00000104419.17",1,2,"VMVVVUVVV",1,7,0.806211180124223,72,78,89,92,98,104,133,136,"CTGGTGT","CTGA","GTGTTGG","CTGA",2.51902423992447,11,6,29,55,2.10759721481218,4.72527303691049,7.95011775740739,101,"ENSG00000079974.19"
"42456","ENSG00000263438.6_29941",29933,29941,9,"ENSG00000263438.6",1,8,"VVVVVVVMV",0,8,0.884057971014493,113,119,133,136,144,150,159,162,"TTCATGC","CTTT","ATCGTGA","CTGA",2.20098059344921,14,8,9,40,2.98227872674073,4.4138706707672,7.95010255482517,101,"ENSG00000079974.19"
"30194","ENSG00000204110.7_22698",22690,22698,9,"ENSG00000204110.7",1,6,"VVVVVMVVV",0,8,0.902691511387163,109,115,133,136,144,150,160,163,"AGGGGGA","TTGC","GTGAGTA","CTGA",2.20467454625925,18,8,10,45,2.65898769979868,4.33920450204841,7.94997054759707,101,"ENSG00000079974.19"
"26974","ENSG00000185352.9_140233",140225,140233,9,"ENSG00000185352.9",1,2,"VMVVVUVVV",1,7,0.806211180124223,80,86,102,105,114,120,133,136,"ATGATGA","TTGA","ACGGAGA","CTCA",2.42850154905263,16,9,13,47,2.71037359831085,4.72509598133209,7.94994070182899,101,"ENSG00000079974.19"
"12364","ENSG00000137968.17_212097",212089,212097,9,"ENSG00000137968.17",0,NA,"VVUVVVVVV",1,8,0.883643892339545,113,119,133,136,150,156,174,177,"ATGAAGT","CAGC","AGTATGA","CTGA",2.31578810155762,14,14,18,55,2.2227923270347,4.41534491768804,7.94992048704622,101,"ENSG00000079974.19"
"19108","ENSG00000161526.15_6032",6024,6032,9,"ENSG00000161526.15",1,2,"VMVVVVUVV",1,7,0.770186335403727,116,122,133,136,145,151,162,165,"ATGCTGA","TGGA","CTGAGAA","CTGA",2.47986290121636,11,9,11,40,2.94427865833799,4.86917449994509,7.94991984156,101,"ENSG00000079974.19"
"42999","ENSG00000267575.9_60715",60707,60715,9,"ENSG00000267575.9",1,1,"MVVVVVVVV",0,8,0.90600414078675,86,92,133,136,181,187,198,201,"CTAATGA","ATGA","ATGTTTG","CTGA",2.44711515858111,41,45,11,106,0.989465826332673,4.32589172088502,7.94990828403202,101,"ENSG00000079974.19"
"26682","ENSG00000184903.10_161894",161886,161894,9,"ENSG00000184903.10",1,3,"VVMVVVVVV",0,8,0.882815734989648,109,115,133,136,138,144,161,164,"ATGGGGA","CTGT","GTTCAGA","CTGA",2.36718581276231,18,2,17,46,1.89331846554193,4.41863930432267,7.94990224428127,101,"ENSG00000079974.19"
"41741","ENSG00000259647.1_30229",30221,30229,9,"ENSG00000259647.1",1,7,"VVVVVVMVV",0,8,0.885300207039338,67,73,86,89,98,104,133,136,"ATGATCA","CAGA","TTGACAA","CTCA",2.33091053483795,13,9,29,60,2.09512994249798,4.40863337702107,7.94983420517842,101,"ENSG00000079974.19"
"24047","ENSG00000174953.14_8416",8408,8416,9,"ENSG00000174953.14",1,7,"VVVVUVMVV",1,7,0.775155279503105,113,119,133,136,138,144,152,155,"ATGATAA","CAGA","ATCCTGG","CTGA",2.50786504457629,14,2,8,33,2.67753215470937,4.84915811297115,7.94977923098357,101,"ENSG00000079974.19"
"41193","ENSG00000258661.1_5935",5927,5935,9,"ENSG00000258661.1",1,2,"VMVVVVVVV",0,8,0.884057971014493,102,108,133,136,150,156,168,171,"ATAATGA","TTCA","AGGCTAA","CTGA",2.38523108071644,25,14,12,60,1.75259129617165,4.41353295857032,7.94976484262829,101,"ENSG00000079974.19"
"34248","ENSG00000232286.1_337",329,337,9,"ENSG00000232286.1",1,6,"VVVVVMVVV",0,8,0.902691511387163,115,121,133,136,181,187,203,206,"ATAATGG","CTTG","ATGCTGC","CTGA",2.33916277055691,12,45,16,82,1.76130372536612,4.33893054893638,7.94969659448503,101,"ENSG00000079974.19"
"11627","ENSG00000135547.9_12466",12458,12466,9,"ENSG00000135547.9",1,3,"VVMVVVVVV",0,8,0.882815734989648,115,121,133,136,183,189,209,212,"TTGGGGA","CTGA","GTGAGAG","CTGA",2.42331593679071,12,47,20,88,1.5182782258976,4.41842945112558,7.94969239108417,101,"ENSG00000079974.19"
"4932","ENSG00000102452.18_323342",323334,323342,9,"ENSG00000102452.18",1,1,"MVVVVVVVV",0,8,0.90600414078675,107,113,133,136,145,151,162,165,"TTGATGA","TTAA","TGGATTA","GTGA",2.23121237120271,20,9,11,49,2.4279168125345,4.32566648847147,7.94968305161847,101,"ENSG00000079974.19"
"10628","ENSG00000131981.16_9128",9120,9128,9,"ENSG00000131981.16",1,1,"MVVVVVVVV",0,8,0.90600414078675,116,122,133,136,147,153,192,195,"ATAAGGA","ACGA","TTGATCT","CTGA",2.32017487701826,11,11,39,70,1.83479874919283,4.32565781566197,7.94967437880897,101,"ENSG00000079974.19"
"26566","ENSG00000184408.10_76288",76280,76288,9,"ENSG00000184408.10",1,3,"UVMVVVVVV",1,7,0.785507246376811,116,122,133,136,140,146,156,159,"ATTATTA","CTGA","ACTATTA","CTGA",2.43767374687673,11,4,10,34,2.97925104248428,4.80760233874895,7.9496313242562,101,"ENSG00000079974.19"
"36274","ENSG00000239482.6_28893",28885,28893,9,"ENSG00000239482.6",1,2,"VMVVVVVVV",0,8,0.884057971014493,116,122,133,136,142,148,188,191,"CTGTTGA","CAGA","GTGAAGA","GTGA",2.35116164654548,11,6,40,66,1.97905054103372,4.4133653795009,7.94959726355887,101,"ENSG00000079974.19"
"26317","ENSG00000183833.16_25082",25074,25082,9,"ENSG00000183833.16",0,NA,"VVVUUVVVV",2,7,0.770600414078675,45,51,63,66,72,78,133,136,"ATGATGA","ATGA","ATGATGA","CTGT",2.62261563984421,12,6,55,82,1.98465839347246,4.86719066477513,7.94959232108983,101,"ENSG00000079974.19"
"45449","ENSG00000285585.1_25028",25020,25028,9,"ENSG00000285585.1",0,NA,"VVVUUVVVV",2,7,0.770600414078675,45,51,63,66,72,78,133,136,"ATGATGA","ATGA","ATGATGA","CTGT",2.62261563984421,12,6,55,82,1.98465839347246,4.86719066477513,7.94959232108983,101,"ENSG00000079974.19"
"16600","ENSG00000151835.17_80188",80180,80188,9,"ENSG00000151835.17",1,2,"VMVVVVVVV",0,8,0.884057971014493,114,120,133,136,146,152,165,168,"GTGATAA","CTCC","GTGATGG","CTTA",2.22516728045284,13,10,13,45,2.8189809746876,4.41335737775997,7.94958926181794,101,"ENSG00000079974.19"
"23857","ENSG00000174469.23_1571439",1571431,1571439,9,"ENSG00000174469.23",0,NA,"VVVVUVVVV",1,8,0.889855072463768,72,78,98,101,115,121,133,136,"GTGATGA","CTGA","TTAATGA","GAGA",2.32340539450631,20,14,12,55,2.07125520811073,4.39015612620487,7.94957641605994,101,"ENSG00000079974.19"
"47019","ENSG00000287523.1_116519",116511,116519,9,"ENSG00000287523.1",0,NA,"UVVVVVVVV",1,8,0.902691511387163,79,85,97,100,108,114,133,136,"GAGATGA","GTGA","ATCAAGC","CTGT",2.21867390781569,12,8,19,48,2.56391001398769,4.33876734985641,7.94953339540506,101,"ENSG00000079974.19"
"30897","ENSG00000214562.15_11562",11554,11562,9,"ENSG00000214562.15",0,NA,"VVVVUVVVV",1,8,0.889855072463768,103,109,133,136,159,165,173,176,"ATGATGG","GAGA","GACACGA","CTGA",2.42832430053627,24,23,8,64,1.3712460453332,4.39001867889375,7.94943896874882,101,"ENSG00000079974.19"
"29486","ENSG00000198060.10_32805",32797,32805,9,"ENSG00000198060.10",0,NA,"VVVVUVVVV",1,8,0.889855072463768,84,90,100,103,111,117,133,136,"ATGATTG","ATGA","ATGTTTA","TTGA",2.23246047166438,10,8,16,43,2.67685428117121,4.38998102306677,7.94940131292185,101,"ENSG00000079974.19"
"7275","ENSG00000113448.20_1395587",1395579,1395587,9,"ENSG00000113448.20",1,8,"VVVVUVVMV",1,7,0.773913043478261,81,87,106,109,116,122,133,136,"GTAATGA","CTGT","TTGAAAA","CTGA",2.52723052799625,19,7,11,46,2.56672208124723,4.85373140030556,7.9493835742186,101,"ENSG00000079974.19"
"18531","ENSG00000157600.12_59889",59881,59889,9,"ENSG00000157600.12",1,7,"VVVVVVMVV",0,8,0.885300207039338,116,122,133,136,151,157,204,207,"ATTATGG","TTCA","TTGAAGA","CTGA",2.41489143090432,11,15,47,82,1.53342437983911,4.40817514646697,7.94937597462432,101,"ENSG00000079974.19"
"8110","ENSG00000116833.14_20646",20638,20646,9,"ENSG00000116833.14",1,8,"VVVVVVVMV",0,8,0.884057971014493,112,118,133,136,175,181,194,197,"CTGAAGC","CTCA","GTGATCC","CTGA",2.37222475155984,15,39,13,76,1.83764798338568,4.41311991511281,7.94935179917078,101,"ENSG00000079974.19"
"25356","ENSG00000181072.12_60320",60312,60320,9,"ENSG00000181072.12",1,6,"VVVVVMUVV",1,7,0.788819875776397,114,120,133,136,139,145,155,158,"TTGATGA","CTGT","ATGATGT","CTGT",2.45221841126968,13,3,10,35,2.82812012749484,4.79406071732318,7.94934022042877,101,"ENSG00000079974.19"
"981","ENSG00000042781.14_555164",555156,555164,9,"ENSG00000042781.14",1,3,"VVMVVVVVV",0,8,0.882815734989648,73,79,89,92,96,102,133,136,"ATGAATA","ATGA","AAGCAGA","CTGA",2.3710763131902,10,4,31,54,1.8643156558615,4.41787276928238,7.94913570924097,101,"ENSG00000079974.19"
"16358","ENSG00000151388.11_341264",341256,341264,9,"ENSG00000151388.11",1,1,"MVVVVUVVV",1,7,0.82815734989648,113,119,133,136,174,180,195,198,"GTGATGG","TGGA","GGGATGA","CTGA",2.51303454763342,14,38,15,76,1.79203910199155,4.63640068822025,7.94903008780617,101,"ENSG00000079974.19"
"25702","ENSG00000182621.18_125923",125915,125923,9,"ENSG00000182621.18",1,2,"VMVVVVVVV",0,8,0.884057971014493,114,120,133,136,139,145,159,162,"CTGGAGA","CTAG","TTGAGGA","CTGA",2.2557506890211,13,3,14,39,2.61265716166711,4.41274877211861,7.94898065617658,101,"ENSG00000079974.19"
"14710","ENSG00000145743.18_478215",478207,478215,9,"ENSG00000145743.18",1,8,"VVVVVVVMV",0,8,0.884057971014493,110,116,133,136,141,147,168,171,"CTAATGG","CTTG","ATGAAGA","CTGA",2.32553332645155,17,5,21,52,2.14704235461545,4.41264946607311,7.94888135013108,101,"ENSG00000079974.19"
"19936","ENSG00000164035.10_397920",397912,397920,9,"ENSG00000164035.10",1,8,"VVVVVVVMV",0,8,0.884057971014493,54,60,68,71,76,82,133,136,"TTCATGA","CTTA","ATTATTT","CTGA",2.39791363666355,8,5,51,73,1.6644811020012,4.41264300327288,7.94887488733085,101,"ENSG00000079974.19"
"35847","ENSG00000237356.7_162306",162298,162306,9,"ENSG00000237356.7",0,NA,"UVVVVVVVV",1,8,0.902691511387163,80,86,99,102,114,120,133,136,"ATAATTA","TTGA","AGGAAGA","TTGA",2.20032055495994,13,12,13,47,2.683370189747,4.33804347236998,7.94880951791863,101,"ENSG00000079974.19"
"16227","ENSG00000151151.6_13764",13756,13764,9,"ENSG00000151151.6",1,8,"VVUVVVVMV",1,7,0.767701863354037,112,118,133,136,145,151,160,163,"GAGATGA","TAGA","TTGAGGA","CTGA",2.49535859692998,15,9,9,42,2.87609901230305,4.87795574795906,7.94876320137521,101,"ENSG00000079974.19"
"21666","ENSG00000168702.18_1267737",1267729,1267737,9,"ENSG00000168702.18",1,1,"MVVVVVVVV",0,8,0.90600414078675,111,117,133,136,142,148,163,166,"ATGGTCA","CAGA","ATGATAG","TTGA",2.19840923375866,16,6,15,46,2.64291398431127,4.32474388567559,7.94876044882259,101,"ENSG00000079974.19"
"17085","ENSG00000153093.20_313218",313210,313218,9,"ENSG00000153093.20",1,8,"VVVVVVVMV",0,8,0.884057971014493,114,120,133,136,146,152,171,174,"GGGGTGA","GAGA","ATGCTGC","CTGA",2.27705752785321,13,10,19,51,2.46958636945555,4.41249247211924,7.94872435617721,101,"ENSG00000079974.19"
"15924","ENSG00000150275.20_54329",54321,54329,9,"ENSG00000150275.20",1,7,"VVVVVVMVV",0,8,0.885300207039338,43,49,63,66,75,81,133,136,"ATGCTGA","TTGA","CTGAAAA","TTGA",2.35709447778891,14,9,52,84,1.91600796311843,4.40749278709445,7.9486936152518,101,"ENSG00000079974.19"
"35682","ENSG00000236744.2_23620",23612,23620,9,"ENSG00000236744.2",1,7,"VVVVVVMVV",0,8,0.885300207039338,43,49,63,66,75,81,133,136,"ATGCTGA","TTGA","CTGAAAA","TTGA",2.35709447778891,14,9,52,84,1.91600796311843,4.40749278709445,7.9486936152518,101,"ENSG00000079974.19"
"31433","ENSG00000223727.6_325987",325979,325987,9,"ENSG00000223727.6",1,1,"MVVVVVVVV",0,8,0.90600414078675,85,91,133,136,146,152,166,169,"AATATGA","AGGA","CTGGGGA","CTGA",2.32925627020866,42,10,14,75,1.77025956387183,4.32465867464905,7.94867523779605,101,"ENSG00000079974.19"
"36514","ENSG00000241553.13_4080",4072,4080,9,"ENSG00000241553.13",1,6,"VVVVVMUVV",1,7,0.788819875776397,111,117,133,136,138,144,154,157,"ATGGTCA","CTGA","GTGGGAA","CTGA",2.50971939432375,16,2,10,37,2.44195526195229,4.79335447269433,7.94863397579992,101,"ENSG00000079974.19"
"38436","ENSG00000250151.9_3493",3485,3493,9,"ENSG00000250151.9",1,6,"VVVVVMUVV",1,7,0.788819875776397,111,117,133,136,138,144,154,157,"ATGGTCA","CTGA","GTGGGAA","CTGA",2.50971939432375,16,2,10,37,2.44195526195229,4.79335447269433,7.94863397579992,101,"ENSG00000079974.19"
"28828","ENSG00000196566.2_43931",43923,43931,9,"ENSG00000196566.2",1,1,"MVVVVVVVV",0,8,0.90600414078675,85,91,133,136,149,155,179,182,"GTGATCA","GTGA","ACGTTTA","CTGA",2.44343973908955,42,13,24,88,1.00871748333419,4.32457893598279,7.94859549912979,101,"ENSG00000079974.19"
"15245","ENSG00000147481.17_626257",626249,626257,9,"ENSG00000147481.17",1,8,"VVVVVVVMV",0,8,0.884057971014493,48,54,62,65,71,77,133,136,"ATAATGA","ATGA","GTGAAAA","CTAA",2.3900701335745,8,6,56,79,1.71543758355161,4.41230961851207,7.94854150257005,101,"ENSG00000079974.19"
"23617","ENSG00000173406.16_458883",458875,458883,9,"ENSG00000173406.16",1,1,"MVVVVUVVV",1,7,0.82815734989648,114,120,133,136,145,151,168,171,"ATGATGA","ATGA","AACATCA","CTTA",2.38468127690984,13,9,17,48,2.64565595626229,4.63588278391531,7.94851218350123,101,"ENSG00000079974.19"
"27757","ENSG00000187323.12_267614",267606,267614,9,"ENSG00000187323.12",1,8,"VVVVVVVMV",0,8,0.884057971014493,115,121,133,136,147,153,190,193,"AAAATGA","TTAA","AAGATGA","CTGA",2.36658066604635,12,11,37,69,1.87181288692869,4.41225433180942,7.94848621586739,101,"ENSG00000079974.19"
"35816","ENSG00000237298.11_244102",244094,244102,9,"ENSG00000237298.11",1,3,"VVMVVVVVV",0,8,0.882815734989648,106,112,133,136,141,147,156,159,"GTTATGT","ATCA","GTATTGA","CTGA",2.29803997356005,21,5,9,44,2.34858436457467,4.41721271374375,7.94847565370234,101,"ENSG00000079974.19"
"25115","ENSG00000179520.11_13725",13717,13725,9,"ENSG00000179520.11",0,NA,"VVVVUVVVV",1,8,0.889855072463768,115,121,133,136,178,184,230,233,"CTGCTGA","GTGA","AGGAGGA","CTGA",2.48176120717019,12,42,46,109,1.01109097673381,4.38904142280044,7.94846171265551,101,"ENSG00000079974.19"
"41977","ENSG00000260192.3_711179",711171,711179,9,"ENSG00000260192.3",0,NA,"VVUVVUVVV",2,7,0.805797101449275,55,61,76,79,100,106,133,136,"GTGATAA","CTGG","CTGATGA","CTGA",2.63243983941893,15,21,27,72,1.35144201431586,4.72526023594384,7.94844864174094,101,"ENSG00000079974.19"
"46006","ENSG00000286111.1_26899",26891,26899,9,"ENSG00000286111.1",0,NA,"VVUVVUVVV",2,7,0.805797101449275,55,61,76,79,100,106,133,136,"GTGATAA","CTGG","CTGATGA","CTGA",2.63243983941893,15,21,27,72,1.35144201431586,4.72526023594384,7.94844864174094,101,"ENSG00000079974.19"
"9268","ENSG00000123572.17_38772",38764,38772,9,"ENSG00000123572.17",1,2,"VMVVVUVVV",1,7,0.806211180124223,52,58,71,74,82,88,133,136,"ATGCTGA","CTTA","TTTATGT","CTGA",2.53569282375466,13,8,45,75,1.98959870861626,4.72355438341184,7.94839910390873,101,"ENSG00000079974.19"
"48184","ENSG00000290564.1_18606",18598,18606,9,"ENSG00000290564.1",1,7,"VVVVVVMVV",0,8,0.885300207039338,55,61,76,79,91,97,133,136,"GTTATGC","GTGA","TTCAAGA","CTGA",2.38639592745858,15,12,36,72,1.71944829667772,4.40718861993373,7.94838944809108,101,"ENSG00000079974.19"
"25137","ENSG00000179676.7_18821",18813,18821,9,"ENSG00000179676.7",1,6,"VVVVVMVVV",0,8,0.902691511387163,108,114,133,136,144,150,201,204,"CTGAGCA","TTGA","ATGAGAA","CTGA",2.36775483427782,19,8,51,87,1.56542761647043,4.3376149612473,7.94838100679596,101,"ENSG00000079974.19"
"32755","ENSG00000227733.12_60099",60091,60099,9,"ENSG00000227733.12",1,1,"MVVVVUVVV",1,7,0.82815734989648,79,85,95,98,104,110,133,136,"TTGAGAA","ATGA","GTGAAGA","CTGA",2.44189500370499,10,6,23,48,2.26364527265876,4.63573632433968,7.9483657239256,101,"ENSG00000079974.19"
"48535","ENSG00000291242.1_65900",65892,65900,9,"ENSG00000291242.1",1,1,"MVVVVUVVV",1,7,0.82815734989648,79,85,95,98,104,110,133,136,"TTGAGAA","ATGA","GTGAAGA","CTGA",2.44189500370499,10,6,23,48,2.26364527265876,4.63573632433968,7.9483657239256,101,"ENSG00000079974.19"
"20379","ENSG00000164756.13_104691",104683,104691,9,"ENSG00000164756.13",1,1,"MVVVVVVVV",0,8,0.90600414078675,49,55,67,70,75,81,133,136,"ATGTTTA","CTGA","CTGAAAA","CAGA",2.30462116879835,12,5,52,78,1.93311981973851,4.32431523626521,7.94833179941221,101,"ENSG00000079974.19"
"46240","ENSG00000286330.1_30066",30058,30066,9,"ENSG00000286330.1",1,7,"VVVVVVMVV",0,8,0.885300207039338,111,117,133,136,187,193,201,204,"ATCATTA","ATAA","GTAATGA","CTGA",2.37145275387746,16,51,8,84,1.81870786447297,4.40709822258067,7.94829905073802,101,"ENSG00000079974.19"
"32838","ENSG00000228061.7_39134",39126,39134,9,"ENSG00000228061.7",1,7,"VVVVVVMVV",0,8,0.885300207039338,88,94,133,136,145,151,174,177,"ATTTTGG","CTGA","ATGAACA","CTGA",2.44748612409163,39,9,23,80,1.31137816048779,4.40698808027466,7.94818890843201,101,"ENSG00000079974.19"
"33319","ENSG00000229337.2_45897",45889,45897,9,"ENSG00000229337.2",0,NA,"VVVVVVUVV",1,8,0.886128364389234,111,117,133,136,180,186,213,216,"ATAATGA","TTTA","TTGAAGT","CTGA",2.48548837023374,16,44,27,96,1.04476609867597,4.40367214172523,7.94818559928217,101,"ENSG00000079974.19"
"27402","ENSG00000186094.18_448065",448057,448065,9,"ENSG00000186094.18",1,8,"VVVVVVVMV",0,8,0.884057971014493,107,113,133,136,168,174,187,190,"GTGATAT","ATGA","CTGGAGA","CTGA",2.430441716879,20,32,13,74,1.4447293640581,4.41191853581286,7.94815041987083,101,"ENSG00000079974.19"
"12321","ENSG00000137869.16_49961",49953,49961,9,"ENSG00000137869.16",1,8,"VVVVVVVMV",0,8,0.884057971014493,113,119,133,136,148,154,173,176,"CTGATTT","AGGA","GTGGGGA","CTGA",2.30137064154895,14,12,19,54,2.30511220618416,4.41189578746095,7.94812767151892,101,"ENSG00000079974.19"
"12049","ENSG00000136936.11_22393",22385,22393,9,"ENSG00000136936.11",1,8,"VVVVVVVMV",0,8,0.884057971014493,92,98,133,136,145,151,167,170,"ACGATGG","CTAA","ATAAACA","CTGA",2.38944338121635,35,9,16,69,1.71772859861249,4.41183778501371,7.94806966907168,101,"ENSG00000079974.19"
"22263","ENSG00000170085.18_64076",64068,64076,9,"ENSG00000170085.18",0,NA,"VVVVVVUVV",1,8,0.886128364389234,107,113,133,136,146,152,164,167,"ATAATAA","CACA","ATACTGA","CTGA",2.290034971993,20,10,12,51,2.34710825270671,4.40350201649834,7.94801547405527,101,"ENSG00000079974.19"
"33808","ENSG00000231204.7_62569",62561,62569,9,"ENSG00000231204.7",0,NA,"VVVVVVUVV",1,8,0.886128364389234,113,119,133,136,144,150,188,191,"ATGGTGG","CTTC","GTGGTGG","CTGA",2.34498201398286,14,8,38,69,1.98075054212953,4.40349099217049,7.94800444972742,101,"ENSG00000079974.19"
"34410","ENSG00000233005.2_159060",159052,159060,9,"ENSG00000233005.2",0,NA,"VVVVVVUVV",1,8,0.886128364389234,113,119,133,136,144,150,188,191,"ATGGTGG","CTTC","GTGGTGG","CTGA",2.34498201398286,14,8,38,69,1.98075054212953,4.40349099217049,7.94800444972742,101,"ENSG00000079974.19"
"30244","ENSG00000204291.11_41483",41475,41483,9,"ENSG00000204291.11",1,7,"VVUVVVMVV",1,7,0.768944099378882,106,112,133,136,139,145,189,192,"ATGATGA","ATGA","ATGACGC","CTGA",2.75533764756621,21,3,44,77,1.11975739811748,4.87216876213973,7.94794515965526,101,"ENSG00000079974.19"
"31863","ENSG00000225087.2_61061",61053,61061,9,"ENSG00000225087.2",1,6,"VVVVVMVVV",0,8,0.902691511387163,84,90,102,105,115,121,133,136,"ATTATGA","ATTA","ACTATGA","CAGA",2.17195334099088,12,10,12,43,2.86881199349382,4.33712523335826,7.94789127890691,101,"ENSG00000079974.19"
"12650","ENSG00000138759.20_181476",181468,181476,9,"ENSG00000138759.20",1,8,"VVVVUVVMV",1,7,0.773913043478261,103,109,133,136,146,152,167,170,"GTGAAGA","CTGA","TAGAAGA","CTGA",2.6213444610807,24,10,15,58,1.93329903347571,4.85223219350343,7.94788436741647,101,"ENSG00000079974.19"
"12608","ENSG00000138688.17_20483",20475,20483,9,"ENSG00000138688.17",1,6,"VVVVVMVVV",0,8,0.902691511387163,101,107,133,136,148,154,189,192,"ATAATGT","GTGA","GAAATGA","CTGA",2.45937945041343,26,12,35,82,0.952533826999528,4.33709920743894,7.94786525298759,101,"ENSG00000079974.19"
"24979","ENSG00000178965.14_78527",78519,78527,9,"ENSG00000178965.14",1,6,"VVVVVMVVV",0,8,0.902691511387163,116,122,133,136,158,164,176,179,"TTATTGA","CTTG","ATGAAGA","CTGA",2.28177891572466,11,22,12,54,2.13647071740144,4.33708253889146,7.94784858444011,101,"ENSG00000079974.19"
"9849","ENSG00000127914.19_73199",73191,73199,9,"ENSG00000127914.19",1,1,"MVVVVVVVV",0,8,0.90600414078675,95,101,133,136,152,158,185,188,"ATGATGC","GTCA","TTGTGGA","CTGA",2.4869401682324,32,16,27,84,0.71566458676543,4.32381642707869,7.94783299022569,101,"ENSG00000079974.19"
"6","ENSG00000000971.17_30114",30106,30114,9,"ENSG00000000971.17",1,6,"VVVVVMVVV",0,8,0.902691511387163,108,114,133,136,142,148,186,189,"ATGACTA","AGGA","TTGCTGA","CTGA",2.36358424232333,19,6,38,72,1.59087272135948,4.33702525087875,7.9477912964274,101,"ENSG00000079974.19"
"47909","ENSG00000289697.1_30016",30008,30016,9,"ENSG00000289697.1",1,6,"VVVVVMVVV",0,8,0.902691511387163,108,114,133,136,142,148,186,189,"ATGACTA","AGGA","TTGCTGA","CTGA",2.36358424232333,19,6,38,72,1.59087272135948,4.33702525087875,7.9477912964274,101,"ENSG00000079974.19"
"45368","ENSG00000285520.1_68330",68322,68330,9,"ENSG00000285520.1",1,1,"MVVVVVVVV",0,8,0.90600414078675,113,119,133,136,185,191,200,203,"ATCATTT","CTAA","TTGACTA","CTGA",2.29967018794545,14,49,9,81,1.96358911568992,4.32368092549824,7.94769748864523,101,"ENSG00000079974.19"
"17084","ENSG00000153093.20_308401",308393,308401,9,"ENSG00000153093.20",1,8,"VVVVVVVMV",0,8,0.884057971014493,111,117,133,136,151,157,169,172,"GTGGGGA","TTGG","GTGTGGA","CTGA",2.2943537984178,16,15,12,52,2.35006582937844,4.4114394547076,7.94767133876557,101,"ENSG00000079974.19"
"16697","ENSG00000152104.12_134919",134911,134919,9,"ENSG00000152104.12",1,7,"UVVVVVMVV",1,7,0.787991718426501,43,49,66,69,73,79,133,136,"ATGAAGA","CTAA","TTGAAGA","CTGA",2.63834338169319,17,4,54,84,1.59368082830878,4.79565917656584,7.94762605027185,101,"ENSG00000079974.19"
"36042","ENSG00000237773.8_47221",47213,47221,9,"ENSG00000237773.8",1,7,"VVVVVVMVV",0,8,0.885300207039338,91,97,105,108,114,120,133,136,"ATGATCA","CAGA","ACTATAA","CAGA",2.23335985916227,8,6,13,36,2.73662182296588,4.40642188767859,7.94762271583594,101,"ENSG00000079974.19"
"18318","ENSG00000157064.11_44008",44000,44008,9,"ENSG00000157064.11",0,NA,"VVUVVUVVV",2,7,0.805797101449275,53,59,77,80,115,121,133,136,"ATTATGA","CAGA","TTGACGG","CTGA",2.58797397760953,18,35,12,74,1.64430367660534,4.72436588183389,7.94755428763099,101,"ENSG00000079974.19"
"17968","ENSG00000155966.14_254122",254114,254122,9,"ENSG00000155966.14",1,6,"UVVVVMVVV",1,7,0.805383022774327,72,78,89,92,110,116,133,136,"ATGTTGA","TTGA","GTTACAA","CTGA",2.52874010721837,11,18,17,55,2.04521797853013,4.72587133999648,7.94740343109378,101,"ENSG00000079974.19"
"2042","ENSG00000069535.14_113355",113347,113355,9,"ENSG00000069535.14",1,1,"MVVVVVVVV",0,8,0.90600414078675,93,99,133,136,145,151,182,185,"ATAATGA","CCCA","ACGATCA","CTGA",2.43352624697156,34,9,31,83,1.06992516999131,4.32335837078376,7.94737493393075,101,"ENSG00000079974.19"
"10035","ENSG00000128908.19_113574",113566,113574,9,"ENSG00000128908.19",1,6,"VVVVVMVVV",0,8,0.902691511387163,102,108,133,136,145,151,185,188,"ATGTTGA","TTGT","TAGATTA","CTGA",2.42405741686218,25,9,34,77,1.18593537309368,4.33657953804372,7.94734558359237,101,"ENSG00000079974.19"
"14553","ENSG00000145362.21_420703",420695,420703,9,"ENSG00000145362.21",1,1,"MVVVVVVVV",0,8,0.90600414078675,109,115,133,136,186,192,209,212,"TTGAAGA","GAGA","ATGTTAA","CTGA",2.38925509503931,18,50,17,94,1.36485888479127,4.32330654626334,7.94732310941033,101,"ENSG00000079974.19"
"9729","ENSG00000126785.13_29015",29007,29015,9,"ENSG00000126785.13",1,1,"MVVVVVVVV",0,8,0.90600414078675,100,106,133,136,152,158,179,182,"GTGAGGA","ATGG","ATGAAAA","CTGA",2.43621412272109,27,16,21,73,1.0516196289912,4.32326177844961,7.94727834159661,101,"ENSG00000079974.19"
"14561","ENSG00000145375.9_111965",111957,111965,9,"ENSG00000145375.9",1,8,"VVVVVVUMV",1,7,0.770186335403727,101,107,133,136,148,154,174,177,"ATAATGA","CTGA","CTGGGGA","CTGA",2.70751844160674,26,12,20,67,1.41584759927046,4.86649263582885,7.94723797744376,101,"ENSG00000079974.19"
"4967","ENSG00000102471.16_37318",37310,37318,9,"ENSG00000102471.16",1,8,"VVVVVVVMV",0,8,0.884057971014493,103,109,133,136,185,191,199,202,"GTGATCA","ATGT","GAGATGA","CTGA",2.46666714750547,24,49,8,90,1.19926795877647,4.41092890220324,7.94716078626121,101,"ENSG00000079974.19"
"26364","ENSG00000183960.9_71405",71397,71405,9,"ENSG00000183960.9",1,8,"VVVVVVVMV",0,8,0.884057971014493,85,91,133,136,139,145,155,158,"ATCATGA","CCTA","GTAACCA","CTGA",2.39131914416782,42,3,10,64,1.70149879048503,4.41090660456762,7.94713848862559,101,"ENSG00000079974.19"
"40556","ENSG00000256995.8_447218",447210,447218,9,"ENSG00000256995.8",1,7,"VVVVVVMVV",0,8,0.885300207039338,94,100,133,136,145,151,195,198,"AGGAGGA","TTGA","AAGATGA","CTGA",2.49698317164836,33,9,44,95,0.976638526060324,4.40579825092901,7.94699907908636,101,"ENSG00000079974.19"
"38169","ENSG00000249738.10_449213",449205,449213,9,"ENSG00000249738.10",1,3,"VVMVVVVVV",0,8,0.882815734989648,115,121,133,136,149,155,164,167,"CACATGA","CGCA","GTGAGTA","CTGA",2.243609948045,12,13,9,43,2.70531919494812,4.41567971214536,7.94694265210395,101,"ENSG00000079974.19"
"25543","ENSG00000182132.14_328125",328117,328125,9,"ENSG00000182132.14",1,2,"VMVVVVVVV",0,8,0.884057971014493,82,88,133,136,140,146,156,159,"TTGATTA","TTGT","ATGCTAA","CTGA",2.37072636439122,45,4,10,68,1.83794479058939,4.41069680496604,7.94692868902401,101,"ENSG00000079974.19"
"30173","ENSG00000203963.12_101426",101418,101426,9,"ENSG00000203963.12",1,1,"MVVVVVVVV",0,8,0.90600414078675,75,81,93,96,106,112,133,136,"GTGTTGA","CTAA","GTGTAGG","CTGC",2.23982650138158,12,10,21,52,2.35895395165083,4.32278265688202,7.94679922002901,101,"ENSG00000079974.19"
"6698","ENSG00000111554.15_20896",20888,20896,9,"ENSG00000111554.15",1,1,"MVVVUUVVV",2,6,0.718012422360248,114,120,133,136,181,187,198,201,"CTGATGA","GTGA","GTGAAGA","CTGA",2.74724405063469,13,45,11,78,1.98400104647668,5.07474034601031,7.9467900354513,101,"ENSG00000079974.19"
"36693","ENSG00000242641.6_16234",16226,16234,9,"ENSG00000242641.6",1,7,"VVVVVVMVV",0,8,0.885300207039338,87,93,103,106,111,117,133,136,"ATGAAGA","AGGA","GAGAAGA","ATGA",2.24696091942133,10,5,16,40,2.6424134007867,4.4055382158989,7.94673904405625,101,"ENSG00000079974.19"
"13410","ENSG00000141376.23_412589",412581,412589,9,"ENSG00000141376.23",1,8,"VVVVVVVMV",0,8,0.884057971014493,114,120,133,136,144,150,164,167,"GAACTGA","ATGA","ATCATGG","CTGA",2.21694972056017,13,8,14,44,2.86230846435328,4.41049331702193,7.9467252010799,101,"ENSG00000079974.19"
"9007","ENSG00000122012.14_90055",90047,90055,9,"ENSG00000122012.14",1,2,"VMVVVVVVV",0,8,0.884057971014493,114,120,133,136,151,157,169,172,"ATTATAT","CTCT","GTGATTA","CTGA",2.26996825901402,13,15,12,49,2.50870554726455,4.41045681850617,7.94668870256414,101,"ENSG00000079974.19"
"24806","ENSG00000178031.18_811220",811212,811220,9,"ENSG00000178031.18",1,2,"VMVVVVVVV",0,8,0.884057971014493,114,120,133,136,151,157,169,172,"ATTATAT","CTCT","GTGATTA","CTGA",2.26996825901402,13,15,12,49,2.50870554726455,4.41045681850617,7.94668870256414,101,"ENSG00000079974.19"
"28283","ENSG00000188612.12_15550",15542,15550,9,"ENSG00000188612.12",1,8,"UVVVVVVMV",1,7,0.786749482401656,114,120,133,136,148,154,162,165,"ATGTGGC","CTGA","TTGCTGA","CTGA",2.4659113396212,13,12,8,42,2.75903702750799,4.799611489579,7.94660941918563,101,"ENSG00000079974.19"
"28451","ENSG00000189159.16_872",864,872,9,"ENSG00000189159.16",1,8,"UVVVVVVMV",1,7,0.786749482401656,114,120,133,136,148,154,162,165,"ATGTGGC","CTGA","TTGCTGA","CTGA",2.4659113396212,13,12,8,42,2.75903702750799,4.799611489579,7.94660941918563,101,"ENSG00000079974.19"
"3119","ENSG00000081189.16_96316",96308,96316,9,"ENSG00000081189.16",1,2,"VMVVVVUVV",1,7,0.770186335403727,108,114,133,136,148,154,185,188,"AAGATGA","CTGA","AAGAAGA","CTGA",2.70202291432223,19,12,31,71,1.44986534085522,4.86583785908418,7.94658320069909,101,"ENSG00000079974.19"
"9800","ENSG00000127328.22_48129",48121,48129,9,"ENSG00000127328.22",1,8,"VVVVVVVMV",0,8,0.884057971014493,83,89,99,102,111,117,133,136,"ATGAAGA","TCGA","TTTATGA","CTCA",2.25062512051005,10,9,16,44,2.63710937770285,4.41031921194246,7.94655109600043,101,"ENSG00000079974.19"
"39172","ENSG00000253197.5_38138",38130,38138,9,"ENSG00000253197.5",1,6,"VVVVVMVVV",0,8,0.902691511387163,110,116,133,136,141,147,158,161,"ATGATTA","GTTA","CTGCTTA","CTTA",2.19801961042965,17,5,11,42,2.689644254218,4.33577708093726,7.94654312648591,101,"ENSG00000079974.19"
"36488","ENSG00000241361.9_2567",2559,2567,9,"ENSG00000241361.9",1,8,"VVVVVVVMV",0,8,0.884057971014493,50,56,74,77,83,89,133,136,"CTGATTA","TTGA","GTGATGA","CTTA",2.39727715766482,18,6,44,77,1.65923615443237,4.41027096804946,7.94650285210743,101,"ENSG00000079974.19"
"48148","ENSG00000290547.1_2763",2755,2763,9,"ENSG00000290547.1",1,8,"VVVVVVVMV",0,8,0.884057971014493,50,56,74,77,83,89,133,136,"CTGATTA","TTGA","GTGATGA","CTTA",2.39727715766482,18,6,44,77,1.65923615443237,4.41027096804946,7.94650285210743,101,"ENSG00000079974.19"
"5630","ENSG00000106028.11_49361",49353,49361,9,"ENSG00000106028.11",1,3,"VVMVVVUVV",1,7,0.768944099378882,113,119,133,136,144,150,165,168,"GTGGTGA","CTGC","CTGATAC","CTGA",2.50666385405929,14,8,15,46,2.77174603734722,4.87070959943562,7.94648599695114,101,"ENSG00000079974.19"
"15829","ENSG00000149948.14_91841",91833,91841,9,"ENSG00000149948.14",1,1,"MVVVVVVVV",0,8,0.90600414078675,111,117,133,136,156,162,183,186,"ATAAAAA","ATGA","TTGAAGA","CTGA",2.35702755200841,16,20,21,66,1.57620538310918,4.32243059912465,7.94644716227165,101,"ENSG00000079974.19"
"36009","ENSG00000237693.5_30226",30218,30226,9,"ENSG00000237693.5",1,2,"VMVVVVVVV",0,8,0.884057971014493,98,104,133,136,138,144,153,156,"ATGAAGG","ACGA","CTGCTGA","CTGA",2.40850862360888,29,2,9,49,1.58364168116353,4.41009145963902,7.94632334369699,101,"ENSG00000079974.19"
"45223","ENSG00000285219.4_716453",716445,716453,9,"ENSG00000285219.4",1,8,"VVVVVVVMV",0,8,0.884057971014493,98,104,133,136,138,144,153,156,"ATGAAGG","ACGA","CTGCTGA","CTGA",2.40850862360888,29,2,9,49,1.58364168116353,4.41009145963902,7.94632334369699,101,"ENSG00000079974.19"
"34261","ENSG00000232310.10_53461",53453,53461,9,"ENSG00000232310.10",1,7,"VVVVVVMVV",0,8,0.885300207039338,109,115,133,136,164,170,182,185,"ATGGTGG","TTGT","GTGAAAA","CTGA",2.38840622668117,18,28,12,67,1.69776303084789,4.40511780218059,7.94631863033794,101,"ENSG00000079974.19"
"504","ENSG00000014824.14_83937",83929,83937,9,"ENSG00000014824.14",1,1,"MVVVVUVVV",1,7,0.82815734989648,114,120,133,136,155,161,169,172,"GTGATCA","GAGA","GGGAAGA","CTGA",2.43524854570593,13,19,8,49,2.29971364386465,4.63367598714271,7.94630538672863,101,"ENSG00000079974.19"
"31363","ENSG00000223561.8_50128",50120,50128,9,"ENSG00000223561.8",1,8,"VVVVUVVMV",1,7,0.773913043478261,110,116,133,136,147,153,169,172,"ATGCTGA","CTTA","AAGATGT","CTGA",2.55807458051142,17,11,16,53,2.34877699722068,4.85065188349087,7.94630405740391,101,"ENSG00000079974.19"
"7207","ENSG00000113300.13_71965",71957,71965,9,"ENSG00000113300.13",1,1,"MVVVVVVVV",0,8,0.90600414078675,66,72,90,93,96,102,133,136,"GTGGTCA","CCGA","ATGTTGC","CTGA",2.37221035548916,18,3,31,61,1.47436911152144,4.32227620369563,7.94629276684262,101,"ENSG00000079974.19"
"1993","ENSG00000068781.21_21791",21783,21791,9,"ENSG00000068781.21",1,2,"VMVVVVVVV",0,8,0.884057971014493,115,121,133,136,138,144,154,157,"AGGAGCA","CTGG","ATGAGTC","CTGA",2.23597420255765,12,2,10,33,2.73361353275093,4.41002705411714,7.94625893817511,101,"ENSG00000079974.19"
"36835","ENSG00000243244.7_22333",22325,22333,9,"ENSG00000243244.7",1,2,"VMVVVVVVV",0,8,0.884057971014493,115,121,133,136,138,144,154,157,"AGGAGCA","CTGG","ATGAGTC","CTGA",2.23597420255765,12,2,10,33,2.73361353275093,4.41002705411714,7.94625893817511,101,"ENSG00000079974.19"
"44444","ENSG00000282218.1_34908",34900,34908,9,"ENSG00000282218.1",1,8,"VVVVUVVMV",1,7,0.773913043478261,41,47,57,60,72,78,133,136,"ATGATGG","CTGA","GCCAGGA","CTGA",2.65748321539606,10,12,55,86,1.6858708041052,4.85060639335307,7.94625856726611,101,"ENSG00000079974.19"
"22389","ENSG00000170448.12_30865",30857,30865,9,"ENSG00000170448.12",1,8,"VVVVVVVMV",0,8,0.884057971014493,108,114,133,136,140,146,183,186,"GTTATGG","CAGA","CTGAGAA","CTGA",2.42829791569723,19,4,37,69,1.45116221396723,4.40995374632053,7.9461856303785,101,"ENSG00000079974.19"
"2914","ENSG00000079246.16_31955",31947,31955,9,"ENSG00000079246.16",1,2,"VMVVVUVVV",1,7,0.806211180124223,106,112,133,136,186,192,216,219,"ATGAGGA","CTGA","ATGAGAA","CTGA",2.72412125207423,21,50,24,104,0.724554721615506,4.72134076719427,7.94618548769116,101,"ENSG00000079974.19"
"44391","ENSG00000281566.4_431629",431621,431629,9,"ENSG00000281566.4",1,1,"MVVVVVVVV",0,8,0.90600414078675,111,117,133,136,140,146,157,160,"ATGTGGG","CGAA","ATGATTG","CTGA",2.18910360202012,16,4,11,40,2.69455314292949,4.32214428909924,7.94616085224624,101,"ENSG00000079974.19"
"21508","ENSG00000168079.17_50372",50364,50372,9,"ENSG00000168079.17",0,NA,"VVVVVVUVV",1,8,0.886128364389234,114,120,133,136,176,182,201,204,"GTGAAGA","GTGC","GGGATAA","CTGA",2.40423978209007,13,40,19,81,1.57831147124565,4.40164417129486,7.9461576288518,101,"ENSG00000079974.19"
"39628","ENSG00000253948.4_4492",4484,4492,9,"ENSG00000253948.4",0,NA,"UVVVVVVVV",1,8,0.902691511387163,106,112,133,136,145,151,167,170,"ATGATTA","CTGT","GTAAAAA","GTGA",2.28336908050808,21,9,16,55,2.11894476243753,4.33535132478952,7.94611737033817,101,"ENSG00000079974.19"
"34806","ENSG00000234173.1_118040",118032,118040,9,"ENSG00000234173.1",0,NA,"UVVVVVVVV",1,8,0.902691511387163,70,76,92,95,113,119,133,136,"GTGAAGA","TTGA","CTGTTGT","CTGT",2.28889644449626,16,18,14,57,2.08200548249184,4.33532877811673,7.94609482366539,101,"ENSG00000079974.19"
"12532","ENSG00000138496.17_1352",1344,1352,9,"ENSG00000138496.17",0,NA,"VVVVVVUVV",1,8,0.886128364389234,114,120,133,136,140,146,154,157,"ATTTAGA","TTGA","GCAGTGA","CTGA",2.19389888146544,13,4,8,34,2.98024488749675,4.40155935764993,7.94607281520686,101,"ENSG00000079974.19"
"38961","ENSG00000251363.3_20965",20957,20965,9,"ENSG00000251363.3",0,NA,"VVVVVVUVV",1,8,0.886128364389234,111,117,133,136,143,149,171,174,"GTGATTT","CATA","TTGAAAA","CTGA",2.30409831350442,16,7,22,54,2.24556648166173,4.40155547625614,7.94606893381307,101,"ENSG00000079974.19"
"14476","ENSG00000145087.13_317024",317016,317024,9,"ENSG00000145087.13",1,7,"VVVVVVMVV",0,8,0.885300207039338,101,107,133,136,151,157,175,178,"ATGAGGA","AGGA","CTATTGA","CTGA",2.4443786261567,26,15,18,68,1.32348336475738,4.40483521811718,7.94603604627453,101,"ENSG00000079974.19"
"30988","ENSG00000215068.10_13023",13015,13023,9,"ENSG00000215068.10",1,1,"MVVVVVVVV",0,8,0.90600414078675,75,81,90,93,100,106,133,136,"TTGAAGA","ATGA","GTGAGAA","ATGA",2.28712038333404,9,7,27,52,2.04010668826068,4.32189397762191,7.9459105407689,101,"ENSG00000079974.19"
"2458","ENSG00000075035.10_1894",1886,1894,9,"ENSG00000075035.10",1,8,"VVVVVVVMV",0,8,0.884057971014493,113,119,133,136,143,149,170,173,"TTGATGT","CTGG","GTCAGGA","CTCA",2.2820770060429,14,7,21,51,2.42466892800458,4.40962890873932,7.94586079279729,101,"ENSG00000079974.19"
"21173","ENSG00000166743.10_62608",62600,62608,9,"ENSG00000166743.10",1,2,"VMVVVVVVV",0,8,0.884057971014493,109,115,133,136,149,155,172,175,"AGGATTA","GAGA","GAGATGG","CTGA",2.33704907594682,18,13,17,57,2.05810914154574,4.40960907863114,7.94584096268911,101,"ENSG00000079974.19"
"22367","ENSG00000170396.9_263452",263444,263452,9,"ENSG00000170396.9",0,NA,"UVVVVVVVV",1,8,0.902691511387163,35,41,58,61,72,78,133,136,"ATTAAGA","TTGA","ATACTGC","CTGA",2.36239222484411,17,11,55,92,1.59082720027972,4.33502717481011,7.94579322035876,101,"ENSG00000079974.19"
"24696","ENSG00000177570.15_316339",316331,316339,9,"ENSG00000177570.15",1,8,"VVVVVVVMV",0,8,0.884057971014493,87,93,107,110,115,121,133,136,"GCAATGT","CAGA","GCAAAGA","CTGA",2.21270843993,14,5,12,40,2.88653824664236,4.40948196154393,7.9457138456019,101,"ENSG00000079974.19"
"25143","ENSG00000179715.13_8533",8525,8533,9,"ENSG00000179715.13",0,NA,"UVVVVVVVV",1,8,0.902691511387163,111,117,133,136,145,151,197,200,"GAGATGA","CTTT","ATAAAGC","CTGA",2.33177891117413,16,9,46,80,1.79442210869277,4.33490371246342,7.94566975801207,101,"ENSG00000079974.19"
"9669","ENSG00000126070.20_62437",62429,62437,9,"ENSG00000126070.20",1,6,"VVVVVMVVV",0,8,0.902691511387163,101,107,133,136,146,152,192,195,"ATGTTCA","GTGA","GTCAAGA","CTGA",2.4430347270733,26,10,40,85,1.05232468337178,4.33480571596511,7.94557176151376,101,"ENSG00000079974.19"
"275","ENSG00000007237.19_173691",173683,173691,9,"ENSG00000007237.19",0,NA,"UVVVVVVVV",1,8,0.902691511387163,113,119,133,136,147,153,197,200,"TTGGTGA","ATTA","CAGATGG","CTGA",2.32961002652887,14,11,44,78,1.80807400739666,4.33470187939729,7.94546792494594,101,"ENSG00000079974.19"
"32888","ENSG00000228221.6_69704",69696,69704,9,"ENSG00000228221.6",1,3,"VVMVVVUVV",1,7,0.768944099378882,116,122,133,136,152,158,181,184,"GTGATGT","CTGA","GTGCCAA","CTGA",2.64849039892044,11,16,23,59,1.82211043428997,4.8696782734399,7.94545467095543,101,"ENSG00000079974.19"
"40914","ENSG00000258081.4_423660",423652,423660,9,"ENSG00000258081.4",1,6,"VVUVVMVVV",1,7,0.786335403726708,111,117,133,136,143,149,158,161,"ATGATGC","AAGA","AAGAAAA","CTGA",2.45092650672985,16,7,9,41,2.86068301322478,4.80004826452261,7.94538987942944,101,"ENSG00000079974.19"
"24913","ENSG00000178568.15_896436",896428,896436,9,"ENSG00000178568.15",1,1,"MVVVVVUVV",1,7,0.792132505175983,116,122,133,136,144,150,203,206,"AAAATGA","CTGA","GGGAAGA","CTGA",2.57170351809113,11,8,53,81,1.96261963638499,4.77682743924814,7.94535745995207,101,"ENSG00000079974.19"
"42773","ENSG00000266602.2_19978",19970,19978,9,"ENSG00000266602.2",1,1,"MVVVUVVVV",1,7,0.795859213250517,94,100,106,109,114,120,133,136,"ATGATGG","AAGA","TAGATCA","CTGA",2.4751533182273,6,5,13,33,2.5462754142017,4.76182438392926,7.94526123693133,101,"ENSG00000079974.19"
"82","ENSG00000004779.10_11767",11759,11767,9,"ENSG00000004779.10",1,3,"VVMVVVVVV",0,8,0.882815734989648,116,122,133,136,140,146,159,162,"ATGATGT","CAGC","GTGTTTG","CTAA",2.2267957048674,11,4,13,37,2.81054232819474,4.41396175682769,7.94522469678628,101,"ENSG00000079974.19"
"28027","ENSG00000188001.10_174171",174163,174171,9,"ENSG00000188001.10",1,2,"VMVVVVVVV",0,8,0.884057971014493,66,72,83,86,94,100,133,136,"TTGAGGT","CTGA","GTGATGG","TTGA",2.33978858398296,11,8,33,61,2.03733370261091,4.40898106562434,7.94521294968231,101,"ENSG00000079974.19"
"33418","ENSG00000229676.3_5478",5470,5478,9,"ENSG00000229676.3",1,1,"MVVVVVVVV",0,8,0.90600414078675,81,87,101,104,111,117,133,136,"GTGATGA","CAGA","ATTATGT","ATAA",2.18372892119991,14,7,16,46,2.72653488024608,4.32118192206137,7.94519848520837,101,"ENSG00000079974.19"
"13415","ENSG00000141376.23_534079",534071,534079,9,"ENSG00000141376.23",1,8,"VVVVVVVMV",0,8,0.884057971014493,59,65,81,84,95,101,133,136,"TGGATGA","CTGA","GTGTTGC","CTGT",2.38084038141378,16,11,32,68,1.763355759977,4.40890624235054,7.94513812640851,101,"ENSG00000079974.19"
"24270","ENSG00000175611.14_102175",102167,102175,9,"ENSG00000175611.14",0,NA,"VVVUVVVVV",1,8,0.880745341614907,96,102,133,136,150,156,165,168,"GTGATGG","CAGC","TTCATGC","CTGA",2.40525254394637,31,14,9,63,1.65347514108467,4.42212302518179,7.94510439164142,101,"ENSG00000079974.19"
"43782","ENSG00000273540.5_627066",627058,627066,9,"ENSG00000273540.5",1,1,"MVVVVVVVV",0,8,0.90600414078675,116,122,133,136,182,188,201,204,"ATGGAGA","ATAA","GAGATGG","CTGA",2.30823571273611,11,46,13,79,1.89602581918196,4.32106597602233,7.94508253916933,101,"ENSG00000079974.19"
"4863","ENSG00000102174.10_189720",189712,189720,9,"ENSG00000102174.10",1,2,"VMVVVVVVV",0,8,0.884057971014493,110,116,133,136,150,156,166,169,"TAGATGA","ATGT","GGAATGT","CTGA",2.28850030520446,17,14,10,50,2.37853307465676,4.40880044400495,7.94503232806292,101,"ENSG00000079974.19"
"23906","ENSG00000174473.16_307699",307691,307699,9,"ENSG00000174473.16",1,1,"MVVVVVVVV",0,8,0.90600414078675,32,38,61,64,73,79,133,136,"GTGAGGA","CTGA","ATGATTT","CTCA",2.40892264078904,23,9,54,95,1.22455897016489,4.32101081052296,7.94502737366996,101,"ENSG00000079974.19"
"17044","ENSG00000153015.17_229515",229507,229515,9,"ENSG00000153015.17",1,8,"VVVVVVVMV",0,8,0.884057971014493,82,88,133,136,145,151,190,193,"ATGATGT","TAGA","ATGGAGT","CTGA",2.49886423073951,45,9,39,102,0.975820389466456,4.4087288152658,7.94496069932377,101,"ENSG00000079974.19"
"6056","ENSG00000107864.15_145388",145380,145388,9,"ENSG00000107864.15",1,3,"VVMVVVVVV",0,8,0.882815734989648,105,111,133,136,164,170,191,194,"ATGATAG","GTGA","TTGATGC","CTGA",2.51760551566358,22,28,21,80,0.870733760686446,4.41369263294425,7.94495557290284,101,"ENSG00000079974.19"
"25404","ENSG00000181355.21_154609",154601,154609,9,"ENSG00000181355.21",1,8,"VVVVVVVMV",0,8,0.884057971014493,84,90,133,136,147,153,163,166,"ATGAGAA","CCCA","ATGATAA","CTGA",2.36990151161517,43,11,10,73,1.83554160142268,4.40872125304762,7.94495313710559,101,"ENSG00000079974.19"
"2316","ENSG00000072858.11_91465",91457,91465,9,"ENSG00000072858.11",1,7,"VVVVVVMVV",0,8,0.885300207039338,111,117,133,136,174,180,191,194,"ATGCTTA","TTGA","ATCAACA","CTGA",2.36700918301611,16,38,11,74,1.83470769128648,4.40369222784847,7.94489305600582,101,"ENSG00000079974.19"
"46388","ENSG00000286546.1_47448",47440,47448,9,"ENSG00000286546.1",1,1,"MVVVVVVVV",0,8,0.90600414078675,96,102,133,136,143,149,160,163,"CTGATCA","TTGA","GTGAGAA","GTGA",2.28983893934644,31,7,11,58,2.01781697593565,4.32085247622798,7.94486903937498,101,"ENSG00000079974.19"
"16106","ENSG00000150687.12_77183",77175,77183,9,"ENSG00000150687.12",1,8,"VVVVUVVMV",1,7,0.773913043478261,71,77,94,97,107,113,133,136,"TTCATGA","CTGA","GTGAACT","CTGA",2.58406905052547,17,10,20,56,2.16961579642561,4.84918569998219,7.94483787389523,101,"ENSG00000079974.19"
"22199","ENSG00000169946.14_229411",229403,229411,9,"ENSG00000169946.14",0,NA,"UVVVVVVVV",1,8,0.902691511387163,114,120,133,136,141,147,195,198,"ATCTTGA","TTCA","TTGAATA","CTGA",2.31075983150322,13,5,48,75,1.93089858928242,4.3339910331593,7.94475707870796,101,"ENSG00000079974.19"
"33648","ENSG00000230575.1_640",632,640,9,"ENSG00000230575.1",0,NA,"VVVVVVUVV",1,8,0.886128364389234,54,60,67,70,75,81,133,136,"GTGATGC","CTGA","CTGCTTA","CAGA",2.40842941423503,7,5,52,73,1.54469116113339,4.4002218140084,7.94473527156534,101,"ENSG00000079974.19"
"14925","ENSG00000146151.14_114308",114300,114308,9,"ENSG00000146151.14",0,NA,"VVVUVVVVV",1,8,0.880745341614907,83,89,104,107,115,121,133,136,"TTGATGA","CAAA","GTAAAGG","CAGA",2.22360384691318,15,8,12,44,2.86287027441583,4.42172398012592,7.94470534658555,101,"ENSG00000079974.19"
"41730","ENSG00000259635.1_121",113,121,9,"ENSG00000259635.1",1,2,"VMVVUVVVV",1,7,0.773913043478261,67,73,88,91,102,108,123,126,"TTGAAGG","CTGA","GTGAAGC","CTGA",2.52505263070057,15,11,15,50,2.56243358186305,4.84902944663337,7.94468162054642,101,"ENSG00000079974.19"
"29752","ENSG00000198673.11_413906",413898,413906,9,"ENSG00000198673.11",1,6,"VVVVVMVVV",0,8,0.902691511387163,82,88,133,136,139,145,160,163,"GTGCTCA","CAGA","TTGGAGA","CTGA",2.37257463993382,45,3,15,72,1.51819524362496,4.3338398774626,7.94460592301126,101,"ENSG00000079974.19"
"11678","ENSG00000135773.13_23493",23485,23493,9,"ENSG00000135773.13",1,2,"VMVUVVVVV",1,7,0.764803312629399,91,97,108,111,116,122,133,136,"CTTTTGA","CTGA","GTGGGGA","CTGA",2.48203224837399,11,5,11,36,2.9946049370839,4.88537164822763,7.94458489874523,101,"ENSG00000079974.19"
"9227","ENSG00000123131.13_19027",19019,19027,9,"ENSG00000123131.13",1,6,"UVVVVMVVV",1,7,0.805383022774327,75,81,97,100,111,117,133,136,"AGGATGC","TTGA","ATCATGT","CTGA",2.46904062077003,16,11,16,52,2.43180036479835,4.72301779248296,7.94454988358027,101,"ENSG00000079974.19"
"38542","ENSG00000250375.2_22926",22918,22926,9,"ENSG00000250375.2",1,1,"MVVVVVVVV",0,8,0.90600414078675,101,107,133,136,153,159,169,172,"TTGTTGA","ATAA","CTGATTT","CTGA",2.35806381359632,26,17,10,62,1.56167179174177,4.3205243039293,7.9445408670763,101,"ENSG00000079974.19"
"46694","ENSG00000287055.1_22195",22187,22195,9,"ENSG00000287055.1",0,NA,"VVVUVVVVV",1,8,0.880745341614907,24,30,40,43,78,84,133,136,"ATGATGA","CTCA","GTGAATA","CTCA",2.51157836804935,10,35,49,103,0.94233323727597,4.4215472560679,7.94452862252753,101,"ENSG00000079974.19"
"48426","ENSG00000291093.1_62773",62765,62773,9,"ENSG00000291093.1",1,3,"VVMVVVVVV",0,8,0.882815734989648,93,99,133,136,145,151,161,164,"ATGATTT","CAAA","ATTAAGA","CTGA",2.35353643176262,34,9,10,62,1.96265184870866,4.41322368178153,7.94448662174012,101,"ENSG00000079974.19"
"42160","ENSG00000260951.2_613",605,613,9,"ENSG00000260951.2",1,1,"MVVVVVVVV",0,8,0.90600414078675,69,75,89,92,110,116,133,136,"ATGATGA","TTGA","GTGATAT","GTCA",2.28712244673603,14,18,17,58,2.03425887182523,4.32043546251635,7.94445202566335,101,"ENSG00000079974.19"
"12084","ENSG00000137135.18_15716",15708,15716,9,"ENSG00000137135.18",1,8,"VVVVVVVMV",0,8,0.884057971014493,82,88,133,136,144,150,202,205,"TTGCTGA","CTGG","GTGCTGT","CTGA",2.49661895546157,45,8,52,114,0.98849464746402,4.40815525430196,7.94438713835993,101,"ENSG00000079974.19"
"23093","ENSG00000172260.15_509176",509168,509176,9,"ENSG00000172260.15",1,7,"VVVVVVMVV",0,8,0.885300207039338,114,120,133,136,164,170,218,221,"ATGTTGA","GTTA","ATGTAGA","CTGA",2.48097135912108,13,28,48,98,1.07288755500169,4.40317415395223,7.94437498210958,101,"ENSG00000079974.19"
"33562","ENSG00000230333.6_72891",72883,72891,9,"ENSG00000230333.6",1,1,"MVVVVVVVV",0,8,0.90600414078675,115,121,133,136,177,183,195,198,"AGGGTTA","TTGT","ATGATGA","CTGA",2.29755329938902,12,41,12,74,1.96423312609283,4.32031378050491,7.94433034365191,101,"ENSG00000079974.19"
"32729","ENSG00000227674.3_205578",205570,205578,9,"ENSG00000227674.3",1,1,"MVVVVVVVV",0,8,0.90600414078675,112,118,133,136,144,150,171,174,"ATGTTCA","ATGC","GTTTTTA","CTGA",2.2386592196823,15,8,21,53,2.35657900258347,4.32024345011637,7.94426001326337,101,"ENSG00000079974.19"
"22284","ENSG00000170153.11_64138",64130,64138,9,"ENSG00000170153.11",0,NA,"VVVVVVUVV",1,8,0.886128364389234,116,122,133,136,142,148,195,198,"TTTAAGA","CTGG","GTGGTGC","CTGA",2.34533489749747,11,6,47,73,1.96336679841651,4.39973319543324,7.94424665299018,101,"ENSG00000079974.19"
"45140","ENSG00000285090.1_87155",87147,87155,9,"ENSG00000285090.1",0,NA,"VVVVVVUVV",1,8,0.886128364389234,110,116,133,136,140,146,164,167,"GGGAAGA","GAGA","GTGTTAA","CTGA",2.30522955573854,17,4,18,48,2.2306581487061,4.39971379674076,7.9442272542977,101,"ENSG00000079974.19"
"29641","ENSG00000198522.14_3696",3688,3696,9,"ENSG00000198522.14",1,2,"VMVVVVVVV",0,8,0.884057971014493,82,88,133,136,166,172,185,188,"TTGATCA","GTGA","GTAAAGA","CTGA",2.49920861223227,45,30,13,97,0.970507622739744,4.40797459273873,7.9442064767967,101,"ENSG00000079974.19"
"41479","ENSG00000259080.1_48897",48889,48897,9,"ENSG00000259080.1",1,2,"VMVVVVVVV",0,8,0.884057971014493,82,88,133,136,166,172,185,188,"TTGATCA","GTGA","GTAAAGA","CTGA",2.49920861223227,45,30,13,97,0.970507622739744,4.40797459273873,7.9442064767967,101,"ENSG00000079974.19"
"44533","ENSG00000282943.1_143006",142998,143006,9,"ENSG00000282943.1",1,8,"VVVVVVVMV",0,8,0.884057971014493,111,117,133,136,165,171,180,183,"GTGAACA","TTGA","ATTATTA","CTGA",2.36011086576802,16,29,9,63,1.89777190985252,4.4079610870765,7.94419297113447,101,"ENSG00000079974.19"
"21624","ENSG00000168615.13_72349",72341,72349,9,"ENSG00000168615.13",1,1,"MVVVVVVVV",0,8,0.90600414078675,106,112,133,136,149,155,175,178,"CCGAGGA","TTGA","CTGTTGC","CTGA",2.34905186216315,21,13,20,63,1.62034367326448,4.3201723552547,7.9441889184017,101,"ENSG00000079974.19"
"4813","ENSG00000101958.14_186394",186386,186394,9,"ENSG00000101958.14",1,1,"MVVVVVVVV",0,8,0.90600414078675,78,84,96,99,106,112,133,136,"ATAATGG","CTTA","TTGAAGG","GTGA",2.22285565433779,12,7,21,49,2.46164960855905,4.32017182603608,7.94418838918308,101,"ENSG00000079974.19"
"14033","ENSG00000144283.23_13738",13730,13738,9,"ENSG00000144283.23",1,1,"MVVVUVVVV",1,7,0.795859213250517,107,113,133,136,144,150,159,162,"ATGATGC","CTGA","ATGTTTA","CTAA",2.48445693478664,20,8,9,46,2.47974039119164,4.76069665577564,7.94413350877771,101,"ENSG00000079974.19"
"17321","ENSG00000153904.21_86561",86553,86561,9,"ENSG00000153904.21",1,6,"UVVVVMVVV",1,7,0.805383022774327,110,116,133,136,145,151,159,162,"ATGATGG","CACA","ATACAGA","CTGA",2.42875769701159,17,9,8,43,2.69811208993262,4.72245751750248,7.94398960859978,101,"ENSG00000079974.19"
"44436","ENSG00000282057.1_86448",86440,86448,9,"ENSG00000282057.1",1,6,"UVVVVMVVV",1,7,0.805383022774327,110,116,133,136,145,151,159,162,"ATGATGG","CACA","ATACAGA","CTGA",2.42875769701159,17,9,8,43,2.69811208993262,4.72245751750248,7.94398960859978,101,"ENSG00000079974.19"
"2419","ENSG00000074416.16_328549",328541,328549,9,"ENSG00000074416.16",1,8,"VVVVVVVMV",0,8,0.884057971014493,84,90,133,136,140,146,161,164,"ATGATAG","CAGA","GCAAGGA","CTGA",2.39634488159397,43,4,15,71,1.65532134517964,4.40773847228485,7.94397035634283,101,"ENSG00000079974.19"
"24506","ENSG00000176658.17_278050",278042,278050,9,"ENSG00000176658.17",1,3,"VVMVVVVVV",0,8,0.882815734989648,23,29,71,74,83,89,133,136,"ATGATGA","GTGA","GAGAGGA","CTCA",2.50354362022267,42,9,44,104,0.960431054716864,4.41268046405034,7.94394340400893,101,"ENSG00000079974.19"
"32979","ENSG00000228412.9_308291",308283,308291,9,"ENSG00000228412.9",1,6,"VVUVVMVVV",1,7,0.786335403726708,113,119,133,136,140,146,154,157,"CAGATGA","CAGA","ATAAGGT","CTGA",2.44202660115757,14,4,8,35,2.91345959558434,4.7984092341587,7.94375084906553,101,"ENSG00000079974.19"
"18720","ENSG00000158290.19_41828",41820,41828,9,"ENSG00000158290.19",1,2,"VMVVVUVVV",1,7,0.806211180124223,107,113,133,136,140,146,185,188,"GTCATGA","CTGA","TTGCCGA","CTGA",2.62838463684221,20,4,39,72,1.3530352379727,4.71889987089685,7.94374459139375,101,"ENSG00000079974.19"
"10375","ENSG00000130699.20_28186",28178,28186,9,"ENSG00000130699.20",1,8,"VVVUVVVMV",1,7,0.764803312629399,113,119,133,136,160,166,175,178,"TTGGTGA","CTGA","ATGTGGA","CTGA",2.61431292795972,14,24,9,56,2.10921741369002,4.8844925666887,7.9437058172063,101,"ENSG00000079974.19"
"35124","ENSG00000235018.1_261",253,261,9,"ENSG00000235018.1",1,8,"VVVUVVVMV",1,7,0.764803312629399,113,119,133,136,160,166,175,178,"TTGGTGA","CTGA","ATGTGGA","CTGA",2.61431292795972,14,24,9,56,2.10921741369002,4.8844925666887,7.9437058172063,101,"ENSG00000079974.19"
"48282","ENSG00000290853.1_33345",33337,33345,9,"ENSG00000290853.1",0,NA,"UVVVVVVVV",1,8,0.902691511387163,85,91,133,136,152,158,174,177,"GTTATGA","CTTT","ATGAACA","CTGA",2.41257657325047,42,16,16,83,1.24789105245051,4.33293371853007,7.94369976407873,101,"ENSG00000079974.19"
"36878","ENSG00000243295.2_623985",623977,623985,9,"ENSG00000243295.2",1,7,"VVVVVVMVV",0,8,0.885300207039338,116,122,133,136,146,152,162,165,"CTGCTGA","CTGT","ATTTTGA","CTAA",2.20558122863766,11,10,10,40,2.90610893538618,4.40249594824265,7.9436967764,101,"ENSG00000079974.19"
"21556","ENSG00000168310.12_3449",3441,3449,9,"ENSG00000168310.12",1,1,"MVVVVVVVV",0,8,0.90600414078675,111,117,133,136,139,145,200,203,"ATTATTC","CAGA","ATCATGA","CTGA",2.3608808492836,16,3,55,83,1.53947202933146,4.31966942280554,7.94368598595254,101,"ENSG00000079974.19"
"35354","ENSG00000235819.2_69071",69063,69071,9,"ENSG00000235819.2",1,5,"VVVVMVVVV",0,8,0.886542443064182,93,99,133,136,141,147,168,171,"GTGATTC","TTGA","ATGAGCA","CTGA",2.42789658550328,34,5,21,69,1.4038861949147,4.39746585790082,7.94363563015755,101,"ENSG00000079974.19"
"22222","ENSG00000169946.14_914214",914206,914214,9,"ENSG00000169946.14",1,8,"UVVVVVVMV",1,7,0.786749482401656,85,91,133,136,143,149,161,164,"TTGATGA","TTAA","ATGATTA","CTGA",2.58416241946526,42,7,12,70,1.95872348879628,4.7966182379745,7.94361616758112,101,"ENSG00000079974.19"
"34240","ENSG00000232284.9_319763",319755,319763,9,"ENSG00000232284.9",1,2,"VMVVVVUVV",1,7,0.770186335403727,111,117,133,136,142,148,169,172,"TTGATGA","GAGA","AGGATGA","CTGA",2.57532905935295,16,6,21,52,2.28228903214793,4.86278735695857,7.94353269857348,101,"ENSG00000079974.19"
"25706","ENSG00000182621.18_269883",269875,269883,9,"ENSG00000182621.18",1,6,"VVVVVMVVV",0,8,0.902691511387163,86,92,133,136,140,146,159,162,"TTGATGT","ATAA","GAAAAGA","CTGA",2.33595683320379,41,4,13,67,1.75785381871154,4.33272484335086,7.94349088889952,101,"ENSG00000079974.19"
"11417","ENSG00000134873.10_69283",69275,69283,9,"ENSG00000134873.10",1,1,"MVVVVVVVV",0,8,0.90600414078675,109,115,133,136,141,147,173,176,"ATTATGC","CTTC","AAGATGT","CTGA",2.31655487919105,18,5,26,58,1.83413704212585,4.31945905918321,7.94347562233021,101,"ENSG00000079974.19"
"12319","ENSG00000137869.16_26228",26220,26228,9,"ENSG00000137869.16",1,3,"VVMVVVVVV",0,8,0.882815734989648,89,95,133,136,170,176,185,188,"ATGATGT","ATGC","GTGAGTT","CTGA",2.49343144736164,38,34,9,90,1.02577434431145,4.41216266501393,7.94342560497252,101,"ENSG00000079974.19"
"26897","ENSG00000185261.16_230738",230730,230738,9,"ENSG00000185261.16",1,8,"VVVVVVVMV",0,8,0.884057971014493,82,88,133,136,149,155,209,212,"ATGATGA","CAGT","GAAATGT","CTGA",2.53999773788181,45,13,54,121,0.695435412652105,4.40718841629938,7.94342030035735,101,"ENSG00000079974.19"
"34587","ENSG00000233491.8_22221",22213,22221,9,"ENSG00000233491.8",1,5,"VVVVMVVVV",0,8,0.886542443064182,104,110,133,136,156,162,181,184,"ATAAAGA","ATGT","GTGATGA","CTGA",2.46939673180042,23,20,19,71,1.12631735093955,4.39724055740226,7.94341032965899,101,"ENSG00000079974.19"
"15579","ENSG00000148814.18_39225",39217,39225,9,"ENSG00000148814.18",1,8,"VVVVVUVMV",1,7,0.806211180124224,83,89,133,136,140,146,154,157,"GTGATTA","CAGA","ATGAAAA","CTGA",2.55838783492132,44,4,8,65,1.81820773877332,4.7185316595622,7.9433763800591,101,"ENSG00000079974.19"
"42003","ENSG00000260289.2_184496",184488,184496,9,"ENSG00000260289.2",1,8,"VVVVVVVMV",0,8,0.884057971014493,114,120,133,136,139,145,156,159,"AGCATGT","GGGA","CTGGAGA","CTGA",2.22655109142357,13,3,11,36,2.78483965074055,4.40712839839109,7.94336028244906,101,"ENSG00000079974.19"
"15627","ENSG00000148948.8_221032",221024,221032,9,"ENSG00000148948.8",1,1,"MVVUVVVVV",1,7,0.786749482401656,114,120,133,136,154,160,176,179,"ATAATGA","ATGT","GTGTTGA","CTGA",2.55876461503299,13,18,16,56,2.12691772769864,4.7963371236463,7.94333505325293,101,"ENSG00000079974.19"
"8625","ENSG00000119906.13_23940",23932,23940,9,"ENSG00000119906.13",0,NA,"VVVUVVVVV",1,8,0.880745341614907,113,119,133,136,183,189,203,206,"ATGTTAG","CTGA","GGGTAGA","CTGA",2.37666773159892,14,47,14,84,1.83695598549499,4.42035188237195,7.94333324883158,101,"ENSG00000079974.19"
"8489","ENSG00000119125.17_96844",96836,96844,9,"ENSG00000119125.17",1,1,"MVVVUVVVV",1,7,0.795859213250517,48,54,77,80,87,93,133,136,"CTGATGT","CTGA","GAGAGGA","CTGA",2.6619019888802,23,7,40,79,1.29349718338347,4.7598776106462,7.94331446364827,101,"ENSG00000079974.19"
"21353","ENSG00000167281.20_182576",182568,182576,9,"ENSG00000167281.20",0,NA,"UVVVVVVVV",1,8,0.902691511387163,85,91,133,136,166,172,183,186,"GTGATGT","GAGA","GTGGAGC","CTGA",2.4438247273039,42,30,11,92,1.03759344581746,4.33243957362753,7.94320561917618,101,"ENSG00000079974.19"
"9134","ENSG00000122786.20_69143",69135,69143,9,"ENSG00000122786.20",1,1,"MVVVVUVVV",1,7,0.82815734989648,106,112,133,136,140,146,156,159,"ATGATGA","ATCA","ATGATGC","GTGA",2.43987692295147,21,4,10,44,2.25623726654087,4.63052085488767,7.94315025447359,101,"ENSG00000079974.19"
"2900","ENSG00000079156.17_148358",148350,148358,9,"ENSG00000079156.17",0,NA,"UVVVVUVVV",2,7,0.824844720496894,113,119,133,136,145,151,205,208,"ATGAGGA","CATA","CAGATGA","CTGA",2.49894694212599,14,9,54,86,1.91541032442302,4.64376415131574,7.94314303330331,101,"ENSG00000079974.19"
"28797","ENSG00000196511.15_258703",258695,258703,9,"ENSG00000196511.15",0,NA,"VVUVVVVVV",1,8,0.883643892339545,20,26,43,46,79,85,133,136,"ATGATGA","TTGA","CTTATGA","CAGA",2.5268968193229,17,33,48,107,0.788100964848559,4.40851994008364,7.94309550944182,101,"ENSG00000079974.19"
"44293","ENSG00000280683.1_131854",131846,131854,9,"ENSG00000280683.1",1,5,"VVUVMVVVV",1,7,0.770186335403727,94,100,111,114,116,122,133,136,"AGGAAGA","CTGA","TAGATCA","CTGA",2.51328761277156,11,2,11,33,2.69406087293081,4.8623279061853,7.94307324780021,101,"ENSG00000079974.19"
"44516","ENSG00000282890.1_505570",505562,505570,9,"ENSG00000282890.1",1,5,"VVUVMVVVV",1,7,0.770186335403727,94,100,111,114,116,122,133,136,"AGGAAGA","CTGA","TAGATCA","CTGA",2.51328761277156,11,2,11,33,2.69406087293081,4.8623279061853,7.94307324780021,101,"ENSG00000079974.19"
"753","ENSG00000032219.19_25009",25001,25009,9,"ENSG00000032219.19",1,8,"VVVVVUVMV",1,7,0.806211180124224,109,115,133,136,166,172,217,220,"AAGATGA","GTGA","ATGATGA","CTGA",2.72218694960281,18,30,45,102,0.724863100994911,4.71819402458675,7.94303874508365,101,"ENSG00000079974.19"
"21875","ENSG00000169251.13_20457",20449,20457,9,"ENSG00000169251.13",1,3,"VVMVVVVVV",0,8,0.882815734989648,105,111,133,136,184,190,207,210,"TGGATCA","ATGA","GTGATGA","CTGA",2.49159853133283,22,48,17,96,1.03604986626712,4.41167668545483,7.94293962541343,101,"ENSG00000079974.19"
"12252","ENSG00000137764.20_173833",173825,173833,9,"ENSG00000137764.20",1,2,"VMVVVVVVV",0,8,0.884057971014493,77,83,99,102,110,116,133,136,"ATGATAA","CTGC","GAGATAT","CTGC",2.26557565110182,16,8,17,50,2.52291018641901,4.40668696510778,7.94291884916575,101,"ENSG00000079974.19"
"17191","ENSG00000153395.10_53300",53292,53300,9,"ENSG00000153395.10",1,3,"VVMVVVVVV",0,8,0.882815734989648,114,120,133,136,177,183,194,197,"CTGTTGT","CAGA","CTCATCA","CTGA",2.34881542509089,13,41,11,74,1.98741384564827,4.41154583656354,7.94280877652214,101,"ENSG00000079974.19"
"25569","ENSG00000182168.15_95914",95906,95914,9,"ENSG00000182168.15",0,NA,"VVVUVVVVV",1,8,0.880745341614907,91,97,133,136,140,146,159,162,"ATGATTA","ATGT","ATTATCT","CTGA",2.38743380336387,36,4,13,62,1.76294673192059,4.41979302191993,7.94277438837956,101,"ENSG00000079974.19"
"21396","ENSG00000167346.9_87709",87701,87709,9,"ENSG00000167346.9",0,NA,"VVVUVVVVV",1,8,0.880745341614907,98,104,133,136,146,152,167,170,"TTGATCA","TTGT","ATGCAGA","CTGA",2.38578452638172,29,10,15,63,1.7738733235912,4.41977587486733,7.94275724132696,101,"ENSG00000079974.19"
"16348","ENSG00000151376.18_1840",1832,1840,9,"ENSG00000151376.18",1,6,"UVVVVMVVV",1,7,0.805383022774327,75,81,97,100,108,114,133,136,"ATTGTGA","CTGA","ATCATAT","CTGA",2.4727130977131,16,8,19,52,2.40009446565695,4.72121211260273,7.94274420370004,101,"ENSG00000079974.19"
"38591","ENSG00000250522.1_4256",4248,4256,9,"ENSG00000250522.1",1,8,"VVVVVVVMV",0,8,0.884057971014493,56,62,78,81,88,94,133,136,"AAGATGA","TTGA","GGGAAGA","CAGA",2.36447716607756,16,7,39,71,1.86279316801825,4.40649356880049,7.94272545285846,101,"ENSG00000079974.19"
"33857","ENSG00000231304.2_727134",727126,727134,9,"ENSG00000231304.2",1,2,"UMVVVVVVV",1,7,0.786749482401656,115,121,133,136,181,187,201,204,"ATAATGA","TAGA","GTGAAGA","CTGA",2.59630732044177,12,45,14,80,1.87412566991883,4.79571028488266,7.94270821448929,101,"ENSG00000079974.19"
"5434","ENSG00000104635.15_6170",6162,6170,9,"ENSG00000104635.15",1,7,"UVVVVVMVV",1,7,0.787991718426501,68,74,99,102,111,117,133,136,"ATAATGA","CTTA","GTTAAGA","CTGA",2.59230897369077,25,9,16,59,1.8808405261532,4.79072508768958,7.94269196139558,101,"ENSG00000079974.19"
"41964","ENSG00000260192.3_360658",360650,360658,9,"ENSG00000260192.3",1,1,"MVVVVVVVV",0,8,0.90600414078675,112,118,133,136,147,153,174,177,"GAGATAA","CACA","GTAATGT","CTGA",2.26045449172444,15,11,21,56,2.20488210257733,4.3186446785184,7.9426612416654,101,"ENSG00000079974.19"
"8557","ENSG00000119541.10_12146",12138,12146,9,"ENSG00000119541.10",1,8,"VVVVVVVMV",0,8,0.884057971014493,116,122,133,136,142,148,157,160,"ATAAAGA","CAGA","GTGAAAG","CCGA",2.18048301363921,11,6,9,35,3.08888184458108,4.40635881721062,7.94259070126859,101,"ENSG00000079974.19"
"4009","ENSG00000091831.25_78681",78673,78681,9,"ENSG00000091831.25",0,NA,"UVVVVVVVV",1,8,0.902691511387163,95,101,133,136,141,147,162,165,"CTGATCA","TTGT","CTTATCA","CTGA",2.33329210806361,32,5,15,61,1.77192026385605,4.33180024607003,7.94256629161868,101,"ENSG00000079974.19"
"2365","ENSG00000073803.14_2157",2149,2157,9,"ENSG00000073803.14",1,2,"VMVVVVVVV",0,8,0.884057971014493,94,100,133,136,138,144,152,155,"AAGATGA","AAGA","GTTCTTA","CTGA",2.41538558472104,33,2,8,52,1.52257460860243,4.40628629335233,7.9425181774103,101,"ENSG00000079974.19"
"7631","ENSG00000115233.12_21795",21787,21795,9,"ENSG00000115233.12",0,NA,"UVVVVVUVV",2,7,0.788819875776397,96,102,133,136,170,176,188,191,"CTGATGA","ATGA","ATGATGG","CTGA",2.72017104129869,31,34,12,86,1.01429505990381,4.78719216714044,7.94247167024603,101,"ENSG00000079974.19"
"32153","ENSG00000226149.6_12794",12786,12794,9,"ENSG00000226149.6",1,2,"VMVVVUVVV",1,7,0.806211180124223,109,115,133,136,139,145,160,163,"CAGATGA","CTGG","CTGAAGT","CTGA",2.50200391655181,18,3,15,45,2.19034904039094,4.71759378768409,7.94243850818098,101,"ENSG00000079974.19"
"15996","ENSG00000150556.17_162897",162889,162897,9,"ENSG00000150556.17",1,5,"VVVVMVVVV",0,8,0.886542443064182,114,120,133,136,149,155,163,166,"TGGATGA","CTGT","GTTTTGA","TTGA",2.2354060018684,13,13,8,43,2.68231038213909,4.39625426531544,7.94242403757216,101,"ENSG00000079974.19"
"36376","ENSG00000240405.7_180517",180509,180517,9,"ENSG00000240405.7",1,1,"MVVVVUVVV",1,7,0.82815734989648,107,113,133,136,155,161,171,174,"GTGAAGA","AGGA","GTGATGG","CTGA",2.50587548381182,20,19,10,58,1.81306091352991,4.62972436806884,7.94235376765476,101,"ENSG00000079974.19"
"19953","ENSG00000164053.22_12350",12342,12350,9,"ENSG00000164053.22",1,6,"VVVUVMVVV",1,7,0.78343685300207,78,84,100,103,116,122,133,136,"ATGATAA","CTGA","CTGATGC","CTTA",2.50730865108732,16,13,11,49,2.51902144510395,4.80860311308819,7.94235052509647,101,"ENSG00000079974.19"
"1069","ENSG00000047365.13_55644",55636,55644,9,"ENSG00000047365.13",1,3,"VVMVVUVVV",1,7,0.804968944099379,74,80,94,97,106,112,133,136,"ATGATGA","CTTA","AAGAGGA","ATGA",2.4772133120068,14,9,21,53,2.37494295172615,4.72242459127621,7.94230036767373,101,"ENSG00000079974.19"
"14551","ENSG00000145362.21_377930",377922,377930,9,"ENSG00000145362.21",0,NA,"VVVVVVUVV",1,8,0.886128364389234,100,106,133,136,142,148,166,169,"GTGGGGA","CTTA","GTGCTGC","CTGA",2.38029367681309,27,6,18,60,1.72249786700936,4.39778059477415,7.94229405233108,101,"ENSG00000079974.19"
"15321","ENSG00000147724.12_220141",220133,220141,9,"ENSG00000147724.12",0,NA,"VVVVVVUVV",1,8,0.886128364389234,115,121,133,136,141,147,183,186,"TAAATGA","GTGA","AAGAAGA","CTGA",2.34230147353041,12,5,36,62,1.97569381878925,4.39775924391466,7.9422727014716,101,"ENSG00000079974.19"
"20516","ENSG00000164989.17_92670",92662,92670,9,"ENSG00000164989.17",1,1,"MVVVVVVVV",0,8,0.90600414078675,95,101,133,136,165,171,186,189,"GTGATAA","ACGA","GTGAAAA","CTGA",2.45567538723207,32,29,15,85,0.901826085985828,4.31824883354991,7.94226539669691,101,"ENSG00000079974.19"
"17146","ENSG00000153250.21_98665",98657,98665,9,"ENSG00000153250.21",0,NA,"UVVVVVVVV",1,8,0.902691511387163,116,122,133,136,149,155,163,166,"ATTAGCA","TTCA","GTGGAGA","CTGA",2.19789350275386,11,13,8,41,2.67327712232689,4.33147511850483,7.94224116405348,101,"ENSG00000079974.19"
"32004","ENSG00000225548.7_3032",3024,3032,9,"ENSG00000225548.7",1,2,"UMVVVVVVV",1,7,0.786749482401656,77,83,93,96,109,115,133,136,"CTCATGA","CTGA","ATAAGAA","CTGA",2.53960028085601,10,13,18,50,2.25028534351067,4.79523847063769,7.94223640024432,101,"ENSG00000079974.19"
"31005","ENSG00000215218.4_26228",26220,26228,9,"ENSG00000215218.4",1,2,"VMVVVVVVV",0,8,0.884057971014493,16,22,62,65,114,120,133,136,"ATGATGA","CTGG","GTGACGC","CCGA",2.50533341930792,40,49,13,111,0.921729277561096,4.40598801823681,7.94221990229478,101,"ENSG00000079974.19"
"10252","ENSG00000130167.14_14614",14606,14614,9,"ENSG00000130167.14",0,NA,"VVVUVVVVV",1,8,0.880745341614907,77,83,95,98,113,119,133,136,"ATGTGGA","CTGA","CTGTTCA","CTTA",2.28758978128244,12,15,14,50,2.42610358741038,4.41917553232333,7.94215689878296,101,"ENSG00000079974.19"
"17356","ENSG00000153956.17_17473",17465,17473,9,"ENSG00000153956.17",1,2,"VMVVVVVVV",0,8,0.884057971014493,101,107,133,136,141,147,184,187,"ATTATGA","ATTA","ATGCTGT","CTGA",2.47826970199474,26,5,37,77,1.10164982625869,4.40586195988924,7.94209384394722,101,"ENSG00000079974.19"
"6630","ENSG00000111110.12_71275",71267,71275,9,"ENSG00000111110.12",1,8,"VVVVVVVMV",0,8,0.884057971014493,105,111,133,136,144,150,164,167,"ATCAAGA","TTGG","ATTAGGA","CTGA",2.31423276568782,22,8,14,53,2.19517912181892,4.40584938993442,7.94208127399239,101,"ENSG00000079974.19"
"36947","ENSG00000243797.6_388301",388293,388301,9,"ENSG00000243797.6",1,8,"VVVVVVVMV",0,8,0.884057971014493,93,99,133,136,142,148,161,164,"ATGATAT","CAAA","TTGTGGA","CTGA",2.35620909383895,34,6,13,62,1.91502752759726,4.40577203829757,7.94200392235554,101,"ENSG00000079974.19"
"2722","ENSG00000077713.19_42446",42438,42446,9,"ENSG00000077713.19",1,1,"MVUVVVVVV",1,7,0.789648033126294,87,93,106,109,116,122,133,136,"GTGATGT","ATGT","CAGGTGA","CTGA",2.41781089667101,13,7,11,40,3.01450882069823,4.78331203295958,7.94190416546475,101,"ENSG00000079974.19"
"17484","ENSG00000154229.12_409864",409856,409864,9,"ENSG00000154229.12",1,2,"VMVVVVVVV",0,8,0.884057971014493,115,121,133,136,142,148,157,160,"GTGCTGG","CAGA","CTGAAAA","ATGA",2.18060984332453,12,6,9,36,3.08515402764691,4.40563824578594,7.94187012984391,101,"ENSG00000079974.19"
"18729","ENSG00000158321.19_153262",153254,153262,9,"ENSG00000158321.19",1,1,"MVVVUVVVV",1,7,0.795859213250517,84,90,133,136,141,147,157,160,"ATGATGG","TAGA","AGGATGA","CTGA",2.56527547260947,43,5,10,67,1.93188223703669,4.75842968027495,7.94186653327702,101,"ENSG00000079974.19"
"34320","ENSG00000232667.12_39458",39450,39458,9,"ENSG00000232667.12",1,2,"VMVVVVVVV",0,8,0.884057971014493,98,104,133,136,138,144,152,155,"ATGAAGG","ACGA","CTGCTGA","CTGA",2.40850862360888,29,2,8,48,1.56580869879914,4.40563321404793,7.9418650981059,101,"ENSG00000079974.19"
"22805","ENSG00000171448.9_14331",14323,14331,9,"ENSG00000171448.9",1,8,"VVVVVVVMV",0,8,0.884057971014493,105,111,133,136,141,147,173,176,"ATGAAGA","CCTA","GTGTTTC","CTGA",2.4176404548928,22,5,26,62,1.50480986532875,4.40560322448685,7.94183510854482,101,"ENSG00000079974.19"
"42443","ENSG00000263072.10_25974",25966,25974,9,"ENSG00000263072.10",1,7,"VVVVVVMVV",0,8,0.885300207039338,68,74,83,86,116,122,133,136,"ATGAATA","CTGA","TTGAGGA","CTGG",2.35940420616453,9,30,11,59,1.87306786950924,4.40060731098485,7.9418081391422,101,"ENSG00000079974.19"
"47099","ENSG00000287667.1_2506",2498,2506,9,"ENSG00000287667.1",1,8,"VVVVVVVMV",0,8,0.884057971014493,110,116,133,136,187,193,204,207,"ACCATGC","CTGC","ATGATGT","CTGA",2.38209807224006,17,51,11,88,1.74144875000344,4.4055256412343,7.94175752529227,101,"ENSG00000079974.19"
"19317","ENSG00000162733.19_126413",126405,126413,9,"ENSG00000162733.19",1,1,"MVVVVVVVV",0,8,0.90600414078675,89,95,133,136,185,191,202,205,"ATGAGGA","TTAA","TTTAGGA","CTGA",2.44214029192134,38,49,11,107,0.98991631762671,4.31771289927558,7.94172946242258,101,"ENSG00000079974.19"
"21842","ENSG00000169118.18_177832",177824,177832,9,"ENSG00000169118.18",1,6,"VVUVVMVVV",1,7,0.786335403726708,50,56,65,68,72,78,133,136,"ATGAGGA","CTGT","TTGTTGA","CTGA",2.6266176157721,9,4,55,77,1.67469947780273,4.79637089573752,7.94171251064435,101,"ENSG00000079974.19"
"44710","ENSG00000283408.2_146210",146202,146210,9,"ENSG00000283408.2",0,NA,"UVVVVVVVV",1,8,0.902691511387163,114,120,133,136,140,146,175,178,"ACAATGC","CAGG","GTGAGGA","CTGA",2.30120313448635,13,4,29,55,1.98237130500249,4.33093138372788,7.94169742927653,101,"ENSG00000079974.19"
"7391","ENSG00000113812.14_11981",11973,11981,9,"ENSG00000113812.14",1,8,"VVVVVVVMV",0,8,0.884057971014493,116,122,133,136,139,145,161,164,"ATGTGGA","TGGA","ATGTCAA","CTGA",2.27141284256561,11,3,16,39,2.4790089179838,4.40544030043863,7.9416721844966,101,"ENSG00000079974.19"
"20310","ENSG00000164627.18_163547",163539,163547,9,"ENSG00000164627.18",0,NA,"VVVVUVVVV",1,8,0.889855072463768,88,94,105,108,113,119,133,136,"TTGAGCA","TAGA","CAGATGG","CTGA",2.20597497813122,11,5,14,39,2.82242244801047,4.38223057555465,7.94165086540972,101,"ENSG00000079974.19"
"48037","ENSG00000290203.13_52759",52751,52759,9,"ENSG00000290203.13",1,8,"VVVVVUVMV",1,7,0.806211180124224,81,87,101,104,112,118,133,136,"AGGCTGT","CTGA","CTTATGG","CTGA",2.41430881525492,14,8,15,46,2.77174603734722,4.71678453476166,7.94162925525856,101,"ENSG00000079974.19"
"40223","ENSG00000255271.1_15560",15552,15560,9,"ENSG00000255271.1",1,6,"VVVVVMVVV",0,8,0.902691511387163,86,92,133,136,172,178,187,190,"ATGATGC","CAAA","GTCAGGG","CTGA",2.44610417814344,41,36,9,95,1.01605749918115,4.33085467170102,7.94162071724967,101,"ENSG00000079974.19"
"45717","ENSG00000285826.1_17577",17569,17577,9,"ENSG00000285826.1",1,8,"UVVVVVVMV",1,7,0.786749482401656,116,122,133,136,146,152,169,172,"GGGATGA","TTGA","GAGAGCA","CTGA",2.49075331794144,11,10,17,47,2.57340273289247,4.79460621312552,7.94160414273214,101,"ENSG00000079974.19"
"41495","ENSG00000259107.2_21015",21007,21015,9,"ENSG00000259107.2",1,1,"MVVVVUVVV",1,7,0.82815734989648,91,97,104,107,112,118,133,136,"GGGAAGA","CAGA","GAGAAGA","CTGA",2.40795403397147,7,5,15,36,2.46286960142375,4.62897412364172,7.94160352322764,101,"ENSG00000079974.19"
"29286","ENSG00000197585.10_407257",407249,407257,9,"ENSG00000197585.10",1,1,"MVVVVVVVV",0,8,0.90600414078675,87,93,133,136,183,189,200,203,"TTAATGA","ATGA","ATGTTTG","CTGA",2.44217514446678,40,47,11,107,0.988985907088982,4.31753838421689,7.94155494736389,101,"ENSG00000079974.19"
"16225","ENSG00000151150.22_674926",674918,674926,9,"ENSG00000151150.22",0,NA,"UVVVVVVVV",1,8,0.902691511387163,101,107,133,136,145,151,183,186,"ATGATTT","CAGA","AAGAAAA","CTGA",2.42227786953957,26,9,32,76,1.17457374192457,4.33077321804709,7.94153926359575,101,"ENSG00000079974.19"
"1111","ENSG00000047662.5_115594",115586,115594,9,"ENSG00000047662.5",1,6,"VVVVVMUVV",1,7,0.788819875776397,47,53,67,70,76,82,133,136,"GGGATGA","GTGA","GTGAGGG","CTGA",2.579308902625,14,6,51,80,1.94963146614138,4.786256037577,7.94153554068259,101,"ENSG00000079974.19"
"40410","ENSG00000255968.1_65570",65562,65570,9,"ENSG00000255968.1",1,8,"VVVVVUVMV",1,7,0.806211180124224,77,83,100,103,112,118,133,136,"ATGTTGG","CTTA","GTCATGG","CTGA",2.45148310680412,17,9,15,50,2.52343478820882,4.71666387505907,7.94150859555597,101,"ENSG00000079974.19"
"45610","ENSG00000285741.1_67159",67151,67159,9,"ENSG00000285741.1",0,NA,"UVVVVVVVV",1,8,0.902691511387163,109,115,133,136,139,145,181,184,"GATATGA","TAGA","GTGAAGA","CTGA",2.38670957873394,18,3,36,66,1.41132208279929,4.33067981858972,7.94144586413838,101,"ENSG00000079974.19"
"37375","ENSG00000247925.2_47231",47223,47231,9,"ENSG00000247925.2",1,1,"MVVVVVUVV",1,7,0.792132505175983,47,53,63,66,113,119,133,136,"CTGATGA","TGGA","TTGAGGA","CTGA",2.59489197625117,10,47,14,80,1.79234774112128,4.77290689569893,7.94143691640286,101,"ENSG00000079974.19"
"20159","ENSG00000164330.17_6104",6096,6104,9,"ENSG00000164330.17",0,NA,"VVVVUVVVV",1,8,0.889855072463768,113,119,133,136,154,160,169,172,"ATGAACA","CAGA","GTGATTA","ATGA",2.27879530604554,14,18,9,50,2.33605336437419,4.38200551783611,7.94142580769118,101,"ENSG00000079974.19"
"37652","ENSG00000248636.7_130971",130963,130971,9,"ENSG00000248636.7",1,1,"MVVVVVVVV",0,8,0.90600414078675,84,90,133,136,182,188,199,202,"TTAATGA","ATGA","ATGTTTG","CTGA",2.44217514446678,43,46,11,109,0.988448216532225,4.3174039615777,7.94142052472469,101,"ENSG00000079974.19"
"45931","ENSG00000286051.1_14221",14213,14221,9,"ENSG00000286051.1",1,7,"VVVVVVMVV",0,8,0.885300207039338,113,119,133,136,143,149,159,162,"TTACTGA","GTCA","CAGAAGA","CTGA",2.19057895831041,14,7,10,40,2.99698625746431,4.40021149488343,7.94141232304078,101,"ENSG00000079974.19"
"46945","ENSG00000287394.1_14209",14201,14209,9,"ENSG00000287394.1",1,7,"VVVVVVMVV",0,8,0.885300207039338,113,119,133,136,143,149,159,162,"TTACTGA","GTCA","CAGAAGA","CTGA",2.19057895831041,14,7,10,40,2.99698625746431,4.40021149488343,7.94141232304078,101,"ENSG00000079974.19"
"30048","ENSG00000198964.14_13051",13043,13051,9,"ENSG00000198964.14",1,8,"VVVVVVVMV",0,8,0.884057971014493,106,112,133,136,187,193,201,204,"GAGATGG","CTGG","GTGGGGA","CTGA",2.43450459604217,21,51,8,89,1.39063741664523,4.40516701423159,7.94139889828956,101,"ENSG00000079974.19"
"43654","ENSG00000273079.7_481163",481155,481163,9,"ENSG00000273079.7",1,8,"VVVVVUVMV",1,7,0.806211180124224,84,90,133,136,142,148,158,161,"AGGAAGA","CTGA","ATTCTGA","CTGA",2.53229099114994,43,6,10,68,1.98423294851996,4.71654322237988,7.94138794287678,101,"ENSG00000079974.19"
"24890","ENSG00000178568.15_133012",133004,133012,9,"ENSG00000178568.15",1,6,"VVVVVMVVV",0,8,0.902691511387163,115,121,133,136,138,144,152,155,"TTTCTGA","TTGT","TAGTTGA","CTGA",2.17577849441468,12,2,8,31,2.81723734531405,4.33060682701964,7.94137287256829,101,"ENSG00000079974.19"
"3182","ENSG00000082068.9_310893",310885,310893,9,"ENSG00000082068.9",1,1,"MVVVVVVVV",0,8,0.90600414078675,82,88,133,136,182,188,199,202,"TTAATGA","ATGA","ATGTTTG","CTGA",2.44217514446678,45,46,11,111,0.988212267561057,4.31734497433491,7.9413615374819,101,"ENSG00000079974.19"
"31708","ENSG00000224509.4_80191",80183,80191,9,"ENSG00000224509.4",1,1,"MVVVVVVVV",0,8,0.90600414078675,82,88,133,136,182,188,199,202,"TTAATGA","ATGA","ATGTTTG","CTGA",2.44217514446678,45,46,11,111,0.988212267561057,4.31734497433491,7.9413615374819,101,"ENSG00000079974.19"
"35425","ENSG00000236021.4_149684",149676,149684,9,"ENSG00000236021.4",1,1,"MVVVVVVVV",0,8,0.90600414078675,82,88,133,136,182,188,199,202,"TTAATGA","ATGA","ATGTTTG","CTGA",2.44217514446678,45,46,11,111,0.988212267561057,4.31734497433491,7.9413615374819,101,"ENSG00000079974.19"
"35853","ENSG00000237356.7_256219",256211,256219,9,"ENSG00000237356.7",1,1,"MVVVVVVVV",0,8,0.90600414078675,82,88,133,136,182,188,199,202,"TTAATGA","ATGA","ATGTTTG","CTGA",2.44217514446678,45,46,11,111,0.988212267561057,4.31734497433491,7.9413615374819,101,"ENSG00000079974.19"
"1600","ENSG00000063438.20_83696",83688,83696,9,"ENSG00000063438.20",1,6,"VVVVVMVVV",0,8,0.902691511387163,110,116,133,136,186,192,208,211,"CTGATGC","TTGG","GTGACAG","CTGA",2.37118031618468,17,50,16,92,1.51440385926488,4.33056815845735,7.94133420400601,101,"ENSG00000079974.19"
"47515","ENSG00000288622.1_133740",133732,133740,9,"ENSG00000288622.1",1,6,"VVVVVMVVV",0,8,0.902691511387163,110,116,133,136,186,192,208,211,"CTGATGC","TTGG","GTGACAG","CTGA",2.37118031618468,17,50,16,92,1.51440385926488,4.33056815845735,7.94133420400601,101,"ENSG00000079974.19"
"19476","ENSG00000163092.22_50111",50103,50111,9,"ENSG00000163092.22",0,NA,"UVVVVUVVV",2,7,0.824844720496894,110,116,133,136,145,151,167,170,"CTGTTGA","CTGT","ATTAGGT","CTGA",2.41547492756519,17,9,16,51,2.46457668551793,4.64193571732147,7.94131459930904,101,"ENSG00000079974.19"
"33469","ENSG00000229956.11_39306",39298,39306,9,"ENSG00000229956.11",0,NA,"UVVVVUVVV",2,7,0.824844720496894,110,116,133,136,145,151,167,170,"CTGTTGA","CTGT","ATTAGGT","CTGA",2.41547492756519,17,9,16,51,2.46457668551793,4.64193571732147,7.94131459930904,101,"ENSG00000079974.19"
"40234","ENSG00000255300.6_14981",14973,14981,9,"ENSG00000255300.6",1,1,"MVVVVVVVV",0,8,0.90600414078675,110,116,133,136,155,161,215,218,"GGGATGA","ATGT","CTGAGGG","CTGA",2.42854982455443,17,19,54,99,1.07872409222213,4.31726406397959,7.94128062712659,101,"ENSG00000079974.19"
"23978","ENSG00000174611.12_23733",23725,23733,9,"ENSG00000174611.12",1,7,"VVVVVVMVV",0,8,0.885300207039338,113,119,133,136,179,185,196,199,"AAGAGGA","AGGA","CTGAAGT","CTGA",2.34699275669514,14,43,11,77,1.95365656657922,4.40006873613671,7.94126956429406,101,"ENSG00000079974.19"
"14952","ENSG00000146350.14_203652",203644,203652,9,"ENSG00000146350.14",1,1,"MVVVVVVVV",0,8,0.90600414078675,111,117,133,136,150,156,175,178,"ATTTTGA","GTGC","CTAATGT","CTGA",2.28489147294818,16,14,19,58,2.03595283509864,4.3171406636883,7.9411572268353,101,"ENSG00000079974.19"
"40054","ENSG00000254789.4_7372",7364,7372,9,"ENSG00000254789.4",1,8,"VVVVVVVMV",0,8,0.884057971014493,106,112,133,136,146,152,173,176,"ATGATGT","CTGT","CTGGAGA","CAGA",2.37770805730119,21,10,21,61,1.76829403319996,4.40492027046864,7.94115215452661,101,"ENSG00000079974.19"
"21565","ENSG00000168356.13_90862",90854,90862,9,"ENSG00000168356.13",1,1,"MVVVVVVVV",0,8,0.90600414078675,100,106,133,136,185,191,208,211,"ATTATCA","TTGA","GTGATCT","CTGA",2.47006671081561,27,49,17,102,0.801423597790379,4.31713375080695,7.94115031395394,101,"ENSG00000079974.19"
"26891","ENSG00000185261.16_144543",144535,144543,9,"ENSG00000185261.16",1,2,"VMVVVVVVV",0,8,0.884057971014493,83,89,133,136,143,149,157,160,"CTTATGA","AGGA","GTGGTAT","CTGA",2.34586742529458,44,7,8,68,1.98044975278937,4.40489148035498,7.94112336441295,101,"ENSG00000079974.19"
"11701","ENSG00000135862.6_2095",2087,2095,9,"ENSG00000135862.6",1,3,"VVMUVVVVV",1,7,0.763561076604555,84,90,101,104,115,121,133,136,"ATGATAC","CTGT","TTGAAGA","CTGA",2.51506914069151,11,11,12,43,2.78034280521069,4.8868676024552,7.94111190887342,101,"ENSG00000079974.19"
"27361","ENSG00000186073.14_1133",1125,1133,9,"ENSG00000186073.14",1,7,"VVVVVVMVV",0,8,0.885300207039338,116,122,133,136,141,147,202,205,"ATGTTGT","GAGA","TTGTTTA","CTGA",2.35389268826062,11,5,55,80,1.90695062474446,4.39989213662048,7.94109296477783,101,"ENSG00000079974.19"
"22607","ENSG00000170946.15_96",88,96,9,"ENSG00000170946.15",1,6,"VVVVVMVVV",0,8,0.902691511387163,80,86,98,101,103,109,120,123,"CTGATGT","CGGA","AGGGTGC","CTGG",2.19650076945051,12,2,11,34,2.67787429758514,4.33030319014713,7.94106923569578,101,"ENSG00000079974.19"
"30353","ENSG00000204740.11_201208",201200,201208,9,"ENSG00000204740.11",1,1,"MVVVVUVVV",1,7,0.82815734989648,110,116,133,136,186,192,212,215,"ATGATGA","TTGT","TTAATGG","CTGA",2.58621630078138,17,50,20,96,1.27229912029804,4.62843528137681,7.94106468096273,101,"ENSG00000079974.19"
"2864","ENSG00000078725.13_115436",115428,115436,9,"ENSG00000078725.13",1,2,"VMVVVVVVV",0,8,0.884057971014493,47,53,66,69,114,120,133,136,"ATGTTGT","CTGA","GTAAAGA","CAGA",2.35528253941385,13,45,13,80,1.91735868374617,4.40481056995962,7.94104245401759,101,"ENSG00000079974.19"
"22160","ENSG00000169918.10_345756",345748,345756,9,"ENSG00000169918.10",1,2,"VMVVVVUVV",1,7,0.770186335403727,104,110,133,136,140,146,162,165,"ATGATGA","ATCA","GTGACCA","CTGA",2.63573237661942,23,4,16,52,1.86958316416542,4.86028308540706,7.94102842702197,101,"ENSG00000079974.19"
"286","ENSG00000007341.19_6631",6623,6631,9,"ENSG00000007341.19",1,8,"VVVVVVVMV",0,8,0.884057971014493,113,119,133,136,146,152,187,190,"CTGATAT","CTGG","CAGAAGA","CTGA",2.35558894344532,14,10,35,68,1.91513983734197,4.40476653174437,7.94099841580234,101,"ENSG00000079974.19"
"27405","ENSG00000186094.18_594040",594032,594040,9,"ENSG00000186094.18",1,5,"VVVVMUVVV",1,7,0.808695652173913,45,51,83,86,90,96,133,136,"ATGGTGA","CTGA","AGGAGGA","CTGA",2.68904792671994,32,4,37,82,0.897768416471651,4.70618864865115,7.9409712573468,101,"ENSG00000079974.19"
"32012","ENSG00000225623.1_42171",42163,42171,9,"ENSG00000225623.1",1,5,"VVVVMUVVV",1,7,0.808695652173913,45,51,83,86,90,96,133,136,"ATGGTGA","CTGA","AGGAGGA","CTGA",2.68904792671994,32,4,37,82,0.897768416471651,4.70618864865115,7.9409712573468,101,"ENSG00000079974.19"
"29748","ENSG00000198673.11_283781",283773,283781,9,"ENSG00000198673.11",1,2,"VMVVVVVVV",0,8,0.884057971014493,87,93,100,103,114,120,133,136,"GTGAAGA","TTGA","GAGATCA","CTAA",2.28295411824144,7,11,13,40,2.39908705683922,4.4046952946122,7.94092717867017,101,"ENSG00000079974.19"
"41008","ENSG00000258342.4_137914",137906,137914,9,"ENSG00000258342.4",1,7,"VVVVVVMVV",0,8,0.885300207039338,95,101,133,136,150,156,171,174,"AGGAAGA","ATAA","GTGAGGA","CTGA",2.42032301175001,32,14,15,70,1.46329227455251,4.39969475488815,7.9408955830455,101,"ENSG00000079974.19"
"1101","ENSG00000047644.20_62795",62787,62795,9,"ENSG00000047644.20",1,1,"MVVVVVVVV",0,8,0.90600414078675,109,115,133,136,177,183,191,194,"ATGATGC","TTTA","GTGATGT","CTAA",2.34224105260283,18,41,8,76,1.65252969537423,4.31686751151493,7.94088407466193,101,"ENSG00000079974.19"
"615","ENSG00000021645.20_205875",205867,205875,9,"ENSG00000021645.20",1,6,"VVVVVMVVV",0,8,0.902691511387163,116,122,133,136,137,143,153,156,"AGGATGG","ATGA","AGGATCA","CTGT",2.20623408097412,11,1,10,31,2.61218004069733,4.33010181179786,7.94086785734651,101,"ENSG00000079974.19"
"2098","ENSG00000070159.14_64805",64797,64805,9,"ENSG00000070159.14",1,8,"VVVVVVVMV",0,8,0.884057971014493,104,110,133,136,143,149,165,168,"GTAATGG","TTGC","GTGAGGC","CTGA",2.33804360250674,23,7,16,55,2.03156280312295,4.40463003829198,7.94086192234995,101,"ENSG00000079974.19"
"44113","ENSG00000278311.5_27295",27287,27295,9,"ENSG00000278311.5",1,6,"VVVVVMVVV",0,8,0.902691511387163,114,120,133,136,183,189,199,202,"ACTATGA","GTAA","TTGACCA","CTGA",2.29845829101295,13,47,10,79,1.99727594783623,4.33008280531398,7.94084885086263,101,"ENSG00000079974.19"
"9398","ENSG00000124440.16_22659",22651,22659,9,"ENSG00000124440.16",1,2,"VMVVVVVVV",0,8,0.884057971014493,113,119,133,136,138,144,155,158,"ATGTTTA","ATAA","GAGAATA","CTGA",2.25614860445634,14,2,11,36,2.57747349206256,4.40461604710953,7.9408479311675,101,"ENSG00000079974.19"
"45961","ENSG00000286074.1_44417",44409,44417,9,"ENSG00000286074.1",0,NA,"VVUVVVVVV",1,8,0.883643892339545,101,107,133,136,147,153,181,184,"GTGCTGA","TTGA","GAGATCT","CTGA",2.47227714063499,26,11,28,74,1.14323454533556,4.4062705373922,7.94084610675038,101,"ENSG00000079974.19"
"20212","ENSG00000164418.22_863698",863690,863698,9,"ENSG00000164418.22",1,7,"VVVVVVMVV",0,8,0.885300207039338,109,115,133,136,141,147,165,168,"ATGAAGA","TAGA","GGGATGA","GTGA",2.30457905544803,18,5,18,50,2.23463831231653,4.39962467049251,7.94082549864986,101,"ENSG00000079974.19"
"32549","ENSG00000227160.3_80188",80180,80188,9,"ENSG00000227160.3",1,8,"VVVVVVVMV",0,8,0.884057971014493,109,115,133,136,142,148,166,169,"TTGAAGT","TAGA","ATGAGTA","CTGA",2.29971067307104,18,6,18,51,2.28669532819324,4.40452495383339,7.94075683789136,101,"ENSG00000079974.19"
"33921","ENSG00000231482.3_172490",172482,172490,9,"ENSG00000231482.3",1,3,"VVMVVVVVV",0,8,0.882815734989648,85,91,102,105,111,117,133,136,"GTAGTGA","CTGA","GTCATTA","CTAA",2.23550627055501,11,6,16,42,2.73454992187137,4.40948126472619,7.94074420468478,101,"ENSG00000079974.19"
"2058","ENSG00000069667.16_455810",455802,455810,9,"ENSG00000069667.16",0,NA,"UVVVVVVVV",1,8,0.902691511387163,113,119,133,136,146,152,208,211,"ATCAGGA","CCAA","TTGAAGT","CTGA",2.31858072367837,14,10,56,89,1.86265809150106,4.32996572900589,7.94073177455454,101,"ENSG00000079974.19"
"36861","ENSG00000243276.6_82187",82179,82187,9,"ENSG00000243276.6",0,NA,"VVVVVVUVV",1,8,0.886128364389234,114,120,133,136,142,148,160,163,"ATGATAA","TTGG","GAAATGA","CTTA",2.19213903450578,13,6,12,40,2.97060724261778,4.39621686816408,7.94073032572102,101,"ENSG00000079974.19"
"1374","ENSG00000054611.14_132239",132231,132239,9,"ENSG00000054611.14",0,NA,"VVVVUVVVV",1,8,0.889855072463768,114,120,133,136,139,145,166,169,"GTGACGG","CTTG","GTGGGGA","CTGA",2.30464793859368,13,3,21,46,2.16091797796966,4.38130939214855,7.94072968200362,101,"ENSG00000079974.19"
"4670","ENSG00000101557.15_1570",1562,1570,9,"ENSG00000101557.15",1,8,"VVVVVVVMV",0,8,0.884057971014493,110,116,133,136,143,149,202,205,"ATTTTGA","CTAT","ATGAAGA","CTGA",2.37924769948135,17,7,53,86,1.75618991040933,4.40446031007125,7.94069219412922,101,"ENSG00000079974.19"
"1943","ENSG00000067798.16_826300",826292,826300,9,"ENSG00000067798.16",0,NA,"VVVVVVUVV",1,8,0.886128364389234,82,88,133,136,141,147,155,158,"GTGAAAA","CAGA","CAGATAA","CTGA",2.35091558673807,45,5,8,67,1.91181383392828,4.39614610304551,7.94065956060245,101,"ENSG00000079974.19"
"33661","ENSG00000230612.3_21386",21378,21386,9,"ENSG00000230612.3",1,1,"MVVVVVVVV",0,8,0.90600414078675,80,86,105,108,114,120,133,136,"ATGACCA","CTGA","ATATTTA","TTGA",2.21759714413097,19,6,13,47,2.48254156689008,4.31663063194081,7.94064719508781,101,"ENSG00000079974.19"
"47310","ENSG00000287963.1_89251",89243,89251,9,"ENSG00000287963.1",1,1,"MVVVVVVVV",0,8,0.90600414078675,109,115,133,136,156,162,176,179,"AAGAAGA","TTAA","GGGATAA","CTGA",2.31758285472055,18,20,14,61,1.81569968383783,4.31656301216038,7.94057957530738,101,"ENSG00000079974.19"
"5684","ENSG00000106261.17_8370",8362,8370,9,"ENSG00000106261.17",1,1,"MVVVVVVVV",0,8,0.90600414078675,110,116,133,136,149,155,167,170,"ATCAGGA","GTGA","GTGAGCA","TTGA",2.22877104513473,17,13,12,51,2.40768236343698,4.31653899941713,7.94055556256413,101,"ENSG00000079974.19"
"19434","ENSG00000162972.11_36532",36524,36532,9,"ENSG00000162972.11",1,8,"VVVVVUVMV",1,7,0.806211180124224,115,121,133,136,147,153,167,170,"ATGTTGG","AAGA","GAGATGA","CTGA",2.42279173160539,12,11,14,46,2.71072431024414,4.71566729690336,7.94051201740025,101,"ENSG00000079974.19"
"39222","ENSG00000253320.7_49545",49537,49545,9,"ENSG00000253320.7",1,8,"VVVVVVVMV",0,8,0.884057971014493,88,94,105,108,112,118,133,136,"GTGAGGA","TTGA","AGGAAGT","ATGA",2.2413817187992,11,4,15,39,2.67446341308508,4.40425205126993,7.9404839353279,101,"ENSG00000079974.19"
"32954","ENSG00000228340.8_314947",314939,314947,9,"ENSG00000228340.8",1,7,"VVVUVVMVV",1,7,0.766045548654244,115,121,133,136,138,144,152,155,"GTGGTGG","CTGA","CTCAAGA","CTGA",2.50318943237521,12,2,8,31,2.81723734531405,4.87629172362053,7.94047391823751,101,"ENSG00000079974.19"
"40409","ENSG00000255968.1_28919",28911,28919,9,"ENSG00000255968.1",1,3,"VVMVVUVVV",1,7,0.804968944099379,82,88,103,106,115,121,133,136,"CTGATAG","TTGA","GTGATTT","CTGA",2.40866373011791,15,9,12,45,2.82414445701873,4.72047566445119,7.94035144084871,101,"ENSG00000079974.19"
"17247","ENSG00000153707.19_368089",368081,368089,9,"ENSG00000153707.19",1,5,"VVVVMVVVV",0,8,0.886542443064182,61,67,80,83,102,108,133,136,"ATGATTA","ATGA","CTGATAA","CTCA",2.39779337595944,13,19,25,66,1.5914081048912,4.39417431948854,7.94034409174527,101,"ENSG00000079974.19"
"36860","ENSG00000243276.6_81618",81610,81618,9,"ENSG00000243276.6",1,7,"VVVVVVMVV",0,8,0.885300207039338,58,64,102,105,110,116,133,136,"ATGATGA","CTGA","GTGTGGA","TGGA",2.39466698841699,38,5,17,69,1.63204819291258,4.39912369558979,7.94032452374714,101,"ENSG00000079974.19"
"21961","ENSG00000169398.20_290426",290418,290426,9,"ENSG00000169398.20",1,6,"VVVVVMVVV",0,8,0.902691511387163,110,116,133,136,140,146,171,174,"ATTATGC","CTCA","CTGATGA","CAGA",2.31785805104921,17,4,25,55,1.86584215098636,4.32955728949528,7.94032333504393,101,"ENSG00000079974.19"
"31543","ENSG00000224063.6_422511",422503,422511,9,"ENSG00000224063.6",0,NA,"VVVUVVVVV",1,8,0.880745341614907,103,109,133,136,150,156,200,203,"AAGATGA","GTGT","CTGTTGA","CTGA",2.52290966465203,24,14,44,91,0.849947492165071,4.41733631412799,7.94031768058761,101,"ENSG00000079974.19"
"2588","ENSG00000076201.16_16344",16336,16344,9,"ENSG00000076201.16",1,2,"VMVVVVVVV",0,8,0.884057971014493,92,98,133,136,141,147,179,182,"GTGATGC","CAGC","GTGAAGT","CTGA",2.48786694866514,35,5,32,81,1.03049630903907,4.40406899170166,7.94030087575963,101,"ENSG00000079974.19"
"14237","ENSG00000144642.22_118291",118283,118291,9,"ENSG00000144642.22",1,6,"VVVVVMVVV",0,8,0.902691511387163,103,109,133,136,152,158,173,176,"GTGAAGA","ATTA","TTAATAA","CTGA",2.36915845154175,24,16,15,64,1.52373364341707,4.32953083009052,7.94029687563917,101,"ENSG00000079974.19"
"44789","ENSG00000283563.1_343904",343896,343904,9,"ENSG00000283563.1",1,6,"VVVVVMVVV",0,8,0.902691511387163,103,109,133,136,152,158,173,176,"GTGAAGA","ATTA","TTAATAA","CTGA",2.36915845154175,24,16,15,64,1.52373364341707,4.32953083009052,7.94029687563917,101,"ENSG00000079974.19"
"20713","ENSG00000165409.18_186208",186200,186208,9,"ENSG00000165409.18",1,8,"VVVVVVVMV",0,8,0.884057971014493,114,120,133,136,149,155,170,173,"ATCATAG","AGGA","ATGGTGA","CTGA",2.26628330915657,13,13,15,50,2.50763308041529,4.4040471186981,7.94027900275607,101,"ENSG00000079974.19"
"18780","ENSG00000158470.5_48373",48365,48373,9,"ENSG00000158470.5",0,NA,"UVVVVVVVV",1,8,0.902691511387163,36,42,55,58,105,111,133,136,"GTGTTGA","CTGA","CTGGTGT","CTTA",2.38693425189985,13,47,22,91,1.40494689771422,4.32946047759497,7.94022652314362,101,"ENSG00000079974.19"
"22411","ENSG00000170516.17_172595",172587,172595,9,"ENSG00000170516.17",1,1,"MVVVVVVVV",0,8,0.90600414078675,75,81,97,100,114,120,133,136,"ATGATTA","CTGA","GTGGAGA","CAGT",2.23270669364419,16,14,13,52,2.38010254964894,4.31620346015256,7.94022002329956,101,"ENSG00000079974.19"
"46978","ENSG00000287442.1_95",87,95,9,"ENSG00000287442.1",1,8,"VVVVVVVMV",0,8,0.884057971014493,37,43,60,63,70,76,97,100,"AGGATGG","TTGA","ATGTTGA","GTGA",2.31008089751845,17,7,21,54,2.21537333202209,4.40397816220293,7.9402100462609,101,"ENSG00000079974.19"
"14340","ENSG00000144724.20_225970",225962,225970,9,"ENSG00000144724.20",0,NA,"VVVUVVVVV",1,8,0.880745341614907,111,117,133,136,141,147,160,163,"GTGATCT","CCTA","ATGCGGG","CTGA",2.24517358302799,16,5,13,43,2.70086535882246,4.41717231141893,7.94015367787856,101,"ENSG00000079974.19"
"17140","ENSG00000153250.21_135471",135463,135471,9,"ENSG00000153250.21",1,1,"MVVVVVVVV",0,8,0.90600414078675,92,98,133,136,141,147,165,168,"ACGATGT","ATGC","CTGCTAA","CTGA",2.35325467258051,35,5,18,67,1.5761347037262,4.31612479689906,7.94014136004606,101,"ENSG00000079974.19"
"3166","ENSG00000081913.14_257381",257373,257381,9,"ENSG00000081913.14",0,NA,"VVUVVUVVV",2,7,0.805797101449275,104,110,133,136,139,145,159,162,"CTGATGT","CAGA","ATGACAA","CTGA",2.55320403873982,23,3,14,49,1.84644137016973,4.7169504071088,7.9401388129059,101,"ENSG00000079974.19"
"4841","ENSG00000102048.16_16027",16019,16027,9,"ENSG00000102048.16",0,NA,"VVVVVUUVV",2,7,0.808281573498965,110,116,133,136,144,150,160,163,"GTAATGA","CACA","GGGATGG","CTGA",2.41163364591392,17,8,10,44,2.7503009857581,4.70696465629605,7.94009095029191,101,"ENSG00000079974.19"
"9646","ENSG00000125966.10_19850",19842,19850,9,"ENSG00000125966.10",0,NA,"VVVVVUUVV",2,7,0.808281573498965,90,96,133,136,145,151,171,174,"ATGCTGT","CTGA","GTAAAGA","CTGA",2.60346075168323,37,9,20,75,1.47127737913402,4.70692059758889,7.94004689158474,101,"ENSG00000079974.19"
"4979","ENSG00000102547.19_45525",45517,45525,9,"ENSG00000102547.19",0,NA,"UVVVVVVVV",1,8,0.902691511387163,82,88,133,136,143,149,185,188,"TTGATCA","ATGA","GTGGTCC","CTGA",2.44088560289628,45,7,36,97,1.04441950518858,4.32924754779094,7.9400135933396,101,"ENSG00000079974.19"
"34675","ENSG00000233760.3_5476",5468,5476,9,"ENSG00000233760.3",1,2,"UMVVVVVVV",1,7,0.786749482401656,100,106,133,136,165,171,188,191,"ATGATGA","GTGT","ATGATGA","CTGA",2.74656242600548,27,29,17,82,0.861600139575038,4.79300407823623,7.94000200784285,101,"ENSG00000079974.19"
"22587","ENSG00000170921.16_312993",312985,312993,9,"ENSG00000170921.16",1,1,"MVVVVVUVV",1,7,0.792132505175983,79,85,97,100,107,113,133,136,"ATGATGC","CTGA","TTGAGAA","TTGA",2.48512054482525,12,7,20,48,2.51839261260212,4.77146572785927,7.93999574856321,101,"ENSG00000079974.19"
"8026","ENSG00000116580.20_13297",13289,13297,9,"ENSG00000116580.20",0,NA,"VVUVVVVVV",1,8,0.883643892339545,43,49,61,64,73,79,133,136,"TTGATGA","GTGA","TGGATCA","TTGA",2.35050263690646,12,9,54,84,1.95165924832839,4.4054192069262,7.93999477628437,101,"ENSG00000079974.19"
"7546","ENSG00000114770.17_78813",78805,78813,9,"ENSG00000114770.17",1,8,"VVVVVVVMV",0,8,0.884057971014493,114,120,133,136,150,156,167,170,"GTGTTAA","ATTA","CTGATAT","CTGA",2.25119058070691,13,14,11,47,2.60696822250829,4.40372635680525,7.93995824086322,101,"ENSG00000079974.19"
"3969","ENSG00000091436.17_3425",3417,3425,9,"ENSG00000091436.17",1,2,"VMVVVUVVV",1,7,0.806211180124223,115,121,133,136,138,144,156,159,"ATGATAT","ATGA","ATGACTT","CTGA",2.43679018337655,12,2,12,35,2.61509581249533,4.71509092541808,7.93993564591497,101,"ENSG00000079974.19"
"34294","ENSG00000232555.2_159798",159790,159798,9,"ENSG00000232555.2",1,7,"VVVVVVMVV",0,8,0.885300207039338,114,120,133,136,145,151,198,201,"TTTAAGA","CAGA","CTGTTGT","CTGA",2.34659069021134,13,9,47,78,1.95097939119319,4.39872933148386,7.93993015964121,101,"ENSG00000079974.19"
"10788","ENSG00000132842.15_216949",216941,216949,9,"ENSG00000132842.15",1,5,"UVVVMUVVV",2,6,0.711387163561077,77,83,97,100,114,120,133,136,"ATGAGGA","CTGA","ATCATTA","CTGA",2.68062463045261,14,14,13,50,2.50658604070126,5.09435422759633,7.93990288184064,101,"ENSG00000079974.19"
"37888","ENSG00000249042.6_36638",36630,36638,9,"ENSG00000249042.6",1,1,"MVVVVVVVV",0,8,0.90600414078675,116,122,133,136,155,161,193,196,"ATCATTA","TTTA","TTGAAGA","CTGA",2.38132309433682,11,19,32,71,1.38792504307791,4.31585308466417,7.93986964781117,101,"ENSG00000079974.19"
"39272","ENSG00000253394.7_316627",316619,316627,9,"ENSG00000253394.7",1,8,"VVVVVVVMV",0,8,0.884057971014493,92,98,133,136,144,150,161,164,"CTAATGA","CATA","TAGATGT","CTGA",2.34498157944503,35,8,11,63,1.98100858860468,4.40355477955955,7.93978666361752,101,"ENSG00000079974.19"
"5318","ENSG00000104324.16_105504",105496,105504,9,"ENSG00000104324.16",1,6,"VVVVVMVVV",0,8,0.902691511387163,87,93,133,136,155,161,172,175,"ATGGTGG","CAGC","CTGATGC","CTGA",2.40090231554225,40,19,11,79,1.30998015578476,4.32899889818327,7.93976494373192,101,"ENSG00000079974.19"
"30769","ENSG00000213277.3_107",99,107,9,"ENSG00000213277.3",0,NA,"VVVVVVUVV",1,8,0.886128364389234,88,94,109,112,162,168,219,222,"ACGATGG","ATGA","ATGAGGC","CTGA",2.50026233142438,15,50,51,125,0.912374459615167,4.3951975006111,7.93971095816803,101,"ENSG00000079974.19"
"35726","ENSG00000236892.2_257",249,257,9,"ENSG00000236892.2",0,NA,"UVVVVVVVV",1,8,0.902691511387163,109,115,133,136,176,182,211,214,"ATAATGT","TTGA","GTGTAAA","CTGA",2.47386440627042,18,40,29,96,0.822779552497974,4.32880223190852,7.93956827745717,101,"ENSG00000079974.19"
"11262","ENSG00000134369.16_49109",49101,49109,9,"ENSG00000134369.16",1,1,"MVVVVVVVV",0,8,0.90600414078675,60,66,78,81,90,96,133,136,"CTAATGA","ATGA","GTGATAT","ATGA",2.29122712769308,12,9,37,67,1.98729055429006,4.31553451806098,7.93955108120798,101,"ENSG00000079974.19"
"48131","ENSG00000290510.1_16383",16375,16383,9,"ENSG00000290510.1",1,6,"VVVVVMVVV",0,8,0.902691511387163,112,118,133,136,178,184,199,202,"GTGAGGG","GGGA","GTGAGGG","CTGA",2.33753570871553,15,42,15,81,1.73149811748095,4.32876737722946,7.93953342277811,101,"ENSG00000079974.19"
"48542","ENSG00000291258.1_32917",32909,32917,9,"ENSG00000291258.1",1,6,"VVVVVMVVV",0,8,0.902691511387163,112,118,133,136,178,184,199,202,"GTGAGGG","GGGA","GTGAGGG","CTGA",2.33753570871553,15,42,15,81,1.73149811748095,4.32876737722946,7.93953342277811,101,"ENSG00000079974.19"
"33132","ENSG00000228791.8_150692",150684,150692,9,"ENSG00000228791.8",1,8,"VVUVVVVMV",1,7,0.767701863354037,55,61,72,75,82,88,133,136,"CTGATGT","CTGA","GTGGAAA","CTGA",2.62389523212344,11,7,45,72,1.98212560509666,4.8686901214799,7.93949757489605,101,"ENSG00000079974.19"
"36165","ENSG00000238098.9_56516",56508,56516,9,"ENSG00000238098.9",1,2,"VMVVVVVVV",0,8,0.884057971014493,83,89,133,136,186,192,202,205,"CTGTTGA","GTGA","TTGAAAA","CTGA",2.49175746401278,44,50,10,113,1.00124959093816,4.4032415044225,7.93947338848047,101,"ENSG00000079974.19"
"7129","ENSG00000112902.12_364946",364938,364946,9,"ENSG00000112902.12",1,8,"VVVVVVVMV",0,8,0.884057971014493,109,115,133,136,141,147,158,161,"AGAATAA","GAGA","CTGATGT","CTGA",2.25247666611639,18,5,11,43,2.5959736736364,4.40312119526974,7.93935307932772,101,"ENSG00000079974.19"
"22448","ENSG00000170579.17_72181",72173,72181,9,"ENSG00000170579.17",1,1,"MVVVVVVVV",0,8,0.90600414078675,90,96,133,136,150,156,169,172,"ATGATGC","GTGA","CTGATTC","CTGT",2.35726937740313,37,14,13,73,1.54620672994643,4.31533397815849,7.93935054130549,101,"ENSG00000079974.19"
"6692","ENSG00000111490.15_5545",5537,5545,9,"ENSG00000111490.15",0,NA,"UVVVVVVVV",1,8,0.902691511387163,116,122,133,136,173,179,187,190,"ATCATGA","CTGT","AAGATCA","CTGC",2.30188921607237,11,37,8,65,1.96837374798334,4.32857546378312,7.93934150933177,101,"ENSG00000079974.19"
"47498","ENSG00000288591.1_5533",5525,5533,9,"ENSG00000288591.1",0,NA,"UVVVVVVVV",1,8,0.902691511387163,116,122,133,136,173,179,187,190,"ATCATGA","CTGT","AAGATCA","CTGC",2.30188921607237,11,37,8,65,1.96837374798334,4.32857546378312,7.93934150933177,101,"ENSG00000079974.19"
"16737","ENSG00000152208.13_54256",54248,54256,9,"ENSG00000152208.13",1,6,"VVVVVMUVV",1,7,0.788819875776397,45,51,64,67,79,85,133,136,"ATGATGG","CTAA","GGGATGC","CTGA",2.605633669511,13,12,48,82,1.76531893825982,4.78405251708329,7.93933202018888,101,"ENSG00000079974.19"
"34237","ENSG00000232284.9_202206",202198,202206,9,"ENSG00000232284.9",1,8,"VVVVVVVMV",0,8,0.884057971014493,113,119,133,136,160,166,187,190,"ATGGTGG","CTTC","ATGAGGA","CTGA",2.40621512209097,14,24,21,68,1.57089215256012,4.40308157495832,7.93931345901629,101,"ENSG00000079974.19"
"43223","ENSG00000270106.6_86502",86494,86502,9,"ENSG00000270106.6",1,2,"UMVVVVVVV",1,7,0.786749482401656,114,120,133,136,163,169,180,183,"ATGATTA","CTTA","GAGCTGA","CTGA",2.56498154040003,13,27,11,60,2.06896943300712,4.79221159225183,7.93920952185846,101,"ENSG00000079974.19"
"28684","ENSG00000196353.13_246131",246123,246131,9,"ENSG00000196353.13",1,1,"MVVVVUVVV",1,7,0.82815734989648,95,101,133,136,146,152,166,169,"ATGATGG","AGGA","GAGATAA","CTGA",2.5069635624515,32,10,14,65,1.79294593941519,4.62650908893963,7.93913848852555,101,"ENSG00000079974.19"
"34514","ENSG00000233290.4_314452",314444,314452,9,"ENSG00000233290.4",1,1,"MVVVVVVVV",0,8,0.90600414078675,115,121,133,136,137,143,153,156,"GGGATTA","CAAA","CCTATGA","CTGA",2.20167689314849,12,1,10,32,2.58240265434145,4.31506215216618,7.93907871531318,101,"ENSG00000079974.19"
"41855","ENSG00000259867.6_210050",210042,210050,9,"ENSG00000259867.6",1,8,"UVVVVVVMV",1,7,0.786749482401656,114,120,133,136,156,162,175,178,"ATGTTGA","ATGA","GTGTTCC","CTGA",2.54630376364701,13,20,13,55,2.19279348636474,4.79203797766953,7.93903590727616,101,"ENSG00000079974.19"
"44413","ENSG00000281732.1_2875",2867,2875,9,"ENSG00000281732.1",1,8,"VVVVVVVMV",0,8,0.884057971014493,107,113,133,136,147,153,209,212,"GTGCTGC","CAGA","GTGCAGA","CTGA",2.44276092757997,20,11,56,96,1.32603526111576,4.40277702791222,7.93900891197019,101,"ENSG00000079974.19"
"19386","ENSG00000162849.16_391575",391567,391575,9,"ENSG00000162849.16",1,8,"VVVVVVUMV",1,7,0.770186335403727,89,95,107,110,114,120,133,136,"TTGCTGT","CTGA","ATGACCA","CTGA",2.49240818535543,12,4,13,38,2.8168696944754,4.8582310658779,7.93897640749281,101,"ENSG00000079974.19"
"41735","ENSG00000259639.6_227277",227269,227277,9,"ENSG00000259639.6",1,8,"VVVVVUVMV",1,7,0.806211180124224,112,118,133,136,166,172,181,184,"GTGATCA","CTGG","GTGATCC","CTGA",2.5346057447385,15,30,9,63,1.95914201002112,4.71412841040278,7.93897313089968,101,"ENSG00000079974.19"
"40647","ENSG00000257261.7_183573",183565,183573,9,"ENSG00000257261.7",1,3,"VVMVVVVVV",0,8,0.882815734989648,89,95,133,136,166,172,182,185,"CTGATGA","CTTC","GTGCAGT","CTGA",2.48651061695069,38,30,10,87,1.05407815929617,4.40770390140852,7.93896684136712,101,"ENSG00000079974.19"
"43565","ENSG00000272369.1_29504",29496,29504,9,"ENSG00000272369.1",1,3,"VVMVVVVVV",0,8,0.882815734989648,89,95,133,136,166,172,182,185,"CTGATGA","CTTC","GTGCAGT","CTGA",2.48651061695069,38,30,10,87,1.05407815929617,4.40770390140852,7.93896684136712,101,"ENSG00000079974.19"
"2904","ENSG00000079156.17_203923",203915,203923,9,"ENSG00000079156.17",1,5,"UVVVMVVVV",1,7,0.789233954451346,111,117,133,136,142,148,159,162,"TTGAGGA","ACGA","CTGAGGA","CTGA",2.44543832854318,16,6,11,42,2.82489093175048,4.78195328050958,7.93888909831497,101,"ENSG00000079974.19"
"17809","ENSG00000155099.8_2554",2546,2554,9,"ENSG00000155099.8",1,7,"VVVVVVMVV",0,8,0.885300207039338,115,121,133,136,140,146,158,161,"AAAAAGA","ATAA","GTGAATA","CTGA",2.20736089870189,12,4,12,37,2.87483027044181,4.39764239878027,7.93884322693762,101,"ENSG00000079974.19"
"19145","ENSG00000162129.15_133687",133679,133687,9,"ENSG00000162129.15",0,NA,"VVVUVVVVV",1,8,0.880745341614907,116,122,133,136,139,145,154,157,"CTGCTGT","AAGA","GGGCTGC","CTGA",2.20986627527397,11,3,9,32,2.93087201071515,4.41582846146874,7.93880982792837,101,"ENSG00000079974.19"
"15816","ENSG00000149656.9_1508",1500,1508,9,"ENSG00000149656.9",0,NA,"VVUVVUVVV",2,7,0.805797101449275,116,122,133,136,145,151,188,191,"ATGCTGA","TTGG","ATGATGC","CTGA",2.53505699941343,11,9,37,66,1.96193366279356,4.71557841472077,7.93876682051787,101,"ENSG00000079974.19"
"30167","ENSG00000203880.13_36198",36190,36198,9,"ENSG00000203880.13",0,NA,"VVUVVUVVV",2,7,0.805797101449275,116,122,133,136,145,151,188,191,"ATGCTGA","TTGG","ATGATGC","CTGA",2.53505699941343,11,9,37,66,1.96193366279356,4.71557841472077,7.93876682051787,101,"ENSG00000079974.19"
"31172","ENSG00000217929.4_1706",1698,1706,9,"ENSG00000217929.4",0,NA,"VVUVVUVVV",2,7,0.805797101449275,116,122,133,136,145,151,188,191,"ATGCTGA","TTGG","ATGATGC","CTGA",2.53505699941343,11,9,37,66,1.96193366279356,4.71557841472077,7.93876682051787,101,"ENSG00000079974.19"
"32364","ENSG00000226838.1_1352",1344,1352,9,"ENSG00000226838.1",0,NA,"VVUVVUVVV",2,7,0.805797101449275,116,122,133,136,145,151,188,191,"ATGCTGA","TTGG","ATGATGC","CTGA",2.53505699941343,11,9,37,66,1.96193366279356,4.71557841472077,7.93876682051787,101,"ENSG00000079974.19"
"33497","ENSG00000230021.10_104597",104589,104597,9,"ENSG00000230021.10",0,NA,"VVUVVUVVV",2,7,0.805797101449275,116,122,133,136,145,151,188,191,"ATGCTGA","TTGG","ATGATGC","CTGA",2.53505699941343,11,9,37,66,1.96193366279356,4.71557841472077,7.93876682051787,101,"ENSG00000079974.19"
"36154","ENSG00000238009.6_1508",1500,1508,9,"ENSG00000238009.6",0,NA,"VVUVVUVVV",2,7,0.805797101449275,116,122,133,136,145,151,188,191,"ATGCTGA","TTGG","ATGATGC","CTGA",2.53505699941343,11,9,37,66,1.96193366279356,4.71557841472077,7.93876682051787,101,"ENSG00000079974.19"
"39925","ENSG00000254468.3_1508",1500,1508,9,"ENSG00000254468.3",0,NA,"VVUVVUVVV",2,7,0.805797101449275,116,122,133,136,145,151,188,191,"ATGCTGA","TTGG","ATGATGC","CTGA",2.53505699941343,11,9,37,66,1.96193366279356,4.71557841472077,7.93876682051787,101,"ENSG00000079974.19"
"42053","ENSG00000260528.6_72464",72456,72464,9,"ENSG00000260528.6",0,NA,"VVUVVUVVV",2,7,0.805797101449275,116,122,133,136,145,151,188,191,"ATGCTGA","TTGG","ATGATGC","CTGA",2.53505699941343,11,9,37,66,1.96193366279356,4.71557841472077,7.93876682051787,101,"ENSG00000079974.19"
"42153","ENSG00000260923.7_1508",1500,1508,9,"ENSG00000260923.7",0,NA,"VVUVVUVVV",2,7,0.805797101449275,116,122,133,136,145,151,188,191,"ATGCTGA","TTGG","ATGATGC","CTGA",2.53505699941343,11,9,37,66,1.96193366279356,4.71557841472077,7.93876682051787,101,"ENSG00000079974.19"
"48081","ENSG00000290384.1_1351",1343,1351,9,"ENSG00000290384.1",0,NA,"VVUVVUVVV",2,7,0.805797101449275,116,122,133,136,145,151,188,191,"ATGCTGA","TTGG","ATGATGC","CTGA",2.53505699941343,11,9,37,66,1.96193366279356,4.71557841472077,7.93876682051787,101,"ENSG00000079974.19"
"48084","ENSG00000290385.1_34726",34718,34726,9,"ENSG00000290385.1",0,NA,"VVUVVUVVV",2,7,0.805797101449275,116,122,133,136,145,151,188,191,"ATGCTGA","TTGG","ATGATGC","CTGA",2.53505699941343,11,9,37,66,1.96193366279356,4.71557841472077,7.93876682051787,101,"ENSG00000079974.19"
"48515","ENSG00000291218.1_1508",1500,1508,9,"ENSG00000291218.1",0,NA,"VVUVVUVVV",2,7,0.805797101449275,116,122,133,136,145,151,188,191,"ATGCTGA","TTGG","ATGATGC","CTGA",2.53505699941343,11,9,37,66,1.96193366279356,4.71557841472077,7.93876682051787,101,"ENSG00000079974.19"
"29312","ENSG00000197653.16_151655",151647,151655,9,"ENSG00000197653.16",1,2,"VMVVVUVVV",1,7,0.806211180124223,94,100,110,113,116,122,133,136,"ATTTTGA","CTGT","GTGTGGT","CTGA",2.40618170482587,10,3,11,33,2.81420863607881,4.71385500039615,7.93869972089304,101,"ENSG00000079974.19"
"9207","ENSG00000123106.11_306521",306513,306521,9,"ENSG00000123106.11",1,2,"VMVVVVVVV",0,8,0.884057971014493,111,117,133,136,143,149,159,162,"AACAGGA","CAGA","ATATTTA","CTGA",2.21315904932557,16,7,10,42,2.85527675341961,4.40241760389751,7.93864948795548,101,"ENSG00000079974.19"
"44086","ENSG00000277661.4_38537",38529,38537,9,"ENSG00000277661.4",1,6,"VVUVVMVVV",1,7,0.786335403726708,81,87,103,106,111,117,133,136,"CTGATAA","CTTA","ATGAGAA","CTGA",2.49617002864127,16,5,16,46,2.53199886574366,4.79328309750471,7.93862471241154,101,"ENSG00000079974.19"
"43801","ENSG00000273734.1_33803",33795,33803,9,"ENSG00000273734.1",1,8,"VVVVVVVMV",0,8,0.884057971014493,85,91,105,108,110,116,133,136,"GTGAGAA","CTAA","GAGCAGA","CTGA",2.31078015332721,14,2,17,42,2.20416087268278,4.40234047371604,7.93857235777401,101,"ENSG00000079974.19"
"20077","ENSG00000164244.21_22517",22509,22517,9,"ENSG00000164244.21",0,NA,"VVVUVVUVV",2,7,0.766873706004141,60,66,78,81,86,92,133,136,"GTGATTA","CTGA","TTGTTGG","CTGA",2.63034592019684,12,5,41,67,1.94836077785415,4.87100006145827,7.93849488547483,101,"ENSG00000079974.19"
"30410","ENSG00000204929.13_620864",620856,620864,9,"ENSG00000204929.13",1,1,"MVVVVVVVV",0,8,0.90600414078675,67,73,82,85,112,118,133,136,"CTGATGA","ATGA","ATTATTT","GTGA",2.3275250470902,9,27,15,60,1.74092975281673,4.31444085002118,7.93845741316817,101,"ENSG00000079974.19"
"14320","ENSG00000144677.15_38076",38068,38076,9,"ENSG00000144677.15",1,7,"VVVVVVMVV",0,8,0.885300207039338,111,117,133,136,182,188,199,202,"AAGATTA","TGGA","GTGAGAA","CTGA",2.36446845110287,16,46,11,82,1.825781171892,4.39722604481112,7.93842687296847,101,"ENSG00000079974.19"
"9675","ENSG00000126091.21_36382",36374,36382,9,"ENSG00000126091.21",1,1,"MVVVVUVVV",1,7,0.82815734989648,103,109,133,136,145,151,168,171,"CTGATGG","CTCA","TTGTTAA","CTGA",2.49553228412769,24,9,17,59,1.86618533390363,4.62576680702206,7.93839620660798,101,"ENSG00000079974.19"
"45089","ENSG00000284989.1_92057",92049,92057,9,"ENSG00000284989.1",1,1,"MVVVVUVVV",1,7,0.82815734989648,103,109,133,136,145,151,168,171,"CTGATGG","CTCA","TTGTTAA","CTGA",2.49553228412769,24,9,17,59,1.86618533390363,4.62576680702206,7.93839620660798,101,"ENSG00000079974.19"
"29196","ENSG00000197415.12_45019",45011,45019,9,"ENSG00000197415.12",0,NA,"UVVVVVVVV",1,8,0.902691511387163,110,116,133,136,167,173,191,194,"GTGCAGA","CAAA","ATGATGA","CTGA",2.38154722969888,17,31,18,75,1.43353461979388,4.32762903777993,7.93839508332858,101,"ENSG00000079974.19"
"39485","ENSG00000253658.6_101572",101564,101572,9,"ENSG00000253658.6",1,2,"UMVVVVVVV",1,7,0.786749482401656,108,114,133,136,143,149,160,163,"ATGATTA","CTGT","ATTACCA","CTGA",2.48978196660847,19,7,11,46,2.56672208124723,4.79131713132592,7.93831506093255,101,"ENSG00000079974.19"
"10241","ENSG00000130052.14_8217",8209,8217,9,"ENSG00000130052.14",1,2,"VMUVVVVVV",1,7,0.767701863354037,114,120,133,136,142,148,159,162,"ATGATGT","GTTA","TAGATGC","CTGA",2.46899951386369,13,6,11,39,3.01000559323771,4.86750058808224,7.93830804149839,101,"ENSG00000079974.19"
"20026","ENSG00000164171.11_1696",1688,1696,9,"ENSG00000164171.11",0,NA,"VVVUVVVVV",1,8,0.880745341614907,106,112,133,136,145,151,161,164,"ATGTTGA","GTGA","TTAATGG","CTGC",2.29496219769343,21,9,10,49,2.36155758272403,4.41532639183672,7.93830775829635,101,"ENSG00000079974.19"
"46652","ENSG00000286982.1_6523",6515,6523,9,"ENSG00000286982.1",1,2,"VMVVVVVVV",0,8,0.884057971014493,96,102,133,136,170,176,186,189,"CTGATGA","GTCA","GTGACAG","CTGA",2.48279080671492,31,34,10,84,1.05620214013069,4.40203521289087,7.93826709694884,101,"ENSG00000079974.19"
"44144","ENSG00000278811.4_138098",138090,138098,9,"ENSG00000278811.4",1,7,"VVVVVVMVV",0,8,0.885300207039338,109,115,133,136,143,149,166,169,"AGGTTGT","GTGA","GTAAGAA","CTGA",2.28357383710782,18,7,17,51,2.36443557425484,4.39706528874341,7.93826611690076,101,"ENSG00000079974.19"
"35096","ENSG00000234915.1_13566",13558,13566,9,"ENSG00000234915.1",1,2,"VMVVVVVVV",0,8,0.884057971014493,79,85,93,96,105,111,133,136,"ATTATGA","TTGA","AAGATAA","CTGC",2.32748404630061,8,9,22,48,2.09113959975909,4.40192497710745,7.93815686116542,101,"ENSG00000079974.19"
"21402","ENSG00000167355.8_63212",63204,63212,9,"ENSG00000167355.8",1,8,"VVUVVVVMV",1,7,0.767701863354037,114,120,133,136,141,147,159,162,"TGGATTA","CTGA","GTGACAA","CTGA",2.48091555961395,13,5,12,39,2.92994340408489,4.86734511704448,7.93815257046063,101,"ENSG00000079974.19"
"28824","ENSG00000196565.15_63165",63157,63165,9,"ENSG00000196565.15",1,8,"VVUVVVVMV",1,7,0.767701863354037,114,120,133,136,141,147,159,162,"TGGATTA","CTGA","GTGACAA","CTGA",2.48091555961395,13,5,12,39,2.92994340408489,4.86734511704448,7.93815257046063,101,"ENSG00000079974.19"
"30821","ENSG00000213931.7_63212",63204,63212,9,"ENSG00000213931.7",1,8,"VVUVVVVMV",1,7,0.767701863354037,114,120,133,136,141,147,159,162,"TGGATTA","CTGA","GTGACAA","CTGA",2.48091555961395,13,5,12,39,2.92994340408489,4.86734511704448,7.93815257046063,101,"ENSG00000079974.19"
"36321","ENSG00000239920.2_235994",235986,235994,9,"ENSG00000239920.2",1,8,"VVUVVVVMV",1,7,0.767701863354037,114,120,133,136,141,147,159,162,"TGGATTA","CTGA","GTGACAA","CTGA",2.48091555961395,13,5,12,39,2.92994340408489,4.86734511704448,7.93815257046063,101,"ENSG00000079974.19"
"15279","ENSG00000147533.19_17690",17682,17690,9,"ENSG00000147533.19",0,NA,"VVVVUVVVV",1,8,0.889855072463768,111,117,133,136,178,184,222,225,"CTGATGA","GTGG","TTCAAGA","CTGA",2.49624301048314,16,42,38,105,0.873129607235021,4.37868741928066,7.93810770913573,101,"ENSG00000079974.19"
"28681","ENSG00000196353.13_110966",110958,110966,9,"ENSG00000196353.13",1,3,"VVMVVVUVV",1,7,0.768944099378882,72,78,94,97,109,115,133,136,"ATGGTGA","CTGT","GGGAGGA","CTGA",2.58140915528268,16,12,18,55,2.2398415730199,4.86230898539277,7.93808538290829,101,"ENSG00000079974.19"
"5949","ENSG00000107295.10_113791",113783,113791,9,"ENSG00000107295.10",0,NA,"VVUVVVVVV",1,8,0.883643892339545,113,119,133,136,144,150,188,191,"ATGGTGG","CTTC","GTGGTGG","CTGA",2.34498201398286,14,8,38,69,1.98075054212953,4.40349099217049,7.93806656152867,101,"ENSG00000079974.19"
"36011","ENSG00000237720.2_11383",11375,11383,9,"ENSG00000237720.2",0,NA,"VVVVUUVVV",2,7,0.812008281573499,110,116,133,136,152,158,177,180,"GTGCTGA","CTGC","CTAATGA","CTGA",2.54115335414512,17,16,19,61,1.81889047261973,4.68997820839679,7.93801133469079,101,"ENSG00000079974.19"
"16088","ENSG00000150672.19_519652",519644,519652,9,"ENSG00000150672.19",1,8,"VVVVVVVMV",0,8,0.884057971014493,104,110,133,136,147,153,175,178,"GTAATAA","CTAA","TTGATAA","CTGA",2.41368747799485,23,11,22,65,1.51568965947838,4.40173487819435,7.93796676225232,101,"ENSG00000079974.19"
"15947","ENSG00000150394.14_256904",256896,256904,9,"ENSG00000150394.14",1,8,"VVVVVVVMV",0,8,0.884057971014493,96,102,133,136,147,153,163,166,"ATAATGA","CTTC","ATTCTCA","CTGA",2.36095242158171,31,11,10,61,1.8671156470664,4.40169961440279,7.93793149846076,101,"ENSG00000079974.19"
"31343","ENSG00000223482.10_69750",69742,69750,9,"ENSG00000223482.10",0,NA,"VVVUVUVVV",2,7,0.802898550724638,110,116,133,136,164,170,180,183,"CTGCTGT","CTGA","ATGTTGA","CTGA",2.56153738865895,17,28,10,64,1.828308879702,4.72630620102375,7.9379004039223,101,"ENSG00000079974.19"
"31968","ENSG00000225484.7_75944",75936,75944,9,"ENSG00000225484.7",0,NA,"VVVUVUVVV",2,7,0.802898550724638,110,116,133,136,164,170,180,183,"CTGCTGT","CTGA","ATGTTGA","CTGA",2.56153738865895,17,28,10,64,1.828308879702,4.72630620102375,7.9379004039223,101,"ENSG00000079974.19"
"11152","ENSG00000134108.14_16593",16585,16593,9,"ENSG00000134108.14",1,7,"VVVVVUMVV",1,7,0.807453416149068,75,81,101,104,113,119,133,136,"TTTATGA","TTGA","GTGAAAC","CTGA",2.47795416337049,20,9,14,52,2.3125843284526,4.70806968773064,7.93788335232691,101,"ENSG00000079974.19"
"328","ENSG00000008277.15_70099",70091,70099,9,"ENSG00000008277.15",1,7,"VVVVVVMVV",0,8,0.885300207039338,106,112,133,136,145,151,161,164,"GTGACAA","CTGA","AAGATGA","CTTA",2.28377509856868,21,9,10,49,2.36155758272403,4.3966812266288,7.93788205478615,101,"ENSG00000079974.19"
"45641","ENSG00000285769.4_118918",118910,118918,9,"ENSG00000285769.4",1,7,"VVVVVVMVV",0,8,0.885300207039338,90,96,106,109,116,122,133,136,"TTTATGG","TTTA","GTTCTGT","CTGA",2.19041372166139,10,7,11,37,2.98392688917998,4.39667125839731,7.93787208655466,101,"ENSG00000079974.19"
"20224","ENSG00000164483.17_41124",41116,41124,9,"ENSG00000164483.17",1,8,"VVVVVVVMV",0,8,0.884057971014493,116,122,133,136,139,145,158,161,"AAAAGGA","CTAA","ATGAGTC","CTGA",2.23637387292896,11,3,13,36,2.69737098893804,4.40163253544944,7.93786441950741,101,"ENSG00000079974.19"
"42150","ENSG00000260916.8_54984",54976,54984,9,"ENSG00000260916.8",1,8,"VVVVVVVMV",0,8,0.884057971014493,90,96,133,136,147,153,168,171,"GTTATGA","ATGT","CTTAGGA","CTGA",2.39249868873266,37,11,15,72,1.65646889560276,4.40161503845512,7.93784692251309,101,"ENSG00000079974.19"
"46282","ENSG00000286429.1_11780",11772,11780,9,"ENSG00000286429.1",1,8,"VVVVVVVMV",0,8,0.884057971014493,108,114,133,136,148,154,166,169,"ATTAAGA","CACA","ATTATGC","CTGA",2.29580825586261,19,12,12,52,2.30103208900523,4.40160511535566,7.93783699941363,101,"ENSG00000079974.19"
"37241","ENSG00000246228.7_60961",60953,60961,9,"ENSG00000246228.7",0,NA,"VVVVVVUVV",1,8,0.886128364389234,116,122,133,136,147,153,165,168,"GTTTTGA","TTGG","GTGTTTC","CTGA",2.21890712291378,11,11,12,43,2.78034280521069,4.39326423949231,7.93777769704924,101,"ENSG00000079974.19"
"8267","ENSG00000117682.18_12003",11995,12003,9,"ENSG00000117682.18",1,1,"MVVVVUVVV",1,7,0.82815734989648,113,119,133,136,143,149,158,161,"CTGAGGA","CCTA","ATGGGGT","CTGA",2.32391906501315,14,7,9,39,3.0073188496743,4.62502815410716,7.93765755369308,101,"ENSG00000079974.19"
"12961","ENSG00000139722.7_19011",19003,19011,9,"ENSG00000139722.7",1,1,"MVVVVVVVV",0,8,0.90600414078675,114,120,133,136,138,144,152,155,"GTGAAGG","CTGC","ATGAGTA","ATGA",2.17452228266886,13,2,8,32,2.75757226228217,4.31359687001864,7.93761343316564,101,"ENSG00000079974.19"
"44249","ENSG00000280138.1_11604",11596,11604,9,"ENSG00000280138.1",1,1,"MVVVVVVVV",0,8,0.90600414078675,114,120,133,136,138,144,152,155,"GTGAAGG","CTGC","ATGAGTA","ATGA",2.17452228266886,13,2,8,32,2.75757226228217,4.31359687001864,7.93761343316564,101,"ENSG00000079974.19"
"12102","ENSG00000137252.10_69411",69403,69411,9,"ENSG00000137252.10",0,NA,"VVUVVUVVV",2,7,0.805797101449275,109,115,133,136,159,165,177,180,"TTGATGA","GGGA","GTGTGGA","CTGA",2.55899741168526,18,23,12,62,1.79748690413097,4.71436741217485,7.93755581797195,101,"ENSG00000079974.19"
"12424","ENSG00000138162.19_107150",107142,107150,9,"ENSG00000138162.19",0,NA,"VVVVUVVVV",1,8,0.889855072463768,112,118,133,136,142,148,157,160,"GAGCTGG","CTGG","CCCATGA","CTGA",2.18633594176686,15,6,9,39,2.93671406819146,4.37807175332597,7.93749204318104,101,"ENSG00000079974.19"
"24098","ENSG00000175161.14_206150",206142,206150,9,"ENSG00000175161.14",1,5,"VVVVMVVVV",0,8,0.886542443064182,114,120,133,136,144,150,159,162,"ATCATGA","ATGT","TTCATAA","CTAA",2.18092980765403,13,8,9,39,3.02568388418325,4.39130398380253,7.93747375605925,101,"ENSG00000079974.19"
"40492","ENSG00000256591.5_48198",48190,48198,9,"ENSG00000256591.5",0,NA,"VVVVVVUVV",1,8,0.886128364389234,91,97,133,136,141,147,175,178,"AGGATTA","ATGA","GTGATTC","CTGA",2.46892739512959,36,5,28,78,1.11210337491114,4.39290483561043,7.93741829316736,101,"ENSG00000079974.19"
"7679","ENSG00000115353.11_20296",20288,20296,9,"ENSG00000115353.11",1,8,"VVVVVVVMV",0,8,0.884057971014493,96,102,133,136,142,148,161,164,"TTGATGG","CAGT","ATGACTG","CTGA",2.35036419776089,31,6,13,59,1.9349765501562,4.40101780047386,7.93724968453183,101,"ENSG00000079974.19"
"12863","ENSG00000139220.17_453353",453345,453353,9,"ENSG00000139220.17",0,NA,"VVVVUVVVV",1,8,0.889855072463768,112,118,133,136,141,147,156,159,"TTAATGT","TGGA","AGGACCA","CTGA",2.19175183672914,15,5,9,38,2.89939127144395,4.37776754574289,7.93718783559797,101,"ENSG00000079974.19"
"16844","ENSG00000152404.16_130858",130850,130858,9,"ENSG00000152404.16",1,8,"VVVVVVVMV",0,8,0.884057971014493,110,116,133,136,147,153,161,164,"TTGAGGA","CTGC","GTGGTGG","ATGA",2.25411802166827,17,11,8,45,2.57626513899442,4.40092965419572,7.93716153825369,101,"ENSG00000079974.19"
"38960","ENSG00000251363.3_180934",180926,180934,9,"ENSG00000251363.3",1,2,"UMVVVUVVV",2,6,0.708902691511387,86,92,105,108,114,120,133,136,"CTGATCA","CTGA","GTGGTGG","CTGA",2.62249810457953,13,6,13,41,2.9227224780417,5.10151079380964,7.93712155985518,101,"ENSG00000079974.19"
"20761","ENSG00000165568.18_52019",52011,52019,9,"ENSG00000165568.18",1,8,"VVVVVVVMV",0,8,0.884057971014493,72,78,89,92,103,109,133,136,"TTGATGA","GTGA","GTATTCA","CTCA",2.32196740524623,11,11,24,55,2.12375004841121,4.40088318751318,7.93711507157115,101,"ENSG00000079974.19"
"7735","ENSG00000115504.15_273072",273064,273072,9,"ENSG00000115504.15",0,NA,"UVVVVVVVV",1,8,0.902691511387163,49,55,64,67,79,85,133,136,"AAAATGA","ATGA","AGCAGGA","CTGA",2.35491278727897,9,12,48,78,1.60594293020976,4.32634037801739,7.93710642356604,101,"ENSG00000079974.19"
"33504","ENSG00000230040.2_29626",29618,29626,9,"ENSG00000230040.2",0,NA,"UVVVVVVVV",1,8,0.902691511387163,111,117,133,136,146,152,167,170,"TAGAAGA","CTGG","ATGATGA","GTGA",2.21268516013156,16,10,15,50,2.553965310048,4.32629992773127,7.93706597327992,101,"ENSG00000079974.19"
"11791","ENSG00000136068.16_36726",36718,36726,9,"ENSG00000136068.16",1,2,"VMUVVVVVV",1,7,0.767701863354037,86,92,107,110,116,122,133,136,"GGGATGT","CTGA","ATTAGGT","CTGA",2.48425400303267,15,6,11,41,2.90323199383234,4.86623133684587,7.93703879026202,101,"ENSG00000079974.19"
"28117","ENSG00000188158.17_178127",178119,178127,9,"ENSG00000188158.17",1,7,"VVVUVVMVV",1,7,0.766045548654244,112,118,133,136,143,149,158,161,"GCAATGA","CTGA","TTGATCC","CTGA",2.48244590303077,15,7,9,40,2.94121729565198,4.8727141622976,7.93689635691458,101,"ENSG00000079974.19"
"35357","ENSG00000235834.1_24892",24884,24892,9,"ENSG00000235834.1",1,7,"VVVUVVMVV",1,7,0.766045548654244,112,118,133,136,143,149,158,161,"GCAATGA","CTGA","TTGATCC","CTGA",2.48244590303077,15,7,9,40,2.94121729565198,4.8727141622976,7.93689635691458,101,"ENSG00000079974.19"
"36312","ENSG00000239893.3_24913",24905,24913,9,"ENSG00000239893.3",1,2,"VMVVVVVVV",0,8,0.884057971014493,94,100,133,136,172,178,194,197,"CAGATGA","TTGA","ATGCAGA","CTGA",2.52160665054362,33,36,16,94,0.791892096025516,4.40065077491242,7.93688265897039,101,"ENSG00000079974.19"
"12950","ENSG00000139679.16_4986",4978,4986,9,"ENSG00000139679.16",0,NA,"UVVVVVVVV",1,8,0.902691511387163,107,113,133,136,144,150,185,188,"TTGAGGT","CAGA","GTGAATC","CTGA",2.36613527669973,20,8,35,72,1.5300451891186,4.3260700917792,7.93683613732785,101,"ENSG00000079974.19"
"10064","ENSG00000129071.10_6386",6378,6386,9,"ENSG00000129071.10",1,8,"VVVVVUVMV",1,7,0.806211180124224,84,90,101,104,114,120,133,136,"ATTATTA","CTTA","GTGTGGT","CTGA",2.40650144112291,11,10,13,43,2.80452405124675,4.71196674801655,7.93681146851344,101,"ENSG00000079974.19"
"1334","ENSG00000053747.17_21236",21228,21236,9,"ENSG00000053747.17",1,2,"UMVVVVVVV",1,7,0.786749482401656,86,92,105,108,113,119,133,136,"AGGTTGA","ATGA","GAGATGT","CTGA",2.4504795299214,13,5,14,41,2.82260799461697,4.78978454852324,7.93678247812987,101,"ENSG00000079974.19"
"26249","ENSG00000183715.14_987818",987810,987818,9,"ENSG00000183715.14",1,7,"VVVVVUMVV",1,7,0.807453416149068,32,38,58,61,75,81,133,136,"ATGACGA","CTGA","GGGAAGG","CTGA",2.65697031938431,20,14,52,95,1.11473627559925,4.70696793454033,7.9367815991366,101,"ENSG00000079974.19"
"3541","ENSG00000085563.15_109672",109664,109672,9,"ENSG00000085563.15",0,NA,"VVVVVVUVV",1,8,0.886128364389234,106,112,133,136,141,147,163,166,"ATGTGGA","CATA","CTGAGAA","CTGA",2.32031846361219,21,5,16,51,2.10026507700415,4.39226370860468,7.93677716616162,101,"ENSG00000079974.19"
"46834","ENSG00000287266.1_4500",4492,4500,9,"ENSG00000287266.1",1,6,"VVVVVMVVV",0,8,0.902691511387163,55,61,96,99,116,122,133,136,"ATGAAGA","CTGA","ATCAATA","CTGT",2.38221754147786,35,17,11,72,1.42253343846993,4.32599592874725,7.93676197429591,101,"ENSG00000079974.19"
"6632","ENSG00000111144.10_33414",33406,33414,9,"ENSG00000111144.10",1,7,"VVVVVUMVV",1,7,0.807453416149068,112,118,133,136,140,146,158,161,"ATAATGT","GTGT","CTGATCA","CTGA",2.41339608438157,15,4,12,40,2.73842218679623,4.70693235400167,7.93674601859795,101,"ENSG00000079974.19"
"37943","ENSG00000249252.5_150312",150304,150312,9,"ENSG00000249252.5",1,1,"MVVVVVVVV",0,8,0.90600414078675,107,113,133,136,142,148,201,204,"TTGAGGG","TAGA","GTGATGT","CTGA",2.3662664556532,20,6,53,88,1.47538010123678,4.31262245139787,7.93663901454487,101,"ENSG00000079974.19"
"18283","ENSG00000156869.14_39344",39336,39344,9,"ENSG00000156869.14",1,2,"UMVVVVVVV",1,7,0.786749482401656,116,122,133,136,143,149,198,201,"ATAATGA","CTTA","GTAATAA","CTGA",2.57710627098807,11,7,49,76,1.9778445971578,4.78963826760289,7.93663619720952,101,"ENSG00000079974.19"
"30868","ENSG00000214216.11_49675",49667,49675,9,"ENSG00000214216.11",1,8,"VVVVVVVMV",0,8,0.884057971014493,107,113,133,136,156,162,171,174,"ATGATGT","CTGC","TTGAAAA","CTAA",2.37518960095373,20,20,9,58,1.76698112496381,4.40039461616383,7.9366265002218,101,"ENSG00000079974.19"
"44606","ENSG00000283154.3_50368",50360,50368,9,"ENSG00000283154.3",1,8,"VVVVVVVMV",0,8,0.884057971014493,107,113,133,136,156,162,171,174,"ATGATGT","CTGC","TTGAAAA","CTAA",2.37518960095373,20,20,9,58,1.76698112496381,4.40039461616383,7.9366265002218,101,"ENSG00000079974.19"
"1308","ENSG00000053108.17_32209",32201,32209,9,"ENSG00000053108.17",1,7,"VVVUVVMVV",1,7,0.766045548654244,95,101,133,136,149,155,206,209,"ATGATGA","CTGC","GTGATGG","CTGA",2.81551844789094,32,13,51,105,0.719572261516572,4.87242381186405,7.93660600648103,101,"ENSG00000079974.19"
"9639","ENSG00000125954.13_21581",21573,21581,9,"ENSG00000125954.13",1,8,"VVVVVUVMV",1,7,0.806211180124224,103,109,133,136,146,152,173,176,"ATGAAGA","CTGT","GTTAAGA","CTGA",2.59057780478963,24,10,21,64,1.5765132504431,4.71175798726015,7.93660270775705,101,"ENSG00000079974.19"
"40991","ENSG00000258289.10_21705",21697,21705,9,"ENSG00000258289.10",1,8,"VVVVVUVMV",1,7,0.806211180124224,103,109,133,136,146,152,173,176,"ATGAAGA","CTGT","GTTAAGA","CTGA",2.59057780478963,24,10,21,64,1.5765132504431,4.71175798726015,7.93660270775705,101,"ENSG00000079974.19"
"28564","ENSG00000196116.8_22742",22734,22742,9,"ENSG00000196116.8",1,1,"MVVVVVVVV",0,8,0.90600414078675,109,115,133,136,144,150,162,165,"AATATGT","GTAA","TTGATAC","CTGA",2.19541238607485,18,8,12,47,2.61382116738451,4.3124759353042,7.9364924984512,101,"ENSG00000079974.19"
"14297","ENSG00000144648.16_68236",68228,68236,9,"ENSG00000144648.16",1,8,"VVVVVUVMV",1,7,0.806211180124224,114,120,133,136,145,151,180,183,"CTGGGGA","CTGA","ATGATCA","CTGA",2.51271541036449,13,9,29,60,2.09512994249798,4.71164150289865,7.93648622339554,101,"ENSG00000079974.19"
"43716","ENSG00000273291.5_63542",63534,63542,9,"ENSG00000273291.5",1,8,"VVVVVUVMV",1,7,0.806211180124224,114,120,133,136,145,151,180,183,"CTGGGGA","CTGA","ATGATCA","CTGA",2.51271541036449,13,9,29,60,2.09512994249798,4.71164150289865,7.93648622339554,101,"ENSG00000079974.19"
"43732","ENSG00000273328.5_63574",63566,63574,9,"ENSG00000273328.5",1,8,"VVVVVUVMV",1,7,0.806211180124224,114,120,133,136,145,151,180,183,"CTGGGGA","CTGA","ATGATCA","CTGA",2.51271541036449,13,9,29,60,2.09512994249798,4.71164150289865,7.93648622339554,101,"ENSG00000079974.19"
"48055","ENSG00000290317.1_63505",63497,63505,9,"ENSG00000290317.1",1,8,"VVVVVUVMV",1,7,0.806211180124224,114,120,133,136,145,151,180,183,"CTGGGGA","CTGA","ATGATCA","CTGA",2.51271541036449,13,9,29,60,2.09512994249798,4.71164150289865,7.93648622339554,101,"ENSG00000079974.19"
"25186","ENSG00000179915.25_191191",191183,191191,9,"ENSG00000179915.25",0,NA,"VVUVVVVVV",1,8,0.883643892339545,100,106,133,136,144,150,178,181,"ATAATGA","GTGC","CTTAAGA","CTGA",2.45156241126476,27,8,28,72,1.26382806056623,4.40189436724949,7.93646993660767,101,"ENSG00000079974.19"
"38362","ENSG00000250049.7_14565",14557,14565,9,"ENSG00000250049.7",1,1,"MVVVVVVVV",0,8,0.90600414078675,113,119,133,136,145,151,166,169,"ATGATAA","TAGA","AGGAGGG","TTGA",2.17731736582969,14,9,15,47,2.73434737282643,4.31244911958942,7.93646568273642,101,"ENSG00000079974.19"
"1412","ENSG00000055163.21_2332",2324,2332,9,"ENSG00000055163.21",0,NA,"VVUVVVVVV",1,8,0.883643892339545,104,110,133,136,157,163,176,179,"GACATGA","CTGG","CTGATAA","CTGA",2.42653488939127,23,21,13,66,1.4305035861943,4.40185071220069,7.93642628155887,101,"ENSG00000079974.19"
"17017","ENSG00000152953.13_379968",379960,379968,9,"ENSG00000152953.13",1,3,"VVMVVVVVV",0,8,0.882815734989648,88,94,102,105,114,120,133,136,"ATTTAGA","CTCA","ATATTGA","CTGA",2.24614799775946,8,9,13,39,2.64563170568707,4.40498792268753,7.93625086264612,101,"ENSG00000079974.19"
"18758","ENSG00000158321.19_996485",996477,996485,9,"ENSG00000158321.19",1,5,"VVVVMVUVV",1,7,0.772670807453416,107,113,133,136,143,149,167,170,"TTGATGA","CTAA","GTGGGCA","CTGA",2.58836477967904,20,7,18,54,2.12649937430732,4.84556614304189,7.93624937285556,101,"ENSG00000079974.19"
"4946","ENSG00000102466.16_276303",276295,276303,9,"ENSG00000102466.16",1,8,"UVVVVVVMV",1,7,0.786749482401656,106,112,133,136,139,145,155,158,"ATGATGA","GTGG","ATGGTTG","CTGA",2.55505826539932,21,3,10,43,2.12304135006302,4.78919077984795,7.93618870945457,101,"ENSG00000079974.19"
"963","ENSG00000042088.14_34134",34126,34134,9,"ENSG00000042088.14",1,8,"VVVVVVVMV",0,8,0.884057971014493,90,96,133,136,147,153,163,166,"ATGCTGA","CTGT","TTGGTGA","CTCA",2.364058645716,37,11,10,67,1.83932835455025,4.39992983149756,7.93616171555553,101,"ENSG00000079974.19"
"41649","ENSG00000259430.2_57634",57626,57634,9,"ENSG00000259430.2",1,7,"VVVVVVMVV",0,8,0.885300207039338,88,94,105,108,113,119,133,136,"ATGCTGT","CTGT","TTGCAGA","CAGA",2.21357656518804,11,5,14,39,2.82242244801047,4.39489988731602,7.93610071547337,101,"ENSG00000079974.19"
"2390","ENSG00000074054.21_102884",102876,102884,9,"ENSG00000074054.21",1,1,"MVVVVVVVV",0,8,0.90600414078675,93,99,133,136,146,152,182,185,"TTCATGA","CTGT","GTGGTTC","CTGA",2.43166676557469,34,10,30,83,1.03698920963921,4.31202524503428,7.93604180818128,101,"ENSG00000079974.19"
"23998","ENSG00000174776.12_15742",15734,15742,9,"ENSG00000174776.12",1,8,"VVVVVVVMV",0,8,0.884057971014493,116,122,133,136,137,143,151,154,"ATGTAGA","TTGC","AGGATTC","CTGA",2.2316643205254,11,1,8,29,2.72142089428563,4.3997957577804,7.93602764183837,101,"ENSG00000079974.19"
"12323","ENSG00000137869.16_6826",6818,6826,9,"ENSG00000137869.16",0,NA,"VVVUVVVVV",1,8,0.880745341614907,113,119,133,136,158,164,182,185,"AAAATGA","CTGA","ATGATAA","CTAA",2.37729594087106,14,22,18,63,1.80346706707773,4.41302666822119,7.93600803468082,101,"ENSG00000079974.19"
"39855","ENSG00000254349.6_44337",44329,44337,9,"ENSG00000254349.6",0,NA,"VVUVVVVVV",1,8,0.883643892339545,73,79,95,98,116,122,133,136,"ATGATTA","GTGA","ATGAGAT","ATGA",2.31135890460046,16,18,11,54,2.1965185983165,4.40139449057989,7.93597005993806,101,"ENSG00000079974.19"
"6665","ENSG00000111254.8_32523",32515,32523,9,"ENSG00000111254.8",0,NA,"UVVVVVVVV",1,8,0.902691511387163,99,105,133,136,142,148,159,162,"GTGTTTA","AAGA","ATGAACA","CTGA",2.28796862559536,28,6,11,54,2.04764127166463,4.32519136057509,7.93595740612374,101,"ENSG00000079974.19"
"20810","ENSG00000165695.10_16931",16923,16931,9,"ENSG00000165695.10",1,3,"UVMVVVVVV",1,7,0.785507246376811,87,93,99,102,112,118,133,136,"AAGATGA","CTGG","CTCATCA","CTGA",2.54097119849501,6,10,15,40,2.2358669863292,4.79391874407398,7.93594772958123,101,"ENSG00000079974.19"
"3820","ENSG00000089169.15_88343",88335,88343,9,"ENSG00000089169.15",1,3,"VVMVVVVVV",0,8,0.882815734989648,58,64,79,82,93,99,133,136,"ATGCTGG","CTGA","TTGCTGA","CTAA",2.37157928119797,15,11,34,69,1.80813789854192,4.40466660996544,7.93592954992403,101,"ENSG00000079974.19"
"11931","ENSG00000136546.17_158956",158948,158956,9,"ENSG00000136546.17",1,6,"VVVVVMVVV",0,8,0.902691511387163,110,116,133,136,179,185,240,243,"ATGATTG","CTGG","ATGAAGC","CTGA",2.4810988592362,17,43,55,124,0.75980979090481,4.32511721311987,7.93588325866853,101,"ENSG00000079974.19"
"25554","ENSG00000182150.19_9389",9381,9389,9,"ENSG00000182150.19",1,2,"VMVVUVVVV",1,7,0.773913043478261,104,110,133,136,160,166,181,184,"ATGATGA","CTGG","CTGTTTA","CTGA",2.71859355444305,23,24,15,71,1.23680769693392,4.84019118163857,7.93584335555161,101,"ENSG00000079974.19"
"22358","ENSG00000170390.16_149300",149292,149300,9,"ENSG00000170390.16",1,6,"VVVVVMVVV",0,8,0.902691511387163,56,62,75,78,90,96,133,136,"TTTAAGA","CTAA","ATGCTAA","CTGA",2.32531409446666,13,12,37,71,1.79804301813446,4.32503424531137,7.93580029086003,101,"ENSG00000079974.19"
"27289","ENSG00000185842.16_87211",87203,87211,9,"ENSG00000185842.16",1,7,"VVVVVUMVV",1,7,0.807453416149068,83,89,109,112,115,121,133,136,"ATGACAA","CTGA","GGGAAAA","CTGA",2.49988466545233,20,3,12,44,2.15799493066485,4.70597317508676,7.93578683968303,101,"ENSG00000079974.19"
"32819","ENSG00000228033.6_33693",33685,33693,9,"ENSG00000228033.6",1,2,"VMVVVVVVV",0,8,0.884057971014493,114,120,133,136,151,157,166,169,"GTGGTGA","TTGA","TAGAGGA","CTAA",2.25689357684259,13,15,9,46,2.55218987166196,4.39953676265315,7.93576864671112,101,"ENSG00000079974.19"
"33339","ENSG00000229400.1_3234",3226,3234,9,"ENSG00000229400.1",1,8,"VVVVVVVMV",0,8,0.884057971014493,115,121,133,136,142,148,159,162,"CTGACAA","TTTA","GTGGGTA","CTGA",2.18525555537937,12,6,11,38,3.02956426608759,4.39948365882085,7.93571554287882,101,"ENSG00000079974.19"
"31914","ENSG00000225249.6_201452",201444,201452,9,"ENSG00000225249.6",0,NA,"UVVVVVVVV",1,8,0.902691511387163,116,122,133,136,175,181,203,206,"GTGAAAA","TTAA","ATGATGA","CTGA",2.38624744159042,11,39,22,81,1.39146350519121,4.32494494561516,7.93571099116382,101,"ENSG00000079974.19"
"29217","ENSG00000197467.17_100404",100396,100404,9,"ENSG00000197467.17",1,8,"VVVVVVVMV",0,8,0.884057971014493,114,120,133,136,143,149,170,173,"ATAAAGA","GAGA","ACGAGGG","CTGA",2.27117069756845,13,7,21,50,2.45668090810329,4.39945472297323,7.9356866070312,101,"ENSG00000079974.19"
"24491","ENSG00000176571.13_412305",412297,412305,9,"ENSG00000176571.13",1,1,"MVVVVUVVV",1,7,0.82815734989648,62,68,103,106,113,119,133,136,"GGGATGA","CAGA","GTACAGA","CTGA",2.49183205233917,35,7,14,65,1.87995479384288,4.623042119026,7.93567151861192,101,"ENSG00000079974.19"
"40442","ENSG00000256234.1_120930",120922,120930,9,"ENSG00000256234.1",0,NA,"VVVVUVVVV",1,8,0.889855072463768,86,92,106,109,115,121,133,136,"CTGATCA","CTCA","TTTATAA","TTGA",2.18626035293775,14,6,12,41,2.92993519723474,4.37625105420494,7.93567134406001,101,"ENSG00000079974.19"
"35227","ENSG00000235437.10_156001",155993,156001,9,"ENSG00000235437.10",0,NA,"VVVUVUVVV",2,7,0.802898550724638,90,96,106,109,115,121,133,136,"ATGAAGC","CAGA","AGGACAA","CTGA",2.39338313809323,10,6,12,37,2.94002531109953,4.72397822459694,7.93557242749549,101,"ENSG00000079974.19"
"22673","ENSG00000171094.18_437912",437904,437912,9,"ENSG00000171094.18",0,NA,"UVVVVVVVV",1,8,0.902691511387163,92,98,109,112,113,119,133,136,"ATTATGT","CTAA","ATGAAAA","ATGA",2.24934754071914,11,1,14,35,2.30351139681666,4.3247904170694,7.93555646261805,101,"ENSG00000079974.19"
"2471","ENSG00000075151.24_29288",29280,29288,9,"ENSG00000075151.24",1,2,"UMVVVVVVV",1,7,0.786749482401656,84,90,103,106,114,120,133,136,"ATAATGC","CAGA","TTAATAA","CTGA",2.43604648995957,13,8,13,43,2.91376640783383,4.7885190852244,7.93551701483103,101,"ENSG00000079974.19"
"14389","ENSG00000144824.21_177604",177596,177604,9,"ENSG00000144824.21",1,8,"VVVVVVVMV",0,8,0.884057971014493,49,55,68,71,114,120,133,136,"GAGATGG","CTGA","CTGAAGA","CAGA",2.35173995086552,13,43,13,78,1.91873242896472,4.39924969201705,7.93548157607502,101,"ENSG00000079974.19"
"1957","ENSG00000068305.19_120050",120042,120050,9,"ENSG00000068305.19",1,8,"VVVVVVVMV",0,8,0.884057971014493,86,92,133,136,184,190,200,203,"GTTATGT","TTGA","CTGTTGA","CTGA",2.48918631780792,41,48,10,108,1.00240244473166,4.39924447419612,7.93547635825409,101,"ENSG00000079974.19"
"39695","ENSG00000254101.8_1232151",1232143,1232151,9,"ENSG00000254101.8",1,8,"VVVVVUVMV",1,7,0.806211180124224,114,120,133,136,149,155,183,186,"AGGATGC","CGGA","GTGGTGA","CTGA",2.54669311290547,13,13,28,63,1.86427536305312,4.71055736227239,7.93540208276928,101,"ENSG00000079974.19"
"7760","ENSG00000115594.12_37253",37245,37253,9,"ENSG00000115594.12",1,7,"VVVVVVMVV",0,8,0.885300207039338,80,86,99,102,109,115,133,136,"CTGATAA","ATGA","CTGATAG","CTGG",2.24129484682617,13,7,18,47,2.63444819381204,4.39410345982995,7.9353042879873,101,"ENSG00000079974.19"
"11579","ENSG00000135372.10_5231",5223,5231,9,"ENSG00000135372.10",0,NA,"UVVVVVUVV",2,7,0.788819875776397,113,119,133,136,144,150,164,167,"CTGATGA","CAGA","AAGATGA","CTCA",2.44382246096662,14,8,14,45,2.8279150943933,4.78001620854268,7.93529571164827,101,"ENSG00000079974.19"
"940","ENSG00000041353.10_2134",2126,2134,9,"ENSG00000041353.10",1,8,"UVVVVVVMV",1,7,0.786749482401656,112,118,133,136,186,192,202,205,"ATGATGA","CCAA","ATTTTGA","CTGA",2.58641555745357,15,50,10,84,1.91030390983393,4.78826857321444,7.93526650282106,101,"ENSG00000079974.19"
"42628","ENSG00000265352.1_12311",12303,12311,9,"ENSG00000265352.1",1,5,"VVVVMVVVV",0,8,0.886542443064182,23,29,72,75,81,87,133,136,"TTGATGA","CTGA","TAGAAGA","GTGA",2.48489941243668,43,6,46,104,0.990302856762558,4.38907473491845,7.93524450717517,101,"ENSG00000079974.19"
"4860","ENSG00000102144.15_84262",84254,84262,9,"ENSG00000102144.15",1,2,"VMVVVVVVV",0,8,0.884057971014493,112,118,133,136,141,147,162,165,"ATGATGG","TTGG","GTGAATG","TTGA",2.23936355055197,15,5,15,44,2.666730280727,4.39895515443504,7.93518703849301,101,"ENSG00000079974.19"
"20646","ENSG00000165240.22_84311",84303,84311,9,"ENSG00000165240.22",1,2,"VMVVVVVVV",0,8,0.884057971014493,112,118,133,136,141,147,162,165,"ATGATGG","TTGG","GTGAATG","TTGA",2.23936355055197,15,5,15,44,2.666730280727,4.39895515443504,7.93518703849301,101,"ENSG00000079974.19"
"48238","ENSG00000290722.1_18230",18222,18230,9,"ENSG00000290722.1",0,NA,"VVVUVVVVV",1,8,0.880745341614907,114,120,133,136,149,155,172,175,"AAGATGT","GGGA","ATCATCT","CTGA",2.2891583793749,13,13,17,52,2.38767349220293,4.41218233867556,7.93516370513519,101,"ENSG00000079974.19"
"3574","ENSG00000086015.23_76605",76597,76605,9,"ENSG00000086015.23",1,1,"MVVVVVVVV",0,8,0.90600414078675,113,119,133,136,175,181,236,239,"ATAATCA","CAGA","CTGTTGG","CTGA",2.44060682393504,14,39,55,117,0.973749182487182,4.31111533551353,7.93513189866052,101,"ENSG00000079974.19"
"13139","ENSG00000140386.13_350852",350844,350852,9,"ENSG00000140386.13",1,1,"MVVVVUVVV",1,7,0.82815734989648,116,122,133,136,144,150,188,191,"ATGATAA","CTTA","GGTATCA","CTGA",2.47474879707096,11,8,38,66,1.99164266666938,4.62249199511894,7.93512139470486,101,"ENSG00000079974.19"
"45254","ENSG00000285280.2_229057",229049,229057,9,"ENSG00000285280.2",1,7,"VVVVVVMVV",0,8,0.885300207039338,56,62,74,77,115,121,133,136,"TTGAGGA","CTGA","GTGTAGT","CAGA",2.34095840582366,12,38,12,71,1.96924029022903,4.39390741559669,7.93510824375404,101,"ENSG00000079974.19"
"19416","ENSG00000162946.23_169573",169565,169573,9,"ENSG00000162946.23",1,1,"MVVVVVVVV",0,8,0.90600414078675,112,118,133,136,140,146,160,163,"ATGGTCG","CAGC","CTGAGCA","CTGA",2.19116837774065,15,4,14,42,2.63601310973313,4.3109505736677,7.9349671368147,101,"ENSG00000079974.19"
"43219","ENSG00000270106.6_267710",267702,267710,9,"ENSG00000270106.6",1,1,"MVVVVVVVV",0,8,0.90600414078675,112,118,133,136,140,146,160,163,"ATGGTCG","CAGC","CTGAGCA","CTGA",2.19116837774065,15,4,14,42,2.63601310973313,4.3109505736677,7.9349671368147,101,"ENSG00000079974.19"
"1305","ENSG00000053108.17_274792",274784,274792,9,"ENSG00000053108.17",1,7,"VVVVVUMVV",1,7,0.807453416149068,84,90,133,136,142,148,170,173,"CTGATGG","CTGA","GTGCAGC","CTGA",2.61429296047989,43,6,22,80,1.39190382702744,4.70513089089001,7.93494455548628,101,"ENSG00000079974.19"
"4352","ENSG00000100297.16_6667",6659,6667,9,"ENSG00000100297.16",1,5,"VVVVMUVVV",1,7,0.808695652173913,110,116,133,136,187,193,205,208,"AGGATGA","CTGC","CTTAGGA","CTGA",2.56302191686804,17,51,12,89,1.71373733168482,4.70013752770127,7.93492013639692,101,"ENSG00000079974.19"
"26720","ENSG00000184984.10_4394",4386,4394,9,"ENSG00000184984.10",1,2,"UMVVVVVVV",1,7,0.786749482401656,116,122,133,136,151,157,167,170,"ATGATGT","CAGT","ATAATTA","CTGA",2.4925561978944,11,15,10,45,2.53462937284945,4.78791767303636,7.93491560264299,101,"ENSG00000079974.19"
"9368","ENSG00000124224.20_50042",50034,50042,9,"ENSG00000124224.20",1,1,"MVVVVVVVV",0,8,0.90600414078675,109,115,133,136,185,191,219,222,"AAGATGA","ATCA","TTGTTGT","CTGA",2.46022150715787,18,49,28,104,0.842033836287692,4.31087763766837,7.93489420081536,101,"ENSG00000079974.19"
"48404","ENSG00000291067.1_73137",73129,73137,9,"ENSG00000291067.1",1,1,"MVVVVVVVV",0,8,0.90600414078675,109,115,133,136,185,191,219,222,"AAGATGA","ATCA","TTGTTGT","CTGA",2.46022150715787,18,49,28,104,0.842033836287692,4.31087763766837,7.93489420081536,101,"ENSG00000079974.19"
"29642","ENSG00000198522.14_7680",7672,7680,9,"ENSG00000198522.14",1,3,"VVMVVVVVV",0,8,0.882815734989648,84,90,133,136,186,192,202,205,"ATGAGGA","CAGG","GTGGTGG","CTGA",2.4919560455661,43,50,10,112,1.00139049229337,4.40360769901684,7.93487063897543,101,"ENSG00000079974.19"
"29165","ENSG00000197372.10_159250",159242,159250,9,"ENSG00000197372.10",0,NA,"VVVVUVVVV",1,8,0.889855072463768,111,117,133,136,142,148,156,159,"GTGGTGC","ATGA","ATCATGA","CTCA",2.19825417771038,16,6,8,39,2.84665549196025,4.3754208358407,7.93484112569577,101,"ENSG00000079974.19"
"40474","ENSG00000256422.8_24786",24778,24786,9,"ENSG00000256422.8",1,7,"VVVVVVMVV",0,8,0.885300207039338,108,114,133,136,153,159,168,171,"AGGATGA","TGGA","GTGAGGA","CAGA",2.33560379860003,19,17,9,54,2.0036684465068,4.39359010929342,7.93479093745077,101,"ENSG00000079974.19"
"37792","ENSG00000248869.7_32629",32621,32629,9,"ENSG00000248869.7",1,3,"VVMVVVVVV",0,8,0.882815734989648,100,106,133,136,156,162,171,174,"ATGATGT","CTCC","ATGGTTT","CTGA",2.43521150182161,27,20,9,65,1.37928326591296,4.40350665284759,7.93476959280618,101,"ENSG00000079974.19"
"5990","ENSG00000107611.16_64750",64742,64750,9,"ENSG00000107611.16",1,1,"MVVVVVVVV",0,8,0.90600414078675,110,116,133,136,173,179,193,196,"ATAATAA","TTCA","ATGAAAA","CTGA",2.34047650786554,17,37,14,77,1.63982112242805,4.31074946038291,7.93476602352991,101,"ENSG00000079974.19"
"27836","ENSG00000187398.12_301019",301011,301019,9,"ENSG00000187398.12",1,1,"MVUVVVVVV",1,7,0.789648033126294,79,85,96,99,109,115,133,136,"ATAATTA","CTGA","AAGAAAA","CTGA",2.4890608012741,11,10,18,48,2.51091418595378,4.77616321527862,7.93475534778379,101,"ENSG00000079974.19"
"696","ENSG00000025800.14_60060",60052,60060,9,"ENSG00000025800.14",1,5,"VVVVMVVVV",0,8,0.886542443064182,80,86,101,104,111,117,133,136,"AGGCTGA","CTGA","GAGGTCA","GTGA",2.23253341508789,15,7,16,47,2.67077226658261,4.38858209179213,7.93475186404886,101,"ENSG00000079974.19"
"46377","ENSG00000286533.1_134712",134704,134712,9,"ENSG00000286533.1",1,3,"VVMVVVVVV",0,8,0.882815734989648,113,119,133,136,147,153,161,164,"ATCATTC","CTCA","ATCATAT","CTGA",2.22257862298596,14,11,8,42,2.79655794474881,4.4034371911638,7.93470013112239,101,"ENSG00000079974.19"
"36732","ENSG00000242808.12_347226",347218,347226,9,"ENSG00000242808.12",1,1,"MVVVVVVVV",0,8,0.90600414078675,112,118,133,136,187,193,202,205,"ATTATTC","ATGA","GTGAAAG","CTGA",2.30008536590912,15,51,9,84,1.90876644070418,4.31066722002457,7.93468378317157,101,"ENSG00000079974.19"
"29385","ENSG00000197893.14_11778",11770,11778,9,"ENSG00000197893.14",1,7,"VVVVVVMVV",0,8,0.885300207039338,113,119,133,136,150,156,167,170,"AAGTTTA","TAGA","ATGTTGA","CTGA",2.24989121485136,14,14,11,48,2.57431153672816,4.39339657560097,7.93459740375832,101,"ENSG00000079974.19"
"41104","ENSG00000258551.7_109954",109946,109954,9,"ENSG00000258551.7",1,2,"VMVVVVVVV",0,8,0.884057971014493,109,115,133,136,150,156,166,169,"ATAATGA","CTAA","ATGAGCT","GTGA",2.29553979340508,18,14,10,51,2.28960117855861,4.39829995031479,7.93453183437276,101,"ENSG00000079974.19"
"37477","ENSG00000248296.1_15256",15248,15256,9,"ENSG00000248296.1",1,2,"VMVVVVVVV",0,8,0.884057971014493,71,77,94,97,111,117,133,136,"ATAATAA","ATTA","CTGTTGT","CTGA",2.31851704840608,17,14,16,56,2.13632487274868,4.39827629886397,7.93450818292194,101,"ENSG00000079974.19"
"44393","ENSG00000281566.4_7698",7690,7698,9,"ENSG00000281566.4",1,8,"VVVVVVVMV",0,8,0.884057971014493,109,115,133,136,142,148,157,160,"AGGAGAA","CTGC","TGGTTGA","CTGA",2.23901021771299,18,6,9,42,2.66619820572753,4.3982332476202,7.93446513167817,101,"ENSG00000079974.19"
"16676","ENSG00000152061.24_421955",421947,421955,9,"ENSG00000152061.24",1,1,"MVVVVVVVV",0,8,0.90600414078675,103,109,133,136,141,147,180,183,"ATGAGGA","ATGA","TTGATGT","CTAA",2.40244997106902,24,5,33,71,1.22540697489719,4.31043502883933,7.93445159198633,101,"ENSG00000079974.19"
"28627","ENSG00000196277.16_244921",244913,244921,9,"ENSG00000196277.16",1,3,"VVMVVVVVV",0,8,0.882815734989648,48,54,69,72,78,84,133,136,"GTGGGGA","CTGT","AAGAGGA","CTGA",2.35745896788639,15,6,49,79,1.89634788932639,4.40318525214224,7.93444819210083,101,"ENSG00000079974.19"
"47639","ENSG00000288785.1_53256",53248,53256,9,"ENSG00000288785.1",1,3,"VVMVVVVVV",0,8,0.882815734989648,47,53,65,68,113,119,133,136,"ATGATTA","ATGA","GTTAAGA","ATGA",2.36072170607527,12,45,14,80,1.87412566991883,4.40306759427183,7.93433053423042,101,"ENSG00000079974.19"
"19531","ENSG00000163214.21_69250",69242,69250,9,"ENSG00000163214.21",0,NA,"VVVVVVUVV",1,8,0.886128364389234,112,118,133,136,147,153,190,193,"TTGTTGT","CAGA","CAGAAGA","CTGA",2.36667946503061,15,11,37,72,1.78114930843872,4.3897531021607,7.93426655971764,101,"ENSG00000079974.19"
"4427","ENSG00000100554.12_54281",54273,54281,9,"ENSG00000100554.12",1,1,"MVVVVVVVV",0,8,0.90600414078675,81,87,102,105,111,117,133,136,"ATGGTGC","GTGA","GTGAGAC","CAGA",2.18775673462501,15,6,16,46,2.65593009876324,4.31024374906582,7.93426031221282,101,"ENSG00000079974.19"
"330","ENSG00000008294.22_33268",33260,33268,9,"ENSG00000008294.22",1,8,"VVVVVUVMV",1,7,0.806211180124224,58,64,106,109,110,116,133,136,"GTAATGA","CTGA","ATGTAGA","CTGA",2.67203146159568,42,1,17,69,1.02398686147028,4.70938248469371,7.9342272051906,101,"ENSG00000079974.19"
"42821","ENSG00000267033.1_129",121,129,9,"ENSG00000267033.1",1,8,"VVVVUVVMV",1,7,0.773913043478261,91,97,104,107,111,117,131,134,"AAGATGA","ATGA","AAGAGGC","CTGA",2.52999569702358,7,4,14,34,2.4875776417171,4.83855390546857,7.93420607938161,101,"ENSG00000079974.19"
"20617","ENSG00000165169.11_6181",6173,6181,9,"ENSG00000165169.11",1,6,"VVVVVMVVV",0,8,0.902691511387163,111,117,133,136,143,149,200,203,"ATTCTGC","CAGA","CTGATAT","CTGA",2.31807861912472,16,7,51,83,1.83982654197477,4.32342100070156,7.93418704625022,101,"ENSG00000079974.19"
"34904","ENSG00000234377.8_149842",149834,149842,9,"ENSG00000234377.8",1,8,"VVVVVVVMV",0,8,0.884057971014493,11,17,26,29,80,86,133,136,"ATGATGA","ATGA","GTAAGGA","ATGA",2.51245637343494,9,51,47,116,0.841791572573654,4.39787518220165,7.93410706625962,101,"ENSG00000079974.19"
"22638","ENSG00000171033.13_42134",42126,42134,9,"ENSG00000171033.13",1,8,"VVVVVVVMV",0,8,0.884057971014493,113,119,133,136,160,166,187,190,"ATGGTGG","CTCC","ATGAGGA","CTGA",2.40308621095205,14,24,21,68,1.57089215256012,4.39786672306011,7.93409860711808,101,"ENSG00000079974.19"
"42588","ENSG00000264673.1_45",37,45,9,"ENSG00000264673.1",1,1,"MVVUVVVVV",1,7,0.786749482401656,13,19,47,50,88,94,103,106,"AAGATGA","GTGA","CTGATGA","CTGA",2.7090957333866,28,38,9,84,1.08768057313889,4.78707969892905,7.93407762853568,101,"ENSG00000079974.19"
"38340","ENSG00000250027.1_3179",3171,3179,9,"ENSG00000250027.1",1,2,"VMUVVVVVV",1,7,0.767701863354037,85,91,133,136,142,148,178,181,"ATGATGA","TTGA","TTGAAAA","CTGA",2.75128750465108,42,6,30,87,1.1111454663754,4.86326554101232,7.93407299442847,101,"ENSG00000079974.19"
"17715","ENSG00000154928.19_456566",456558,456566,9,"ENSG00000154928.19",1,6,"VVVVVMVVV",0,8,0.902691511387163,111,117,133,136,173,179,216,219,"GTGATGT","ATCA","GTCAGGA","CTGA",2.46074304581014,16,37,37,99,0.888013052774528,4.3232416728772,7.93400771842585,101,"ENSG00000079974.19"
"20721","ENSG00000165416.15_19870",19862,19870,9,"ENSG00000165416.15",1,1,"MVVVVVUVV",1,7,0.792132505175983,105,111,133,136,145,151,164,167,"TTGATGT","CTTA","ATGTTGG","CTGA",2.52823899333638,22,9,13,53,2.20689216183111,4.76545469601842,7.93398471672235,101,"ENSG00000079974.19"
"24368","ENSG00000176102.13_42685",42677,42685,9,"ENSG00000176102.13",1,7,"UVVVVVMVV",1,7,0.787991718426501,113,119,133,136,147,153,167,170,"CTGATGT","TTGG","TTGATAA","CTGA",2.46835399392028,14,11,14,48,2.67218893375837,4.78197055664007,7.93393743034607,101,"ENSG00000079974.19"
"12148","ENSG00000137478.15_104846",104838,104846,9,"ENSG00000137478.15",1,1,"MVVVVVVVV",0,8,0.90600414078675,112,118,133,136,149,155,177,180,"ATTATGA","CAGT","TTGAGGA","CAGA",2.284238439763,15,13,22,59,2.01120429644479,4.30986514038286,7.93388170352985,101,"ENSG00000079974.19"
"45386","ENSG00000285535.2_45299",45291,45299,9,"ENSG00000285535.2",0,NA,"VVVUVVVVV",1,8,0.880745341614907,114,120,133,136,153,159,177,180,"GAAATGA","GTCA","GTGCTGA","CTGA",2.337535437549,13,17,18,57,2.05979418861683,4.41084094306921,7.93382230952884,101,"ENSG00000079974.19"
"37542","ENSG00000248441.9_12941",12933,12941,9,"ENSG00000248441.9",1,5,"VVVVMVVVV",0,8,0.886542443064182,90,96,107,110,112,118,133,136,"GTCATTA","CTGA","GTGTTGG","TTGA",2.27319316446323,11,2,15,37,2.39598293789928,4.38765100858021,7.93382078083694,101,"ENSG00000079974.19"
"15377","ENSG00000148090.12_33092",33084,33092,9,"ENSG00000148090.12",1,2,"VMVVVVVVV",0,8,0.884057971014493,62,68,86,89,95,101,133,136,"GTGATAA","CAGA","GTGATGG","TTGA",2.37745166495132,18,6,32,65,1.74051334552135,4.39754777796588,7.93377966202385,101,"ENSG00000079974.19"
"3571","ENSG00000086015.23_124797",124789,124797,9,"ENSG00000086015.23",1,3,"VVMVVVVVV",0,8,0.882815734989648,95,101,109,112,116,122,133,136,"ATGATGA","ATGA","TTAATGT","TAGA",2.21980434640791,8,4,11,32,2.8112293139677,4.40248123917178,7.93374417913037,101,"ENSG00000079974.19"
"10316","ENSG00000130508.11_43672",43664,43672,9,"ENSG00000130508.11",0,NA,"VVVVUUVVV",2,7,0.812008281573499,67,73,88,91,103,109,133,136,"GTGACTC","CTGA","GTGATGA","CTGA",2.51305575158786,15,12,24,60,1.98912449030152,4.68570737522182,7.93374050151581,101,"ENSG00000079974.19"
"22475","ENSG00000170624.14_295029",295021,295029,9,"ENSG00000170624.14",1,1,"MVVVVVVVV",0,8,0.90600414078675,112,118,133,136,179,185,210,213,"ATGAAAA","CTAA","CTGTTCA","CTGA",2.40777799803148,15,43,25,92,1.18657527780717,4.30960714950425,7.93362371265125,101,"ENSG00000079974.19"
"3567","ENSG00000085982.16_56441",56433,56441,9,"ENSG00000085982.16",1,2,"VMVVVVVVV",0,8,0.884057971014493,116,122,133,136,139,145,157,160,"ATTAGGA","TTGA","ATGAAGC","CTGG",2.2236009547455,11,3,12,35,2.76538674811928,4.39734827827232,7.93358016233029,101,"ENSG00000079974.19"
"15918","ENSG00000150275.20_284437",284429,284437,9,"ENSG00000150275.20",1,1,"MVVVUVVVV",1,7,0.795859213250517,106,112,133,136,140,146,173,176,"ATTATGA","GTGA","GTGAAAA","CTGA",2.63237650357104,21,4,27,61,1.45111110799856,4.75007194961804,7.93350880262011,101,"ENSG00000079974.19"
"35683","ENSG00000236744.2_253728",253720,253728,9,"ENSG00000236744.2",1,1,"MVVVUVVVV",1,7,0.795859213250517,106,112,133,136,140,146,173,176,"ATTATGA","GTGA","GTGAAAA","CTGA",2.63237650357104,21,4,27,61,1.45111110799856,4.75007194961804,7.93350880262011,101,"ENSG00000079974.19"
"2052","ENSG00000069667.16_332008",332000,332008,9,"ENSG00000069667.16",0,NA,"VVUVVVUVV",2,7,0.769772256728778,116,122,133,136,140,146,154,157,"ATAATGA","CTGA","GTAATAA","CAGA",2.45525613465694,11,4,8,32,3.04928404403719,4.85441456877086,7.93350359568597,101,"ENSG00000079974.19"
"17800","ENSG00000155093.19_616644",616636,616644,9,"ENSG00000155093.19",1,6,"VVVVVMVVV",0,8,0.902691511387163,57,63,76,79,112,118,133,136,"CTGATGC","TTTA","ATATTTA","CTGA",2.31736040193376,13,33,15,70,1.84188064953744,4.32273749894062,7.93350354448928,101,"ENSG00000079974.19"
"34557","ENSG00000233417.2_73679",73671,73679,9,"ENSG00000233417.2",1,2,"VMVVVVVVV",0,8,0.884057971014493,114,120,133,136,149,155,190,193,"ATAAGGA","ATCA","GTCATGA","CTGA",2.37691598921932,13,13,35,70,1.74281247308949,4.39722976697124,7.93346165102921,101,"ENSG00000079974.19"
"42037","ENSG00000260372.7_500484",500476,500484,9,"ENSG00000260372.7",1,7,"UVVVVVMVV",1,7,0.787991718426501,106,112,133,136,143,149,164,167,"AAGATGA","TTGA","ATCAAAA","CTGA",2.53481379735169,21,7,15,52,2.22717570314514,4.7814835880391,7.9334504617451,101,"ENSG00000079974.19"
"23542","ENSG00000173209.23_6149",6141,6149,9,"ENSG00000173209.23",1,1,"MVVVVVVVV",0,8,0.90600414078675,116,122,133,136,149,155,209,212,"ACGTTGA","AGGA","CTGAAGG","CTGA",2.33515144511186,11,13,54,87,1.66989132687507,4.3093919069052,7.9334084700522,101,"ENSG00000079974.19"
"35115","ENSG00000234956.7_47760",47752,47760,9,"ENSG00000234956.7",1,2,"VMVVVVVVV",0,8,0.884057971014493,110,116,133,136,144,150,159,162,"AAGAGGA","CCAA","AAGACCA","CTGA",2.22539756168787,17,8,9,43,2.7526408765568,4.39715615528565,7.93338803934362,101,"ENSG00000079974.19"
"33307","ENSG00000229306.1_1646",1638,1646,9,"ENSG00000229306.1",0,NA,"VVUVVVVVV",1,8,0.883643892339545,89,95,133,136,142,148,164,167,"ATTTTGA","TTGA","GTCTTAA","CTGA",2.3774390619953,38,6,16,69,1.74530579707982,4.39872488592879,7.93330045528697,101,"ENSG00000079974.19"
"43917","ENSG00000275390.1_23033",23025,23033,9,"ENSG00000275390.1",0,NA,"VVUVVVVVV",1,8,0.883643892339545,89,95,133,136,142,148,164,167,"ATTTTGA","TTGA","GTCTTAA","CTGA",2.3774390619953,38,6,16,69,1.74530579707982,4.39872488592879,7.93330045528697,101,"ENSG00000079974.19"
"15942","ENSG00000150347.17_92147",92139,92147,9,"ENSG00000150347.17",1,6,"VVVVVMVVV",0,8,0.902691511387163,80,86,102,105,116,122,133,136,"TTGATGC","TTGC","GTGAAAA","TTGA",2.19425230941786,16,11,11,47,2.66153838573431,4.32247177879667,7.93323782434533,101,"ENSG00000079974.19"
"17422","ENSG00000154162.15_1009572",1009564,1009572,9,"ENSG00000154162.15",1,1,"MVVUVVVVV",1,7,0.786749482401656,110,116,133,136,139,145,155,158,"ATGAAGA","TTGG","ATGAAGC","CTGA",2.49664493261833,17,3,10,39,2.50064968307193,4.7862373084652,7.93323523807183,101,"ENSG00000079974.19"
"37965","ENSG00000249279.6_18172",18164,18172,9,"ENSG00000249279.6",1,1,"MVUVVVVVV",1,7,0.789648033126294,109,115,133,136,145,151,162,165,"ATGATGG","GTGG","TTGCTCA","CTGA",2.4739435078224,18,9,11,47,2.60548191312479,4.7746096579852,7.93320179049038,101,"ENSG00000079974.19"
"35282","ENSG00000235535.9_49064",49056,49064,9,"ENSG00000235535.9",1,7,"UVVVVVMVV",1,7,0.787991718426501,83,89,97,100,104,110,133,136,"ATATTGA","CTGA","ATGAGGT","CTGA",2.57829874687673,8,4,23,44,1.9362747694348,4.78123327048658,7.93320014419259,101,"ENSG00000079974.19"
"790","ENSG00000033327.13_93708",93700,93708,9,"ENSG00000033327.13",1,6,"VVVVVMVVV",0,8,0.902691511387163,108,114,133,136,158,164,174,177,"ATAATGA","CTTA","TTGATAT","CTTA",2.32638233276413,19,22,10,60,1.78031240827057,4.32238199000786,7.93314803555651,101,"ENSG00000079974.19"
"17118","ENSG00000153165.19_76582",76574,76582,9,"ENSG00000153165.19",1,5,"VVUVMVVVV",1,7,0.770186335403727,116,122,133,136,145,151,161,164,"AAGGTGA","CTAA","TTGATAA","CTGA",2.4659104843463,11,9,10,39,2.9701612525466,4.85239112038049,7.93313646199539,101,"ENSG00000079974.19"
"958","ENSG00000041982.17_15010",15002,15010,9,"ENSG00000041982.17",0,NA,"UVVVVUVVV",2,7,0.824844720496894,42,48,62,65,96,102,133,136,"ATGCTGA","CTGG","TTGATCA","CTGA",2.61316138665423,14,31,31,85,1.11358186425414,4.63366444382059,7.93304332580817,101,"ENSG00000079974.19"
"10057","ENSG00000129003.19_127734",127726,127734,9,"ENSG00000129003.19",1,7,"VVVVVVMVV",0,8,0.885300207039338,116,122,133,136,147,153,161,164,"TTCATAA","TTCA","GTAATAA","CTGA",2.20984806273021,11,11,8,39,2.83485122318002,4.39179291034536,7.93299373850271,101,"ENSG00000079974.19"
"13740","ENSG00000143341.12_286300",286292,286300,9,"ENSG00000143341.12",1,8,"VVVVVVUMV",1,7,0.770186335403727,81,87,100,103,108,114,133,136,"ATAATGA","CTTC","ATGAGGA","CTGA",2.5353612053655,13,5,19,46,2.50647802784211,4.85222151590302,7.93296685751793,101,"ENSG00000079974.19"
"1449","ENSG00000056291.19_78737",78729,78737,9,"ENSG00000056291.19",0,NA,"VVVVUVVVV",1,8,0.889855072463768,106,112,133,136,149,155,210,213,"TTGATGA","ATCA","ATGGTTT","CTGA",2.45837913461595,21,13,55,98,1.10471931084161,4.37347838540366,7.93289867525873,101,"ENSG00000079974.19"
"12836","ENSG00000139174.12_10938",10930,10938,9,"ENSG00000139174.12",1,6,"VVVVVMVVV",0,8,0.902691511387163,83,89,133,136,140,146,157,160,"AGGATTA","TTAA","TTGCAGA","CTGA",2.31970000362669,44,4,11,68,1.82384417629809,4.32212771678568,7.93289376233433,101,"ENSG00000079974.19"
"35299","ENSG00000235652.11_60319",60311,60319,9,"ENSG00000235652.11",0,NA,"UVVVVVVVV",1,8,0.902691511387163,62,68,79,82,98,104,133,136,"ATGATAG","CTGA","ATGTTGT","GTGA",2.35141710779612,11,16,29,65,1.61238522359895,4.32212481889327,7.93289086444193,101,"ENSG00000079974.19"
"31823","ENSG00000224931.4_156",148,156,9,"ENSG00000224931.4",0,NA,"VVVVVVUVV",1,8,0.886128364389234,106,112,133,136,138,144,157,160,"TAGATGA","CAGA","GTGAAGA","TTGA",2.35398451175367,21,2,13,45,1.86018601625728,4.38835402365376,7.9328674812107,101,"ENSG00000079974.19"
"44142","ENSG00000278803.3_5622",5614,5622,9,"ENSG00000278803.3",0,NA,"VVVVVVUVV",1,8,0.886128364389234,106,112,133,136,138,144,157,160,"TAGATGA","CAGA","GTGAAGA","TTGA",2.35398451175367,21,2,13,45,1.86018601625728,4.38835402365376,7.9328674812107,101,"ENSG00000079974.19"
"47222","ENSG00000287862.1_241141",241133,241141,9,"ENSG00000287862.1",0,NA,"UVVVVVVVV",1,8,0.902691511387163,77,83,102,105,115,121,133,136,"ATTATTA","TTGA","GTGATAG","ATGA",2.22817457199113,19,10,12,50,2.43387182890351,4.32209224387777,7.93285828942642,101,"ENSG00000079974.19"
"20297","ENSG00000164619.10_205307",205299,205307,9,"ENSG00000164619.10",1,1,"MVVVVVVVV",0,8,0.90600414078675,108,114,133,136,142,148,188,191,"ATAATAA","GTTA","GTGAACA","CTGA",2.34812384152586,19,6,40,74,1.58111756061854,4.30881912603106,7.93283568917806,101,"ENSG00000079974.19"
"28378","ENSG00000188917.15_26500",26492,26500,9,"ENSG00000188917.15",1,2,"VMVVVVVVV",0,8,0.884057971014493,116,122,133,136,145,151,162,165,"ATGTTGA","AGGA","ATGAAAT","GTGA",2.19628019865747,11,9,11,40,2.94427865833799,4.39653666234695,7.93276854640492,101,"ENSG00000079974.19"
"23235","ENSG00000172349.18_100684",100676,100684,9,"ENSG00000172349.18",1,6,"UVVVVMVVV",1,7,0.805383022774327,113,119,133,136,141,147,168,171,"AAGATGG","AAGA","GTGAAGA","CTGA",2.47320663795493,14,5,21,49,2.35685975405862,4.71122600177288,7.93275809287018,101,"ENSG00000079974.19"
"2144","ENSG00000070729.14_62188",62180,62188,9,"ENSG00000070729.14",1,7,"VVVVVVMVV",0,8,0.885300207039338,92,98,133,136,145,151,174,177,"GTGTTGA","TTAA","GTGAGCA","CTGA",2.43718060834927,35,9,23,76,1.31792380950852,4.39144863295925,7.9326494611166,101,"ENSG00000079974.19"
"35937","ENSG00000237505.8_197486",197478,197486,9,"ENSG00000237505.8",1,6,"UVVVVMVVV",1,7,0.805383022774327,116,122,133,136,139,145,163,166,"ATGATGA","CTTA","CTGATTT","CTCA",2.47627822513422,11,3,18,41,2.33591124580786,4.71110818667566,7.93264027777297,101,"ENSG00000079974.19"
"567","ENSG00000019505.8_17817",17809,17817,9,"ENSG00000019505.8",1,3,"VVMVVVVVV",0,8,0.882815734989648,68,74,87,90,98,104,133,136,"GGGATGA","CTCA","GTGAAGT","CAGA",2.32114553269105,13,8,29,59,2.1311853990133,4.40137223757175,7.93263517753034,101,"ENSG00000079974.19"
"22629","ENSG00000170965.10_71119",71111,71119,9,"ENSG00000170965.10",1,8,"VVVVVUVMV",1,7,0.806211180124224,107,113,133,136,146,152,164,167,"GTGATGG","AAGA","GTCAGGA","CTGA",2.47260552740543,20,10,12,51,2.34710825270671,4.70778627551906,7.93263099601595,101,"ENSG00000079974.19"
"8600","ENSG00000119705.10_16724",16716,16724,9,"ENSG00000119705.10",0,NA,"VVVUVVVVV",1,8,0.880745341614907,114,120,133,136,150,156,179,182,"TTGGTAA","CTGC","GTGCAGA","CTGA",2.34918153272949,13,14,23,59,1.97708763688371,4.40957446377008,7.9325558302297,101,"ENSG00000079974.19"
"9058","ENSG00000122507.21_166134",166126,166134,9,"ENSG00000122507.21",1,1,"MVVVVUVVV",1,7,0.82815734989648,116,122,133,136,137,143,151,154,"ATGATGG","CTTA","TTGAGAA","TTGA",2.36373248300132,11,1,8,29,2.72142089428563,4.61990936190694,7.93253876149286,101,"ENSG00000079974.19"
"37078","ENSG00000245164.10_232764",232756,232764,9,"ENSG00000245164.10",1,7,"VVVVVVMVV",0,8,0.885300207039338,112,118,133,136,153,159,171,174,"GGGCTGT","ATGA","GAGAGGA","CTGA",2.29040948281007,15,17,12,53,2.29582439573712,4.39130523695106,7.93250606510841,101,"ENSG00000079974.19"
"13440","ENSG00000141434.12_16519",16511,16519,9,"ENSG00000141434.12",1,3,"VVMVVVVVV",0,8,0.882815734989648,74,80,93,96,108,114,133,136,"ATGATGA","ATGA","GTGAAAA","ATGT",2.29020733868591,13,12,19,53,2.33691292363537,4.40124046205202,7.93250340201061,101,"ENSG00000079974.19"
"33305","ENSG00000229272.2_184616",184608,184616,9,"ENSG00000229272.2",0,NA,"VVVVVVUVV",1,8,0.886128364389234,83,89,133,136,143,149,165,168,"GTCATGA","CCAA","GTGACTT","CTGA",2.36893870780929,44,7,16,76,1.7588584542041,4.38794579323318,7.93245925079012,101,"ENSG00000079974.19"
"5444","ENSG00000104723.21_287893",287885,287893,9,"ENSG00000104723.21",1,3,"VVMVVVVVV",0,8,0.882815734989648,115,121,133,136,141,147,157,160,"AAGATAA","CTGG","ATGATTT","CGGA",2.18555663529662,12,5,10,36,3.03415759690402,4.40113379138703,7.93239673134562,101,"ENSG00000079974.19"
"33135","ENSG00000228794.12_33477",33469,33477,9,"ENSG00000228794.12",1,5,"VVVVMVVVV",0,8,0.886542443064182,104,110,133,136,146,152,174,177,"GAGATGA","ATGT","CAGAGGA","CTGA",2.39489359422389,23,10,22,64,1.57880218198207,4.38618986920201,7.93235964145873,101,"ENSG00000079974.19"
"68","ENSG00000003436.16_34322",34314,34322,9,"ENSG00000003436.16",1,1,"MVVVVVVVV",0,8,0.90600414078675,114,120,133,136,137,143,157,160,"GTAATAA","ACGA","ATTATTA","CTGA",2.2442749099199,13,1,14,37,2.27153407300812,4.30834170145186,7.93235826459886,101,"ENSG00000079974.19"
"18984","ENSG00000159961.3_11557",11549,11557,9,"ENSG00000159961.3",1,1,"MVVVUVVVV",1,7,0.795859213250517,107,113,133,136,142,148,197,200,"GTGATGA","AGGA","GTAATGA","CTGA",2.62776025893627,20,6,49,84,1.47725187098284,4.74891339930616,7.93235025230823,101,"ENSG00000079974.19"
"13050","ENSG00000139971.15_82658",82650,82658,9,"ENSG00000139971.15",1,7,"UVVVVVMVV",1,7,0.787991718426501,108,114,133,136,142,148,160,163,"ATGATGA","CTGG","ATGACTA","TTGA",2.48979891158591,19,6,12,46,2.52282050316678,4.78036997843488,7.93233685214089,101,"ENSG00000079974.19"
"30664","ENSG00000206199.11_6147",6139,6147,9,"ENSG00000206199.11",1,6,"UVVVVMVVV",1,7,0.805383022774327,108,114,133,136,138,144,152,155,"ATGGTCA","CTAA","GTGATGT","CTGA",2.50516714573599,19,2,8,38,2.14204744131342,4.71079043655501,7.93232252765231,101,"ENSG00000079974.19"
"32595","ENSG00000227252.2_91268",91260,91268,9,"ENSG00000227252.2",1,8,"VVUVVVVMV",1,7,0.767701863354037,98,104,112,115,116,122,133,136,"GTGATGC","CTGG","TTGAACA","CTGA",2.54440351887114,8,1,11,29,2.48336616421614,4.86151407250593,7.93232152592208,101,"ENSG00000079974.19"
"11532","ENSG00000135298.15_240936",240928,240936,9,"ENSG00000135298.15",1,1,"MVVVVVVVV",0,8,0.90600414078675,109,115,133,136,146,152,161,164,"AAGATGA","GTCA","GTGAACT","GTGA",2.19980054931239,18,10,9,46,2.56730584202412,4.30816070936002,7.93217727250702,101,"ENSG00000079974.19"
"45640","ENSG00000285769.4_102228",102220,102228,9,"ENSG00000285769.4",1,8,"VVVVVVVMV",0,8,0.884057971014493,104,110,133,136,141,147,174,177,"GAGATGT","CAGA","TTGGGGA","CTGA",2.42635928202121,23,5,27,64,1.40802345196442,4.39593799969312,7.9321698837511,101,"ENSG00000079974.19"
"27926","ENSG00000187672.15_679699",679691,679699,9,"ENSG00000187672.15",1,5,"VVVVMUVVV",1,7,0.808695652173913,112,118,133,136,140,146,157,160,"CTCATGG","CAGA","GTGCTGC","CTGA",2.40173014070629,15,4,11,39,2.77782053741616,4.69733870219786,7.93212131089351,101,"ENSG00000079974.19"
"9077","ENSG00000122547.11_52395",52387,52395,9,"ENSG00000122547.11",1,7,"VVVVVVMVV",0,8,0.885300207039338,99,105,133,136,139,145,154,157,"GTGATGA","TAGA","GTGATTT","GTGA",2.36775049921007,28,3,9,49,1.77867659918131,4.39091998181211,7.93212080996946,101,"ENSG00000079974.19"
"35298","ENSG00000235649.2_7045",7037,7045,9,"ENSG00000235649.2",1,6,"VVVVVMVVV",0,8,0.902691511387163,46,52,62,65,113,119,133,136,"ATAATGG","CTGA","GTGAGCT","ATGA",2.32397849097964,10,48,14,81,1.79200945809607,4.32129984949008,7.93206589503873,101,"ENSG00000079974.19"
"23700","ENSG00000173578.9_57820",57812,57820,9,"ENSG00000173578.9",1,8,"VVVVVVVMV",0,8,0.884057971014493,85,91,133,136,157,163,176,179,"ATGAGGA","CTAC","GTAAAGA","CTGA",2.46371920813417,42,21,13,85,1.15823417543264,4.39575722408178,7.93198910813975,101,"ENSG00000079974.19"
"19021","ENSG00000160199.15_35393",35385,35393,9,"ENSG00000160199.15",1,2,"VMVVVVVVV",0,8,0.884057971014493,78,84,98,101,110,116,133,136,"ATCATGG","TTGA","ATGCTGT","TTGA",2.245452423773,14,9,17,49,2.61329259943963,4.39574385614824,7.93197574020621,101,"ENSG00000079974.19"
"41751","ENSG00000259673.6_131007",130999,131007,9,"ENSG00000259673.6",1,1,"MVVVVVVVV",0,8,0.90600414078675,84,90,133,136,143,149,159,162,"AAAATGA","CTAT","ATCTTGA","CTGA",2.28468141698502,43,7,10,69,2.00042307550076,4.30790813051689,7.93192469366389,101,"ENSG00000079974.19"
"37632","ENSG00000248550.4_97902",97894,97902,9,"ENSG00000248550.4",0,NA,"VVVUVVVVV",1,8,0.880745341614907,113,119,133,136,143,149,163,166,"ATAACGC","GAGA","ATGATTG","CTGA",2.21875516894879,14,7,14,44,2.84394342984433,4.4089111390424,7.93189250550202,101,"ENSG00000079974.19"
"24675","ENSG00000177414.14_61579",61571,61579,9,"ENSG00000177414.14",1,1,"MVVVUVVVV",1,7,0.795859213250517,87,93,133,136,144,150,161,164,"AAGATGA","CTGT","GTGACAT","CTGA",2.55299900774982,40,8,11,68,1.97382614135459,4.74845488158835,7.93189173459042,101,"ENSG00000079974.19"
"25114","ENSG00000179476.8_1885",1877,1885,9,"ENSG00000179476.8",1,1,"MVVVVVVVV",0,8,0.90600414078675,62,68,84,87,98,104,133,136,"ATGATGT","TTGT","GTGAAGG","CTCA",2.3114279943847,16,11,29,65,1.82193258941871,4.30786313799585,7.93187970114285,101,"ENSG00000079974.19"
"41703","ENSG00000259575.1_2114",2106,2114,9,"ENSG00000259575.1",0,NA,"VVUVVVVVV",1,8,0.883643892339545,115,121,133,136,153,159,186,189,"ATGCTCA","GAGA","CTGAAGA","CTGA",2.39359727684709,12,17,27,65,1.63183731832397,4.39728812432614,7.93186369368432,101,"ENSG00000079974.19"
"13809","ENSG00000143546.10_561",553,561,9,"ENSG00000143546.10",1,8,"VVVVVUVMV",1,7,0.806211180124224,109,115,133,136,142,148,169,172,"ATGTTGA","TTGA","ATCATCG","CTGA",2.5076252423535,18,6,21,54,2.11054503111961,4.7070116617024,7.9318563821993,101,"ENSG00000079974.19"
"43156","ENSG00000269504.3_5953",5945,5953,9,"ENSG00000269504.3",1,6,"VVVVVMVVV",0,8,0.902691511387163,111,117,133,136,147,153,207,210,"CTTATGC","CTCA","ATTATGT","CTGA",2.34154158956934,16,11,54,90,1.6739376652871,4.32105373227067,7.93181977781932,101,"ENSG00000079974.19"
"45775","ENSG00000285894.2_57364",57356,57364,9,"ENSG00000285894.2",1,3,"VVMVVVVVV",0,8,0.882815734989648,102,108,133,136,144,150,174,177,"GTGGTGA","ATGT","ATGTTGT","CTGA",2.41950306608107,25,8,24,66,1.47220516053298,4.40055640026836,7.93181934022696,101,"ENSG00000079974.19"
"9009","ENSG00000122025.15_84339",84331,84339,9,"ENSG00000122025.15",1,6,"VVVVVMVVV",0,8,0.902691511387163,116,122,133,136,159,165,173,176,"AAAATCA","CTGC","GTCTTGA","CTGA",2.27334951466697,11,23,8,51,2.12852440081656,4.32104695798242,7.93181300353107,101,"ENSG00000079974.19"
"8709","ENSG00000120341.19_37514",37506,37514,9,"ENSG00000120341.19",0,NA,"UVVVVVVVV",1,8,0.902691511387163,89,95,133,136,146,152,168,171,"CTGAGGA","CTTT","GTGAAAT","CTGA",2.34364019023725,38,10,16,73,1.65972667313387,4.32099865201221,7.93176469756087,101,"ENSG00000079974.19"
"39737","ENSG00000254154.8_91218",91210,91218,9,"ENSG00000254154.8",0,NA,"UVVVVVVVV",1,8,0.902691511387163,89,95,133,136,146,152,168,171,"CTGAGGA","CTTT","GTGAAAT","CTGA",2.34364019023725,38,10,16,73,1.65972667313387,4.32099865201221,7.93176469756087,101,"ENSG00000079974.19"
"12517","ENSG00000138442.11_95342",95334,95342,9,"ENSG00000138442.11",0,NA,"UVVVVVVVV",1,8,0.902691511387163,112,118,133,136,147,153,174,177,"AGGAAGA","CCAA","GTAAGAA","CTGA",2.26186533238729,15,11,21,56,2.20488210257733,4.32099607962316,7.93176212517181,101,"ENSG00000079974.19"
"15105","ENSG00000147050.17_191860",191852,191860,9,"ENSG00000147050.17",1,8,"VVVVVVVMV",0,8,0.884057971014493,108,114,133,136,185,191,216,219,"GTGATTA","CTAA","GTTATAA","CTGA",2.50966191485232,19,49,25,102,0.851040308240601,4.39552993514735,7.93176181920532,101,"ENSG00000079974.19"
"17275","ENSG00000153814.13_265087",265079,265087,9,"ENSG00000153814.13",1,1,"MVVVVVVVV",0,8,0.90600414078675,84,90,133,136,140,146,154,157,"GGGATGA","ATGA","ATGATTT","ATGA",2.31188840294151,43,4,8,64,1.81834897226195,4.30773458130134,7.93175114444834,101,"ENSG00000079974.19"
"44326","ENSG00000280870.3_53664",53656,53664,9,"ENSG00000280870.3",1,8,"VVVVVVVMV",0,8,0.884057971014493,115,121,133,136,144,150,159,162,"CTGAAGA","GAGA","GTGAAGG","CTGG",2.1805126767212,12,8,9,38,3.04524255703313,4.39549843379362,7.93173031785159,101,"ENSG00000079974.19"
"4837","ENSG00000102038.16_33398",33390,33398,9,"ENSG00000102038.16",1,1,"MVVVVUVVV",1,7,0.82815734989648,63,69,97,100,109,115,133,136,"CAGAAGA","CTGA","TTGAAGA","CTGA",2.5217451815789,28,9,18,64,1.66460384754782,4.61905959785178,7.9316889974377,101,"ENSG00000079974.19"
"20356","ENSG00000164741.15_246430",246422,246430,9,"ENSG00000164741.15",1,2,"VMVVUVVVV",1,7,0.773913043478261,75,81,96,99,115,121,133,136,"AGGATGG","CTGA","TTAATTA","CTGA",2.54814546815694,15,16,12,52,2.35646305272445,4.83602487677601,7.93167705068905,101,"ENSG00000079974.19"
"5616","ENSG00000105993.15_26242",26234,26242,9,"ENSG00000105993.15",1,7,"VVVVVVMVV",0,8,0.885300207039338,106,112,133,136,140,146,154,157,"GTAATAA","CTGT","ATTAGTA","CTGA",2.29750973892913,21,4,8,42,2.24513148273467,4.39046576889889,7.93166659705624,101,"ENSG00000079974.19"
"21498","ENSG00000168038.11_2528",2520,2528,9,"ENSG00000168038.11",1,1,"MVVVVVVVV",0,8,0.90600414078675,111,117,133,136,145,151,163,166,"ACGAAGA","CTTA","GTCATTA","CTAA",2.1719869454989,16,9,12,46,2.75065253458755,4.30764137614506,7.93165793929205,101,"ENSG00000079974.19"
"1474","ENSG00000057704.13_6479",6471,6479,9,"ENSG00000057704.13",1,1,"MVVVVVVVV",0,8,0.90600414078675,115,121,133,136,143,149,178,181,"GTAAGGA","CATA","AGGAAGA","CTGA",2.26219461993789,12,7,29,57,2.14909010847978,4.30759689368309,7.93161345683009,101,"ENSG00000079974.19"
"20605","ENSG00000165164.14_113146",113138,113146,9,"ENSG00000165164.14",1,7,"VVVVVVMVV",0,8,0.885300207039338,113,119,133,136,166,172,224,227,"AACATGA","GAGA","GTGATGA","CTGA",2.4817525082076,14,30,52,105,1.0165703857631,4.39039677678677,7.93159760494412,101,"ENSG00000079974.19"
"31684","ENSG00000224409.1_3792",3784,3792,9,"ENSG00000224409.1",1,1,"MVVVVVVVV",0,8,0.90600414078675,111,117,133,136,142,148,185,188,"GGGAGGT","ATGA","GTGGTGC","CTGA",2.30577371348393,16,6,37,68,1.85826019057712,4.30752123678417,7.93153779993116,101,"ENSG00000079974.19"
"15276","ENSG00000147509.14_23295",23287,23295,9,"ENSG00000147509.14",1,8,"VVVVVUVMV",1,7,0.806211180124224,56,62,100,103,108,114,133,136,"ATGATGT","CTGA","GTGAAGA","CGGA",2.59755725344888,38,5,19,71,1.50972085164746,4.70669230199333,7.93153702249023,101,"ENSG00000079974.19"
"17860","ENSG00000155561.15_2969",2961,2969,9,"ENSG00000155561.15",1,8,"VVVVVVVMV",0,8,0.884057971014493,111,117,133,136,141,147,162,165,"GTTTTGC","GTGA","CTGTTGC","CTGA",2.24830798948532,16,5,15,45,2.59247467372287,4.39529865090625,7.93153053496422,101,"ENSG00000079974.19"
"17958","ENSG00000155903.14_96845",96837,96845,9,"ENSG00000155903.14",1,8,"VVVVVVVMV",0,8,0.884057971014493,103,109,133,136,138,144,159,162,"ATAATGT","AAGA","ATGCAGA","CTGA",2.40300038282895,24,2,15,50,1.56110614954249,4.39527717543388,7.93150905949185,101,"ENSG00000079974.19"
"20584","ENSG00000165115.15_49974",49966,49974,9,"ENSG00000165115.15",1,5,"VVVVMVVVV",0,8,0.886542443064182,114,120,133,136,141,147,158,161,"ACTATGA","CAGA","CAGAAGA","CTTA",2.18524894028014,13,5,11,38,2.9726827964902,4.38525226625611,7.93142203851284,101,"ENSG00000079974.19"
"40518","ENSG00000256742.1_1196",1188,1196,9,"ENSG00000256742.1",1,2,"VMVVVVVVV",0,8,0.884057971014493,110,116,133,136,141,147,178,181,"ATGTTCA","TTTA","GGGATGA","CTGA",2.36807035014944,17,5,31,62,1.79359714029705,4.39518320198999,7.93141508604797,101,"ENSG00000079974.19"
"32744","ENSG00000227712.3_45066",45058,45066,9,"ENSG00000227712.3",1,8,"VVVVVVVMV",0,8,0.884057971014493,71,77,87,90,98,104,133,136,"ATGAAGC","CTGA","TTGAGGG","CTGT",2.32881853997106,10,8,29,56,2.05490063023879,4.3950893908448,7.93132127490277,101,"ENSG00000079974.19"
"28276","ENSG00000188596.11_323575",323567,323575,9,"ENSG00000188596.11",0,NA,"UVVVVUVVV",2,7,0.824844720496894,94,100,133,136,139,145,190,193,"ATGATGA","ATCA","CTGATAA","CTGA",2.6703607549978,33,3,45,90,0.72518810075243,4.63189828351778,7.93127716550535,101,"ENSG00000079974.19"
"9482","ENSG00000124812.15_12517",12509,12517,9,"ENSG00000124812.15",1,8,"VVVVVVVMV",0,8,0.884057971014493,111,117,133,136,150,156,164,167,"TAGATTA","GAGA","GTGAGGG","CTGA",2.27046527928849,16,14,8,47,2.44361812123082,4.39501332912185,7.93124521317982,101,"ENSG00000079974.19"
"13730","ENSG00000143324.14_21260",21252,21260,9,"ENSG00000143324.14",1,2,"VMVVVVVVV",0,8,0.884057971014493,115,121,133,136,147,153,176,179,"TTGTAGA","TTGG","GTGATGT","CTGA",2.30789294183079,12,11,23,55,2.19397689199859,4.3949824593843,7.93121434344227,101,"ENSG00000079974.19"
"21154","ENSG00000166669.14_80315",80307,80315,9,"ENSG00000166669.14",0,NA,"UVVVVVVVV",1,8,0.902691511387163,111,117,133,136,147,153,199,202,"CTGAACA","ATGA","GTAATAA","CTGA",2.34041043648075,16,11,46,82,1.67894453344433,4.32042019416233,7.93118623971098,101,"ENSG00000079974.19"
"37504","ENSG00000248346.1_2586",2578,2586,9,"ENSG00000248346.1",1,1,"MVVVVVUVV",1,7,0.792132505175983,108,114,133,136,146,152,160,163,"ATGGTGG","CAGA","ATGCAGA","CTGA",2.48867778657022,19,10,8,46,2.45931604094766,4.76262532118728,7.93115534189121,101,"ENSG00000079974.19"
"14856","ENSG00000145982.13_421826",421818,421826,9,"ENSG00000145982.13",0,NA,"VVVVVVUVV",1,8,0.886128364389234,84,90,133,136,143,149,166,169,"GTGAAGA","GTAA","TTAAGGA","CTGA",2.37724340993569,43,7,17,76,1.69809252222632,4.38659548044939,7.93110893800633,101,"ENSG00000079974.19"
"2683","ENSG00000077274.9_3539",3531,3539,9,"ENSG00000077274.9",0,NA,"UVVUVVVVV",2,7,0.78343685300207,106,112,133,136,144,150,158,161,"ATGATGA","CAGA","ATGAACA","ATGA",2.52130928924186,21,8,8,46,2.38070738542802,4.79735899509344,7.93110640710172,101,"ENSG00000079974.19"
"21590","ENSG00000168405.18_5625",5617,5625,9,"ENSG00000168405.18",1,7,"VVVVVVMVV",0,8,0.885300207039338,114,120,133,136,153,159,181,184,"TTGAAGG","CTAC","ATGATGA","CTGA",2.3592451813551,13,17,22,61,1.83131727081957,4.38990461996339,7.93110544812074,101,"ENSG00000079974.19"
"42660","ENSG00000265533.1_316981",316973,316981,9,"ENSG00000265533.1",1,8,"VVVVVVVMV",0,8,0.884057971014493,89,95,133,136,149,155,177,180,"ATGATGT","TTGT","AGAATGA","CTGA",2.4712071932264,38,13,22,82,1.10477576304549,4.39487259613871,7.93110448019668,101,"ENSG00000079974.19"
"11862","ENSG00000136250.12_101116",101108,101116,9,"ENSG00000136250.12",0,NA,"VVVUVVVVV",1,8,0.880745341614907,116,122,133,136,145,151,161,164,"CTGTTGG","GAGA","GTTTTGC","CTGA",2.19932651305224,11,9,10,39,2.9701612525466,4.40808450155705,7.93106586801668,101,"ENSG00000079974.19"
"23945","ENSG00000174482.11_757068",757060,757068,9,"ENSG00000174482.11",1,6,"VVVVVMVVV",0,8,0.902691511387163,95,101,107,110,114,120,133,136,"GTGCTCT","ATGA","GTCAGAA","CTGA",2.21704031927462,6,4,13,32,2.50089585850817,4.32029116341808,7.93105720896673,101,"ENSG00000079974.19"
"37549","ENSG00000248455.8_8818",8810,8818,9,"ENSG00000248455.8",0,NA,"UVVVVVVVV",1,8,0.902691511387163,113,119,133,136,148,154,184,187,"AGAATGA","CTAC","GTCATGT","CTGA",2.31370770448161,14,12,30,65,1.85633599927327,4.32026350728768,7.93102955283633,101,"ENSG00000079974.19"
"47296","ENSG00000287949.1_98385",98377,98385,9,"ENSG00000287949.1",1,1,"MVVVVVVVV",0,8,0.90600414078675,115,121,133,136,179,185,208,211,"ATCAAGA","ATAA","TTGAAGA","CTGA",2.37976548395051,12,43,23,87,1.36287271965457,4.30699398649783,7.93101054964482,101,"ENSG00000079974.19"
"40284","ENSG00000255467.1_971",963,971,9,"ENSG00000255467.1",1,1,"MVVVVVVVV",0,8,0.90600414078675,116,122,133,136,138,144,171,174,"AATATGG","CTCA","GTGATTC","CTGA",2.3284646784133,11,2,27,49,1.70480235647046,4.30697505313977,7.93099161628677,101,"ENSG00000079974.19"
"33373","ENSG00000229558.2_3959",3951,3959,9,"ENSG00000229558.2",1,8,"VVVVVVVMV",0,8,0.884057971014493,99,105,133,136,150,156,171,174,"ATGAATA","ATGT","GTGATGT","CTGA",2.4091301093205,28,14,15,66,1.51786354633978,4.39468273545244,7.93091461951041,101,"ENSG00000079974.19"
"43335","ENSG00000271395.2_111717",111709,111717,9,"ENSG00000271395.2",1,8,"VVVVVVVMV",0,8,0.884057971014493,97,103,133,136,138,144,154,157,"ATTATGA","CAAA","AAGAATA","CTGA",2.40141159388663,30,2,10,51,1.56924336812594,4.39466349850921,7.93089538256718,101,"ENSG00000079974.19"
"28206","ENSG00000188487.12_103775",103767,103775,9,"ENSG00000188487.12",0,NA,"UVVVVVVVV",1,8,0.902691511387163,84,90,133,136,184,190,205,208,"GAGATGA","GTGA","ATCAGGG","CTGA",2.46921686148364,43,48,15,115,0.819032066420817,4.32011945241128,7.93088549795993,101,"ENSG00000079974.19"
"40586","ENSG00000257060.8_65895",65887,65895,9,"ENSG00000257060.8",1,1,"MVVVVVVVV",0,8,0.90600414078675,115,121,133,136,154,160,176,179,"AAAATGA","CAGG","GTAATCT","CTGA",2.26436939266408,12,18,16,55,2.13148180977598,4.30681944021746,7.93083600336446,101,"ENSG00000079974.19"
"16328","ENSG00000151322.20_722825",722817,722825,9,"ENSG00000151322.20",1,5,"VVVVMVVVV",0,8,0.886542443064182,104,110,133,136,139,145,162,165,"CTGATGC","CCTA","GTTCTGA","CTGA",2.38001367629698,23,3,17,52,1.67178618346451,4.3846360063611,7.93080577861783,101,"ENSG00000079974.19"
"3653","ENSG00000087263.17_1262",1254,1262,9,"ENSG00000087263.17",1,2,"VMVVVUVVV",1,7,0.806211180124223,115,121,133,136,144,150,159,162,"ATGTTGG","AGGA","GTGGTTA","CTGA",2.36676413799175,12,8,9,38,3.04524255703313,4.70591753591121,7.9307622564081,101,"ENSG00000079974.19"
"35511","ENSG00000236213.4_28209",28201,28209,9,"ENSG00000236213.4",1,6,"VVVVVMVVV",0,8,0.902691511387163,87,93,133,136,177,183,199,202,"ATGATGG","CATA","GTGTATA","CTGA",2.47707241896133,40,41,16,106,0.766091445516554,4.31997689298135,7.93074293853,101,"ENSG00000079974.19"
"47870","ENSG00000289545.2_101242",101234,101242,9,"ENSG00000289545.2",1,6,"VVVVVMVVV",0,8,0.902691511387163,87,93,133,136,177,183,199,202,"ATGATGG","CATA","GTGTATA","CTGA",2.47707241896133,40,41,16,106,0.766091445516554,4.31997689298135,7.93074293853,101,"ENSG00000079974.19"
"26212","ENSG00000183690.13_112817",112809,112817,9,"ENSG00000183690.13",1,6,"VVVVUMVVV",1,7,0.792546583850932,113,119,133,136,144,150,161,164,"GTGATAA","CTGA","ATGAGGC","CTCA",2.41327316721525,14,8,11,42,2.95372298478643,4.76055269155536,7.93073902695909,101,"ENSG00000079974.19"
"326","ENSG00000008277.15_153583",153575,153583,9,"ENSG00000008277.15",0,NA,"UVVVVVVVV",1,8,0.902691511387163,114,120,133,136,140,146,161,164,"ATGATTA","ATCA","GTGAATG","CTCA",2.19077256447211,13,4,15,41,2.67464895969158,4.31994984737641,7.93071589292506,101,"ENSG00000079974.19"
"16628","ENSG00000151914.22_399197",399189,399197,9,"ENSG00000151914.22",1,7,"VVVVVVMVV",0,8,0.885300207039338,109,115,133,136,147,153,163,166,"TTGACCA","CACA","CTGCTGA","CTGA",2.25821843200558,18,11,10,48,2.50326153916375,4.38951277146691,7.93071359962426,101,"ENSG00000079974.19"
"40756","ENSG00000257545.5_224322",224314,224322,9,"ENSG00000257545.5",1,1,"MVVVVVVVV",0,8,0.90600414078675,95,101,133,136,182,188,199,202,"ATGAAGT","ATGA","ATGTTTG","CTGA",2.43229511623813,32,46,11,98,1.01134167818052,4.30666061327535,7.93067717642235,101,"ENSG00000079974.19"
"48362","ENSG00000291034.1_94859",94851,94859,9,"ENSG00000291034.1",1,8,"VVVVVVVMV",0,8,0.884057971014493,99,105,133,136,146,152,165,168,"ATAATGA","CAGA","TTGAGGC","CTTA",2.3523195262154,28,10,13,60,1.8952871761146,4.39435433772098,7.93058622177895,101,"ENSG00000079974.19"
"36796","ENSG00000243040.7_5862",5854,5862,9,"ENSG00000243040.7",0,NA,"VVVVUVVVV",1,8,0.889855072463768,115,121,133,136,143,149,165,168,"CTGCTGT","ATAA","GAGAGGC","CTGA",2.20759305790767,12,7,16,44,2.76737040921505,4.37116436548321,7.93058465533829,101,"ENSG00000079974.19"
"10413","ENSG00000130997.16_39104",39096,39104,9,"ENSG00000130997.16",1,3,"VVMVVUVVV",1,7,0.804968944099379,89,95,110,113,116,122,133,136,"CTGATGA","CTGT","TTGTTGA","CTGT",2.4280199118705,15,3,11,38,2.65595836413498,4.71068944415124,7.93056522054875,101,"ENSG00000079974.19"
"48046","ENSG00000290263.1_39259",39251,39259,9,"ENSG00000290263.1",1,3,"VVMVVUVVV",1,7,0.804968944099379,89,95,110,113,116,122,133,136,"CTGATGA","CTGT","TTGTTGA","CTGT",2.4280199118705,15,3,11,38,2.65595836413498,4.71068944415124,7.93056522054875,101,"ENSG00000079974.19"
"35743","ENSG00000236935.3_13171",13163,13171,9,"ENSG00000236935.3",1,1,"MVVVVVVVV",0,8,0.90600414078675,77,83,96,99,116,122,133,136,"ATTATCT","CTGA","GTGTTAA","ATGA",2.22237531096476,13,17,11,50,2.4102845289433,4.30652998384376,7.93054654699076,101,"ENSG00000079974.19"
"20842","ENSG00000165837.12_19529",19521,19529,9,"ENSG00000165837.12",1,8,"VVVVVVVMV",0,8,0.884057971014493,112,118,133,136,179,185,206,209,"AGGATGC","CAAA","GTGCTGA","CTGA",2.43051643090432,15,43,21,88,1.37381131354744,4.39431354656072,7.93054543061869,101,"ENSG00000079974.19"
"8653","ENSG00000120088.16_15550",15542,15550,9,"ENSG00000120088.16",1,5,"VVVVMVUVV",1,7,0.772670807453416,114,120,133,136,144,150,201,204,"ATGATGA","GGGA","CTGCTCA","CTGA",2.60628308612117,13,8,51,81,1.98418666039938,4.83985180863512,7.93053503844878,101,"ENSG00000079974.19"
"42495","ENSG00000263715.7_179483",179475,179483,9,"ENSG00000263715.7",1,5,"VVVVMVUVV",1,7,0.772670807453416,114,120,133,136,144,150,201,204,"ATGATGA","GGGA","CTGCTCA","CTGA",2.60628308612117,13,8,51,81,1.98418666039938,4.83985180863512,7.93053503844878,101,"ENSG00000079974.19"
"40078","ENSG00000254946.2_3723",3715,3723,9,"ENSG00000254946.2",1,3,"VVMVVVVVV",0,8,0.882815734989648,116,122,133,136,137,143,159,162,"GGAATGA","CAGA","ATCTTGG","CTGA",2.31886062908104,11,1,16,37,2.13788582932481,4.39923917246628,7.93050211242487,101,"ENSG00000079974.19"
"10963","ENSG00000133226.19_24625",24617,24625,9,"ENSG00000133226.19",0,NA,"UVVVVVVVV",1,8,0.902691511387163,110,116,133,136,144,150,164,167,"ATTATGA","ATGT","ATTGTGA","GTGA",2.19961332318387,17,8,14,48,2.61482619096146,4.31972875304682,7.93049479859548,101,"ENSG00000079974.19"
"1663","ENSG00000064787.14_87056",87048,87056,9,"ENSG00000064787.14",1,2,"VMVVVVVVV",0,8,0.884057971014493,110,116,133,136,149,155,170,173,"ATGATAC","CATA","GTGGCTA","CTGA",2.29660454812648,17,13,15,54,2.26632550433409,4.39425562296099,7.93048750701896,101,"ENSG00000079974.19"
"45720","ENSG00000285834.1_24454",24446,24454,9,"ENSG00000285834.1",1,2,"VMVVVVVVV",0,8,0.884057971014493,109,115,133,136,145,151,161,164,"AAGATCA","CAGA","TTGATTA","ATGA",2.24332799549222,18,9,10,46,2.62102556697454,4.39413638423067,7.93036826828864,101,"ENSG00000079974.19"
"37370","ENSG00000247828.10_98429",98421,98429,9,"ENSG00000247828.10",1,6,"VVUVVMVVV",1,7,0.786335403726708,115,121,133,136,183,189,216,219,"ATGATGA","GAGA","TTGATGT","CTGA",2.69018230135642,12,47,27,95,1.20547054898623,4.78500480617393,7.93034642108076,101,"ENSG00000079974.19"
"23653","ENSG00000173482.17_326817",326809,326817,9,"ENSG00000173482.17",0,NA,"UVVUVVVVV",2,7,0.78343685300207,110,116,133,136,141,147,168,171,"CTGATGA","TAGA","CTGAAAA","CTGA",2.55590267797291,17,5,21,52,2.14704235461545,4.79659838527538,7.93034579728366,101,"ENSG00000079974.19"
"2637","ENSG00000077092.20_353374",353366,353374,9,"ENSG00000077092.20",1,1,"MVVVVVVVV",0,8,0.90600414078675,90,96,133,136,162,168,178,181,"GGGATGT","GTGT","TTGATGA","CTGA",2.41747183444356,37,26,10,82,1.10862532145903,4.30627605443735,7.93029261758435,101,"ENSG00000079974.19"
"8743","ENSG00000120549.19_8775",8767,8775,9,"ENSG00000120549.19",1,8,"VVVVVVVMV",0,8,0.884057971014493,66,72,82,85,98,104,133,136,"AAGACGA","CGGA","GAGATAC","CTGA",2.37205485211468,10,13,29,61,1.76238968438536,4.39402217462081,7.93025405867878,101,"ENSG00000079974.19"
"14659","ENSG00000145685.14_210081",210073,210081,9,"ENSG00000145685.14",1,7,"VVVVVVMVV",0,8,0.885300207039338,85,91,103,106,115,121,133,136,"TTGTTGT","CTGA","GTGGTAC","CTGT",2.19442905609763,12,9,12,42,2.92620981779387,4.38893421461119,7.93013504276854,101,"ENSG00000079974.19"
"11248","ENSG00000134343.14_40472",40464,40472,9,"ENSG00000134343.14",1,6,"VVVVVMVVV",0,8,0.902691511387163,74,80,98,101,111,117,133,136,"ATGATGT","CATA","ATCATCA","TTGA",2.24309964234233,18,10,16,53,2.32325104645034,4.31931216551648,7.93007821106513,101,"ENSG00000079974.19"
"30036","ENSG00000198961.10_53288",53280,53288,9,"ENSG00000198961.10",1,8,"VVVVVVVMV",0,8,0.884057971014493,114,120,133,136,148,154,206,209,"ATGAGAA","GTGA","ATTAAAA","CTGA",2.37182801180121,13,12,52,86,1.76300947064722,4.39379905399716,7.93003093805513,101,"ENSG00000079974.19"
"32376","ENSG00000226868.1_826",818,826,9,"ENSG00000226868.1",1,8,"VVVVVVVMV",0,8,0.884057971014493,113,119,133,136,153,159,191,194,"GTGAAGA","ATGC","ATGGTGG","CTGA",2.41390663761894,14,17,32,72,1.48240520641214,4.39377903096794,7.93001091502591,101,"ENSG00000079974.19"
"4962","ENSG00000102466.16_583384",583376,583384,9,"ENSG00000102466.16",1,6,"VVVVVMVVV",0,8,0.902691511387163,111,117,133,136,148,154,163,166,"ATGATTG","CTGG","ATGCTCA","CTGC",2.20057279746014,16,12,9,46,2.6064885571107,4.31924346837791,7.93000951392656,101,"ENSG00000079974.19"
"36267","ENSG00000239440.6_466200",466192,466200,9,"ENSG00000239440.6",1,8,"VVVVVVVMV",0,8,0.884057971014493,115,121,133,136,184,190,201,204,"ATGCTTT","CGGC","GTGATGA","CTGA",2.33816088035238,12,48,11,80,1.98727270165384,4.39375297600076,7.92998486005873,101,"ENSG00000079974.19"
"28921","ENSG00000196712.20_208524",208516,208524,9,"ENSG00000196712.20",0,NA,"UVVVVVVVV",1,8,0.902691511387163,116,122,133,136,146,152,165,168,"AAGTTTA","GAGA","GTTTTGA","CTGA",2.17079477250789,11,10,13,43,2.80452405124675,4.31912230032483,7.92988834587349,101,"ENSG00000079974.19"
"18878","ENSG00000159111.13_4158",4150,4158,9,"ENSG00000159111.13",1,1,"MVVVVVUVV",1,7,0.792132505175983,114,120,133,136,144,150,160,163,"CTAATGA","TAGA","GAGATGT","CTGA",2.40446841687695,13,8,10,40,3.01535129197326,4.7612851844549,7.92981520515884,101,"ENSG00000079974.19"
"28039","ENSG00000188002.13_30652",30644,30652,9,"ENSG00000188002.13",1,6,"VVVVVMVVV",0,8,0.902691511387163,114,120,133,136,146,152,204,207,"AGGAAAA","CAGA","GTCAGGA","CTGA",2.30704792761811,13,10,52,84,1.89536080340054,4.31892008021366,7.92968612576231,101,"ENSG00000079974.19"
"48414","ENSG00000291079.1_30682",30674,30682,9,"ENSG00000291079.1",1,6,"VVVVVMVVV",0,8,0.902691511387163,114,120,133,136,146,152,204,207,"AGGAAAA","CAGA","GTCAGGA","CTGA",2.30704792761811,13,10,52,84,1.89536080340054,4.31892008021366,7.92968612576231,101,"ENSG00000079974.19"
"13465","ENSG00000141503.17_21540",21532,21540,9,"ENSG00000141503.17",0,NA,"VVVVUVVVV",1,8,0.889855072463768,64,70,81,84,102,108,133,136,"CGGTTGA","GTGA","GTGGAGA","CTGA",2.37904133839528,11,18,25,63,1.62060073812754,4.37021908185735,7.92963937171242,101,"ENSG00000079974.19"
"42030","ENSG00000260372.7_199610",199602,199610,9,"ENSG00000260372.7",1,7,"VVVVVVMVV",0,8,0.885300207039338,112,118,133,136,150,156,172,175,"GTGGTAA","TAGA","GTGGTGC","CTGA",2.28940268512544,15,14,16,54,2.29088740152071,4.38839299225591,7.92959382041326,101,"ENSG00000079974.19"
"28342","ENSG00000188732.11_18800",18792,18800,9,"ENSG00000188732.11",0,NA,"VVVVUVVVV",1,8,0.889855072463768,103,109,133,136,180,186,201,204,"ATGATAA","AAGA","TTGTTTA","CTGA",2.4663276921425,24,44,15,92,1.03839490333838,4.37014487940543,7.9295651692605,101,"ENSG00000079974.19"
"34272","ENSG00000232396.2_3552",3544,3552,9,"ENSG00000232396.2",1,8,"VVVUVVVMV",1,7,0.764803312629399,116,122,133,136,149,155,167,170,"GTGATGG","CTGG","GTGCAGC","CTGA",2.52724519523346,11,13,12,45,2.63304008119191,4.87033534568707,7.92954859620467,101,"ENSG00000079974.19"
"1472","ENSG00000057663.16_29456",29448,29456,9,"ENSG00000057663.16",1,3,"UVMVVVVVV",1,7,0.785507246376811,92,98,108,111,112,118,133,136,"ATGATGA","TAGA","GTGATGA","TTGA",2.54344018192383,10,1,15,35,2.1937536296276,4.78750537727996,7.9295343627872,101,"ENSG00000079974.19"
"15871","ENSG00000149972.12_6958",6950,6958,9,"ENSG00000149972.12",1,2,"VMUVVVVVV",1,7,0.767701863354037,115,121,133,136,143,149,158,161,"GAGATGA","GTGA","AGGTTAA","CTGA",2.45359186148364,12,7,9,37,3.07762537929755,4.85872611396379,7.92953356737994,101,"ENSG00000079974.19"
"42303","ENSG00000261592.1_1349",1341,1349,9,"ENSG00000261592.1",1,2,"VMVVVVVVV",0,8,0.884057971014493,111,117,133,136,174,180,194,197,"CTGGTGA","GTCA","TTCATGA","CTGA",2.37791981451595,16,38,14,77,1.72030161468306,4.39327509453068,7.92950697858865,101,"ENSG00000079974.19"
"8071","ENSG00000116711.10_5803",5795,5803,9,"ENSG00000116711.10",0,NA,"UVVVVVVVV",1,8,0.902691511387163,111,117,133,136,146,152,180,183,"TTCATGA","CTGA","ATGTTTT","CTTA",2.30462889608532,16,10,28,63,1.91060759268583,4.31870005831365,7.92946610386231,101,"ENSG00000079974.19"
"37025","ENSG00000244342.5_172445",172437,172445,9,"ENSG00000244342.5",1,7,"VVVVVVMVV",0,8,0.885300207039338,61,67,78,81,111,117,133,136,"GTAATGA","GTGA","CTGAAGA","ATGA",2.36527706058283,11,30,16,66,1.78437811705217,4.38822296356776,7.92942379172511,101,"ENSG00000079974.19"
"9478","ENSG00000124788.19_354765",354757,354765,9,"ENSG00000124788.19",1,2,"VMVVVVVVV",0,8,0.884057971014493,111,117,133,136,144,150,158,161,"ATGCTGA","TTCA","AAGAGGA","ATGA",2.21157825124366,16,8,8,41,2.82885170854667,4.39317667920943,7.9294085632674,101,"ENSG00000079974.19"
"18158","ENSG00000156299.15_383030",383022,383030,9,"ENSG00000156299.15",1,1,"MVVVVUVVV",1,7,0.82815734989648,73,79,88,91,100,106,133,136,"CTGATAA","GTGA","TTGTTCA","CTGA",2.47149285616216,9,9,27,54,1.99049287186069,4.61677797823544,7.92940737782136,101,"ENSG00000079974.19"
"21766","ENSG00000168916.16_42162",42154,42162,9,"ENSG00000168916.16",1,8,"VVVUVVVMV",1,7,0.764803312629399,114,120,133,136,148,154,174,177,"AAGATGA","TTGA","TTGCTAA","CTGA",2.5804219054598,13,12,20,54,2.27795983930753,4.87019313559321,7.92940638611081,101,"ENSG00000079974.19"
"17875","ENSG00000155657.29_15465",15457,15465,9,"ENSG00000155657.29",1,5,"VVVVMVVVV",0,8,0.886542443064182,110,116,133,136,184,190,198,201,"CTGCTGA","ATTA","ATGATTC","CTGA",2.36946183802633,17,48,8,82,1.73649599489589,4.38322706210119,7.92939683435791,101,"ENSG00000079974.19"
"19673","ENSG00000163596.17_91436",91428,91436,9,"ENSG00000163596.17",1,3,"VVMVVVVVV",0,8,0.882815734989648,83,89,104,107,114,120,133,136,"CTGATGA","CTGA","ATGCATA","CACA",2.21326486091394,15,7,13,44,2.83729252071384,4.39809789836837,7.92936083832696,101,"ENSG00000079974.19"
"37430","ENSG00000248165.1_20666",20658,20666,9,"ENSG00000248165.1",1,7,"UVVVVVMVV",1,7,0.787991718426501,99,105,133,136,148,154,173,176,"GTGATGG","GTGA","GTGATGG","CTGA",2.65356229769261,28,12,19,68,1.41910921578154,4.77738113343307,7.92934800713908,101,"ENSG00000079974.19"
"22391","ENSG00000170456.16_159653",159645,159653,9,"ENSG00000170456.16",1,7,"VVVVVVMVV",0,8,0.885300207039338,89,95,133,136,143,149,168,171,"ATGATTA","CACA","GAGCTGG","CTGA",2.39614454398559,38,7,19,73,1.57826177425442,4.3881396835396,7.92934051169695,101,"ENSG00000079974.19"
"39633","ENSG00000253956.1_11006",10998,11006,9,"ENSG00000253956.1",1,2,"VMVVVVVVV",0,8,0.884057971014493,92,98,106,109,116,122,133,136,"GTCATGA","CTAA","GTCATTT","CTCA",2.20856332454788,8,7,11,35,2.84853916022757,4.39307366430336,7.92930554836133,101,"ENSG00000079974.19"
"34674","ENSG00000233725.7_40064",40056,40064,9,"ENSG00000233725.7",1,1,"MVVVVVVVV",0,8,0.90600414078675,77,83,99,102,114,120,133,136,"ATGATTC","CTGG","TTGTAGA","CAGA",2.20460974078894,16,12,13,50,2.52363528668645,4.30525838965318,7.92927495280018,101,"ENSG00000079974.19"
"44424","ENSG00000281883.1_64933",64925,64933,9,"ENSG00000281883.1",1,1,"MVVVVVVVV",0,8,0.90600414078675,77,83,99,102,114,120,133,136,"ATGATTC","CTGG","TTGTAGA","CAGA",2.20460974078894,16,12,13,50,2.52363528668645,4.30525838965318,7.92927495280018,101,"ENSG00000079974.19"
"40406","ENSG00000255944.1_10269",10261,10269,9,"ENSG00000255944.1",1,8,"VVVVVVVMV",0,8,0.884057971014493,73,79,106,109,116,122,133,136,"CTGCTGA","CTGA","TTGGTCA","CTGC",2.32254070470814,27,7,11,54,2.08850561077034,4.39302757720615,7.92925946126412,101,"ENSG00000079974.19"
"40515","ENSG00000256732.2_10265",10257,10265,9,"ENSG00000256732.2",1,8,"VVVVVVVMV",0,8,0.884057971014493,73,79,106,109,116,122,133,136,"CTGCTGA","CTGA","TTGGTCA","CTGC",2.32254070470814,27,7,11,54,2.08850561077034,4.39302757720615,7.92925946126412,101,"ENSG00000079974.19"
"17920","ENSG00000155849.16_201137",201129,201137,9,"ENSG00000155849.16",0,NA,"VVVVUVVVV",1,8,0.889855072463768,116,122,133,136,150,156,164,167,"TTGAGGA","CTGT","GTTATGT","CTGG",2.23262586025511,11,14,8,42,2.59516639846677,4.36983470004188,7.92925498989695,101,"ENSG00000079974.19"
"3098","ENSG00000081052.14_149845",149837,149845,9,"ENSG00000081052.14",1,1,"MVVVUVVVV",1,7,0.795859213250517,116,122,133,136,139,145,187,190,"CTGATCT","CTGA","GTGAGGA","CTGA",2.59405994297049,11,3,42,65,1.68934557559021,4.74576963218171,7.92920648518378,101,"ENSG00000079974.19"
"38255","ENSG00000249853.9_190618",190610,190618,9,"ENSG00000249853.9",0,NA,"UVVVVVVVV",1,8,0.902691511387163,114,120,133,136,145,151,198,201,"GTGAAAA","AAGA","GTGTTAA","CTGA",2.29839850457455,13,9,47,78,1.95097939119319,4.31840902208922,7.92917506763787,101,"ENSG00000079974.19"
"4499","ENSG00000100731.16_51689",51681,51689,9,"ENSG00000100731.16",1,2,"VMVVVVVVV",0,8,0.884057971014493,116,122,133,136,149,155,177,180,"AGAATTA","CTGG","ATTATGA","CTGA",2.32424566253209,11,13,22,55,2.07658592823546,4.39288925294568,7.92912113700365,101,"ENSG00000079974.19"
"28633","ENSG00000196277.16_412721",412713,412721,9,"ENSG00000196277.16",0,NA,"VVVVUVVVV",1,8,0.889855072463768,91,97,133,136,181,187,200,203,"CTGAAGA","ATGT","TTGATGA","CTGA",2.48262384608832,36,45,13,103,0.927914175625145,4.36968495405348,7.92910524390856,101,"ENSG00000079974.19"
"41346","ENSG00000258890.8_31167",31159,31167,9,"ENSG00000258890.8",1,5,"VVVVMVVVV",0,8,0.886542443064182,111,117,133,136,137,143,152,155,"GTGCTAA","TTGT","GTGAGCA","CTGA",2.28567771526573,16,1,9,35,2.29387178397808,4.38293080477074,7.92910057702747,101,"ENSG00000079974.19"
"31586","ENSG00000224184.7_149606",149598,149606,9,"ENSG00000224184.7",1,1,"MVVVVVVVV",0,8,0.90600414078675,42,48,61,64,72,78,133,136,"ATGCTGA","CTAA","GCCATGA","CTGC",2.28558749482033,13,8,55,85,1.98296466383371,4.30505365732564,7.92907022047264,101,"ENSG00000079974.19"
"3858","ENSG00000089558.9_20366",20358,20366,9,"ENSG00000089558.9",0,NA,"VVVVVVUVV",1,8,0.886128364389234,44,50,64,67,116,122,133,136,"AGGATTG","CGGA","CTGAAGT","CTGA",2.33810417596217,14,49,11,83,1.95074779386467,4.38452724173645,7.92904069929339,101,"ENSG00000079974.19"
"8415","ENSG00000118733.17_29362",29354,29362,9,"ENSG00000118733.17",1,1,"MVVVVVVVV",0,8,0.90600414078675,114,120,133,136,181,187,210,213,"AGGATGG","AGGA","GTGGTTA","CTGA",2.37946703142859,13,45,23,90,1.35696827575046,4.30502045465194,7.92903701779893,101,"ENSG00000079974.19"
"47753","ENSG00000289192.1_50",42,50,9,"ENSG00000289192.1",1,1,"MVVVVVVVV",0,8,0.90600414078675,33,39,52,55,100,106,129,132,"AGGATGG","AGGA","GTGGTTA","CTGA",2.37946703142859,13,45,23,90,1.35696827575046,4.30502045465194,7.92903701779893,101,"ENSG00000079974.19"
"22357","ENSG00000170390.16_14593",14585,14593,9,"ENSG00000170390.16",1,2,"VMVVVUVVV",1,7,0.806211180124223,78,84,96,99,111,117,133,136,"AGGAAGA","CTGT","ATGATCT","CTGA",2.44365559809104,12,12,16,49,2.5257316390656,4.70419223991814,7.92903696041504,101,"ENSG00000079974.19"
"44604","ENSG00000283154.3_488937",488929,488937,9,"ENSG00000283154.3",1,5,"VVVVMVVVV",0,8,0.886542443064182,83,89,133,136,153,159,174,177,"GTAATGA","AAGA","GTTAGGA","CTGA",2.44282656442692,44,17,15,85,1.24559579126482,4.38277655519441,7.92894632745114,101,"ENSG00000079974.19"
"34156","ENSG00000231999.8_47946",47938,47946,9,"ENSG00000231999.8",1,2,"VMVVVUVVV",1,7,0.806211180124223,112,118,133,136,145,151,161,164,"GTGATGT","GGGA","AAGAGAA","CTGA",2.39159780936593,15,9,10,43,2.87242091295343,4.70410157718158,7.92894629767848,101,"ENSG00000079974.19"
"19735","ENSG00000163630.11_327651",327643,327651,9,"ENSG00000163630.11",1,8,"VVUVVVVMV",1,7,0.767701863354037,110,116,133,136,148,154,163,166,"TTGATTA","CTCA","ATGTTGA","CTGA",2.53652641428466,17,12,9,47,2.52224465846997,4.85810518842527,7.92891264184141,101,"ENSG00000079974.19"
"26861","ENSG00000185053.14_780111",780103,780111,9,"ENSG00000185053.14",0,NA,"UVVVVVVVV",1,8,0.902691511387163,110,116,133,136,140,146,186,189,"ATTATGA","CTGC","CTGAAGT","CTTA",2.34888197795746,17,4,40,70,1.61321519899752,4.31810709634514,7.92887314189379,101,"ENSG00000079974.19"
"31430","ENSG00000223727.6_141783",141775,141783,9,"ENSG00000223727.6",1,1,"MVVVVVVVV",0,8,0.90600414078675,64,70,84,87,95,101,133,136,"ATGAAGA","GAGA","AAGATGA","CAGA",2.27676157063352,14,8,32,63,2.04088035654689,4.30482270685925,7.92883927000625,101,"ENSG00000079974.19"
"13191","ENSG00000140538.17_255783",255775,255783,9,"ENSG00000140538.17",0,NA,"UVVVVVVVV",1,8,0.902691511387163,113,119,133,136,144,150,168,171,"ATGTTGG","TTGG","GTGAAGA","CTTA",2.20265712802273,14,8,18,49,2.58779318571819,4.31804350980076,7.92880955534942,101,"ENSG00000079974.19"
"39122","ENSG00000251670.1_66989",66981,66989,9,"ENSG00000251670.1",1,6,"VVVVVMVVV",0,8,0.902691511387163,109,115,133,136,152,158,185,188,"ACAATGG","CTGT","ATGATGG","CTGA",2.38703408375737,18,16,27,70,1.35857005336372,4.31803265293656,7.92879869848521,101,"ENSG00000079974.19"
"18451","ENSG00000157423.18_58939",58931,58939,9,"ENSG00000157423.18",1,1,"MVVVVVVVV",0,8,0.90600414078675,74,80,93,96,107,113,133,136,"ATAAAGA","TTGA","CAGATGA","CTCA",2.23077372904843,13,11,20,53,2.34728147399957,4.30477658358061,7.92879314672761,101,"ENSG00000079974.19"
"17552","ENSG00000154415.8_181346",181338,181346,9,"ENSG00000154415.8",1,6,"VVVVVMVVV",0,8,0.902691511387163,97,103,133,136,148,154,188,191,"CTGATTA","GTCA","GTGAGGA","CTGA",2.45985681503093,30,12,34,85,0.873041935951042,4.31802184237264,7.9287878879213,101,"ENSG00000079974.19"
"33712","ENSG00000230871.1_112",104,112,9,"ENSG00000230871.1",1,1,"MVVVVVUVV",1,7,0.792132505175983,51,57,78,81,92,98,114,117,"ATGATGA","TTGA","CTGATGC","CAGA",2.55561303553912,21,11,16,57,2.00341292320107,4.76020829003213,7.92873831073606,101,"ENSG00000079974.19"
"34943","ENSG00000234426.3_196205",196197,196205,9,"ENSG00000234426.3",0,NA,"UVVVVVVVV",1,8,0.902691511387163,101,107,133,136,145,151,160,163,"TTGATCA","CTCA","CTGATGT","CTGT",2.27823756855316,26,9,9,53,2.08296029849765,4.31780268887968,7.92856873442833,101,"ENSG00000079974.19"
"47586","ENSG00000288701.1_120035",120027,120035,9,"ENSG00000288701.1",1,6,"VVVVVMVVV",0,8,0.902691511387163,86,92,133,136,145,151,165,168,"ATGGTGT","GTGT","GTGTTCT","CTGA",2.31722286679207,41,9,14,73,1.82292848386154,4.3177702322855,7.92853627783415,101,"ENSG00000079974.19"
"7385","ENSG00000113805.9_305943",305935,305943,9,"ENSG00000113805.9",1,2,"VMVVVUVVV",1,7,0.806211180124223,112,118,133,136,144,150,169,172,"ATGATTT","CTGG","TTGCTGG","CTGA",2.45142748223111,15,8,19,51,2.47186958003076,4.70367986539287,7.92852458588977,101,"ENSG00000079974.19"
"11014","ENSG00000133454.16_162889",162881,162889,9,"ENSG00000133454.16",0,NA,"VVUVVVVVV",1,8,0.883643892339545,83,89,133,136,144,150,165,168,"CTGATGC","ATTA","GTGTTTT","CTGA",2.3657517610651,44,8,15,76,1.80406961130524,4.39393700460148,7.92851257395966,101,"ENSG00000079974.19"
"17518","ENSG00000154274.15_25633",25625,25633,9,"ENSG00000154274.15",1,1,"MVVVVUVVV",1,7,0.82815734989648,109,115,133,136,141,147,166,169,"AATATGA","TTGA","ATAAGGA","CTGA",2.44347896834484,18,5,19,51,2.17356733004269,4.61585677975208,7.928486179338,101,"ENSG00000079974.19"
"14009","ENSG00000144229.13_62196",62188,62196,9,"ENSG00000144229.13",1,1,"MVVVVUVVV",1,7,0.82815734989648,116,122,133,136,140,146,155,158,"GTTATCA","ATGA","ATTTAGA","CTGA",2.31658595480076,11,4,9,33,3.01944027565145,4.61583666024746,7.92846605983338,101,"ENSG00000079974.19"
"28977","ENSG00000196872.12_68702",68694,68702,9,"ENSG00000196872.12",1,2,"VMUVVVVVV",1,7,0.767701863354037,90,96,107,110,115,121,133,136,"CTGATGC","TTGA","ATGGTTT","CTGA",2.47311041039027,11,5,12,37,2.94317471065411,4.85764436164732,7.92845181506347,101,"ENSG00000079974.19"
"10621","ENSG00000131941.8_54331",54323,54331,9,"ENSG00000131941.8",0,NA,"UVVVVVVVV",1,8,0.902691511387163,103,109,133,136,185,191,206,209,"ATGGTGA","CAAA","AGGCTGA","CTGA",2.43517272799181,24,49,15,97,1.03624107896292,4.3176814830604,7.92844752860906,101,"ENSG00000079974.19"
"44665","ENSG00000283329.2_15226",15218,15226,9,"ENSG00000283329.2",1,8,"VVVVVVVMV",0,8,0.884057971014493,45,51,64,67,116,122,133,136,"ATGCTGA","CGGA","CTGTAGA","CTGG",2.33795039656527,13,49,11,82,1.9824660190089,4.39220049902768,7.92843238308565,101,"ENSG00000079974.19"
"33410","ENSG00000229656.9_19485",19477,19485,9,"ENSG00000229656.9",1,8,"VVVVVVVMV",0,8,0.884057971014493,111,117,133,136,142,148,164,167,"GTGAAGG","GGGA","GTTAAAA","CTGA",2.2478641409763,16,6,16,47,2.58300164463542,4.39219064611936,7.92842253017733,101,"ENSG00000079974.19"
"16756","ENSG00000152214.14_164603",164595,164603,9,"ENSG00000152214.14",1,1,"MVVVVUVVV",1,7,0.82815734989648,91,97,133,136,143,149,201,204,"ATGATGA","TTGT","TTGATAT","CTGA",2.61831089537598,36,7,52,104,1.00768554337274,4.61577287813648,7.9284022777224,101,"ENSG00000079974.19"
"45858","ENSG00000285987.1_245826",245818,245826,9,"ENSG00000285987.1",0,NA,"UVVVVVUVV",2,7,0.788819875776397,116,122,133,136,144,150,159,162,"ATGGAGA","TTGT","GTGATGT","CTGA",2.40802472264714,11,8,9,37,3.03891519075247,4.77310333543336,7.92838283853895,101,"ENSG00000079974.19"
"18667","ENSG00000158019.21_422459",422451,422459,9,"ENSG00000158019.21",1,6,"VVVVVMVVV",0,8,0.902691511387163,112,118,133,136,158,164,183,186,"ATACAGA","CTGG","TTGAAGA","CTGA",2.33730856665004,15,22,19,65,1.6882743078897,4.31758285472249,7.92834890027114,101,"ENSG00000079974.19"
"6270","ENSG00000109158.11_50012",50004,50012,9,"ENSG00000109158.11",1,3,"VVMVVUVVV",1,7,0.804968944099379,86,92,133,136,153,159,173,176,"ATGATGA","ATGC","CTGAAAA","CTGA",2.62997771707878,41,17,14,81,1.30050533379187,4.70842252857927,7.92829830497678,101,"ENSG00000079974.19"
"19615","ENSG00000163492.16_133892",133884,133892,9,"ENSG00000163492.16",0,NA,"VVVVVVUVV",1,8,0.886128364389234,111,117,133,136,146,152,168,171,"CTGTTTA","ATGT","ATAATGA","CTGA",2.25598669155552,16,10,16,51,2.4951072073571,4.38375462109848,7.92826807865541,101,"ENSG00000079974.19"
"8755","ENSG00000120594.17_455224",455216,455224,9,"ENSG00000120594.17",1,1,"MVVVVVUVV",1,7,0.792132505175983,113,119,133,136,141,147,160,163,"CTGATGT","TTCA","GAGAAGA","CTGA",2.42998624961152,14,5,13,41,2.83865348206628,4.75964045320244,7.92817047390637,101,"ENSG00000079974.19"
"21253","ENSG00000166922.9_10502",10494,10502,9,"ENSG00000166922.9",1,2,"VMVVVVVVV",0,8,0.884057971014493,42,48,67,70,80,86,133,136,"GTAATGA","CTGA","GTGGTTA","CTGG",2.41316321835244,19,10,47,85,1.47985496231515,4.39190243783285,7.92813432189082,101,"ENSG00000079974.19"
"47655","ENSG00000288864.1_38318",38310,38318,9,"ENSG00000288864.1",1,2,"VMVVVVVVV",0,8,0.884057971014493,42,48,67,70,80,86,133,136,"GTAATGA","CTGA","GTGGTTA","CTGG",2.41316321835244,19,10,47,85,1.47985496231515,4.39190243783285,7.92813432189082,101,"ENSG00000079974.19"
"21079","ENSG00000166401.15_35435",35427,35435,9,"ENSG00000166401.15",1,8,"VVVVVVVMV",0,8,0.884057971014493,108,114,133,136,146,152,170,173,"GTGATTA","CTCA","TTGATGT","CAGA",2.31844455851646,19,10,18,56,2.11111378758853,4.39185271109123,7.9280845951492,101,"ENSG00000079974.19"
"41214","ENSG00000258700.6_256970",256962,256970,9,"ENSG00000258700.6",0,NA,"VVVVVVUVV",1,8,0.886128364389234,72,78,90,93,105,111,133,136,"TTGGTGC","CTGA","ATGATGT","ATGA",2.30409684151083,12,12,22,55,2.17363713207623,4.38357068553711,7.92808414309405,101,"ENSG00000079974.19"
"19930","ENSG00000164035.10_137178",137170,137178,9,"ENSG00000164035.10",1,1,"MVVVVVVVV",0,8,0.90600414078675,106,112,133,136,147,153,169,172,"ATGAAGA","GAGA","ATAATGA","ATGA",2.28191963047907,21,11,16,57,2.00341292320107,4.30405261493206,7.92806917807906,101,"ENSG00000079974.19"
"9099","ENSG00000122641.11_8445",8437,8445,9,"ENSG00000122641.11",0,NA,"UVVVVUVVV",2,7,0.824844720496894,80,86,99,102,115,121,133,136,"GTGCTGA","CTGA","CTGTTTA","CTCA",2.37962259930437,13,13,12,47,2.65060692815329,4.6286893975456,7.92806827953318,101,"ENSG00000079974.19"
"23211","ENSG00000172318.6_491002",490994,491002,9,"ENSG00000172318.6",1,3,"VVMVVVVVV",0,8,0.882815734989648,114,120,133,136,148,154,163,166,"GTGGTGG","ATGA","TTGAGGA","CTGG",2.22220951237386,13,12,9,43,2.77248270211289,4.39680319615132,7.92806613610991,101,"ENSG00000079974.19"
"14005","ENSG00000144229.13_480450",480442,480450,9,"ENSG00000144229.13",1,6,"VVVVVMVVV",0,8,0.902691511387163,116,122,133,136,148,154,178,181,"ATGTTGG","CTAT","TTCATTA","CTGA",2.28220425739777,11,12,24,56,2.054477522715,4.31729314300837,7.92805918855702,101,"ENSG00000079974.19"
"28344","ENSG00000188738.16_83511",83503,83511,9,"ENSG00000188738.16",1,2,"VMVVVUVVV",1,7,0.806211180124223,78,84,107,110,115,121,133,136,"TGGATGA","ATGA","GTCATAA","CTGA",2.49736287453984,23,5,12,49,2.1637276125875,4.70320336071327,7.92804808121016,101,"ENSG00000079974.19"
"12347","ENSG00000137936.18_213628",213620,213628,9,"ENSG00000137936.18",1,8,"UVVVVVVMV",1,7,0.786749482401656,113,119,133,136,139,145,153,156,"TTGATGA","CCGA","TTGAAGA","CTGC",2.44685539415369,14,3,8,34,2.81163651498766,4.78100145233641,7.92799938194303,101,"ENSG00000079974.19"
"5779","ENSG00000106648.14_24872",24864,24872,9,"ENSG00000106648.14",1,8,"VVVVVVVMV",0,8,0.884057971014493,88,94,133,136,142,148,176,179,"ATGCTGA","CAGG","AGGAAGA","CTGA",2.46096681489223,39,6,28,82,1.16043980871189,4.3917213103317,7.92795319438967,101,"ENSG00000079974.19"
"23557","ENSG00000173218.15_19136",19128,19136,9,"ENSG00000173218.15",0,NA,"VVVVVVUVV",1,8,0.886128364389234,110,116,133,136,144,150,171,174,"AGGATGA","TTGA","GTTTGGA","CTGT",2.29976829023049,17,8,21,55,2.2019673648156,4.38343899158806,7.92795244914499,101,"ENSG00000079974.19"
"12928","ENSG00000139618.18_22980",22972,22980,9,"ENSG00000139618.18",1,8,"VVVVVVVMV",0,8,0.884057971014493,86,92,100,103,113,119,133,136,"CTCATGG","CTGA","CTGAAGC","GTGA",2.25629561015169,8,10,14,41,2.5248618556943,4.39170814750972,7.92794003156769,101,"ENSG00000079974.19"
"32925","ENSG00000228262.11_63020",63012,63020,9,"ENSG00000228262.11",1,6,"VVVVVMVVV",0,8,0.902691511387163,108,114,133,136,142,148,159,162,"TTGATCA","CTGT","TTGCTGG","CTAA",2.20740363369975,19,6,11,45,2.55244338173121,4.31711690159904,7.9278829471477,101,"ENSG00000079974.19"
"48433","ENSG00000291102.1_22680",22672,22680,9,"ENSG00000291102.1",0,NA,"UVVVVVVVV",1,8,0.902691511387163,75,81,94,97,102,108,133,136,"ATGATGT","CATA","TTGAATA","CTGC",2.26020268288288,13,5,25,52,2.20041553462096,4.3171083551267,7.92787440067535,101,"ENSG00000079974.19"
"5807","ENSG00000106771.13_61962",61954,61962,9,"ENSG00000106771.13",1,8,"VVVVVVVMV",0,8,0.884057971014493,111,117,133,136,143,149,164,167,"ATGAGGA","AAGA","ATCAAGA","CTAA",2.23631958849621,16,7,15,47,2.65775615213065,4.39163835219301,7.92787023625098,101,"ENSG00000079974.19"
"30392","ENSG00000204842.18_26172",26164,26172,9,"ENSG00000204842.18",1,2,"VMVVVVVVV",0,8,0.884057971014493,110,116,133,136,145,151,205,208,"ATGACAA","GTGA","GGGAGCA","CTGA",2.37900140343562,17,9,54,89,1.70651933381821,4.39163217251391,7.92786405657188,101,"ENSG00000079974.19"
"8044","ENSG00000116668.13_18652",18644,18652,9,"ENSG00000116668.13",1,8,"VVVVVVVMV",0,8,0.884057971014493,93,99,133,136,140,146,164,167,"GTGGTGA","TTGT","CTGGAGA","CTGA",2.41207454478756,34,4,18,65,1.48593083597151,4.39160695030548,7.92783883436345,101,"ENSG00000079974.19"
"479","ENSG00000013016.16_10859",10851,10859,9,"ENSG00000013016.16",1,8,"VVVVVUVMV",1,7,0.806211180124224,109,115,133,136,178,184,198,201,"ATGATGA","CTAG","CTGTTTA","CTGA",2.59030819774718,18,42,14,83,1.54264120424766,4.70284063064055,7.92768535113745,101,"ENSG00000079974.19"
"46797","ENSG00000287185.1_4736",4728,4736,9,"ENSG00000287185.1",1,1,"MVVVUVVVV",1,7,0.795859213250517,111,117,133,136,167,173,185,188,"ATGATGT","ATTA","GAGATGA","CTGA",2.57072718020337,16,31,12,68,1.83840411822677,4.74414632989564,7.92758318289771,101,"ENSG00000079974.19"
"36905","ENSG00000243499.1_490",482,490,9,"ENSG00000243499.1",1,7,"VVVVVUMVV",1,7,0.807453416149068,106,112,133,136,138,144,155,158,"ATGATGT","CTTA","ACAAAGA","CTGA",2.52864966777229,21,2,11,43,1.93319775461894,4.69771555160855,7.92752921620482,101,"ENSG00000079974.19"
"35594","ENSG00000236414.1_2928",2920,2928,9,"ENSG00000236414.1",1,1,"MVVVVVVVV",0,8,0.90600414078675,114,120,133,136,148,154,166,169,"ATGAAGA","CAGT","GTTAACA","ATGA",2.17354249943689,13,12,12,46,2.7236491260237,4.30348311390075,7.92749967704775,101,"ENSG00000079974.19"
"39310","ENSG00000253438.5_74253",74245,74253,9,"ENSG00000253438.5",1,6,"VVVVVMVVV",0,8,0.902691511387163,87,93,133,136,176,182,195,198,"GTGATCA","TTGT","GTGTAGA","CTGA",2.45079268026602,40,40,13,102,0.928036896517478,4.3166636912394,7.92742973678805,101,"ENSG00000079974.19"
"35924","ENSG00000237484.7_153784",153776,153784,9,"ENSG00000237484.7",1,8,"VVVVVVVMV",0,8,0.884057971014493,109,115,133,136,144,150,159,162,"GTGATTC","TTCA","ATGACTT","CTGA",2.23565617942136,18,8,9,44,2.66030850452613,4.39117075850046,7.92740264255843,101,"ENSG00000079974.19"
"26839","ENSG00000185052.13_391955",391947,391955,9,"ENSG00000185052.13",1,1,"MVVVVUVVV",1,7,0.82815734989648,106,112,133,136,146,152,162,165,"GTGATAA","GTCA","GTGTTAA","CTGA",2.42251315741778,21,10,10,50,2.30875419617235,4.61471047807271,7.92733987765863,101,"ENSG00000079974.19"
"6291","ENSG00000109265.15_20440",20432,20440,9,"ENSG00000109265.15",0,NA,"VVVVVUUVV",2,7,0.808281573498965,95,101,109,112,115,121,133,136,"CTCATGA","CTGG","GTTATCT","CTGA",2.41951140286664,8,3,12,32,2.6466277482812,4.69417594184803,7.92730223584389,101,"ENSG00000079974.19"
"2457","ENSG00000075035.10_17873",17865,17873,9,"ENSG00000075035.10",1,8,"VVVVUVVMV",1,7,0.773913043478261,98,104,111,114,116,122,133,136,"ATGGTGG","CTGG","ATGGTGA","CTGA",2.51444902088338,7,2,11,29,2.56351878374008,4.83162806407399,7.92728023798704,101,"ENSG00000079974.19"
"8672","ENSG00000120217.14_5182",5174,5182,9,"ENSG00000120217.14",1,8,"VVVVVVVMV",0,8,0.884057971014493,98,104,133,136,138,144,172,175,"AAGATGA","TTGA","AGGTTGG","CTGA",2.52087798654088,29,2,28,68,0.758339703393376,4.39104823674981,7.92728012080778,101,"ENSG00000079974.19"
"41017","ENSG00000258394.1_198235",198227,198235,9,"ENSG00000258394.1",1,2,"VMVVVVVVV",0,8,0.884057971014493,113,119,133,136,141,147,202,205,"TAGATGT","TTTA","GTGATAA","CTGA",2.35021495285024,14,5,55,83,1.89605869873083,4.39103959609977,7.92727148015774,101,"ENSG00000079974.19"
"16404","ENSG00000151474.23_156924",156916,156924,9,"ENSG00000151474.23",1,8,"VVVVVVVMV",0,8,0.884057971014493,98,104,133,136,142,148,190,193,"ATAATGA","CAGG","CTGAGCA","CTGA",2.4761978296932,29,6,42,86,1.05614507298841,4.39103265106911,7.92726453512708,101,"ENSG00000079974.19"
"8570","ENSG00000119650.13_55152",55144,55152,9,"ENSG00000119650.13",1,8,"UVVVVVVMV",1,7,0.786749482401656,71,77,92,95,109,115,133,136,"ATGAAGA","CTTA","GTGGACA","CTGA",2.54288886506768,15,14,18,56,2.16834432199952,4.78023418894601,7.92723211855263,101,"ENSG00000079974.19"
"9479","ENSG00000124788.19_42628",42620,42628,9,"ENSG00000124788.19",1,2,"VMVVVVVVV",0,8,0.884057971014493,76,82,99,102,110,116,133,136,"ATCATGC","ATGA","GTGAAAA","ATGA",2.26862155634898,17,8,17,51,2.43972052476323,4.3909660584391,7.92719794249707,101,"ENSG00000079974.19"
"40290","ENSG00000255476.1_10708",10700,10708,9,"ENSG00000255476.1",1,2,"VMVVVVVVV",0,8,0.884057971014493,58,64,77,80,85,91,133,136,"ATTATGA","ATGA","TTGATTT","ATGA",2.34341884172539,13,5,42,69,1.94076307274673,4.390888837729,7.92712072178697,101,"ENSG00000079974.19"
"28417","ENSG00000189108.13_1119319",1119311,1119319,9,"ENSG00000189108.13",1,1,"MVVVVVVVV",0,8,0.90600414078675,116,122,133,136,165,171,199,202,"AAAAAGA","ATGA","GTGAAGA","CTGA",2.40025774188424,11,29,28,77,1.21063143600866,4.30308742880924,7.92710399195624,101,"ENSG00000079974.19"
"25443","ENSG00000181544.16_44914",44906,44914,9,"ENSG00000181544.16",1,3,"VVMVVVVVV",0,8,0.882815734989648,99,105,133,136,148,154,168,171,"ATTTTGA","ATGA","ATGCTAC","CTGA",2.38022231301854,28,12,14,63,1.71516657212013,4.39582883139427,7.92709177135286,101,"ENSG00000079974.19"
"26556","ENSG00000184408.10_220773",220765,220773,9,"ENSG00000184408.10",1,2,"UMVVVVVVV",1,7,0.786749482401656,101,107,133,136,144,150,158,161,"ATAATGG","CTGA","CTAATTA","CTGA",2.5529239543001,26,8,8,51,2.10085497009797,4.78008699969133,7.92708492929795,101,"ENSG00000079974.19"
"4045","ENSG00000092439.16_75788",75780,75788,9,"ENSG00000092439.16",1,3,"VVMVVVVVV",0,8,0.882815734989648,81,87,99,102,116,122,133,136,"GTGATTA","CAGA","ATGTGTA","TTGA",2.24555602990202,12,14,11,46,2.61284691321392,4.39580511147351,7.92706805143211,101,"ENSG00000079974.19"
"37865","ENSG00000248975.2_92516",92508,92516,9,"ENSG00000248975.2",0,NA,"VVVUVVVVV",1,8,0.880745341614907,112,118,133,136,142,148,179,182,"GTGAGGT","ATCA","ATCATGA","CTGA",2.34238118977626,15,6,31,61,2.00042597787294,4.40407514409534,7.92705651055497,101,"ENSG00000079974.19"
"24165","ENSG00000175387.16_34723",34715,34723,9,"ENSG00000175387.16",0,NA,"UVVVVVVVV",1,8,0.902691511387163,66,72,81,84,92,98,133,136,"ATTATGT","CTGA","TTACTGA","ATGA",2.30837614065825,9,8,35,61,1.87590207024647,4.31626908532537,7.92703513087402,101,"ENSG00000079974.19"
"11371","ENSG00000134769.23_357594",357586,357594,9,"ENSG00000134769.23",1,8,"VVVVVUVMV",1,7,0.806211180124224,115,121,133,136,141,147,161,164,"ATGAGAA","GTGA","ATGTATA","CTGA",2.39589895774716,12,5,14,40,2.83609251362198,4.7021880579841,7.92703277848099,101,"ENSG00000079974.19"
"18762","ENSG00000158352.18_43699",43691,43699,9,"ENSG00000158352.18",1,5,"VVVVMVVVV",0,8,0.886542443064182,104,110,133,136,170,176,187,190,"GTGATGT","TGGA","ATGAAAT","CTGA",2.43606587333103,23,34,11,77,1.2829131446784,4.38083807505464,7.92700784731137,101,"ENSG00000079974.19"
"30760","ENSG00000213185.7_15894",15886,15894,9,"ENSG00000213185.7",0,NA,"VVVUVVVVV",1,8,0.880745341614907,75,81,92,95,109,115,133,136,"ATGTGGA","CTGA","GTCAGGA","CTGG",2.30731709788476,11,14,18,52,2.23394698278989,4.40401524217207,7.9269966086317,101,"ENSG00000079974.19"
"45975","ENSG00000286088.1_15836",15828,15836,9,"ENSG00000286088.1",0,NA,"VVVUVVVVV",1,8,0.880745341614907,75,81,92,95,109,115,133,136,"ATGTGGA","CTGA","GTCAGGA","CTGG",2.30731709788476,11,14,18,52,2.23394698278989,4.40401524217207,7.9269966086317,101,"ENSG00000079974.19"
"33507","ENSG00000230084.8_40158",40150,40158,9,"ENSG00000230084.8",0,NA,"UVVUVVVVV",2,7,0.78343685300207,85,91,133,136,144,150,171,174,"CTGATGA","AAGA","CTGATGA","CTGA",2.65877038845561,42,8,21,80,1.44765106466943,4.79319674692671,7.92694415893499,101,"ENSG00000079974.19"
"8477","ENSG00000119121.22_36748",36740,36748,9,"ENSG00000119121.22",1,3,"VVMVVVUVV",1,7,0.768944099378882,114,120,133,136,137,143,152,155,"AACATGG","CTGA","GTGATGG","CTGA",2.52422234116615,13,1,9,32,2.57651761548694,4.85116663914865,7.92694303666418,101,"ENSG00000079974.19"
"13683","ENSG00000143164.16_126659",126651,126659,9,"ENSG00000143164.16",1,2,"VMVVVVVVV",0,8,0.884057971014493,116,122,133,136,150,156,165,168,"TTTATGT","CTTT","GTAATGC","CTGA",2.24311674424362,11,14,9,43,2.60861207307167,4.39068092534062,7.92691280939859,101,"ENSG00000079974.19"
"16557","ENSG00000151789.13_524161",524153,524161,9,"ENSG00000151789.13",1,3,"VVMVVVVVV",0,8,0.882815734989648,83,89,104,107,112,118,133,136,"TTGATGT","CTTA","ATGTAGC","TTGA",2.23736664777654,15,5,15,44,2.666730280727,4.39562698314265,7.92688992310124,101,"ENSG00000079974.19"
"2071","ENSG00000069869.17_108078",108070,108078,9,"ENSG00000069869.17",1,5,"VVVVMVVVV",0,8,0.886542443064182,89,95,106,109,114,120,133,136,"CTGATGA","CTGA","ATAAACA","AAGA",2.19561886670545,11,5,13,38,2.88521413468769,4.38066831151434,7.92683808377107,101,"ENSG00000079974.19"
"32355","ENSG00000226829.2_55311",55303,55311,9,"ENSG00000226829.2",1,2,"VMVVVVVVV",0,8,0.884057971014493,77,83,101,104,116,122,133,136,"TGGATTA","CTAA","ATGCTTT","CTGA",2.271549121837,18,12,11,50,2.41874360150039,4.39060110343677,7.92683298749474,101,"ENSG00000079974.19"
"1108","ENSG00000047648.23_473677",473669,473677,9,"ENSG00000047648.23",1,1,"MVVVUVVVV",1,7,0.795859213250517,99,105,133,136,144,150,202,205,"TTGATGA","ATGA","AGGATGA","CTGA",2.68609251367085,28,8,52,97,1.06619511338995,4.74336963446557,7.92680648746764,101,"ENSG00000079974.19"
"40240","ENSG00000255311.5_69601",69593,69601,9,"ENSG00000255311.5",1,1,"MVVVVVVVV",0,8,0.90600414078675,114,120,133,136,143,149,174,177,"CTGAAGA","CTCA","GGGAAGA","CAGA",2.24135131098169,13,7,25,54,2.2687465120276,4.30277214630972,7.92678870945672,101,"ENSG00000079974.19"
"20718","ENSG00000165409.18_9381",9373,9381,9,"ENSG00000165409.18",1,5,"VVVVMUVVV",1,7,0.808695652173913,115,121,133,136,171,177,186,189,"CTGATGA","TAGA","ATGAATT","CTGA",2.51240605635129,12,35,9,65,2.01863489697515,4.69200215149594,7.92678476019159,101,"ENSG00000079974.19"
"46842","ENSG00000287279.1_9686",9678,9686,9,"ENSG00000287279.1",1,3,"VVMVVVVVV",0,8,0.882815734989648,27,33,46,49,91,97,133,136,"TTAATGA","CTGG","GTAATGG","CTGA",2.48059997026254,13,42,36,100,1.04472271560598,4.3955139626724,7.92677690263099,101,"ENSG00000079974.19"
"39561","ENSG00000253807.6_354013",354005,354013,9,"ENSG00000253807.6",0,NA,"UVVVVUVVV",2,7,0.824844720496894,87,93,133,136,144,150,170,173,"GGGATGA","CTGC","GTGATAC","CTGA",2.55076128820833,40,8,20,77,1.50449331137008,4.62739214152306,7.92677102351064,101,"ENSG00000079974.19"
"32158","ENSG00000226167.1_36531",36523,36531,9,"ENSG00000226167.1",1,2,"VMVVVVVVV",0,8,0.884057971014493,73,79,92,95,102,108,133,136,"GTGATAG","CTGA","GTGCTTA","TTGA",2.2939706683256,13,7,25,54,2.2687465120276,4.39047107521623,7.9267029592742,101,"ENSG00000079974.19"
"28314","ENSG00000188647.13_45883",45875,45883,9,"ENSG00000188647.13",1,5,"VVVVMVVVV",0,8,0.886542443064182,116,122,133,136,146,152,162,165,"ATGCTCT","CCCA","GAGATGT","CTGA",2.19236975438158,11,10,10,40,2.90610893538618,4.38047682448251,7.92664659673924,101,"ENSG00000079974.19"
"33141","ENSG00000228824.8_142594",142586,142594,9,"ENSG00000228824.8",1,3,"VVMVVVVVV",0,8,0.882815734989648,82,88,109,112,116,122,133,136,"GTGATTT","CTGA","CTGAAAA","TTGA",2.30132257519012,21,4,11,45,2.23936645981481,4.39537924027057,7.92664218022916,101,"ENSG00000079974.19"
"24688","ENSG00000177570.15_127469",127461,127469,9,"ENSG00000177570.15",1,5,"UVVVMVVVV",1,7,0.789233954451346,112,118,133,136,145,151,170,173,"ATGATTA","GTAA","GTGAATA","CTGA",2.49647847068451,15,9,19,52,2.43562425526398,4.76970351495684,7.92663933276223,101,"ENSG00000079974.19"
"40709","ENSG00000257434.1_6323",6315,6323,9,"ENSG00000257434.1",0,NA,"UVVVVUVVV",2,7,0.824844720496894,90,96,103,106,115,121,133,136,"ATGAAGA","TTGA","GTGAAGC","CTGC",2.38646112721003,7,9,12,37,2.59924011442306,4.62724524062248,7.92662412261006,101,"ENSG00000079974.19"
"47018","ENSG00000287520.1_349",341,349,9,"ENSG00000287520.1",1,8,"VVVVVVVMV",0,8,0.884057971014493,115,121,133,136,153,159,175,178,"TTCAAGA","CTGG","ATCATAA","CTGA",2.30620012714137,12,17,16,54,2.18688884759407,4.39038909046747,7.92662097452544,101,"ENSG00000079974.19"
"39747","ENSG00000254180.2_129373",129365,129373,9,"ENSG00000254180.2",1,1,"MVVVVVVVV",0,8,0.90600414078675,72,78,87,90,97,103,133,136,"TTGAAGA","ATGA","GTGAGAA","ATGA",2.28712038333404,9,7,30,55,1.96288513390714,4.30258858903352,7.92660515218052,101,"ENSG00000079974.19"
"22446","ENSG00000170579.17_667136",667128,667136,9,"ENSG00000170579.17",1,8,"VVVVVVVMV",0,8,0.884057971014493,78,84,96,99,108,114,133,136,"ATTATAA","CTCA","ATGAAGA","CAGA",2.25513423646187,12,9,19,49,2.5272142097279,4.39036061320175,7.92659249725973,101,"ENSG00000079974.19"
"31057","ENSG00000215386.15_585187",585179,585187,9,"ENSG00000215386.15",1,6,"UVVVVMVVV",1,7,0.805383022774327,67,73,87,90,98,104,133,136,"ATGATGC","TAGA","CTGTTTA","CTGA",2.50810947192282,14,8,29,60,2.09946238993511,4.70504805068848,7.92658014178579,101,"ENSG00000079974.19"
"43069","ENSG00000267952.1_2456",2448,2456,9,"ENSG00000267952.1",1,8,"VVVVVVVMV",0,8,0.884057971014493,93,99,133,136,140,146,189,192,"AGGATGA","TTCA","GTGGGGA","CTGA",2.50503029727598,34,4,43,90,0.861108401906464,4.39032759593658,7.92655947999455,101,"ENSG00000079974.19"
"28332","ENSG00000188693.8_7733",7725,7733,9,"ENSG00000188693.8",0,NA,"UVVVVVVVV",1,8,0.902691511387163,83,89,107,110,116,122,133,136,"GTTATGG","CTTA","GTGAAAA","CAGA",2.19275044232318,18,6,11,44,2.64463021358059,4.31574162393378,7.92650766948243,101,"ENSG00000079974.19"
"22626","ENSG00000170965.10_137737",137729,137737,9,"ENSG00000170965.10",1,1,"MVVVUVVVV",1,7,0.795859213250517,111,117,133,136,141,147,158,161,"GTCATGA","GGGA","ATGGGGA","CTGA",2.42892447972013,16,5,11,41,2.77930076081277,4.7430326564034,7.92646950940548,101,"ENSG00000079974.19"
"7839","ENSG00000115896.16_340489",340481,340489,9,"ENSG00000115896.16",1,6,"VVVVVMVVV",0,8,0.902691511387163,115,121,133,136,139,145,188,191,"ATGAACA","CAAA","GTGACCA","CTGA",2.33258041267013,12,3,43,67,1.71216500547776,4.31567527248633,7.92644131803498,101,"ENSG00000079974.19"
"4109","ENSG00000095303.17_17612",17604,17612,9,"ENSG00000095303.17",0,NA,"VVVVVVUVV",1,8,0.886128364389234,111,117,133,136,153,159,167,170,"ATGATGA","CCGG","AGGCAGA","CAGA",2.29209635083188,16,17,8,50,2.24693442766583,4.38189419163626,7.92640764919319,101,"ENSG00000079974.19"
"13105","ENSG00000140262.18_216755",216747,216755,9,"ENSG00000140262.18",1,3,"VVMVVVVVV",0,8,0.882815734989648,104,110,133,136,173,179,187,190,"ATTCTGA","ATGA","ATGGTGT","CTGA",2.44708416428406,23,37,8,77,1.26663004178806,4.39513111758712,7.92639405754571,101,"ENSG00000079974.19"
"41662","ENSG00000259474.1_1596",1588,1596,9,"ENSG00000259474.1",1,1,"MVVVVVVVV",0,8,0.90600414078675,113,119,133,136,173,179,205,208,"ATGATCA","TTGC","ATATGGA","CTGA",2.39930174447016,14,37,26,86,1.2137502960935,4.30227381480698,7.92629037795397,101,"ENSG00000079974.19"
"31822","ENSG00000224924.9_84822",84814,84822,9,"ENSG00000224924.9",1,6,"UVVVVMVVV",1,7,0.805383022774327,84,90,98,101,106,112,133,136,"ATCATAA","CTGA","GTGGTTC","CTGA",2.50256298994831,8,5,21,43,2.13527257796825,4.70475646107258,7.92628855216989,101,"ENSG00000079974.19"
"29470","ENSG00000198010.13_854685",854677,854685,9,"ENSG00000198010.13",1,2,"VMVVVVVVV",0,8,0.884057971014493,113,119,133,136,148,154,208,211,"ATTATGT","TTAA","CTGAAAA","CTGA",2.37442848166366,14,12,54,89,1.73069360681142,4.39005420447562,7.92628608853359,101,"ENSG00000079974.19"
"7251","ENSG00000113396.13_14856",14848,14856,9,"ENSG00000113396.13",1,1,"MVVVVVVVV",0,8,0.90600414078675,70,76,85,88,112,118,133,136,"TTGAAGA","CTGA","GAGAAAA","ATGA",2.31134354657864,9,24,15,57,1.80003375613199,4.30224768333073,7.92626424647773,101,"ENSG00000079974.19"
"22300","ENSG00000170242.19_2382",2374,2382,9,"ENSG00000170242.19",0,NA,"UVVVVVVVV",1,8,0.902691511387163,84,90,133,136,175,181,192,195,"ATGATAA","ATAA","AAGATTA","CTGA",2.43998352883025,43,39,11,102,0.995376928091277,4.31548344673991,7.92624949228856,101,"ENSG00000079974.19"
"4751","ENSG00000101849.18_133766",133758,133766,9,"ENSG00000101849.18",1,8,"UVVVVVVMV",1,7,0.786749482401656,85,91,133,136,143,149,164,167,"GTCATGA","ATGA","CTGATGG","CTGA",2.59487093305707,42,7,15,73,1.81777121736551,4.77922769276983,7.92622562237645,101,"ENSG00000079974.19"
"31461","ENSG00000223786.1_458174",458166,458174,9,"ENSG00000223786.1",1,8,"UVVVVVVMV",1,7,0.786749482401656,114,120,133,136,140,146,156,159,"TTAATCA","ATGA","ATGAAGA","CTGA",2.42712026071924,13,4,10,36,2.93592546001572,4.779181799536,7.92617972914262,101,"ENSG00000079974.19"
"36863","ENSG00000243295.2_118967",118959,118967,9,"ENSG00000243295.2",0,NA,"UVVVVUVVV",2,7,0.824844720496894,72,78,92,95,115,121,133,136,"ATGAAGT","CTGT","AAGGTGA","CTGA",2.44600788642384,14,20,12,55,2.20000620555778,4.62668136209584,7.92606024408342,101,"ENSG00000079974.19"
"26021","ENSG00000183166.11_450471",450463,450471,9,"ENSG00000183166.11",1,5,"VVVVMVVVV",0,8,0.886542443064182,94,100,133,136,155,161,182,185,"ATGGTGG","CTGC","CTGATGC","CTGA",2.50791107649344,33,19,21,82,0.800012621819435,4.37985494961058,7.92602472186731,101,"ENSG00000079974.19"
"30566","ENSG00000205754.13_93408",93400,93408,9,"ENSG00000205754.13",1,7,"VVVVVVMVV",0,8,0.885300207039338,99,105,133,136,161,167,182,185,"GTTATGA","TTTA","TTGAAGA","CTGA",2.4780062277172,28,25,15,77,1.01901022255059,4.38476293516631,7.92596376332366,101,"ENSG00000079974.19"
"40571","ENSG00000257046.5_240502",240494,240502,9,"ENSG00000257046.5",1,7,"VVVVVVMVV",0,8,0.885300207039338,99,105,133,136,161,167,182,185,"GTTATGA","TTTA","TTGAAGA","CTGA",2.4780062277172,28,25,15,77,1.01901022255059,4.38476293516631,7.92596376332366,101,"ENSG00000079974.19"
"40596","ENSG00000257062.6_8997",8989,8997,9,"ENSG00000257062.6",1,7,"VVVVVVMVV",0,8,0.885300207039338,99,105,133,136,161,167,182,185,"GTTATGA","TTTA","TTGAAGA","CTGA",2.4780062277172,28,25,15,77,1.01901022255059,4.38476293516631,7.92596376332366,101,"ENSG00000079974.19"
"48137","ENSG00000290524.1_1607",1599,1607,9,"ENSG00000290524.1",1,7,"VVVVVVMVV",0,8,0.885300207039338,99,105,133,136,161,167,182,185,"GTTATGA","TTTA","TTGAAGA","CTGA",2.4780062277172,28,25,15,77,1.01901022255059,4.38476293516631,7.92596376332366,101,"ENSG00000079974.19"
"26222","ENSG00000183715.14_1095270",1095262,1095270,9,"ENSG00000183715.14",1,2,"VMVVVVVVV",0,8,0.884057971014493,94,100,109,112,114,120,133,136,"ACGATGT","CCGA","GTGCGGA","CTGT",2.26049234841565,9,2,13,33,2.48886880128086,4.38970444767963,7.9259363317376,101,"ENSG00000079974.19"
"34002","ENSG00000231698.3_60657",60649,60657,9,"ENSG00000231698.3",1,1,"MVVVVVVVV",0,8,0.90600414078675,90,96,133,136,182,188,199,202,"ATGAAGT","ATGA","ATGTTTG","CTGA",2.43229511623813,37,46,11,103,0.992234841889539,4.30188390420261,7.9259004673496,101,"ENSG00000079974.19"
"989","ENSG00000042813.8_106275",106267,106275,9,"ENSG00000042813.8",1,1,"MVVVVVVVV",0,8,0.90600414078675,89,95,133,136,150,156,185,188,"TTGATGA","TTCA","ATGGTAT","CTGA",2.46488642413325,38,14,29,90,0.774812298664839,4.3018471148883,7.9258636780353,101,"ENSG00000079974.19"
"41877","ENSG00000259905.7_213793",213785,213793,9,"ENSG00000259905.7",0,NA,"VVVVUVVVV",1,8,0.889855072463768,87,93,133,136,142,148,160,163,"GTGACTA","CTAA","TTTATGT","CTGA",2.32837209910149,40,6,12,67,1.94327781325734,4.36643961848349,7.92585990833856,101,"ENSG00000079974.19"
"41880","ENSG00000259905.7_420860",420852,420860,9,"ENSG00000259905.7",0,NA,"VVVVUVVVV",1,8,0.889855072463768,87,93,133,136,142,148,160,163,"GTGACTA","CTAA","TTTATGT","CTGA",2.32837209910149,40,6,12,67,1.94327781325734,4.36643961848349,7.92585990833856,101,"ENSG00000079974.19"
"1424","ENSG00000055609.21_244939",244931,244939,9,"ENSG00000055609.21",0,NA,"VVUUVVVVV",2,7,0.764389233954451,114,120,133,136,186,192,213,216,"GTGCTGA","CTGA","TTGAAGA","CTGA",2.70240855490282,13,50,21,93,1.45681046368218,4.86821687409191,7.92577380990972,101,"ENSG00000079974.19"
"43784","ENSG00000273540.5_68722",68714,68722,9,"ENSG00000273540.5",1,1,"MVVVVVVVV",0,8,0.90600414078675,70,76,85,88,95,101,133,136,"CTGAAGA","ATGA","GTGAGAA","ATGA",2.29206039744837,9,7,32,57,1.92660692683327,4.30175239412226,7.92576895726926,101,"ENSG00000079974.19"
"45225","ENSG00000285219.4_779361",779353,779361,9,"ENSG00000285219.4",1,1,"MVVVVVVVV",0,8,0.90600414078675,70,76,85,88,95,101,133,136,"CTGAAGA","ATGA","GTGAGAA","ATGA",2.29206039744837,9,7,32,57,1.92660692683327,4.30175239412226,7.92576895726926,101,"ENSG00000079974.19"
"41250","ENSG00000258743.8_85325",85317,85325,9,"ENSG00000258743.8",1,1,"MVUVVVVVV",1,7,0.789648033126294,110,116,133,136,144,150,162,165,"ATTATGA","GTAA","TTGATTT","CTGA",2.45468236309138,17,8,12,46,2.70380730046761,4.76708909693588,7.92568122944105,101,"ENSG00000079974.19"
"28692","ENSG00000196353.13_522689",522681,522689,9,"ENSG00000196353.13",1,8,"VVVVVUVMV",1,7,0.806211180124224,68,74,89,92,102,108,133,136,"ATGATGA","ATGA","ATGTTGC","GTGA",2.50838422092529,15,10,25,59,2.08071655644337,4.70081950731965,7.92566422781655,101,"ENSG00000079974.19"
"43722","ENSG00000273294.1_9691",9683,9691,9,"ENSG00000273294.1",1,8,"UVVVVVVMV",1,7,0.786749482401656,85,91,133,136,156,162,179,182,"TTGATGA","ATGA","ATGATGT","CTGA",2.72072089204923,42,20,17,88,0.976375479990844,4.77862869007976,7.92562661968639,101,"ENSG00000079974.19"
"23993","ENSG00000174720.18_7641",7633,7641,9,"ENSG00000174720.18",1,8,"VVVVVUVMV",1,7,0.806211180124224,40,46,91,94,103,109,133,136,"GTGGTGA","CTGA","ATCAGGA","CTGA",2.63075689265483,45,9,24,87,1.2646849464486,4.70076605770353,7.92561077820043,101,"ENSG00000079974.19"
"15482","ENSG00000148488.17_115611",115603,115611,9,"ENSG00000148488.17",0,NA,"VVVVVVUVV",1,8,0.886128364389234,56,62,71,74,83,89,133,136,"AAGATGA","CTGG","GTGATTT","CTAA",2.35923254019385,9,9,44,71,1.79589381053382,4.38102768628988,7.92554114384681,101,"ENSG00000079974.19"
"31408","ENSG00000223715.3_247191",247183,247191,9,"ENSG00000223715.3",1,3,"VVMUVVVVV",1,7,0.763561076604555,106,112,133,136,173,179,187,190,"GTGATGG","GTGA","GTGATGA","CTGA",2.71226162201694,21,37,8,75,1.40341586491032,4.87129000292247,7.92553430934069,101,"ENSG00000079974.19"
"42232","ENSG00000261235.1_87605",87597,87605,9,"ENSG00000261235.1",1,6,"VVUVVMVVV",1,7,0.786335403726708,106,112,133,136,146,152,161,164,"ATGATGT","CTGA","GTGATCC","GTGA",2.52190570904734,21,10,9,49,2.3078378577736,4.78013564618896,7.92547726109579,101,"ENSG00000079974.19"
"38470","ENSG00000250305.9_21634",21626,21634,9,"ENSG00000250305.9",0,NA,"UVVVVVVVV",1,8,0.902691511387163,42,48,70,73,79,85,133,136,"ATGATCA","CAGA","TTGATCA","ATGA",2.39012264873756,22,6,48,85,1.32469207582584,4.31471076685239,7.92547681240105,101,"ENSG00000079974.19"
"10395","ENSG00000130803.15_19494",19486,19494,9,"ENSG00000130803.15",1,8,"VVVVVVVMV",0,8,0.884057971014493,106,112,133,136,148,154,165,168,"GTGAAGA","TTGA","ATGTGGA","CTGG",2.30928737113719,21,12,11,53,2.16159133348738,4.38921011860049,7.92544200265846,101,"ENSG00000079974.19"
"12278","ENSG00000137770.14_51713",51705,51713,9,"ENSG00000137770.14",1,2,"UMVVVVVVV",1,7,0.786749482401656,116,122,133,136,145,151,162,165,"ATGATTT","TTGA","GTTCTGT","CTGA",2.42542210811482,11,9,11,40,2.94427865833799,4.77843984477586,7.92543777438248,101,"ENSG00000079974.19"
"7084","ENSG00000112699.11_89615",89607,89615,9,"ENSG00000112699.11",1,2,"VMVVVVVVV",0,8,0.884057971014493,114,120,133,136,154,160,179,182,"CTAATAA","ATGA","TTGTTGT","CTGA",2.34197207221669,13,18,19,59,1.94364187998557,4.38919725702422,7.92542914108219,101,"ENSG00000079974.19"
"45913","ENSG00000286046.1_122827",122819,122827,9,"ENSG00000286046.1",0,NA,"UVVVVVVVV",1,8,0.902691511387163,98,104,133,136,142,148,157,160,"ATGTAGA","CTAG","CTGTTTA","CTGA",2.28261589005488,29,6,9,53,2.04117810130961,4.31465434208553,7.92542038763418,101,"ENSG00000079974.19"
"4764","ENSG00000101868.13_135698",135690,135698,9,"ENSG00000101868.13",1,2,"VMVVVUVVV",1,7,0.806211180124223,113,119,133,136,145,151,188,191,"ATGAAGA","TTGA","AGGCAGA","CTGA",2.52762908087798,14,9,37,69,1.95104153825371,4.70047551936006,7.92532023985695,101,"ENSG00000079974.19"
"6592","ENSG00000110888.19_9448",9440,9448,9,"ENSG00000110888.19",0,NA,"UVVVVVVVV",1,8,0.902691511387163,109,115,133,136,149,155,190,193,"ATAATCA","AAGA","GTGAAAA","CTGA",2.3766877147445,18,13,35,75,1.413565096273,4.31453746530908,7.92530351085773,101,"ENSG00000079974.19"
"39445","ENSG00000253596.1_1654",1646,1654,9,"ENSG00000253596.1",1,6,"VVVVVMVVV",0,8,0.902691511387163,105,111,133,136,152,158,173,176,"TTGATTA","TTCA","GTGTAAA","CTGA",2.3422902702871,22,16,15,62,1.64273920170105,4.31450191757043,7.92526796311908,101,"ENSG00000079974.19"
"32679","ENSG00000227542.1_1687",1679,1687,9,"ENSG00000227542.1",1,7,"VVVVVVMVV",0,8,0.885300207039338,101,107,133,136,144,150,163,166,"ATGAGGA","CTGT","GTAATTA","CTAA",2.32452422774121,26,8,13,56,2.03935863440875,4.38404670483754,7.92524753299489,101,"ENSG00000079974.19"
"5315","ENSG00000104321.11_26330",26322,26330,9,"ENSG00000104321.11",1,6,"UVVVVMVVV",1,7,0.805383022774327,70,76,85,88,98,104,133,136,"ATAATGA","CTGA","GTGATTA","CTAA",2.5397155941164,9,10,29,57,1.88341415350018,4.70371286190237,7.92524495299968,101,"ENSG00000079974.19"
"7704","ENSG00000115415.21_55744",55736,55744,9,"ENSG00000115415.21",1,6,"VVVVVMVVV",0,8,0.902691511387163,95,101,133,136,143,149,159,162,"AAGATGA","TTAA","ATGATCA","CTCA",2.28517829586817,32,7,10,58,2.02333608073958,4.31446451329852,7.92523055884717,101,"ENSG00000079974.19"
"36072","ENSG00000237844.2_265009",265001,265009,9,"ENSG00000237844.2",1,8,"VVVVVVVMV",0,8,0.884057971014493,112,118,133,136,149,155,210,213,"GTGATTA","CTTT","TTGTAGA","CTGA",2.39271727543819,15,13,55,92,1.60437022085337,4.38895468094365,7.92518656500163,101,"ENSG00000079974.19"
"26278","ENSG00000183775.11_305818",305810,305818,9,"ENSG00000183775.11",0,NA,"VVUVVVVVV",1,8,0.883643892339545,68,74,86,89,104,110,133,136,"AGCATGG","GTGA","ATGAACA","CTGA",2.34746828245295,12,15,23,59,1.91265067104214,4.39060980518212,7.9251853745403,101,"ENSG00000079974.19"
"9530","ENSG00000125257.16_108896",108888,108896,9,"ENSG00000125257.16",1,8,"VVVVVVVMV",0,8,0.884057971014493,108,114,133,136,146,152,167,170,"GTGAACA","CTCT","CTGTTGA","CTGA",2.28951850792207,19,10,15,53,2.29230370715312,4.38894010665839,7.92517199071636,101,"ENSG00000079974.19"
"3686","ENSG00000087884.16_21442",21434,21442,9,"ENSG00000087884.16",0,NA,"VVUVVVVVV",1,8,0.883643892339545,104,110,133,136,145,151,205,208,"ATCATGG","CTAA","ATAAGGA","CTGA",2.45067082690481,23,9,54,95,1.22455897016489,4.39059112071591,7.92516669007408,101,"ENSG00000079974.19"
"17049","ENSG00000153037.15_1910",1902,1910,9,"ENSG00000153037.15",1,5,"VVVVMVVVV",0,8,0.886542443064182,103,109,133,136,161,167,184,187,"ATGATGA","CTCA","AGGAAGA","CTCA",2.4714601248061,24,25,17,75,1.03955952153143,4.37899008839303,7.92515986064976,101,"ENSG00000079974.19"
"41336","ENSG00000258864.1_35885",35877,35885,9,"ENSG00000258864.1",1,5,"VVVVMVVVV",0,8,0.886542443064182,103,109,133,136,161,167,184,187,"ATGATGA","CTCA","AGGAAGA","CTCA",2.4714601248061,24,25,17,75,1.03955952153143,4.37899008839303,7.92515986064976,101,"ENSG00000079974.19"
"19341","ENSG00000162804.14_20785",20777,20785,9,"ENSG00000162804.14",1,7,"VVVVVVMVV",0,8,0.885300207039338,51,57,69,72,80,86,133,136,"GTGATTA","CTGA","GAGACAA","CTCA",2.33163091054433,12,8,47,76,1.99156076283992,4.38394170828386,7.92514253644121,101,"ENSG00000079974.19"
"15005","ENSG00000146555.20_829700",829692,829700,9,"ENSG00000146555.20",0,NA,"VVVVVUUVV",2,7,0.808281573498965,116,122,133,136,144,150,164,167,"CTGCTGA","CTCT","TTGCTGA","CTGA",2.38764704842446,11,8,14,42,2.85020883553461,4.69196395625775,7.92509025025361,101,"ENSG00000079974.19"
"34495","ENSG00000233208.6_11360",11352,11360,9,"ENSG00000233208.6",1,1,"MVVVVUVVV",1,7,0.82815734989648,85,91,100,103,108,114,133,136,"GTGATGA","CTGG","CTGACCA","CTTA",2.41337925782967,9,5,19,42,2.36041529509093,4.61240258682219,7.92503198640811,101,"ENSG00000079974.19"
"338","ENSG00000008513.16_97864",97856,97864,9,"ENSG00000008513.16",1,7,"VVVVVVMVV",0,8,0.885300207039338,91,97,133,136,140,146,158,161,"ATGAACA","CTGG","ATGCTTC","CTGA",2.35994781448997,36,4,12,61,1.80187937411288,4.38371620101151,7.92491702916886,101,"ENSG00000079974.19"
"31996","ENSG00000225546.6_215664",215656,215664,9,"ENSG00000225546.6",1,1,"MVVVVVVVV",0,8,0.90600414078675,106,112,133,136,144,150,176,179,"ATTATGT","TTAA","TTTAGGA","CTGA",2.33557713031231,21,8,26,64,1.63276955813133,4.30082094005334,7.92483750320034,101,"ENSG00000079974.19"
"30134","ENSG00000203739.6_50549",50541,50549,9,"ENSG00000203739.6",1,8,"VVVUVVVMV",1,7,0.764803312629399,95,101,108,111,116,122,133,136,"ATGAAGA","CTAA","AAGTTGT","CTGA",2.50151905736887,7,5,11,32,2.78555061077569,4.86558608164203,7.92479933215963,101,"ENSG00000079974.19"
"41807","ENSG00000259754.2_62033",62025,62033,9,"ENSG00000259754.2",1,1,"MVVVVVVVV",0,8,0.90600414078675,112,118,133,136,138,144,157,160,"ATGAACA","CAAA","GATATAA","CTGA",2.22067162888635,15,2,13,39,2.39864009385863,4.3007794049419,7.9247959680889,101,"ENSG00000079974.19"
"31604","ENSG00000224184.7_633737",633729,633737,9,"ENSG00000224184.7",1,6,"VVVVVMVVV",0,8,0.902691511387163,105,111,133,136,147,153,178,181,"AATATGA","CGGA","ATCTAGA","CTGA",2.37163821723704,22,11,25,67,1.44516838135282,4.31402245739993,7.92478850294859,101,"ENSG00000079974.19"
"25241","ENSG00000180198.17_10934",10926,10934,9,"ENSG00000180198.17",1,2,"VMVVUVVVV",1,7,0.773913043478261,94,100,109,112,115,121,133,136,"ATGATGG","GTAA","TTGGAGA","CTGA",2.49192946154834,9,3,12,33,2.70344767915189,4.82907768903521,7.92472986294826,101,"ENSG00000079974.19"
"47201","ENSG00000287841.1_9350",9342,9350,9,"ENSG00000287841.1",1,3,"UVMVVVVVV",1,7,0.785507246376811,91,97,105,108,115,121,133,136,"ATAATAA","TTGA","ATGACCA","CTGA",2.45079123827179,8,7,12,36,2.79174292706196,4.78258779555181,7.92461678105905,101,"ENSG00000079974.19"
"7221","ENSG00000113319.13_243493",243485,243493,9,"ENSG00000113319.13",1,7,"VVVVUVMVV",1,7,0.775155279503105,45,51,80,83,108,114,133,136,"ATGATGT","CTGA","GTGAGTA","CTGA",2.78068346001259,29,25,19,82,0.757824743187549,4.8239286191512,7.92454973716362,101,"ENSG00000079974.19"
"11200","ENSG00000134216.19_15390",15382,15390,9,"ENSG00000134216.19",0,NA,"VVUVVVVVV",1,8,0.883643892339545,112,118,133,136,151,157,211,214,"AAAATGA","AAGA","CTGAAGA","CTGA",2.41428916146291,15,15,54,93,1.4642669905942,4.38988201675341,7.92445758611159,101,"ENSG00000079974.19"
"2220","ENSG00000071909.19_18407",18399,18407,9,"ENSG00000071909.19",0,NA,"UVVVVVVVV",1,8,0.902691511387163,107,113,133,136,145,151,160,163,"GTGTTGA","CTTA","TTACTGA","GTGA",2.22186353881013,20,9,9,47,2.44234172667085,4.31369132968459,7.92445737523324,101,"ENSG00000079974.19"
"28901","ENSG00000196660.12_217292",217284,217292,9,"ENSG00000196660.12",1,6,"VVVVVMVVV",0,8,0.902691511387163,108,114,133,136,162,168,186,189,"GTGAAAA","CCAA","GTGATGA","CTGA",2.39062368892661,19,26,18,72,1.31724532106405,4.3136841451437,7.92445019069235,101,"ENSG00000079974.19"
"4094","ENSG00000095002.15_131602",131594,131602,9,"ENSG00000095002.15",1,8,"VVVVVUVMV",1,7,0.806211180124224,72,78,92,95,106,112,133,136,"TTGATGG","CTGA","GTGAGGA","CTGC",2.48085391161653,14,11,21,55,2.25933010761251,4.699589046264,7.9244337667609,101,"ENSG00000079974.19"
"35344","ENSG00000235760.4_7661",7653,7661,9,"ENSG00000235760.4",1,8,"VVVVVUVMV",1,7,0.806211180124224,72,78,92,95,106,112,133,136,"TTGATGG","CTGA","GTGAGGA","CTGC",2.48085391161653,14,11,21,55,2.25933010761251,4.699589046264,7.9244337667609,101,"ENSG00000079974.19"
"27170","ENSG00000185666.15_397259",397251,397259,9,"ENSG00000185666.15",1,2,"VMVVVVVVV",0,8,0.884057971014493,115,121,133,136,156,162,217,220,"AAAATGA","CAGA","CTGGTGG","CTGA",2.44104610849129,12,20,55,96,1.27892399994713,4.38814118080561,7.92437306486358,101,"ENSG00000079974.19"
"23464","ENSG00000172987.13_8198",8190,8198,9,"ENSG00000172987.13",1,7,"VVVVVVMVV",0,8,0.885300207039338,116,122,133,136,159,165,178,181,"ATGCTAG","CTGT","GTGACCA","CTGA",2.31984351412988,11,23,13,56,2.06702806512733,4.38316287316496,7.92436370132231,101,"ENSG00000079974.19"
"37551","ENSG00000248457.1_11371",11363,11371,9,"ENSG00000248457.1",1,8,"VVVUVVVMV",1,7,0.764803312629399,114,120,133,136,137,143,166,169,"ATAATGA","GTGA","CTGAAGA","CTGA",2.66644936877922,13,1,23,46,1.6841351440735,4.86511606731708,7.92432931783468,101,"ENSG00000079974.19"
"23042","ENSG00000172020.13_52624",52616,52624,9,"ENSG00000172020.13",1,8,"VVVVVVVMV",0,8,0.884057971014493,116,122,133,136,150,156,165,168,"ATAACAA","CAAA","ATGATGT","CTGA",2.24153466508769,11,14,9,43,2.60861207307167,4.3880441267474,7.92427601080537,101,"ENSG00000079974.19"
"36092","ENSG00000237877.8_428291",428283,428291,9,"ENSG00000237877.8",0,NA,"VVUVUVVVV",2,7,0.773498964803312,72,78,93,96,103,109,133,136,"CAGATGA","CTGA","ATGGAAA","CTGA",2.56466036210876,15,7,24,55,2.22332493913863,4.83026517163258,7.92426103084583,101,"ENSG00000079974.19"
"1765","ENSG00000065923.10_152943",152935,152943,9,"ENSG00000065923.10",1,8,"VVVVVVVMV",0,8,0.884057971014493,109,115,133,136,148,154,169,172,"ATGATGG","TTCA","TTGTTGA","CTGT",2.29537925218916,18,12,15,54,2.24938156912139,4.38797747926227,7.92420936332024,101,"ENSG00000079974.19"
"44414","ENSG00000281756.1_5836",5828,5836,9,"ENSG00000281756.1",0,NA,"VVUUVVVVV",2,7,0.764389233954451,30,36,46,49,90,96,133,136,"ATGAGGA","CTGA","CTGAAGA","CTGA",2.7756415223445,10,41,37,97,0.96197732315456,4.86656353469615,7.92412047051395,101,"ENSG00000079974.19"
"27520","ENSG00000186439.14_13205",13197,13205,9,"ENSG00000186439.14",1,6,"VVVVVMVVV",0,8,0.902691511387163,113,119,133,136,145,151,173,176,"ATGTTTA","ATTA","ATCAATA","CTGA",2.23966368242542,14,9,22,54,2.32215770235751,4.31331222963174,7.9240782751804,101,"ENSG00000079974.19"
"6908","ENSG00000112234.9_70476",70468,70476,9,"ENSG00000112234.9",0,NA,"UVVVVVVVV",1,8,0.902691511387163,106,112,133,136,142,148,160,163,"AGGTTGA","TTTA","ATTTTTA","CTGA",2.23493613530651,21,6,12,48,2.35350933762834,4.31327089325127,7.92403693879992,101,"ENSG00000079974.19"
"15416","ENSG00000148200.17_217297",217289,217297,9,"ENSG00000148200.17",1,2,"UMVVVUVVV",2,6,0.708902691511387,111,117,133,136,147,153,163,166,"ATGATGA","TTGG","ATGAGGT","CTGA",2.65146889693198,16,11,10,46,2.67708203958406,5.08838533811597,7.92399610416152,101,"ENSG00000079974.19"
"24872","ENSG00000178412.4_23613",23605,23613,9,"ENSG00000178412.4",1,2,"VMVVVVVVV",0,8,0.884057971014493,116,122,133,136,141,147,157,160,"ATGCCAA","GTGT","ATGAAAA","CTGA",2.17691019393926,11,5,10,35,3.03788541383819,4.38765501002498,7.92388689408295,101,"ENSG00000079974.19"
"33308","ENSG00000229308.1_698",690,698,9,"ENSG00000229308.1",1,5,"VVVVMVVVV",0,8,0.886542443064182,112,118,133,136,148,154,172,175,"CTTCTGA","GTTA","ATGATAA","CTGA",2.27986218051764,15,12,18,54,2.31147481177949,4.3776390038076,7.92380877606433,101,"ENSG00000079974.19"
"36874","ENSG00000243295.2_460779",460771,460779,9,"ENSG00000243295.2",0,NA,"VVVVVVUVV",1,8,0.886128364389234,112,118,133,136,137,143,157,160,"CTGGGGA","CAGA","TTCATGG","CTGA",2.30477759535925,15,1,14,39,2.15134362042704,4.37913189737218,7.92364535492911,101,"ENSG00000079974.19"
"6043","ENSG00000107798.18_48088",48080,48088,9,"ENSG00000107798.18",0,NA,"UVVVVVVVV",1,8,0.902691511387163,17,23,65,68,112,118,133,136,"ATGATGA","TTGA","CTTATAA","CTGG",2.46454763978622,42,44,15,110,0.821117418387336,4.31285875424053,7.92362479978919,101,"ENSG00000079974.19"
"44015","ENSG00000276759.2_4212",4204,4212,9,"ENSG00000276759.2",1,8,"VVVVVVVMV",0,8,0.884057971014493,114,120,133,136,156,162,177,180,"TTTTTGA","CTTA","TTGAATA","CTGA",2.31880844201936,13,20,15,57,2.09071791296689,4.38736021494066,7.92359209899864,101,"ENSG00000079974.19"
"9493","ENSG00000124813.23_300008",3e+05,300008,9,"ENSG00000124813.23",1,2,"VMVVVUVVV",1,7,0.806211180124223,116,122,133,136,144,150,177,180,"AGGATGA","ATTA","ATGAGAA","CTGA",2.49447286484355,11,8,27,55,2.16504047686188,4.69871489395472,7.92355961445161,101,"ENSG00000079974.19"
"6465","ENSG00000110048.12_19360",19352,19360,9,"ENSG00000110048.12",0,NA,"VVVVVVUVV",1,8,0.886128364389234,100,106,133,136,144,150,166,169,"TTGATGG","GTGA","GTGCTGA","CTGC",2.35025781176198,27,8,16,60,1.84779175577172,4.37904429187956,7.9235577494365,101,"ENSG00000079974.19"
"46813","ENSG00000287226.1_152606",152598,152606,9,"ENSG00000287226.1",1,2,"VMVVVUVVV",1,7,0.806211180124223,113,119,133,136,178,184,204,207,"ATGATAA","GAGA","CTGATGA","CTGA",2.59644124201904,14,42,20,85,1.4852436524902,4.69871298315427,7.92355770365117,101,"ENSG00000079974.19"
"26022","ENSG00000183166.11_493558",493550,493558,9,"ENSG00000183166.11",1,3,"VVMVVVVVV",0,8,0.882815734989648,114,120,133,136,143,149,162,165,"ATTATGA","GTTA","GTGAAAG","CGGA",2.19552731557784,13,7,13,42,2.93215203790703,4.39225020210649,7.92351314206508,101,"ENSG00000079974.19"
"46959","ENSG00000287409.1_89308",89300,89308,9,"ENSG00000287409.1",0,NA,"VVVVUVVVV",1,8,0.889855072463768,75,81,93,96,100,106,133,136,"GTGATTA","CAGA","CTTATGA","CCGA",2.312188510597,12,4,27,52,2.04177102644943,4.36409027427402,7.9235105641291,101,"ENSG00000079974.19"
"38085","ENSG00000249484.9_520887",520879,520887,9,"ENSG00000249484.9",0,NA,"VVUVVVVVV",1,8,0.883643892339545,106,112,133,136,185,191,206,209,"ATGATAG","CAGA","GTGAGTG","CTGA",2.44913204375613,21,49,15,94,1.22801859008559,4.38889138711495,7.92346695647312,101,"ENSG00000079974.19"
"25118","ENSG00000179571.10_20015",20007,20015,9,"ENSG00000179571.10",1,2,"VMUVVVVVV",1,7,0.767701863354037,66,72,80,83,93,99,133,136,"ATTATGA","CTGG","GTGGTGA","CTGA",2.65766413084161,8,10,34,61,1.69286910557905,4.85265749446412,7.92346494788026,101,"ENSG00000079974.19"
"45444","ENSG00000285582.1_14610",14602,14610,9,"ENSG00000285582.1",1,2,"VMVVVVVVV",0,8,0.884057971014493,87,93,103,106,111,117,133,136,"GTGTTGC","CAGA","ATGATGT","CTAA",2.23596785044572,10,5,16,40,2.6424134007867,4.38721643427288,7.92344831833085,101,"ENSG00000079974.19"
"15621","ENSG00000148948.8_1288862",1288854,1288862,9,"ENSG00000148948.8",0,NA,"VVUVVVVVV",1,8,0.883643892339545,78,84,95,98,112,118,133,136,"ATTATAT","CTTA","TTTATTA","CTGA",2.27093864429292,11,14,15,49,2.4158946589946,4.38887140523684,7.92344697459502,101,"ENSG00000079974.19"
"24573","ENSG00000177054.14_49830",49822,49830,9,"ENSG00000177054.14",1,8,"VVVVVVVMV",0,8,0.884057971014493,114,120,133,136,174,180,193,196,"CTGAGGA","TTCA","GGAATGA","CTGA",2.34344093356506,13,38,13,73,1.92577863914253,4.38717954906073,7.9234114331187,101,"ENSG00000079974.19"
"35577","ENSG00000236364.4_1707",1699,1707,9,"ENSG00000236364.4",0,NA,"VVVUVVVVV",1,8,0.880745341614907,49,55,69,72,110,116,133,136,"AAGATGA","CTGA","GAGCTGG","CAGA",2.38937209385891,14,38,17,78,1.6725679206199,4.40042880325315,7.92341016971278,101,"ENSG00000079974.19"
"3523","ENSG00000085382.12_109930",109922,109930,9,"ENSG00000085382.12",0,NA,"VVUUVVVVV",2,7,0.764389233954451,51,57,97,100,110,116,133,136,"ATGTTGA","CTGA","TTGACCA","CTGA",2.67990192689161,40,10,17,76,1.59727515976898,4.86582200142825,7.92337893724606,101,"ENSG00000079974.19"
"26076","ENSG00000183230.18_831540",831532,831540,9,"ENSG00000183230.18",1,8,"VVVVVUVMV",1,7,0.806211180124224,93,99,105,108,114,120,133,136,"GTGTTCA","CTGA","GGGAGGG","CTGA",2.43552560367354,6,6,13,34,2.55708261177742,4.69847999240025,7.92332471289715,101,"ENSG00000079974.19"
"42172","ENSG00000260971.4_274119",274111,274119,9,"ENSG00000260971.4",1,8,"VVVVVVVMV",0,8,0.884057971014493,111,117,133,136,146,152,160,163,"ATGTTGC","CTGC","TTTATGA","TTGA",2.22293956825645,16,10,8,43,2.7286426117718,4.38705993337036,7.92329181742833,101,"ENSG00000079974.19"
"44996","ENSG00000284686.1_320927",320919,320927,9,"ENSG00000284686.1",1,8,"VVVVVVVMV",0,8,0.884057971014493,111,117,133,136,146,152,160,163,"ATGTTGC","CTGC","TTTATGA","TTGA",2.22293956825645,16,10,8,43,2.7286426117718,4.38705993337036,7.92329181742833,101,"ENSG00000079974.19"
"23185","ENSG00000172292.15_139203",139195,139203,9,"ENSG00000172292.15",1,2,"VMVVVVVVV",0,8,0.884057971014493,101,107,133,136,148,154,204,207,"ATGTTGA","ATGA","GGTATAA","CTGA",2.49689497986323,26,12,50,97,0.901952890761346,4.38697985579571,7.92321173985368,101,"ENSG00000079974.19"
"7061","ENSG00000112655.16_66381",66373,66381,9,"ENSG00000112655.16",0,NA,"VVUVVVVVV",1,8,0.883643892339545,111,117,133,136,173,179,187,190,"ATGATGG","CTGC","CTGGGGA","CTGC",2.35843843934878,16,37,8,70,1.83148633266691,4.38860231541469,7.92317788477287,101,"ENSG00000079974.19"
"42752","ENSG00000266357.6_89690",89682,89690,9,"ENSG00000266357.6",1,3,"VVMVVVVVV",0,8,0.882815734989648,116,122,133,136,138,144,153,156,"GTCCTGA","ATGA","GTGATGC","CTGT",2.21355797376246,11,2,9,31,2.81035846144707,4.39185290496587,7.92311584492446,101,"ENSG00000079974.19"
"20352","ENSG00000164741.15_157076",157068,157076,9,"ENSG00000164741.15",1,6,"VVVVVMVVV",0,8,0.902691511387163,113,119,133,136,148,154,181,184,"ATGTAGA","CTAG","CTGAACA","CTGA",2.29739629546028,14,12,27,62,1.93329672977263,4.31231800821029,7.92308405375895,101,"ENSG00000079974.19"
"36230","ENSG00000239265.5_158003",157995,158003,9,"ENSG00000239265.5",1,7,"VVVUVVMVV",1,7,0.766045548654244,103,109,133,136,150,156,165,168,"GTGATGA","CTGC","CTCATGG","CTGA",2.63940646787988,24,14,9,56,1.8394421620906,4.85887132032245,7.92305351493943,101,"ENSG00000079974.19"
"36839","ENSG00000243273.2_119917",119909,119917,9,"ENSG00000243273.2",1,7,"VVVUVVMVV",1,7,0.766045548654244,103,109,133,136,150,156,165,168,"GTGATGA","CTGC","CTCATGG","CTGA",2.63940646787988,24,14,9,56,1.8394421620906,4.85887132032245,7.92305351493943,101,"ENSG00000079974.19"
"5008","ENSG00000102738.8_5409",5401,5409,9,"ENSG00000102738.8",1,5,"VVVVMUVVV",1,7,0.808695652173913,105,111,133,136,140,146,156,159,"ATGATGT","ATGT","TTTAGGA","CTGA",2.48581476857397,22,4,10,45,2.18078859510726,4.68822176306676,7.92300437176241,101,"ENSG00000079974.19"
"7960","ENSG00000116147.17_22547",22539,22547,9,"ENSG00000116147.17",1,8,"VVVVVUVMV",1,7,0.806211180124224,77,83,97,100,107,113,133,136,"ATGATGA","TTGT","CTGAAGA","CAGA",2.44670737220995,14,7,20,50,2.4810605553237,4.69811075918085,7.92295547967774,101,"ENSG00000079974.19"
"5629","ENSG00000106028.11_30704",30696,30704,9,"ENSG00000106028.11",1,1,"MVVVVUVVV",1,7,0.82815734989648,70,76,91,94,103,109,133,136,"CTGATGA","ATGA","GTGAGGG","CTCA",2.44003711272726,15,9,24,57,2.17386681192099,4.61019522419235,7.92282462377827,101,"ENSG00000079974.19"
"317","ENSG00000008196.13_13368",13360,13368,9,"ENSG00000008196.13",1,3,"VVMVVVVVV",0,8,0.882815734989648,62,68,97,100,108,114,133,136,"ATAAAGA","CTGT","CTTCTGA","CTGA",2.39184624639637,29,8,19,65,1.62048997619543,4.39153290470948,7.92279584466807,101,"ENSG00000079974.19"
"33813","ENSG00000231210.3_65882",65874,65882,9,"ENSG00000231210.3",1,1,"MVVVVUVVV",1,7,0.82815734989648,114,120,133,136,142,148,158,161,"ATGATGA","AGGA","GGGCTGG","CTGG",2.31020669840679,13,6,10,38,3.03922922923171,4.61015180465258,7.9227812042385,101,"ENSG00000079974.19"
"47895","ENSG00000289605.1_280909",280901,280909,9,"ENSG00000289605.1",1,2,"VMVVVVVVV",0,8,0.884057971014493,54,60,71,74,115,121,133,136,"ATGATAA","TTGA","ATGCTCA","CTAA",2.3410949491747,11,41,12,73,1.93887612964134,4.3865439477015,7.92277583175947,101,"ENSG00000079974.19"
"7321","ENSG00000113522.14_15788",15780,15788,9,"ENSG00000113522.14",1,1,"MVUVVVVVV",1,7,0.789648033126294,98,104,110,113,115,121,133,136,"ATGATGT","CTGA","GAGATGC","CTCA",2.49674885576548,6,2,12,29,2.41149641393193,4.76412219642546,7.92271432893063,101,"ENSG00000079974.19"
"44850","ENSG00000283782.2_160975",160967,160975,9,"ENSG00000283782.2",1,1,"MVUVVVVVV",1,7,0.789648033126294,98,104,110,113,115,121,133,136,"ATGATGT","CTGA","GAGATGC","CTCA",2.49674885576548,6,2,12,29,2.41149641393193,4.76412219642546,7.92271432893063,101,"ENSG00000079974.19"
"10181","ENSG00000129682.16_104050",104042,104050,9,"ENSG00000129682.16",0,NA,"VVVVVVUVV",1,8,0.886128364389234,114,120,133,136,150,156,187,190,"GGCAGGA","CTCA","GTGATGA","CTGA",2.36807300586566,13,14,31,67,1.72558017466174,4.37818338677487,7.9226968443318,101,"ENSG00000079974.19"
"48413","ENSG00000291076.1_62",54,62,9,"ENSG00000291076.1",1,1,"MVVVVUVVV",1,7,0.82815734989648,43,49,64,67,81,87,103,106,"GTGTTGC","CAGA","GGGAAGA","CTGA",2.42235177901715,15,14,16,54,2.29088740152071,4.60997481540876,7.92260421499468,101,"ENSG00000079974.19"
"2255","ENSG00000072201.14_201662",201654,201662,9,"ENSG00000072201.14",1,1,"MVVVVUVVV",1,7,0.82815734989648,81,87,104,107,113,119,133,136,"ATCATGA","TTGT","ACAATGT","CTGA",2.37382102574276,17,6,14,46,2.61427567441327,4.60993729484125,7.92256669442717,101,"ENSG00000079974.19"
"20743","ENSG00000165495.16_246495",246487,246495,9,"ENSG00000165495.16",1,1,"MVVVVUVVV",1,7,0.82815734989648,116,122,133,136,174,180,195,198,"AGGAAGA","CGGA","CTGATAA","CTGA",2.495521528477,11,38,15,73,1.80293103060209,4.60993530511219,7.92256470469811,101,"ENSG00000079974.19"
"10410","ENSG00000130962.18_25613",25605,25613,9,"ENSG00000130962.18",1,1,"MVUVVVVVV",1,7,0.789648033126294,86,92,105,108,111,117,133,136,"GTGATTT","CTGG","ATGATGT","CTGA",2.4864641508687,13,3,16,41,2.4791944645903,4.76390553426207,7.92249766676724,101,"ENSG00000079974.19"
"38520","ENSG00000250349.3_25592",25584,25592,9,"ENSG00000250349.3",1,1,"MVUVVVVVV",1,7,0.789648033126294,86,92,105,108,111,117,133,136,"GTGATTT","CTGG","ATGATGT","CTGA",2.4864641508687,13,3,16,41,2.4791944645903,4.76390553426207,7.92249766676724,101,"ENSG00000079974.19"
"18725","ENSG00000158321.19_1122619",1122611,1122619,9,"ENSG00000158321.19",1,1,"MVVVVVUVV",1,7,0.792132505175983,88,94,105,108,111,117,133,136,"ATGATGA","CAGA","GTGAACT","CTTA",2.48052743596001,11,3,16,39,2.4790089179838,4.75396462276263,7.92249464346656,101,"ENSG00000079974.19"
"35316","ENSG00000235703.7_144152",144144,144152,9,"ENSG00000235703.7",0,NA,"VVUVVVVVV",1,8,0.883643892339545,116,122,133,136,145,151,202,205,"AAGATGG","CAGG","TTGATCT","CTGA",2.34355713942637,11,9,51,80,1.92730968868418,4.38775598788165,7.92233155723983,101,"ENSG00000079974.19"
"40252","ENSG00000255364.1_11323",11315,11323,9,"ENSG00000255364.1",0,NA,"UVVVVVVVV",1,8,0.902691511387163,112,118,133,136,180,186,198,201,"AGGATGA","AAGA","ATGGTGA","CTGG",2.30630532856509,15,44,12,80,1.87077557822273,4.31153610883084,7.92230215437949,101,"ENSG00000079974.19"
"36202","ENSG00000238280.2_24549",24541,24549,9,"ENSG00000238280.2",1,8,"VVVVVVVMV",0,8,0.884057971014493,112,118,133,136,142,148,157,160,"ATAATTA","CTAA","GAGAGGA","GTGA",2.19110242334271,15,6,9,39,2.93671406819146,4.38601588928572,7.92224777334369,101,"ENSG00000079974.19"
"13725","ENSG00000143322.22_103021",103013,103021,9,"ENSG00000143322.22",0,NA,"VVVVVVUVV",1,8,0.886128364389234,104,110,133,136,141,147,159,162,"GTGATGA","ACGA","TTGGTTA","GTGA",2.30204072263124,23,5,12,49,2.1637276125875,4.3776664408656,7.92217989842254,101,"ENSG00000079974.19"
"14931","ENSG00000146166.17_4466",4458,4466,9,"ENSG00000146166.17",1,1,"MVVVVVUVV",1,7,0.792132505175983,80,86,98,101,111,117,133,136,"ATAATGT","CTTA","ATCATAA","CTGA",2.45322892018984,12,10,16,47,2.65966656413832,4.75363150801765,7.92216152872159,101,"ENSG00000079974.19"
"26746","ENSG00000185008.19_1424378",1424370,1424378,9,"ENSG00000185008.19",1,8,"VVVUVVVMV",1,7,0.764803312629399,43,49,63,66,107,113,133,136,"ATGATGT","CAGA","CTGTTGA","CTGA",2.69478956392626,14,41,20,84,1.48636286019901,4.86290665492686,7.92211990544446,101,"ENSG00000079974.19"
"7405","ENSG00000114013.16_59754",59746,59754,9,"ENSG00000114013.16",1,2,"UMVVVUVVV",2,6,0.708902691511387,111,117,133,136,144,150,162,165,"ATGATCA","CTGA","ATCAAAA","CTGA",2.6335937649011,16,8,12,45,2.7886146674117,5.08647660835477,7.92208737440031,101,"ENSG00000079974.19"
"36458","ENSG00000241163.10_20321",20313,20321,9,"ENSG00000241163.10",1,8,"VVVVVUVMV",1,7,0.806211180124224,52,58,69,72,108,114,133,136,"CTGATGA","CAGA","GGGACCA","CTGA",2.58333138953804,11,36,19,75,1.56646293233366,4.69716804898015,7.92201276947705,101,"ENSG00000079974.19"
"16880","ENSG00000152578.14_162117",162109,162117,9,"ENSG00000152578.14",0,NA,"UVVVVVVVV",1,8,0.902691511387163,57,63,108,111,116,122,133,136,"ATATTGA","CTGA","ATTAGGA","ATGA",2.29909990517789,45,5,11,70,1.91745051609383,4.31119580431993,7.92196184986859,101,"ENSG00000079974.19"
"2108","ENSG00000070214.17_72235",72227,72235,9,"ENSG00000070214.17",0,NA,"VVVVUVVVV",1,8,0.889855072463768,97,103,133,136,140,146,162,165,"ATGTTGC","TTAA","ATGAAGT","CTGA",2.37154899225894,30,4,16,59,1.63982530131609,4.36253797909392,7.92195826894899,101,"ENSG00000079974.19"
"44004","ENSG00000276644.5_238951",238943,238951,9,"ENSG00000276644.5",1,6,"VVVVVMVVV",0,8,0.902691511387163,111,117,133,136,146,152,178,181,"GTAATGG","GTGG","GGGTTGA","CTGA",2.29082294239106,16,10,26,61,1.97242722015458,4.31114504235708,7.92191108790573,101,"ENSG00000079974.19"
"24037","ENSG00000174899.13_96893",96885,96893,9,"ENSG00000174899.13",0,NA,"VVVVVVUVV",1,8,0.886128364389234,101,107,133,136,142,148,169,172,"AAGAAGA","CTAA","CAGATTA","CTGA",2.3897750797992,26,6,21,62,1.57768234923265,4.37737905364016,7.9218925111971,101,"ENSG00000079974.19"
"2557","ENSG00000075785.14_90157",90149,90157,9,"ENSG00000075785.14",1,3,"UVMVVVVVV",1,7,0.785507246376811,113,119,133,136,140,146,155,158,"TTGATAA","TTGA","GTTATTT","CTGA",2.43247360871563,14,4,9,36,2.90285289478319,4.77983590488851,7.92186489039576,101,"ENSG00000079974.19"
"40840","ENSG00000257904.1_34643",34635,34643,9,"ENSG00000257904.1",1,1,"MVVVVUVVV",1,7,0.82815734989648,25,31,51,54,75,81,133,136,"CTGATGA","CAGA","GTAATGT","CTGA",2.65596652467318,20,21,52,102,0.730342838015441,4.60919658395916,7.92182598354508,101,"ENSG00000079974.19"
"14565","ENSG00000145375.9_170671",170663,170671,9,"ENSG00000145375.9",1,2,"VMVVVVVVV",0,8,0.884057971014493,81,87,105,108,116,122,133,136,"CTGCTGA","CTGC","GGGAGGA","CTGG",2.23488589005082,18,8,11,46,2.64288057764558,4.38552996116276,7.92176184522073,101,"ENSG00000079974.19"
"18013","ENSG00000156011.18_182584",182576,182584,9,"ENSG00000156011.18",1,8,"VVVVVVVMV",0,8,0.884057971014493,93,99,133,136,145,151,160,163,"GTTATGG","TAGA","TTAATGA","CTGA",2.33710231224021,34,9,9,61,1.96129920647537,4.38549532201919,7.92172720607716,101,"ENSG00000079974.19"
"34626","ENSG00000233635.2_37598",37590,37598,9,"ENSG00000233635.2",1,5,"UVVVMVVVV",1,7,0.789233954451346,84,90,103,106,111,117,133,136,"AGGCTGA","TTGA","CTGAATA","CTGA",2.45416961665017,13,5,16,43,2.69799301074586,4.76478094710341,7.92171676490879,101,"ENSG00000079974.19"
"41019","ENSG00000258394.1_265313",265305,265313,9,"ENSG00000258394.1",0,NA,"UVVVVUVVV",2,7,0.824844720496894,102,108,133,136,153,159,175,178,"ATGATGA","GTGT","GTAAAAA","CTGA",2.56961985843791,25,17,16,67,1.35840583100473,4.62230122181437,7.92168010380195,101,"ENSG00000079974.19"
"23273","ENSG00000172456.18_490807",490799,490807,9,"ENSG00000172456.18",0,NA,"VVUVVVVVV",1,8,0.883643892339545,114,120,133,136,181,187,208,211,"ACAATGA","AGGA","ATGAGGA","CTGA",2.41344363550267,13,45,21,88,1.45857041526875,4.38704866298831,7.92162423234649,101,"ENSG00000079974.19"
"7582","ENSG00000114933.16_18478",18470,18478,9,"ENSG00000114933.16",1,3,"VVMVVVVVV",0,8,0.882815734989648,116,122,133,136,148,154,168,171,"ATGATTT","CTCA","ATGTAGA","TTGA",2.24169752749764,11,12,14,46,2.61612816994928,4.39019458831671,7.9214575282753,101,"ENSG00000079974.19"
"30744","ENSG00000213047.13_266903",266895,266903,9,"ENSG00000213047.13",1,8,"VVVVVVVMV",0,8,0.884057971014493,42,48,63,66,73,79,133,136,"CTGTTGA","CTGA","ATCATGT","GTGA",2.3445724345237,15,7,54,85,1.9103995659129,4.38522061568439,7.92145249974236,101,"ENSG00000079974.19"
"44722","ENSG00000283434.2_88924",88916,88924,9,"ENSG00000283434.2",0,NA,"UVVVVVVVV",1,8,0.902691511387163,110,116,133,136,148,154,181,184,"AAGAGGA","TGGA","CTGACAA","CTGA",2.32773991107731,17,12,27,65,1.72440383325854,4.31066747677682,7.92143352232547,101,"ENSG00000079974.19"
"18950","ENSG00000159461.15_1741",1733,1741,9,"ENSG00000159461.15",0,NA,"VVUVVUVVV",2,7,0.805797101449275,108,114,133,136,140,146,173,176,"CTGATGG","GTGA","GTGAAGT","CTGA",2.57617996873345,19,4,27,59,1.61814346992741,4.69816914870426,7.92135755450137,101,"ENSG00000079974.19"
"16495","ENSG00000151693.11_28997",28989,28997,9,"ENSG00000151693.11",0,NA,"UVVVUVVVV",2,7,0.792546583850932,110,116,133,136,142,148,158,161,"GTGATGG","GTCA","CTGTTGT","CTGA",2.43725094566474,17,6,10,42,2.7561906869595,4.75113258118111,7.92131891658483,101,"ENSG00000079974.19"
"10761","ENSG00000132704.16_5778",5770,5778,9,"ENSG00000132704.16",1,6,"VVVUVMVVV",1,7,0.78343685300207,89,95,107,110,112,118,133,136,"AAGAAGA","CTGA","TTTATAA","CTGA",2.51214827433291,12,2,15,38,2.40231030417994,4.78749136659983,7.92123877860811,101,"ENSG00000079974.19"
"9740","ENSG00000126861.5_21774",21766,21774,9,"ENSG00000126861.5",1,6,"UVVVVMVVV",1,7,0.805383022774327,114,120,133,136,153,159,186,189,"CTGATCA","CTAA","GTGAAGA","CTGA",2.57571612626203,13,17,27,66,1.62730643062295,4.69968681809246,7.92121890918977,101,"ENSG00000079974.19"
"46902","ENSG00000287349.1_3847",3839,3847,9,"ENSG00000287349.1",1,5,"VVVVMVVVV",0,8,0.886542443064182,93,99,107,110,115,121,133,136,"AGGATCA","CTGG","ATGAGGC","ATGA",2.20689397364944,8,5,12,34,2.78735387808412,4.37499509227009,7.92116486452682,101,"ENSG00000079974.19"
"43119","ENSG00000268833.1_7872",7864,7872,9,"ENSG00000268833.1",1,2,"VMVVVVVVV",0,8,0.884057971014493,108,114,133,136,160,166,180,183,"ATTATGT","CAGG","GTGATAG","CTGA",2.39172734341652,19,24,14,66,1.59487605541373,4.38493125288098,7.92116313693895,101,"ENSG00000079974.19"
"45522","ENSG00000285681.2_18268",18260,18268,9,"ENSG00000285681.2",1,1,"MVVVVVUVV",1,7,0.792132505175983,38,44,55,58,108,114,133,136,"ATGATGC","TTGA","AAGAGGA","CTGA",2.61891890854969,11,50,19,89,1.55095262891188,4.75260300481079,7.92113302551472,101,"ENSG00000079974.19"
"22487","ENSG00000170624.14_634418",634410,634418,9,"ENSG00000170624.14",0,NA,"VVVVVVUVV",1,8,0.886128364389234,61,67,102,105,111,117,133,136,"ACGATGA","ATGA","CTGAGGT","CAGA",2.36332086313257,35,6,16,66,1.75094250060954,4.37660373037334,7.92111718793027,101,"ENSG00000079974.19"
"2958","ENSG00000079691.19_98357",98349,98357,9,"ENSG00000079691.19",1,2,"VMVVVUVVV",1,7,0.806211180124223,92,98,108,111,116,122,133,136,"TTGATGT","CTTC","CTTAGGA","CTGA",2.37247365744355,10,5,11,35,2.96818958154212,4.69617015779144,7.92101487828833,101,"ENSG00000079974.19"
"31674","ENSG00000224382.2_15943",15935,15943,9,"ENSG00000224382.2",1,7,"VVVVVVMVV",0,8,0.885300207039338,109,115,133,136,141,147,183,186,"GAGATGA","CAGG","ATGAATT","CTGA",2.38158356564087,18,5,36,68,1.64191350252502,4.37978431836603,7.92098514652338,101,"ENSG00000079974.19"
"23799","ENSG00000174175.17_33978",33970,33978,9,"ENSG00000174175.17",0,NA,"VVVVVVUVV",1,8,0.886128364389234,111,117,133,136,140,146,186,189,"GTTATGA","GTTA","CAGATTA","CTGA",2.3714604610494,16,4,40,69,1.69611112362816,4.37646188265605,7.92097534021298,101,"ENSG00000079974.19"
"6819","ENSG00000111961.19_210174",210166,210174,9,"ENSG00000111961.19",1,8,"VVVUVVVMV",1,7,0.764803312629399,115,121,133,136,143,149,157,160,"GAGATGA","CTTA","GTCATTG","CTGA",2.45462038531411,12,7,8,36,3.08286607336289,4.86175049386423,7.92096374438183,101,"ENSG00000079974.19"
"41532","ENSG00000259200.2_112931",112923,112931,9,"ENSG00000259200.2",0,NA,"UVVVVUVVV",2,7,0.824844720496894,89,95,133,136,143,149,193,196,"CTGATGA","CTGT","CTGTTCA","CTGA",2.62113043310602,38,7,44,98,1.0121239694987,4.62158171421804,7.92096059620562,101,"ENSG00000079974.19"
"29586","ENSG00000198363.18_89337",89329,89337,9,"ENSG00000198363.18",0,NA,"VVVVVVUVV",1,8,0.886128364389234,116,122,133,136,148,154,188,191,"AGGATGT","CACA","CTGCTGC","CTGA",2.35520465384846,11,12,34,66,1.80420550242076,4.37639246535262,7.92090592290955,101,"ENSG00000079974.19"
"12157","ENSG00000137494.14_16368",16360,16368,9,"ENSG00000137494.14",1,7,"VVVVVVMVV",0,8,0.885300207039338,115,121,133,136,140,146,193,196,"CTGTTCA","TTGA","GAGAGGA","CTGA",2.35140713071681,12,4,47,72,1.84267159014352,4.3796797820639,7.92088061022125,101,"ENSG00000079974.19"
"45948","ENSG00000286069.2_56372",56364,56372,9,"ENSG00000286069.2",1,8,"VVVVVVVMV",0,8,0.884057971014493,116,122,133,136,142,148,175,178,"GGGCTGA","TTGC","GTGAAGG","CTGA",2.30641392236789,11,6,27,53,2.16233877661654,4.38460789810062,7.92083978215859,101,"ENSG00000079974.19"
"42561","ENSG00000264343.7_80082",80074,80082,9,"ENSG00000264343.7",1,2,"VMUVVVVVV",1,7,0.767701863354037,65,71,79,82,92,98,133,136,"ATTATGA","CTGG","GTGGTGA","CTGA",2.65766413084161,8,10,35,62,1.68234250164871,4.85002584348153,7.92083329689768,101,"ENSG00000079974.19"
"43268","ENSG00000270629.7_79841",79833,79841,9,"ENSG00000270629.7",1,2,"VMUVVVVVV",1,7,0.767701863354037,65,71,79,82,92,98,133,136,"ATTATGA","CTGG","GTGGTGA","CTGA",2.65766413084161,8,10,35,62,1.68234250164871,4.85002584348153,7.92083329689768,101,"ENSG00000079974.19"
"43359","ENSG00000271425.9_80041",80033,80041,9,"ENSG00000271425.9",1,2,"VMUVVVVVV",1,7,0.767701863354037,65,71,79,82,92,98,133,136,"ATTATGA","CTGG","GTGGTGA","CTGA",2.65766413084161,8,10,35,62,1.68234250164871,4.85002584348153,7.92083329689768,101,"ENSG00000079974.19"
"43680","ENSG00000273136.8_77455",77447,77455,9,"ENSG00000273136.8",1,2,"VMUVVVVVV",1,7,0.767701863354037,65,71,79,82,92,98,133,136,"ATTATGA","CTGG","GTGGTGA","CTGA",2.65766413084161,8,10,35,62,1.68234250164871,4.85002584348153,7.92083329689768,101,"ENSG00000079974.19"
"46100","ENSG00000286185.1_81116",81108,81116,9,"ENSG00000286185.1",1,2,"VMUVVVVVV",1,7,0.767701863354037,65,71,79,82,92,98,133,136,"ATTATGA","CTGG","GTGGTGA","CTGA",2.65766413084161,8,10,35,62,1.68234250164871,4.85002584348153,7.92083329689768,101,"ENSG00000079974.19"
"46149","ENSG00000286219.2_81118",81110,81118,9,"ENSG00000286219.2",1,2,"VMUVVVVVV",1,7,0.767701863354037,65,71,79,82,92,98,133,136,"ATTATGA","CTGG","GTGGTGA","CTGA",2.65766413084161,8,10,35,62,1.68234250164871,4.85002584348153,7.92083329689768,101,"ENSG00000079974.19"
"48338","ENSG00000291005.1_12712",12704,12712,9,"ENSG00000291005.1",1,2,"VMUVVVVVV",1,7,0.767701863354037,65,71,79,82,92,98,133,136,"ATTATGA","CTGG","GTGGTGA","CTGA",2.65766413084161,8,10,35,62,1.68234250164871,4.85002584348153,7.92083329689768,101,"ENSG00000079974.19"
"13871","ENSG00000143797.12_103594",103586,103594,9,"ENSG00000143797.12",1,8,"VVVVVVVMV",0,8,0.884057971014493,111,117,133,136,145,151,161,164,"AAGAAGA","ATGA","ATGTTGT","CTCA",2.21116956089526,16,9,10,44,2.79714621987804,4.38456915646161,7.92080104051958,101,"ENSG00000079974.19"
"41360","ENSG00000258918.1_25872",25864,25872,9,"ENSG00000258918.1",1,2,"VMVVVVVVV",0,8,0.884057971014493,73,79,99,102,109,115,133,136,"CTGATGA","CAGA","ATTCTGC","CTGT",2.31167357100523,20,7,18,54,2.12649937430732,4.38441412858554,7.92064601264351,101,"ENSG00000079974.19"
"30641","ENSG00000206120.11_538985",538977,538985,9,"ENSG00000206120.11",1,8,"VVVVVVVMV",0,8,0.884057971014493,102,108,133,136,154,160,169,172,"ATGATCA","CTTG","TTCGTGA","CTGA",2.39914001359034,25,18,9,61,1.54312481047553,4.38434789193612,7.92057977599409,101,"ENSG00000079974.19"
"5146","ENSG00000103489.12_13303",13295,13303,9,"ENSG00000103489.12",1,3,"VVMVVVVVV",0,8,0.882815734989648,57,63,70,73,115,121,133,136,"GTTATGA","CTGA","TTGTGGA","CTTA",2.39736979329869,7,42,12,70,1.57468527602242,4.38928764117009,7.92055058112869,101,"ENSG00000079974.19"
"48284","ENSG00000290870.1_18804",18796,18804,9,"ENSG00000290870.1",1,8,"UVVVVUVMV",2,6,0.708902691511387,88,94,133,136,145,151,172,175,"CTGATGA","CTGA","ATGAGGA","CTGA",2.83898879913788,39,9,21,78,1.41298030008374,5.08489307358407,7.92050383962962,101,"ENSG00000079974.19"
"20853","ENSG00000165886.5_46118",46110,46118,9,"ENSG00000165886.5",1,5,"UVVVMVVVV",1,7,0.789233954451346,114,120,133,136,151,157,189,192,"ATGATGA","CCTA","ATGGTGG","CTGA",2.61216036515239,13,15,32,69,1.63981789936521,4.76355508342861,7.920490901234,101,"ENSG00000079974.19"
"8593","ENSG00000119685.20_89938",89930,89938,9,"ENSG00000119685.20",1,2,"VMVVVVVVV",0,8,0.884057971014493,94,100,133,136,145,151,160,163,"ATGAGGG","TTGT","ATTATAA","CTGA",2.33564171419762,33,9,9,60,1.96608671128481,4.38425786815057,7.92048975220854,101,"ENSG00000079974.19"
"31076","ENSG00000215474.8_11593",11585,11593,9,"ENSG00000215474.8",0,NA,"VVVVUVVVV",1,8,0.889855072463768,114,120,133,136,145,151,170,173,"CTGAGAA","ATTA","ATGAATA","CTGA",2.23829784720064,13,9,19,50,2.52224550927215,4.3610577893191,7.92047807917418,101,"ENSG00000079974.19"
"28199","ENSG00000188452.15_135625",135617,135625,9,"ENSG00000188452.15",1,3,"VVMVVVVVV",0,8,0.882815734989648,80,86,95,98,108,114,133,136,"ATTATGT","GTGA","TTGATGG","CTAA",2.28664225122841,9,10,19,47,2.31252571027928,4.38920184628384,7.92046478624243,101,"ENSG00000079974.19"
"26326","ENSG00000183850.14_36786",36778,36786,9,"ENSG00000183850.14",1,8,"VVVVVUVMV",1,7,0.806211180124224,106,112,133,136,138,144,161,164,"ATTATGA","TTAA","GTGAAGA","CTGA",2.57220785948891,21,2,17,49,1.63385048129142,4.69547571947103,7.92032043996793,101,"ENSG00000079974.19"
"25923","ENSG00000183098.11_611156",611148,611156,9,"ENSG00000183098.11",1,6,"VVVVVMVVV",0,8,0.902691511387163,115,121,133,136,144,150,166,169,"GCCATAA","ATGA","GAGACAA","CTGA",2.17303080164125,12,8,16,45,2.75134207376402,4.30955352117642,7.92031956672507,101,"ENSG00000079974.19"
"21650","ENSG00000168675.19_283215",283207,283215,9,"ENSG00000168675.19",1,8,"VVVVUVVMV",1,7,0.773913043478261,74,80,91,94,101,107,133,136,"CTGATGT","TTGA","ATGGAGA","CTGA",2.56310503407182,11,7,26,53,2.21130148005632,4.82466709346712,7.92031926738016,101,"ENSG00000079974.19"
"33795","ENSG00000231185.9_134062",134054,134062,9,"ENSG00000231185.9",1,8,"VVVVVVVMV",0,8,0.884057971014493,111,117,133,136,153,159,192,195,"ATGAGCA","CTGT","CTGCAGA","CTGA",2.42913029959212,16,17,33,75,1.34196884396363,4.38404271031111,7.92027459436908,101,"ENSG00000079974.19"
"5548","ENSG00000105810.10_109614",109606,109614,9,"ENSG00000105810.10",1,5,"VVVVMVVVV",0,8,0.886542443064182,114,120,133,136,143,149,162,165,"ATAATAA","CTGC","CTGAATA","CTAA",2.18463487456184,13,7,13,42,2.93215203790703,4.3740961337465,7.92026590600323,101,"ENSG00000079974.19"
"26462","ENSG00000184304.17_438640",438632,438640,9,"ENSG00000184304.17",1,2,"VMVVVVVVV",0,8,0.884057971014493,112,118,133,136,140,146,157,160,"ATTATGA","CAGC","GTCATCA","CAGA",2.21373011855067,15,4,11,39,2.77782053741616,4.38400533193849,7.92023721599646,101,"ENSG00000079974.19"
"21181","ENSG00000166762.19_8959",8951,8959,9,"ENSG00000166762.19",1,1,"MVVVVUVVV",1,7,0.82815734989648,115,121,133,136,182,188,220,223,"CTGATGA","CCTA","GTGATGG","CTGA",2.60064240753351,12,46,32,99,1.09270197638515,4.60757950665214,7.92020890623806,101,"ENSG00000079974.19"
"21803","ENSG00000169016.17_3645",3637,3645,9,"ENSG00000169016.17",1,1,"MVVVVVUVV",1,7,0.792132505175983,102,108,133,136,149,155,174,177,"TTGATGA","CTAA","GTAAGGA","CTGA",2.63481748238174,25,13,19,66,1.44118401398758,4.75165847413313,7.92018849483706,101,"ENSG00000079974.19"
"14895","ENSG00000146090.16_14486",14478,14486,9,"ENSG00000146090.16",1,3,"VVMVVVVVV",0,8,0.882815734989648,110,116,133,136,182,188,198,201,"GTGACGT","CTAA","GGGAAGT","CTGA",2.36974292917645,17,46,10,82,1.75708092710102,4.38884178040268,7.92010472036127,101,"ENSG00000079974.19"
"27773","ENSG00000187323.12_73675",73667,73675,9,"ENSG00000187323.12",1,6,"VVVVVMVVV",0,8,0.902691511387163,43,49,69,72,115,121,133,136,"TTGATGA","GTGA","ATAATTA","CTGG",2.36772633381766,20,43,12,84,1.45243450804141,4.30931918337311,7.92008522892177,101,"ENSG00000079974.19"
"36377","ENSG00000240405.7_191590",191582,191590,9,"ENSG00000240405.7",1,8,"UVVVVUVMV",2,6,0.708902691511387,109,115,133,136,148,154,167,170,"ATGAGGA","CTGA","AAGAGGA","CTGA",2.6979388196418,18,12,13,52,2.35161283170159,5.0844679073284,7.92007867337395,101,"ENSG00000079974.19"
"16001","ENSG00000150625.17_364648",364640,364648,9,"ENSG00000150625.17",1,5,"VVVVMVVVV",0,8,0.886542443064182,113,119,133,136,181,187,199,202,"GCGAGGG","CTGC","ATGAGGA","CTGA",2.33564834975823,14,45,12,80,1.92457140293921,4.37389010033186,7.92005987258859,101,"ENSG00000079974.19"
"29373","ENSG00000197863.9_30772",30764,30772,9,"ENSG00000197863.9",1,2,"VMVVVVVVV",0,8,0.884057971014493,110,116,133,136,142,148,159,162,"ATAATGA","CAGC","CTGTTTA","GTGA",2.21975037758125,17,6,11,43,2.73696258561126,4.38382460903823,7.9200564930962,101,"ENSG00000079974.19"
"1011","ENSG00000044115.21_84867",84859,84867,9,"ENSG00000044115.21",0,NA,"VVVVUVVVV",1,8,0.889855072463768,35,41,56,59,71,77,133,136,"AGAATGT","CTGA","ACAAAGA","CTGA",2.3649283435694,15,12,56,92,1.67589213702779,4.36052027353928,7.91994056339435,101,"ENSG00000079974.19"
"29553","ENSG00000198216.14_390629",390621,390629,9,"ENSG00000198216.14",1,1,"MVVVVUVVV",1,7,0.82815734989648,91,97,133,136,141,147,167,170,"GTGATGG","ATGA","TAGAAGA","CTGA",2.54625280187013,36,5,20,70,1.45395546262661,4.6072435354402,7.91987293502612,101,"ENSG00000079974.19"
"32716","ENSG00000227646.7_11244",11236,11244,9,"ENSG00000227646.7",1,1,"MVVUVVVVV",1,7,0.786749482401656,114,120,133,136,143,149,170,173,"TTCATGA","CAGA","GTAATGG","CTGA",2.49521907335807,13,7,21,50,2.45668090810329,4.7728686826226,7.91986661222923,101,"ENSG00000079974.19"
"18615","ENSG00000157837.16_80751",80743,80751,9,"ENSG00000157837.16",1,1,"MVVUVVVVV",1,7,0.786749482401656,63,69,99,102,109,115,133,136,"ATGATAA","CAGA","ATGTGGA","CTGA",2.61175017971142,30,7,18,64,1.67959982979858,4.77281692363535,7.91981485324197,101,"ENSG00000079974.19"
"23684","ENSG00000173517.11_75190",75182,75190,9,"ENSG00000173517.11",1,2,"VMVVVUVVV",1,7,0.806211180124223,76,82,96,99,111,117,133,136,"AGGAAGA","CTGT","ATGATCT","CTGA",2.44365559809104,14,12,16,51,2.48875095851114,4.69494706977953,7.91979179027642,101,"ENSG00000079974.19"
"44170","ENSG00000279082.5_89611",89603,89611,9,"ENSG00000279082.5",1,2,"VMVVVUVVV",1,7,0.806211180124223,76,82,96,99,111,117,133,136,"AGGAAGA","CTGT","ATGATCT","CTGA",2.44365559809104,14,12,16,51,2.48875095851114,4.69494706977953,7.91979179027642,101,"ENSG00000079974.19"
"16149","ENSG00000150995.21_144034",144026,144034,9,"ENSG00000150995.21",1,2,"VMVVVUVVV",1,7,0.806211180124223,84,90,103,106,114,120,133,136,"GTTATGT","CTGC","GTGGGTA","CTGA",2.3798530718586,13,8,13,43,2.91376640783383,4.69486338838945,7.91970810888635,101,"ENSG00000079974.19"
"11643","ENSG00000135605.13_52427",52419,52427,9,"ENSG00000135605.13",1,2,"VMVVVVVVV",0,8,0.884057971014493,51,57,68,71,116,122,133,136,"ATGGTTA","CTGA","AGGATGA","CTTA",2.33557580762283,11,45,11,76,1.96317474763225,4.38342003294611,7.91965191700408,101,"ENSG00000079974.19"
"11761","ENSG00000135976.21_4792",4784,4792,9,"ENSG00000135976.21",1,5,"VVVVMVVVV",0,8,0.886542443064182,116,122,133,136,178,184,192,195,"GTGGTGA","CTAA","TTGAAGA","ATGA",2.33011391047633,11,42,8,70,1.95983156572765,4.37348107555913,7.91965084781586,101,"ENSG00000079974.19"
"37088","ENSG00000245248.9_284090",284082,284090,9,"ENSG00000245248.9",0,NA,"VVVVVVUVV",1,8,0.886128364389234,113,119,133,136,142,148,161,164,"GTACAGA","CAGA","GTGGTCT","CTGA",2.19243548746095,14,6,13,42,2.88424365300399,4.37512005901925,7.91963351657618,101,"ENSG00000079974.19"
"42913","ENSG00000267327.2_15195",15187,15195,9,"ENSG00000267327.2",1,2,"VMVVVVVVV",0,8,0.884057971014493,97,103,133,136,141,147,199,202,"ATGATTT","CAGA","TTGCAGA","CTGA",2.48351097764768,30,5,52,96,0.976599492466301,4.3833348358627,7.91956671992068,101,"ENSG00000079974.19"
"44552","ENSG00000282987.1_212543",212535,212543,9,"ENSG00000282987.1",1,8,"VVVVVVVMV",0,8,0.884057971014493,111,117,133,136,163,169,218,221,"CTAATGA","CTCA","GTCAGGA","CTGA",2.49066886168973,16,27,49,101,0.928646485575581,4.38327639087677,7.91950827493474,101,"ENSG00000079974.19"
"15713","ENSG00000149256.16_579610",579602,579610,9,"ENSG00000149256.16",1,7,"VVVVUVMVV",1,7,0.775155279503105,86,92,100,103,116,122,133,136,"ATCATGA","CTGG","GTTAGAA","CTGA",2.5260462523774,8,13,11,41,2.4352223922574,4.81888268536002,7.91950380337244,101,"ENSG00000079974.19"
"11682","ENSG00000135778.12_16884",16876,16884,9,"ENSG00000135778.12",0,NA,"UVVVVUVVV",2,7,0.824844720496894,106,112,133,136,145,151,164,167,"ATGAGGA","ATGT","GTGTCCA","CTGA",2.43009715523021,21,9,13,52,2.27979314932535,4.62011021271501,7.91948909470259,101,"ENSG00000079974.19"
"8722","ENSG00000120500.19_2681",2673,2681,9,"ENSG00000120500.19",1,8,"VVUVVVVMV",1,7,0.767701863354037,89,95,103,106,116,122,133,136,"GTGATCC","CTGA","TTGATTT","CTGA",2.50796791851838,8,10,11,38,2.67493665756754,4.84868069525585,7.91948814867199,101,"ENSG00000079974.19"
"15073","ENSG00000147010.19_136004",135996,136004,9,"ENSG00000147010.19",1,1,"MVVUVVVVV",1,7,0.786749482401656,107,113,133,136,143,149,172,175,"ATGCTGA","CAGA","ATAAAGA","CTGA",2.58612326044918,20,7,23,59,1.8490236824409,4.77246135469219,7.91945928429882,101,"ENSG00000079974.19"
"24221","ENSG00000175497.17_437486",437478,437486,9,"ENSG00000175497.17",1,3,"VVMVVVVVV",0,8,0.882815734989648,85,91,133,136,143,149,160,163,"AGGGTGA","GTGG","GTGACCA","CTGA",2.33493736379906,42,7,11,69,1.98643492504726,4.38817100426024,7.91943394421884,101,"ENSG00000079974.19"
"2697","ENSG00000077420.16_82108",82100,82108,9,"ENSG00000077420.16",1,2,"VMVVVVVVV",0,8,0.884057971014493,112,118,133,136,145,151,163,166,"ATTATCA","CTTT","ATTCTTA","CTGA",2.20623502086534,15,9,12,45,2.82414445701873,4.38309448236357,7.91932636642154,101,"ENSG00000079974.19"
"20422","ENSG00000164808.17_108858",108850,108858,9,"ENSG00000164808.17",1,1,"MVVVVUVVV",1,7,0.82815734989648,107,113,133,136,144,150,161,164,"ATGAAGA","CTTC","GAGATAT","CTGA",2.39430258322889,20,8,11,48,2.46461261679429,4.60665745958006,7.91928685916598,101,"ENSG00000079974.19"
"48014","ENSG00000290028.1_62",54,62,9,"ENSG00000290028.1",1,1,"MVVVVUVVV",1,7,0.82815734989648,38,44,64,67,75,81,92,95,"ATGAAGA","CTTC","GAGATAT","CTGA",2.39430258322889,20,8,11,48,2.46461261679429,4.60665745958006,7.91928685916598,101,"ENSG00000079974.19"
"5965","ENSG00000107371.14_40884",40876,40884,9,"ENSG00000107371.14",0,NA,"VVUVVUVVV",2,7,0.805797101449275,104,110,133,136,148,154,169,172,"GTGATGA","CTGA","AGGAGGA","CTGG",2.53925964161056,23,12,15,59,1.85593148595622,4.69608227417332,7.91927067997042,101,"ENSG00000079974.19"
"40383","ENSG00000255872.3_277454",277446,277454,9,"ENSG00000255872.3",0,NA,"VVUVVUVVV",2,7,0.805797101449275,104,110,133,136,148,154,169,172,"GTGATGA","CTGA","AGGAGGA","CTGG",2.53925964161056,23,12,15,59,1.85593148595622,4.69608227417332,7.91927067997042,101,"ENSG00000079974.19"
"26584","ENSG00000184564.11_7256",7248,7256,9,"ENSG00000184564.11",1,7,"VVVVVVMVV",0,8,0.885300207039338,116,122,133,136,176,182,191,194,"AGGCTGA","AAGA","CTGACTA","CTGA",2.32967383645195,11,40,9,69,1.98078869929088,4.37798690224263,7.91918773039998,101,"ENSG00000079974.19"
"15736","ENSG00000149294.17_229358",229350,229358,9,"ENSG00000149294.17",0,NA,"VVVVVVUVV",1,8,0.886128364389234,90,96,107,110,113,119,133,136,"ATGATGA","CCTA","CTGATGA","GTGG",2.23091639797092,11,3,14,37,2.62588846823633,4.37466611367728,7.91917957123422,101,"ENSG00000079974.19"
"24288","ENSG00000175728.4_41802",41794,41802,9,"ENSG00000175728.4",1,1,"MVVVVVUVV",1,7,0.792132505175983,115,121,133,136,141,147,174,177,"ATGATGC","ATGA","AGGCTCA","CTGA",2.53006364605942,12,5,27,53,2.13534500369515,4.75060899435615,7.91913901506008,101,"ENSG00000079974.19"
"29381","ENSG00000197892.13_38796",38788,38796,9,"ENSG00000197892.13",1,8,"VVVVVVVMV",0,8,0.884057971014493,115,121,133,136,138,144,154,157,"ATACTTA","CAGT","TTGATGT","CTGA",2.2196567767725,12,2,10,33,2.73361353275093,4.38283134447523,7.91906322853321,101,"ENSG00000079974.19"
"30110","ENSG00000203711.16_40056",40048,40056,9,"ENSG00000203711.16",0,NA,"UVUVVVVVV",2,7,0.786335403726708,88,94,108,111,115,121,133,136,"ATCATGT","CTGG","GTGGGGG","CTGA",2.44355403671432,14,4,12,39,2.80452374081856,4.77372099639517,7.919062611302,101,"ENSG00000079974.19"
"17268","ENSG00000153767.10_33330",33322,33330,9,"ENSG00000153767.10",1,8,"VVVVVVVMV",0,8,0.884057971014493,102,108,133,136,142,148,165,168,"ATGATCA","CACA","ACTTTGA","CTGA",2.35165878705718,25,6,17,57,1.85316821633999,4.38272336584696,7.91895524990493,101,"ENSG00000079974.19"
"17557","ENSG00000154438.8_17929",17921,17929,9,"ENSG00000154438.8",0,NA,"UVVVVVVVV",1,8,0.902691511387163,105,111,133,136,145,151,168,171,"ATCATGT","TTGC","ATAACAA","CTGA",2.28712116454302,22,9,17,57,1.98521013848261,4.30817114219235,7.91893718774101,101,"ENSG00000079974.19"
"8410","ENSG00000118707.11_4635",4627,4635,9,"ENSG00000118707.11",1,3,"VVMVVVVVV",0,8,0.882815734989648,103,109,133,136,148,154,186,189,"ATGATTA","CAGT","ATGGTGG","CTGA",2.47145563808971,24,12,32,77,1.07426858740512,4.3876598770008,7.91892281695939,101,"ENSG00000079974.19"
"41636","ENSG00000259399.1_3570",3562,3570,9,"ENSG00000259399.1",1,3,"VVMVVVVVV",0,8,0.882815734989648,103,109,133,136,148,154,186,189,"ATGATTA","CAGT","ATGGTGG","CTGA",2.47145563808971,24,12,32,77,1.07426858740512,4.3876598770008,7.91892281695939,101,"ENSG00000079974.19"
"5896","ENSG00000107104.21_92168",92160,92168,9,"ENSG00000107104.21",0,NA,"VVVUVVVVV",1,8,0.880745341614907,111,117,133,136,185,191,201,204,"ATCATGT","CAAA","GAGATGG","CTGA",2.36171028354312,16,49,10,84,1.83894837186414,4.39592089887124,7.91890226533086,101,"ENSG00000079974.19"
"4645","ENSG00000101452.15_6023",6015,6023,9,"ENSG00000101452.15",1,8,"VVVVVUVMV",1,7,0.806211180124224,111,117,133,136,146,152,166,169,"AAGATGA","ATGG","GTGCCCA","CTGA",2.4251095217369,16,10,14,49,2.60866090854085,4.69401443003005,7.91885915052694,101,"ENSG00000079974.19"
"22947","ENSG00000171759.10_43162",43154,43162,9,"ENSG00000171759.10",0,NA,"VVVVVUUVV",2,7,0.808281573498965,90,96,133,136,144,150,161,164,"ATTATGA","TAGA","GTGATTG","CTGA",2.51493715793629,37,8,11,65,1.97666123580486,4.68572723884503,7.91885353284089,101,"ENSG00000079974.19"
"10910","ENSG00000133106.15_53263",53255,53263,9,"ENSG00000133106.15",0,NA,"UVVVVUVVV",2,7,0.824844720496894,25,31,59,62,72,78,133,136,"ATGAGGA","CAGA","ATGAGGT","CTGA",2.62513613977169,28,10,55,102,0.976966858949094,4.61946861435676,7.91884749634434,101,"ENSG00000079974.19"
"36231","ENSG00000239265.5_204970",204962,204970,9,"ENSG00000239265.5",1,7,"VVVVVVMVV",0,8,0.885300207039338,115,121,133,136,159,165,219,222,"ATAATAA","CTAA","GTGATAG","CTGA",2.45044134989781,12,23,54,98,1.17423281948277,4.37762712136704,7.91882794952439,101,"ENSG00000079974.19"
"32952","ENSG00000228340.8_290856",290848,290856,9,"ENSG00000228340.8",1,2,"VMVUVVVVV",1,7,0.764803312629399,65,71,109,112,116,122,133,136,"TTGATGA","ATGA","TTGCAGA","CTGA",2.64175129745463,38,4,11,62,1.82648390129312,4.85953980441434,7.91875305493194,101,"ENSG00000079974.19"
"17228","ENSG00000153707.19_1861284",1861276,1861284,9,"ENSG00000153707.19",1,7,"VVVVVVMVV",0,8,0.885300207039338,113,119,133,136,161,167,199,202,"ATGTTGG","TTGC","GTGAAGA","CTGA",2.4497992029378,14,25,32,80,1.17821421340738,4.37755222491485,7.9187530530722,101,"ENSG00000079974.19"
"36058","ENSG00000237813.4_83056",83048,83056,9,"ENSG00000237813.4",1,6,"VVVVVMVVV",0,8,0.902691511387163,110,116,133,136,144,150,202,205,"AAGTTGA","TTGT","CTGAACA","CTGA",2.32329316902224,17,8,52,86,1.74316764509114,4.30794719297652,7.91871323852517,101,"ENSG00000079974.19"
"11662","ENSG00000135698.10_9200",9192,9200,9,"ENSG00000135698.10",1,5,"VVVVMVVVV",0,8,0.886542443064182,94,100,133,136,186,192,208,211,"ATGATGG","AGGA","GAGATAA","CTGA",2.5069635624515,33,50,16,108,0.776381793406435,4.37236805243744,7.91853782469417,101,"ENSG00000079974.19"
"46269","ENSG00000286414.1_15950",15942,15950,9,"ENSG00000286414.1",0,NA,"VVVVVVUVV",1,8,0.886128364389234,103,109,133,136,145,151,191,194,"ATCATCA","GTGA","GCGAGGA","CTGA",2.44600779541334,24,9,40,82,1.18910163153039,4.37395506690483,7.91846852446176,101,"ENSG00000079974.19"
"47740","ENSG00000289156.2_18459",18451,18459,9,"ENSG00000289156.2",1,8,"VVVVVVVMV",0,8,0.884057971014493,116,122,133,136,144,150,175,178,"AAAATGA","CAGT","CTCATGC","CTGA",2.29413368840538,11,8,25,53,2.2346495145557,4.38221852598122,7.91845041003919,101,"ENSG00000079974.19"
"37000","ENSG00000244128.9_467041",467033,467041,9,"ENSG00000244128.9",0,NA,"VVVVVVUVV",1,8,0.886128364389234,113,119,133,136,169,175,189,192,"TTGCTGT","CTGT","TTGTTCA","CTGA",2.34465117067492,14,33,14,70,1.86442002119651,4.37385695642399,7.91837041398093,101,"ENSG00000079974.19"
"39128","ENSG00000251680.6_198525",198517,198525,9,"ENSG00000251680.6",1,8,"VVVVVVVMV",0,8,0.884057971014493,79,85,96,99,109,115,133,136,"ATGCTGA","ATGA","GAAATGG","CTTA",2.25264437939129,11,10,18,48,2.51091418595378,4.38213584547394,7.91836772953191,101,"ENSG00000079974.19"
"20834","ENSG00000165807.8_14224",14216,14224,9,"ENSG00000165807.8",0,NA,"UVUVVVVVV",2,7,0.786335403726708,101,107,133,136,144,150,160,163,"ATGCTAA","CTGA","CTGGAGA","CTGA",2.54575920530622,26,8,10,53,2.1203653111673,4.77302333663553,7.91836495154236,101,"ENSG00000079974.19"
"14002","ENSG00000144229.13_403460",403452,403460,9,"ENSG00000144229.13",1,6,"VVVVVMVVV",0,8,0.902691511387163,95,101,133,136,144,150,168,171,"TTAATGA","CGGC","ATTATTA","CTGA",2.3376304010375,32,8,18,67,1.64608283733199,4.30757137772883,7.91833742327748,101,"ENSG00000079974.19"
"19273","ENSG00000162636.16_67085",67077,67085,9,"ENSG00000162636.16",0,NA,"VVVUVVVVV",1,8,0.880745341614907,91,97,133,136,144,150,176,179,"TGGATGA","CTGC","GATATGA","CTGA",2.45281394513484,36,8,26,79,1.22910804867508,4.39530025406016,7.91828162051979,101,"ENSG00000079974.19"
"47759","ENSG00000289197.2_70658",70650,70658,9,"ENSG00000289197.2",1,6,"VVVVVMVVV",0,8,0.902691511387163,88,94,101,104,114,120,133,136,"TTGATGT","TTGA","ATCATCT","CTAA",2.21341960489958,7,10,13,39,2.47388617951085,4.30750421971035,7.918270265259,101,"ENSG00000079974.19"
"32841","ENSG00000228063.4_17073",17065,17073,9,"ENSG00000228063.4",1,7,"VVVVVVMVV",0,8,0.885300207039338,105,111,133,136,152,158,174,177,"CTTATGA","CATA","ATGTTGT","CTGA",2.38861141693955,22,16,16,63,1.58417385820889,4.3770624927848,7.91826332094215,101,"ENSG00000079974.19"
"46658","ENSG00000286993.1_4651",4643,4651,9,"ENSG00000286993.1",1,8,"VVVVVVVMV",0,8,0.884057971014493,111,117,133,136,182,188,208,211,"ATGATCA","CAAA","CTTATTA","CTGA",2.42574897157837,16,46,20,91,1.35644841314241,4.38202705591622,7.91825893997419,101,"ENSG00000079974.19"
"48347","ENSG00000291011.1_44635",44627,44635,9,"ENSG00000291011.1",1,7,"VVVVVVMVV",0,8,0.885300207039338,61,67,86,89,114,120,133,136,"GTGATTT","CTGC","GTGCAAA","CTGA",2.38322012539767,19,25,13,66,1.61985447247914,4.37699716044923,7.91819798860658,101,"ENSG00000079974.19"
"10107","ENSG00000129292.21_15798",15790,15798,9,"ENSG00000129292.21",1,2,"VMVVVVVVV",0,8,0.884057971014493,84,90,133,136,139,145,165,168,"ATGAGAA","CAGA","CTGACGT","CTGA",2.44651332367755,43,3,20,75,1.21776210089805,4.38196273135376,7.91819461541173,101,"ENSG00000079974.19"
"28080","ENSG00000188107.15_1964477",1964469,1964477,9,"ENSG00000188107.15",1,1,"MVVVVVUVV",1,7,0.792132505175983,89,95,104,107,116,122,133,136,"GTATTGA","CTCA","ATGCTGA","CTGA",2.42489568510806,9,9,11,38,2.83244385572892,4.74960377244567,7.9181337931496,101,"ENSG00000079974.19"
"44227","ENSG00000279847.3_3945",3937,3945,9,"ENSG00000279847.3",1,6,"VVVUVMVVV",1,7,0.78343685300207,112,118,133,136,143,149,158,161,"ATGATAT","CTTA","ATGGAGT","CTGA",2.42941874357003,15,7,9,40,2.94121729565198,4.78433556319638,7.91808297520466,101,"ENSG00000079974.19"
"10801","ENSG00000132874.15_223167",223159,223167,9,"ENSG00000132874.15",1,3,"UVMVVVVVV",1,7,0.785507246376811,110,116,133,136,137,143,155,158,"TTGATAA","CAGA","ATGGTGA","CTGA",2.55306247824849,17,1,12,39,2.08356190846817,4.77599460753119,7.91802359303844,101,"ENSG00000079974.19"
"44106","ENSG00000278254.4_23626",23618,23626,9,"ENSG00000278254.4",0,NA,"UVVVVVVVV",1,8,0.902691511387163,89,95,133,136,137,143,152,155,"ATGAAGA","ATAA","AAGTTAA","CTGA",2.38523508331346,38,1,9,57,1.32728454826422,4.30721294258848,7.91797898813714,101,"ENSG00000079974.19"
"6911","ENSG00000112237.13_3946",3938,3946,9,"ENSG00000112237.13",1,8,"VVVVVVVMV",0,8,0.884057971014493,109,115,133,136,180,186,202,205,"ATCATAA","CTTA","ATCAGGA","CTGA",2.41480284635666,18,44,16,87,1.4281444667154,4.38170752727328,7.91793941133125,101,"ENSG00000079974.19"
"7210","ENSG00000113312.12_21617",21609,21617,9,"ENSG00000113312.12",1,8,"UVVVVUVMV",2,6,0.708902691511387,65,71,104,107,115,121,133,136,"GTGATGA","CTAA","GTGATGG","CTGA",2.75514658221199,33,8,12,62,1.96158008083572,5.08230599056224,7.91791675660779,101,"ENSG00000079974.19"
"20043","ENSG00000164181.14_72760",72752,72760,9,"ENSG00000164181.14",0,NA,"UVVVVVVVV",1,8,0.902691511387163,112,118,133,136,142,148,171,174,"ATCTTGA","GTCA","ATGGTAG","CTGA",2.24644379456516,15,6,23,53,2.25213989393559,4.30710796442582,7.91787400997448,101,"ENSG00000079974.19"
"47955","ENSG00000289768.1_71926",71918,71926,9,"ENSG00000289768.1",1,5,"VVVVMVVVV",0,8,0.886542443064182,31,37,60,63,114,120,133,136,"ATTATTA","CTTA","TGGATGA","CTGA",2.44408590058237,23,51,13,96,1.19284602369729,4.37168800689494,7.91785777915167,101,"ENSG00000079974.19"
"46843","ENSG00000287280.1_56432",56424,56432,9,"ENSG00000287280.1",0,NA,"VVVUVVVVV",1,8,0.880745341614907,112,118,133,136,142,148,196,199,"ATGGTGC","CTGC","AAAAGGA","CTGA",2.35234980553652,15,6,48,78,1.89711651255447,4.39486213736615,7.91784350382578,101,"ENSG00000079974.19"
"34752","ENSG00000233933.2_343",335,343,9,"ENSG00000233933.2",0,NA,"UVVVVVVVV",1,8,0.902691511387163,22,28,46,49,99,105,133,136,"GTGATGC","CGGA","GACATCA","CTGA",2.45795942067407,18,50,28,105,0.841808912072154,4.30705126247482,7.91781730802347,101,"ENSG00000079974.19"
"21211","ENSG00000166833.23_526597",526589,526597,9,"ENSG00000166833.23",0,NA,"VVUVVVVVV",1,8,0.883643892339545,42,48,65,68,114,120,133,136,"ATCATGC","CTGA","TTGATAA","CTAA",2.37848057866693,17,46,13,85,1.67624290253571,4.38319502341215,7.91777059277033,101,"ENSG00000079974.19"
"39364","ENSG00000253521.2_26383",26375,26383,9,"ENSG00000253521.2",1,3,"VVMVVVVVV",0,8,0.882815734989648,86,92,101,104,112,118,133,136,"ATAATGT","GTGA","ATAATGT","TTGA",2.23227399674548,9,8,15,41,2.66416212963374,4.3864971936509,7.91776013360949,101,"ENSG00000079974.19"
"23365","ENSG00000172766.19_63236",63228,63236,9,"ENSG00000172766.19",1,8,"VVVVUVVMV",1,7,0.773913043478261,71,77,90,93,97,103,133,136,"TTGTTGA","CTGA","ATGTTTA","CTGA",2.59925476596922,13,4,30,56,1.95998539001854,4.82208762411999,7.91773979803304,101,"ENSG00000079974.19"
"20378","ENSG00000164754.16_27589",27581,27589,9,"ENSG00000164754.16",1,7,"UVVVVVMVV",1,7,0.787991718426501,110,116,133,136,164,170,182,185,"ATGTTGA","ATGA","TTGAAAA","CTGA",2.59148957445782,17,28,12,66,1.78640127840487,4.76574961036425,7.91771648407025,101,"ENSG00000079974.19"
"25369","ENSG00000181143.15_96575",96567,96575,9,"ENSG00000181143.15",1,2,"VMVVVVVVV",0,8,0.884057971014493,44,50,84,87,97,103,133,136,"ATGATGA","CTGC","GAGATAA","CTGC",2.47333698070948,34,10,30,83,1.03698920963921,4.38147560359227,7.91770748765024,101,"ENSG00000079974.19"
"16085","ENSG00000150672.19_27740",27732,27740,9,"ENSG00000150672.19",1,2,"VMVVVVVVV",0,8,0.884057971014493,106,112,133,136,142,148,156,159,"ATGAATA","ATAA","TTATTGA","CTGA",2.27150717271055,21,6,8,44,2.38245702136303,4.38145954319167,7.91769142724964,101,"ENSG00000079974.19"
"23632","ENSG00000173406.16_903174",903166,903174,9,"ENSG00000173406.16",0,NA,"UVVVVVVVV",1,8,0.902691511387163,107,113,133,136,149,155,166,169,"TTGAATA","CTTA","GTCACAA","CTGA",2.25856446921805,20,13,11,53,2.17045201927719,4.30688712018272,7.91765316573137,101,"ENSG00000079974.19"
"30140","ENSG00000203799.14_25448",25440,25448,9,"ENSG00000203799.14",1,7,"VVVVVVMVV",0,8,0.885300207039338,53,59,70,73,109,115,133,136,"GAGATGA","CTGA","GTGAATT","CTCA",2.38175673546947,11,36,18,74,1.62724016041294,4.37640459921901,7.91760542737636,101,"ENSG00000079974.19"
"13224","ENSG00000140632.17_26077",26069,26077,9,"ENSG00000140632.17",1,7,"VVVVVVMVV",0,8,0.885300207039338,111,117,133,136,143,149,169,172,"ATAAAGA","GTGT","GTGGTCG","CTGA",2.27265217356885,16,7,20,52,2.35457706427138,4.3763978886826,7.91759871683995,101,"ENSG00000079974.19"
"19267","ENSG00000162631.20_284977",284969,284977,9,"ENSG00000162631.20",1,8,"VVVVVVVMV",0,8,0.884057971014493,100,106,133,136,146,152,165,168,"ATGAGGA","ATGA","AAGAAGA","CTGT",2.34082472975628,27,10,13,59,1.91996613939546,4.38136608444266,7.91759796850063,101,"ENSG00000079974.19"
"19399","ENSG00000162885.14_6671",6663,6671,9,"ENSG00000162885.14",1,2,"VMVVVVVVV",0,8,0.884057971014493,110,116,133,136,159,165,177,180,"ATGGAGA","GTTA","GTGAAAA","CTGA",2.34585082706821,17,23,12,61,1.88612674312966,4.38128306422943,7.9175149482874,101,"ENSG00000079974.19"
"39622","ENSG00000253926.1_20346",20338,20346,9,"ENSG00000253926.1",1,8,"VVVVUVVMV",1,7,0.773913043478261,113,119,133,136,141,147,155,158,"ATGATGA","GAGA","TTGAAGA","CTGC",2.44639610444523,14,5,8,36,2.97807621886246,4.82184589545766,7.9174980693707,101,"ENSG00000079974.19"
"1605","ENSG00000063761.16_110198",110190,110198,9,"ENSG00000063761.16",0,NA,"UVVVVVUVV",2,7,0.788819875776397,115,121,133,136,139,145,156,159,"CAGATGG","CTGA","GGGAGCA","CTGA",2.43455911804536,12,3,11,35,2.81845516435072,4.76221232116328,7.91749182426886,101,"ENSG00000079974.19"
"29789","ENSG00000198730.9_7878",7870,7878,9,"ENSG00000198730.9",1,6,"VVVVVMVVV",0,8,0.902691511387163,55,61,98,101,112,118,133,136,"GTGAAGA","CTGA","ATATAGA","GTGA",2.33553968308842,37,11,15,72,1.65646889560276,4.30668336238139,7.91744940793005,101,"ENSG00000079974.19"
"22377","ENSG00000170417.16_232058",232050,232058,9,"ENSG00000170417.16",1,6,"UVVVVMVVV",1,7,0.805383022774327,112,118,133,136,149,155,164,167,"GTGATTA","TTAA","GTGTTCA","CTGA",2.42648996004394,15,13,9,46,2.60637481336811,4.6957436367486,7.91727572784591,101,"ENSG00000079974.19"
"13438","ENSG00000141431.14_58080",58072,58080,9,"ENSG00000141431.14",1,2,"VMVVVVUVV",1,7,0.770186335403727,73,79,93,96,116,122,133,136,"TAGATGA","CTGA","GTGGGCA","CTGA",2.56774399664308,14,20,11,54,2.22777040045062,4.83651592785112,7.91726126946603,101,"ENSG00000079974.19"
"6732","ENSG00000111728.11_127567",127559,127567,9,"ENSG00000111728.11",1,8,"VVVVVVVMV",0,8,0.884057971014493,116,122,133,136,144,150,172,175,"CTCATGT","GTGG","ATGATCT","CTGA",2.27314606032197,11,8,22,50,2.36979866126275,4.38102643251898,7.91725831657695,101,"ENSG00000079974.19"
"27702","ENSG00000187172.16_25292",25284,25292,9,"ENSG00000187172.16",0,NA,"UVVVVVVVV",1,8,0.902691511387163,112,118,133,136,150,156,188,191,"TTAATTA","CTGC","GAGAAGA","CTGA",2.34048614229671,15,14,32,70,1.62265269917537,4.30647341195503,7.91723945750368,101,"ENSG00000079974.19"
"48134","ENSG00000290523.1_65949",65941,65949,9,"ENSG00000290523.1",0,NA,"UVVVVVVVV",1,8,0.902691511387163,112,118,133,136,150,156,188,191,"TTAATTA","CTGC","GAGAAGA","CTGA",2.34048614229671,15,14,32,70,1.62265269917537,4.30647341195503,7.91723945750368,101,"ENSG00000079974.19"
"16681","ENSG00000152061.24_61597",61589,61597,9,"ENSG00000152061.24",1,8,"VVVVVVVMV",0,8,0.884057971014493,110,116,133,136,139,145,155,158,"GTGATGA","ATGG","GAGATTT","CCGA",2.25347800578199,17,3,10,39,2.50064968307193,4.3809590970713,7.91719098112927,101,"ENSG00000079974.19"
"13038","ENSG00000139970.18_12544",12536,12544,9,"ENSG00000139970.18",0,NA,"VVVVUVVVV",1,8,0.889855072463768,112,118,133,136,179,185,196,199,"ATGTTAA","CTGA","GTGGGGA","ATGA",2.32976607990943,15,43,11,78,1.89924194475536,4.35775395270456,7.91717424255963,101,"ENSG00000079974.19"
"5691","ENSG00000106299.8_20842",20834,20842,9,"ENSG00000106299.8",1,3,"VVMVVVVVV",0,8,0.882815734989648,22,28,65,68,75,81,133,136,"ATAATGA","CAGT","GTAATGT","CTGA",2.48062428759666,37,7,52,105,1.00587041242473,4.38584141576729,7.91710435572588,101,"ENSG00000079974.19"
"29829","ENSG00000198780.13_77815",77807,77815,9,"ENSG00000198780.13",0,NA,"VVVVVVUVV",1,8,0.886128364389234,107,113,133,136,168,174,187,190,"GTGATAA","ATCA","CTGGAGA","CTGA",2.40684217510881,20,32,13,74,1.4447293640581,4.37258596619587,7.91709942375281,101,"ENSG00000079974.19"
"14442","ENSG00000145012.14_199586",199578,199586,9,"ENSG00000145012.14",0,NA,"VVVVUVVVV",1,8,0.889855072463768,68,74,87,90,113,119,133,136,"GTGAAGA","CTCA","GTGAAGG","CAGA",2.30859850480572,13,23,14,59,2.04004895092253,4.35767641240684,7.91709670226191,101,"ENSG00000079974.19"
"4968","ENSG00000102471.16_45002",44994,45002,9,"ENSG00000102471.16",1,2,"VMVVVVVVV",0,8,0.884057971014493,88,94,133,136,180,186,197,200,"GTGAAGA","ATGC","ATGATGC","CTGA",2.47978501599732,39,44,11,103,0.991160998345761,4.38076527624864,7.91699716030661,101,"ENSG00000079974.19"
"2118","ENSG00000070366.14_220893",220885,220893,9,"ENSG00000070366.14",1,5,"VVVVMVVVV",0,8,0.886542443064182,35,41,81,84,93,99,133,136,"ATGGTGA","CTGA","ATGAAAA","CTCA",2.47014710625662,40,9,34,92,1.015653903179,4.37082531955579,7.91699509181252,101,"ENSG00000079974.19"
"16981","ENSG00000152931.9_36795",36787,36795,9,"ENSG00000152931.9",1,6,"VVVVVMUVV",1,7,0.788819875776397,53,59,72,75,111,117,133,136,"CTGGTGA","CTGT","CTGATGA","CTGA",2.59142835982596,13,36,16,74,1.77052337919538,4.76167811117545,7.91695761428104,101,"ENSG00000079974.19"
"8217","ENSG00000117419.16_95792",95784,95792,9,"ENSG00000117419.16",1,6,"VVVVVMVVV",0,8,0.902691511387163,73,79,103,106,112,118,133,136,"AAGATCA","CTGA","CTTAGGA","CTTA",2.28083868694534,24,6,15,54,2.01899807907114,4.30614733134335,7.916913376892,101,"ENSG00000079974.19"
"3896","ENSG00000090402.8_91458",91450,91458,9,"ENSG00000090402.8",1,6,"VVVVVMVVV",0,8,0.902691511387163,116,122,133,136,147,153,172,175,"AAGCTGA","ATTA","AGGCTAA","CTGA",2.22573919645392,11,11,19,50,2.38594163489309,4.30605073614647,7.91681678169512,101,"ENSG00000079974.19"
"7789","ENSG00000115760.16_240955",240947,240955,9,"ENSG00000115760.16",1,2,"UMVVVVVVV",1,7,0.786749482401656,94,100,109,112,114,120,133,136,"GTGATGA","TTGA","ATCATGA","ATGA",2.48854425050875,9,2,13,33,2.48886880128086,4.76979095116813,7.91678888077475,101,"ENSG00000079974.19"
"36162","ENSG00000238062.6_4462",4454,4462,9,"ENSG00000238062.6",0,NA,"VVVVVVUVV",1,8,0.886128364389234,60,66,97,100,111,117,133,136,"ATCCTGA","CTGA","ATGAGGA","CTTA",2.37950605138105,31,11,16,67,1.62568806626041,4.37226543553352,7.91677889309046,101,"ENSG00000079974.19"
"8109","ENSG00000116830.12_35149",35141,35149,9,"ENSG00000116830.12",1,8,"VVVVVUVMV",1,7,0.806211180124224,92,98,109,112,116,122,133,136,"GTTATAA","GTGA","ATGCTCA","CTGA",2.3756146804388,11,4,11,35,2.92998831380578,4.69185487918278,7.91669959967968,101,"ENSG00000079974.19"
"31909","ENSG00000225233.2_68493",68485,68493,9,"ENSG00000225233.2",0,NA,"VVUUVVVVV",2,7,0.764389233954451,115,121,133,136,149,155,182,185,"AGGATGA","CAGA","ATGAGGT","CTGA",2.63078187018807,12,13,27,61,1.8978531456071,4.85909973671522,7.91665667253302,101,"ENSG00000079974.19"
"19700","ENSG00000163618.18_287026",287018,287026,9,"ENSG00000163618.18",1,2,"VMVVVVVVV",0,8,0.884057971014493,113,119,133,136,149,155,171,174,"ATAATGA","CTTA","ATAAGGG","CAGA",2.26572234241664,14,13,16,52,2.41686210039474,4.38041942912641,7.91665131318438,101,"ENSG00000079974.19"
"34184","ENSG00000232053.7_297147",297139,297147,9,"ENSG00000232053.7",1,8,"VVVVVVVMV",0,8,0.884057971014493,111,117,133,136,144,150,168,171,"ATGATGT","TAGA","CAGATGC","TTGA",2.25908985815264,16,8,18,51,2.46106634516174,4.38041634987816,7.91664823393613,101,"ENSG00000079974.19"
"10405","ENSG00000130939.20_13637",13629,13637,9,"ENSG00000130939.20",0,NA,"UVVVVUVVV",2,7,0.824844720496894,114,120,133,136,145,151,204,207,"ATAATGG","CTGT","GGGAAGA","CTGA",2.47822437205202,13,9,53,84,1.94739526294558,4.61722276915643,7.91660165114401,101,"ENSG00000079974.19"
"35748","ENSG00000236963.9_58566",58558,58566,9,"ENSG00000236963.9",1,7,"VVVVVVMVV",0,8,0.885300207039338,115,121,133,136,137,143,152,155,"ATGATAC","CAGA","CTGAAGC","CTGG",2.22980388090732,12,1,9,31,2.63618269851883,4.37538547614191,7.91658630429926,101,"ENSG00000079974.19"
"38914","ENSG00000251291.2_69728",69720,69728,9,"ENSG00000251291.2",1,3,"VVMVVVVVV",0,8,0.882815734989648,114,120,133,136,140,146,184,187,"ATGTTGG","ATGT","GTAATGT","CTGA",2.35163807247066,13,4,38,64,1.86358030880135,4.38529186465145,7.91655480461004,101,"ENSG00000079974.19"
"43875","ENSG00000274840.4_21683",21675,21683,9,"ENSG00000274840.4",1,3,"VVMVVVVVV",0,8,0.882815734989648,111,117,133,136,144,150,171,174,"CTAATGA","GTGT","ATTTTTA","CTGA",2.28842439647984,16,8,21,54,2.2849160480881,4.38526967282175,7.91653261278034,101,"ENSG00000079974.19"
"15184","ENSG00000147255.19_237988",237980,237988,9,"ENSG00000147255.19",1,8,"VVVVVUVMV",1,7,0.806211180124224,115,121,133,136,176,182,200,203,"ATGAGGA","GTGG","GTGAAGA","CTGA",2.5684531661222,12,40,18,79,1.6436193973638,4.69166012621128,7.91650484670818,101,"ENSG00000079974.19"
"12840","ENSG00000139180.11_14952",14944,14952,9,"ENSG00000139180.11",1,6,"UVVVVMVVV",1,7,0.805383022774327,86,92,107,110,112,118,133,136,"GTGATGA","CTGA","AAGATTT","TTGA",2.47558324199666,15,2,15,41,2.27597803192469,4.6949665779756,7.91649866907291,101,"ENSG00000079974.19"
"40347","ENSG00000255639.3_14946",14938,14946,9,"ENSG00000255639.3",1,6,"UVVVVMVVV",1,7,0.805383022774327,86,92,107,110,112,118,133,136,"GTGATGA","CTGA","AAGATTT","TTGA",2.47558324199666,15,2,15,41,2.27597803192469,4.6949665779756,7.91649866907291,101,"ENSG00000079974.19"
"37367","ENSG00000247828.10_161045",161037,161045,9,"ENSG00000247828.10",1,1,"MVVVUVVVV",1,7,0.795859213250517,114,120,133,136,142,148,197,200,"ATAATGG","CTAA","GTGATTA","CTGA",2.54245954355018,13,6,49,77,1.98248073634324,4.73305275666944,7.91648960967151,101,"ENSG00000079974.19"
"3536","ENSG00000085491.17_65945",65937,65945,9,"ENSG00000085491.17",1,8,"VVVVVVVMV",0,8,0.884057971014493,105,111,133,136,138,144,164,167,"ATGATTC","GAGA","TTGAAGA","CTGA",2.42128174059807,22,2,20,53,1.37882517932471,4.38017586249462,7.91640774655259,101,"ENSG00000079974.19"
"27771","ENSG00000187323.12_666903",666895,666903,9,"ENSG00000187323.12",1,2,"VMVVVVVVV",0,8,0.884057971014493,74,80,93,96,106,112,133,136,"ATGAAGA","ATGA","AAGCAGA","CTGG",2.27492246703636,13,10,21,53,2.35429579200826,4.38011139306266,7.91634327712063,101,"ENSG00000079974.19"
"21923","ENSG00000169306.10_284374",284366,284374,9,"ENSG00000169306.10",1,7,"VVVVVVMVV",0,8,0.885300207039338,107,113,133,136,144,150,168,171,"ATGATTG","TGGA","GTCAGGC","CTGA",2.30810442785238,20,8,18,55,2.11309340710084,4.37511406486251,7.91631489301986,101,"ENSG00000079974.19"
"28967","ENSG00000196839.14_34516",34508,34516,9,"ENSG00000196839.14",0,NA,"VVVUVVVVV",1,8,0.880745341614907,69,75,86,89,107,113,133,136,"GTGCTGG","GTGA","ATGTTCT","CTGA",2.35640715693082,11,18,20,58,1.86395289218285,4.39333348459708,7.9163148510567,101,"ENSG00000079974.19"
"39039","ENSG00000251555.1_10143",10135,10143,9,"ENSG00000251555.1",1,2,"VMVVVVVVV",0,8,0.884057971014493,93,99,105,108,112,118,133,136,"TAGATGA","CTGA","ATATTGT","CTCA",2.28169790590949,6,4,15,34,2.30900909342729,4.3800821165393,7.91631400059727,101,"ENSG00000079974.19"
"12045","ENSG00000136931.10_14996",14988,14996,9,"ENSG00000136931.10",0,NA,"UVVVVUVVV",2,7,0.824844720496894,108,114,133,136,178,184,193,196,"ATGAGGA","CAGA","ATGGCCA","CTGA",2.53307532896088,19,42,9,79,1.58037691432431,4.61688644351588,7.91626532550346,101,"ENSG00000079974.19"
"8676","ENSG00000120251.22_168517",168509,168517,9,"ENSG00000120251.22",1,5,"VVVVMVVVV",0,8,0.886542443064182,78,84,97,100,116,122,133,136,"GTGTTGA","CAGA","TAGATGT","CTCA",2.25136009519576,13,16,11,49,2.47123372674381,4.37007525701222,7.91624502926895,101,"ENSG00000079974.19"
"34867","ENSG00000234323.10_366527",366519,366527,9,"ENSG00000234323.10",0,NA,"UVVVVVVVV",1,8,0.902691511387163,112,118,133,136,160,166,217,220,"GTGATGT","CAGT","GTGTTTT","CTGA",2.42455232599145,15,24,51,99,1.05817430218793,4.30546411886606,7.91623016441471,101,"ENSG00000079974.19"
"26476","ENSG00000184305.16_1143556",1143548,1143556,9,"ENSG00000184305.16",1,8,"VVVVVVVMV",0,8,0.884057971014493,88,94,133,136,159,165,182,185,"GTAATGA","CAGA","TTTATTA","CTGA",2.49703283577963,39,23,17,88,0.872849649132259,4.37993380524911,7.91616568930708,101,"ENSG00000079974.19"
"25704","ENSG00000182621.18_174738",174730,174738,9,"ENSG00000182621.18",0,NA,"VVVVUUVVV",2,7,0.812008281573499,83,89,104,107,115,121,133,136,"GTCAAGA","CTGC","TTGAAAA","CTGA",2.37142709339248,15,8,12,44,2.86287027441583,4.66809605759142,7.91612918388542,101,"ENSG00000079974.19"
"31963","ENSG00000225479.1_3285",3277,3285,9,"ENSG00000225479.1",0,NA,"VVVVUUVVV",2,7,0.812008281573499,83,89,104,107,115,121,133,136,"GTCAAGA","CTGC","TTGAAAA","CTGA",2.37142709339248,15,8,12,44,2.86287027441583,4.66809605759142,7.91612918388542,101,"ENSG00000079974.19"
"16285","ENSG00000151276.24_627129",627121,627129,9,"ENSG00000151276.24",1,7,"VVVVVVMVV",0,8,0.885300207039338,108,114,133,136,141,147,163,166,"TTGGTGT","CGGA","ATTCTGG","CTGA",2.28474719556964,19,5,16,49,2.2680215466113,4.37491737926889,7.91611820742624,101,"ENSG00000079974.19"
"9216","ENSG00000123119.12_42785",42777,42785,9,"ENSG00000123119.12",1,5,"VVVVMVVVV",0,8,0.886542443064182,34,40,62,65,116,122,133,136,"GGGATGA","CTGA","TCGATGA","CTCA",2.42343661444866,22,51,11,93,1.32350068226037,4.36993619464619,7.91610596690292,101,"ENSG00000079974.19"
"31524","ENSG00000223993.2_19341",19333,19341,9,"ENSG00000223993.2",1,8,"VVVVVVVMV",0,8,0.884057971014493,116,122,133,136,140,146,182,185,"ATGCTTA","GAGA","GTGTTGG","CTGA",2.34940060134307,11,4,36,60,1.85663994564415,4.37982765531616,7.91605953937413,101,"ENSG00000079974.19"
"28371","ENSG00000188897.10_59550",59542,59550,9,"ENSG00000188897.10",1,5,"UVVVMVVVV",1,7,0.789233954451346,115,121,133,136,145,151,161,164,"ATGATGA","TTGA","GGTATCA","ATGA",2.40789947376305,12,9,10,40,2.98383131815811,4.75912361914462,7.91605943695,101,"ENSG00000079974.19"
"30796","ENSG00000213639.11_18832",18824,18832,9,"ENSG00000213639.11",1,8,"VVVVVVVMV",0,8,0.884057971014493,74,80,101,104,115,121,133,136,"ATCATGC","CTGA","TTTATGT","CTAA",2.29739949758585,21,11,12,53,2.20311905755079,4.37977892703078,7.91601081108875,101,"ENSG00000079974.19"
"20754","ENSG00000165525.18_52271",52263,52271,9,"ENSG00000165525.18",1,8,"VVVVVUVMV",1,7,0.806211180124224,67,73,84,87,94,100,133,136,"AAGAGGA","CAGA","GAGATGA","CTGA",2.50705770274257,11,7,33,60,2.05068975827797,4.69110194414044,7.91594666463733,101,"ENSG00000079974.19"
"19051","ENSG00000160584.17_220560",220552,220560,9,"ENSG00000160584.17",1,3,"VVMVVVVVV",0,8,0.882815734989648,106,112,133,136,150,156,173,176,"ATGAGGA","CAGA","GTGCTGT","CTGC",2.37121480772536,21,14,17,61,1.73019414855162,4.38457321668017,7.91583615663876,101,"ENSG00000079974.19"
"43072","ENSG00000268038.5_2846",2838,2846,9,"ENSG00000268038.5",0,NA,"VVVVVUUVV",2,7,0.808281573498965,116,122,133,136,143,149,172,175,"CTGAGGG","CAGA","ATGATGT","CTGA",2.45944599214347,11,7,23,50,2.33425246943534,4.68263977093129,7.91576606492715,101,"ENSG00000079974.19"
"12429","ENSG00000138162.19_30459",30451,30459,9,"ENSG00000138162.19",0,NA,"VVUVVVUVV",2,7,0.769772256728778,95,101,133,136,139,145,157,160,"CTGATGT","CTGA","CTGACGG","CTGA",2.64965536725858,32,3,12,56,1.6823302818238,4.83667484922025,7.91576387613536,101,"ENSG00000079974.19"
"1082","ENSG00000047617.17_163943",163935,163943,9,"ENSG00000047617.17",1,8,"VVVVVVVMV",0,8,0.884057971014493,109,115,133,136,147,153,162,165,"ATGTTAA","CTAC","CTAATTA","CTGA",2.25227909388443,18,11,9,47,2.50284565971135,4.37950990473521,7.91574178879319,101,"ENSG00000079974.19"
"17097","ENSG00000153107.13_228803",228795,228803,9,"ENSG00000153107.13",1,2,"VMVVVVVVV",0,8,0.884057971014493,109,115,133,136,148,154,177,180,"TTGATCA","CAAA","GGGTTGA","CTGA",2.35903762146679,18,12,23,62,1.79087526305895,4.37944818487606,7.91568006893403,101,"ENSG00000079974.19"
"45106","ENSG00000285016.1_43146",43138,43146,9,"ENSG00000285016.1",1,2,"VMVVVVVVV",0,8,0.884057971014493,109,115,133,136,148,154,177,180,"TTGATCA","CAAA","GGGTTGA","CTGA",2.35903762146679,18,12,23,62,1.79087526305895,4.37944818487606,7.91568006893403,101,"ENSG00000079974.19"
"41534","ENSG00000259200.2_139436",139428,139436,9,"ENSG00000259200.2",0,NA,"VVVUVVVVV",1,8,0.880745341614907,115,121,133,136,141,147,155,158,"TTTAGGA","TTGC","GTTAAAA","CTGA",2.17384386333567,12,5,8,34,3.07847702438505,4.39269236165572,7.91567372811534,101,"ENSG00000079974.19"
"6602","ENSG00000110975.8_8184",8176,8184,9,"ENSG00000110975.8",1,5,"VVVVMVVVV",0,8,0.886542443064182,88,94,133,136,139,145,153,156,"ATTATGA","GTCA","ACTAAGA","CTGA",2.36919015154316,39,3,8,59,1.68305716486873,4.36941454378912,7.91558431604585,101,"ENSG00000079974.19"
"14462","ENSG00000145012.14_623416",623408,623416,9,"ENSG00000145012.14",1,8,"VVVVUVVMV",1,7,0.773913043478261,79,85,96,99,104,110,133,136,"GTGCTGC","CTGA","GTGAATA","CTGA",2.55188117501764,11,5,23,48,2.26679467221333,4.8198339597494,7.91548613366245,101,"ENSG00000079974.19"
"20623","ENSG00000165185.15_111249",111241,111249,9,"ENSG00000165185.15",1,8,"VVVVVVVMV",0,8,0.884057971014493,112,118,133,136,147,153,196,199,"ATGCTGT","GAGA","ATAAGGA","CTGA",2.3641667016883,15,11,43,78,1.75575240680716,4.37921593784896,7.91544782190693,101,"ENSG00000079974.19"
"23971","ENSG00000174600.14_13982",13974,13982,9,"ENSG00000174600.14",0,NA,"VVVVUVVVV",1,8,0.889855072463768,109,115,133,136,141,147,155,158,"ACGATGT","CTGT","CTGATCT","CTCA",2.22190628252006,18,5,8,40,2.6110837409858,4.35594807277987,7.91536836263495,101,"ENSG00000079974.19"
"36087","ENSG00000237877.8_159380",159372,159380,9,"ENSG00000237877.8",0,NA,"UVVVVUVVV",2,7,0.824844720496894,70,76,87,90,115,121,133,136,"ATGAAGA","CAGA","TTGATGA","ATGA",2.46107991952281,11,25,12,57,2.05675042332901,4.61598747170361,7.91536635369118,101,"ENSG00000079974.19"
"19954","ENSG00000164054.17_9881",9873,9881,9,"ENSG00000164054.17",1,3,"VVMVVVVVV",0,8,0.882815734989648,110,116,133,136,153,159,167,170,"ATAATTA","CAGA","TTGATGA","CAGA",2.30588770634608,17,17,8,51,2.16374476601005,4.38408236874598,7.91534530870457,101,"ENSG00000079974.19"
"40035","ENSG00000254734.1_59547",59539,59547,9,"ENSG00000254734.1",1,2,"VMVVVVVVV",0,8,0.884057971014493,110,116,133,136,150,156,188,191,"ATAATGT","TTAA","GTGAAAA","CTGA",2.40723445497995,17,14,32,72,1.46817631535953,4.37910150380647,7.91533338786444,101,"ENSG00000079974.19"
"18782","ENSG00000158470.5_51652",51644,51652,9,"ENSG00000158470.5",0,NA,"UVVVVVVVV",1,8,0.902691511387163,100,106,133,136,145,151,163,166,"ATGTTGG","GTCA","ATGGTTT","CTGA",2.28101823094579,27,9,12,57,2.01128328865986,4.30451787374127,7.91528391928993,101,"ENSG00000079974.19"
"36393","ENSG00000240423.3_75831",75823,75831,9,"ENSG00000240423.3",1,2,"VMVVVVVVV",0,8,0.884057971014493,82,88,106,109,114,120,133,136,"ATGTTGG","CTGA","AGGTTAA","CTAA",2.24897418668921,18,5,13,45,2.52296193527474,4.37903079496737,7.91526267902534,101,"ENSG00000079974.19"
"32437","ENSG00000226995.9_33426",33418,33426,9,"ENSG00000226995.9",1,1,"MVVVVVUVV",1,7,0.792132505175983,33,39,52,55,75,81,133,136,"ATGATAA","TTGA","ATGCTGA","CTGA",2.6567018507191,13,20,52,94,1.27520549818747,4.74663779241203,7.91516781311597,101,"ENSG00000079974.19"
"23669","ENSG00000173482.17_74968",74960,74968,9,"ENSG00000173482.17",1,8,"VVVVVVVMV",0,8,0.884057971014493,114,120,133,136,144,150,163,166,"ATGATCA","GTAA","GTGAAAC","CTTA",2.19028904580242,13,8,13,43,2.91376640783383,4.3789233449625,7.91515522902047,101,"ENSG00000079974.19"
"5510","ENSG00000105483.18_16723",16715,16723,9,"ENSG00000105483.18",0,NA,"VVUVVVUVV",2,7,0.769772256728778,114,120,133,136,140,146,165,168,"GTGATGT","GTGA","CAGATCA","CTGA",2.53943146122806,13,4,19,45,2.4146880499628,4.83605778120413,7.91514680811925,101,"ENSG00000079974.19"
"39472","ENSG00000253641.6_586",578,586,9,"ENSG00000253641.6",1,8,"VVVVVVVMV",0,8,0.884057971014493,98,104,133,136,146,152,200,203,"CTGAGGT","CTTA","TTGATGA","CTGA",2.483229313579,29,10,48,96,0.960701539078634,4.37889090740132,7.91512279145929,101,"ENSG00000079974.19"
"44511","ENSG00000282890.1_295344",295336,295344,9,"ENSG00000282890.1",1,1,"MVVUVVVVV",1,7,0.786749482401656,109,115,133,136,152,158,179,182,"AAGATGA","CCGA","GTGTTGT","CTGA",2.61858193657978,18,16,21,64,1.61528059546554,4.76812337649935,7.91512130610597,101,"ENSG00000079974.19"
"44548","ENSG00000282987.1_165407",165399,165407,9,"ENSG00000282987.1",1,2,"VMVVVVVVV",0,8,0.884057971014493,115,121,133,136,146,152,169,172,"AACATGA","ATGA","GTGAAAA","CAGA",2.23763541233244,12,10,17,48,2.59782127016637,4.378847671429,7.91507955548697,101,"ENSG00000079974.19"
"46629","ENSG00000286937.1_5000",4992,5000,9,"ENSG00000286937.1",1,7,"VVVVVVMVV",0,8,0.885300207039338,3,9,18,21,72,78,133,136,"GTGATGT","CTAA","ATGCTTC","CTGA",2.49866788006241,9,51,55,124,0.83772617273793,4.37387800995517,7.91507883811252,101,"ENSG00000079974.19"
"18225","ENSG00000156639.12_201424",201416,201424,9,"ENSG00000156639.12",0,NA,"VVVVUVVVV",1,8,0.889855072463768,109,115,133,136,140,146,160,163,"TGGAGGA","CTCA","AAGTTGT","CTGA",2.25616958647944,18,4,14,45,2.3814967845591,4.35565684027218,7.91507713012725,101,"ENSG00000079974.19"
"8297","ENSG00000118007.13_196194",196186,196194,9,"ENSG00000118007.13",1,1,"MVVVVVUVV",1,7,0.792132505175983,112,118,133,136,144,150,160,163,"GGGATGT","CTTA","GTTATTA","CTGA",2.41085196754913,15,8,10,42,2.91350402497271,4.74646261882506,7.91499263952899,101,"ENSG00000079974.19"
"26712","ENSG00000184911.15_6730",6722,6730,9,"ENSG00000184911.15",0,NA,"VVVUVVVVV",1,8,0.880745341614907,92,98,133,136,143,149,163,166,"GTGATTC","CTTA","ATGTAAA","CTGA",2.35320704536866,35,7,14,65,1.87995479384288,4.39200044074181,7.91498180720144,101,"ENSG00000079974.19"
"43154","ENSG00000269502.6_6634",6626,6634,9,"ENSG00000269502.6",0,NA,"VVVUVVVVV",1,8,0.880745341614907,92,98,133,136,143,149,163,166,"GTGATTC","CTTA","ATGTAAA","CTGA",2.35320704536866,35,7,14,65,1.87995479384288,4.39200044074181,7.91498180720144,101,"ENSG00000079974.19"
"24567","ENSG00000176928.7_19894",19886,19894,9,"ENSG00000176928.7",1,8,"VVVVVVVMV",0,8,0.884057971014493,90,96,133,136,140,146,164,167,"GTGATGG","GAGA","GTCAACA","CTGA",2.40550623944412,37,4,18,68,1.47808676360101,4.37869875664046,7.91493064069843,101,"ENSG00000079974.19"
"113","ENSG00000005108.17_222993",222985,222993,9,"ENSG00000005108.17",1,2,"VMVUVVVVV",1,7,0.764803312629399,71,77,104,107,112,118,133,136,"ATGATGT","GTGA","CTGGGGA","CTGA",2.63572925204993,27,5,15,56,1.85121484824225,4.85568579881045,7.91489904932805,101,"ENSG00000079974.19"
"37765","ENSG00000248752.3_982691",982683,982691,9,"ENSG00000248752.3",1,5,"VVVVMVVVV",0,8,0.886542443064182,91,97,105,108,116,122,133,136,"AGGATGG","CAGA","CAGATAA","CTGT",2.20030659137563,8,8,11,36,2.80610115474832,4.3687029409798,7.91487271323653,101,"ENSG00000079974.19"
"30606","ENSG00000206047.3_2055",2047,2055,9,"ENSG00000206047.3",1,5,"VVVVMVUVV",1,7,0.772670807453416,116,122,133,136,142,148,159,162,"ATTCTGA","CTGC","GTGTTTA","CTGA",2.44096428893312,11,6,11,37,3.02323689980693,4.82408303984026,7.91476626965392,101,"ENSG00000079974.19"
"36364","ENSG00000240247.8_2044",2036,2044,9,"ENSG00000240247.8",1,5,"VVVVMVUVV",1,7,0.772670807453416,116,122,133,136,142,148,159,162,"ATTCTGA","CTGC","GTGTTTA","CTGA",2.44096428893312,11,6,11,37,3.02323689980693,4.82408303984026,7.91476626965392,101,"ENSG00000079974.19"
"13131","ENSG00000140382.15_63437",63429,63437,9,"ENSG00000140382.15",1,6,"VVVVVMVVV",0,8,0.902691511387163,81,87,104,107,116,122,133,136,"CTGAGGA","CAGA","GGAAAGA","CTAA",2.17807884817598,17,9,11,46,2.6954680462079,4.30399842517861,7.91476447072727,101,"ENSG00000079974.19"
"41786","ENSG00000259723.1_1700",1692,1700,9,"ENSG00000259723.1",1,5,"UVVVMVVVV",1,7,0.789233954451346,88,94,133,136,178,184,193,196,"ATGATGA","CTGG","TTGCTCA","CTGA",2.70381314903765,39,42,9,99,1.00567711315764,4.75777452668549,7.91471034449087,101,"ENSG00000079974.19"
"26038","ENSG00000183230.18_1018477",1018469,1018477,9,"ENSG00000183230.18",1,1,"MVVUVVVVV",1,7,0.786749482401656,113,119,133,136,165,171,190,193,"ATGATGC","CTCC","GTGATGA","CTGA",2.62055471597789,14,29,19,71,1.60046217993091,4.76770673827922,7.91470466788584,101,"ENSG00000079974.19"
"7963","ENSG00000116147.17_295993",295985,295993,9,"ENSG00000116147.17",0,NA,"VVUVVVVVV",1,8,0.883643892339545,100,106,133,136,150,156,167,170,"ATCATGT","CAGC","TTGAGGT","CTGA",2.37139246650832,27,14,11,61,1.71120519043264,4.38012207512202,7.9146976444802,101,"ENSG00000079974.19"
"13741","ENSG00000143341.12_306953",306945,306953,9,"ENSG00000143341.12",1,3,"VVMVVVVVV",0,8,0.882815734989648,112,118,133,136,150,156,171,174,"GTTCTGA","CACA","GTGTTGG","CTGA",2.27761847778178,15,14,15,53,2.34953424156411,4.38341435669399,7.91467729665258,101,"ENSG00000079974.19"
"17122","ENSG00000153201.17_44616",44608,44616,9,"ENSG00000153201.17",1,2,"UMVVVVVVV",1,7,0.786749482401656,70,76,88,91,109,115,133,136,"ATGATGA","TTGA","CTGATAA","GTGA",2.55923272665881,12,18,18,57,2.00897062613614,4.76763053429871,7.91462846390534,101,"ENSG00000079974.19"
"34930","ENSG00000234423.2_183370",183362,183370,9,"ENSG00000234423.2",1,8,"UVVVVVVMV",1,7,0.786749482401656,116,122,133,136,142,148,157,160,"ATGAAGA","ATGA","CTGATTA","CTCA",2.39723786278925,11,6,9,35,3.08888184458108,4.76761689912735,7.91461482873398,101,"ENSG00000079974.19"
"9524","ENSG00000125246.16_71463",71455,71463,9,"ENSG00000125246.16",0,NA,"VVUVVVVVV",1,8,0.883643892339545,116,122,133,136,148,154,189,192,"ATGCAGA","ATGG","TTGTTGA","CTGA",2.35894534017708,11,12,35,67,1.79368048993213,4.37999568944483,7.914571258803,101,"ENSG00000079974.19"
"6121","ENSG00000108021.22_50779",50771,50779,9,"ENSG00000108021.22",0,NA,"VVUVVVVVV",1,8,0.883643892339545,87,93,108,111,114,120,133,136,"GTGAAGA","CAGA","GTAAATA","ATGA",2.24358280437661,15,3,13,40,2.5626010950941,4.37995494773455,7.91453051709273,101,"ENSG00000079974.19"
"40610","ENSG00000257164.5_31685",31677,31685,9,"ENSG00000257164.5",1,5,"UVVVMVVVV",1,7,0.789233954451346,113,119,133,136,143,149,160,163,"ATGTTGA","AAGA","GAGGTTA","CTGA",2.40846729999312,14,7,11,41,2.97383677531519,4.75757136048399,7.91450717828937,101,"ENSG00000079974.19"
"14479","ENSG00000145087.13_397817",397809,397817,9,"ENSG00000145087.13",1,2,"VMVVVUVVV",1,7,0.806211180124223,111,117,133,136,150,156,172,175,"ATGATGG","CAAA","ATAATAA","CTGA",2.48088842207332,16,14,16,55,2.21925416276112,4.68962757747915,7.91447229797605,101,"ENSG00000079974.19"
"35373","ENSG00000235885.8_153885",153877,153885,9,"ENSG00000235885.8",1,8,"VVVVUVVMV",1,7,0.773913043478261,95,101,133,136,141,147,156,159,"ATGATAA","ATGA","TTGAGGT","CTGA",2.59825199363423,32,5,9,55,1.95350799076556,4.81879698708177,7.91444916099482,101,"ENSG00000079974.19"
"21952","ENSG00000169372.13_74979",74971,74979,9,"ENSG00000169372.13",1,7,"VVVVVVMVV",0,8,0.885300207039338,115,121,133,136,152,158,192,195,"ATGCTAA","GGGA","GTGATCA","CTGA",2.39106256169766,12,16,34,71,1.55236704080061,4.37319602969625,7.9143968578536,101,"ENSG00000079974.19"
"11910","ENSG00000136492.10_17719",17711,17719,9,"ENSG00000136492.10",1,2,"UMVVVVVVV",1,7,0.786749482401656,112,118,133,136,161,167,177,180,"TTGATGA","CTAA","GTTTTTA","CTGA",2.55542559048985,15,25,10,59,2.03333013577129,4.76737518475924,7.91437311436586,101,"ENSG00000079974.19"
"5127","ENSG00000103316.12_40983",40975,40983,9,"ENSG00000103316.12",1,8,"VVVVUVVMV",1,7,0.773913043478261,110,116,133,136,140,146,163,166,"ATGATGA","GTGC","ACGTGGA","CTGA",2.54725342911748,17,4,17,47,2.29314669564479,4.81870905577366,7.9143612296867,101,"ENSG00000079974.19"
"3666","ENSG00000087303.19_18867",18859,18867,9,"ENSG00000087303.19",1,1,"MVVVVUVVV",1,7,0.82815734989648,114,120,133,136,143,149,174,177,"GTGTTGT","ATGA","CTGATAG","CTGA",2.42072321662151,13,7,25,54,2.2687465120276,4.60172532237608,7.914354721962,101,"ENSG00000079974.19"
"25302","ENSG00000180628.15_10893",10885,10893,9,"ENSG00000180628.15",1,7,"UVVVVVMVV",1,7,0.787991718426501,78,84,96,99,113,119,133,136,"ATTGTGA","CAGA","TTGATTA","CTGA",2.48310298541056,12,14,14,49,2.4955092537077,4.76238228911119,7.91434916281719,101,"ENSG00000079974.19"
"31405","ENSG00000223715.3_206082",206074,206082,9,"ENSG00000223715.3",1,2,"VMVVVVVVV",0,8,0.884057971014493,73,79,93,96,116,122,133,136,"ATGCTGT","CTGA","TTTATCA","CTGG",2.29264994087242,14,20,11,54,2.22777040045062,4.37802583490002,7.91425771895799,101,"ENSG00000079974.19"
"18895","ENSG00000159216.19_280695",280687,280695,9,"ENSG00000159216.19",0,NA,"VVUVVVVVV",1,8,0.883643892339545,69,75,85,88,95,101,133,136,"TTGATGG","CAGA","GTGAAGG","GTGA",2.32633670471939,10,7,32,58,2.00964354873527,4.3796387283828,7.91421429774098,101,"ENSG00000079974.19"
"33700","ENSG00000230794.1_8970",8962,8970,9,"ENSG00000230794.1",0,NA,"VVUVVVVVV",1,8,0.883643892339545,69,75,85,88,95,101,133,136,"TTGATGG","CAGA","GTGAAGG","GTGA",2.32633670471939,10,7,32,58,2.00964354873527,4.3796387283828,7.91421429774098,101,"ENSG00000079974.19"
"9259","ENSG00000123500.10_33998",33990,33998,9,"ENSG00000123500.10",1,3,"VVMVVVVVV",0,8,0.882815734989648,103,109,133,136,144,150,165,168,"ATTTTGA","GAGA","GTAATGC","CTGA",2.32646899383578,24,8,15,56,2.02174888831231,4.38288554513771,7.9141484850963,101,"ENSG00000079974.19"
"36799","ENSG00000243055.1_6763",6755,6763,9,"ENSG00000243055.1",1,2,"VMVVVVVVV",0,8,0.884057971014493,114,120,133,136,187,193,233,236,"GTGATGG","GTAA","GTGTGGA","CTGA",2.47417896802377,13,51,40,113,1.01685108915111,4.37784438566073,7.9140762697187,101,"ENSG00000079974.19"
"21538","ENSG00000168243.11_88968",88960,88968,9,"ENSG00000168243.11",0,NA,"VVVVVVUVV",1,8,0.886128364389234,111,117,133,136,144,150,191,194,"TTTAAGA","CTGT","ATGAACA","CTGA",2.34553838242796,16,8,41,74,1.84130438077578,4.36955673257388,7.91407019013081,101,"ENSG00000079974.19"
"40740","ENSG00000257522.7_174891",174883,174891,9,"ENSG00000257522.7",1,8,"VVVVVVVMV",0,8,0.884057971014493,104,110,133,136,146,152,191,194,"GTGATGC","CCAA","GTGCTGG","CTGA",2.44727619755733,23,10,39,81,1.19616763859309,4.37783557224383,7.9140674563018,101,"ENSG00000079974.19"
"1987","ENSG00000068724.18_4119",4111,4119,9,"ENSG00000068724.18",1,7,"VVVVVVMVV",0,8,0.885300207039338,108,114,133,136,142,148,160,163,"AGGGTGA","TGGA","GGCATGT","CTGA",2.24524173497248,19,6,12,46,2.52282050316678,4.37277468407917,7.91397551223652,101,"ENSG00000079974.19"
"42760","ENSG00000266524.3_10374",10366,10374,9,"ENSG00000266524.3",1,8,"VVVVVUVMV",1,7,0.806211180124224,115,121,133,136,146,152,178,181,"AAGACGA","CGGA","GGGATGA","CTGA",2.49325417643901,12,10,26,57,2.13469969700818,4.68909855165039,7.91394327214728,101,"ENSG00000079974.19"
"28581","ENSG00000196177.13_47329",47321,47329,9,"ENSG00000196177.13",0,NA,"VVVVVVUVV",1,8,0.886128364389234,110,116,133,136,160,166,187,190,"ATCATGG","CTTC","ATGAAGA","CTGA",2.41735637979186,17,24,21,71,1.36200110152543,4.36942757503446,7.9139410325914,101,"ENSG00000079974.19"
"13095","ENSG00000140090.18_47825",47817,47825,9,"ENSG00000140090.18",0,NA,"VVUVVVVVV",1,8,0.883643892339545,82,88,133,136,144,150,161,164,"AAGATGG","TTGC","ATTATTA","CTGA",2.33171748766572,45,8,11,73,1.97263823835189,4.37935537236417,7.91393094172235,101,"ENSG00000079974.19"
"6859","ENSG00000112139.17_4591",4583,4591,9,"ENSG00000112139.17",0,NA,"UVVVVVVVV",1,8,0.902691511387163,116,122,133,136,178,184,195,198,"TTGCTGG","TTTA","AGGATGA","CTGA",2.28695827477131,11,42,11,73,1.96546834025181,4.3029642096818,7.91373025523045,101,"ENSG00000079974.19"
"35509","ENSG00000236212.2_39392",39384,39392,9,"ENSG00000236212.2",1,3,"VVMVVVVVV",0,8,0.882815734989648,109,115,133,136,145,151,196,199,"ATGAGGG","TGGA","ATGTAGA","CTGA",2.38581845539439,18,9,45,81,1.62430067836107,4.38243926191425,7.91370220187284,101,"ENSG00000079974.19"
"17348","ENSG00000153944.12_107095",107087,107095,9,"ENSG00000153944.12",1,6,"VVVVVMVVV",0,8,0.902691511387163,64,70,93,96,109,115,133,136,"ATGAAGG","CTGA","ATGGTGT","CTGT",2.34122102714419,23,13,18,63,1.60320567007349,4.30283646275869,7.91360250830735,101,"ENSG00000079974.19"
"42685","ENSG00000265752.3_4308",4300,4308,9,"ENSG00000265752.3",1,8,"VVVVVUUMV",2,6,0.692339544513457,103,109,133,136,149,155,169,172,"ATGAAGA","CTGA","CTGATGA","CTGA",2.81899360325392,24,13,14,60,1.78349840429396,5.14419727316336,7.91355545121719,101,"ENSG00000079974.19"
"4961","ENSG00000102466.16_580411",580403,580411,9,"ENSG00000102466.16",1,7,"VVVVVVMVV",0,8,0.885300207039338,88,94,133,136,146,152,161,164,"ATGATCA","CTAT","AAAATAA","CTGA",2.33854801514634,39,10,9,67,1.8988869988405,4.37230177495403,7.91350260311138,101,"ENSG00000079974.19"
"16084","ENSG00000150672.19_262096",262088,262096,9,"ENSG00000150672.19",0,NA,"VVVVVVUVV",1,8,0.886128364389234,94,100,133,136,145,151,171,174,"GTGATGA","ATGT","ATGAAGA","CTCA",2.39880094051943,33,9,20,71,1.48390574678739,4.36897800422923,7.91349146178616,101,"ENSG00000079974.19"
"40482","ENSG00000256551.2_8586",8578,8586,9,"ENSG00000256551.2",1,1,"MVVUVVVVV",1,7,0.786749482401656,95,101,110,113,116,122,133,136,"TTGAGGA","CTGC","CTTTTGA","CTGA",2.44294524174549,9,3,11,32,2.7794809799021,4.76644564788468,7.9134435774913,101,"ENSG00000079974.19"
"30376","ENSG00000204764.14_232538",232530,232538,9,"ENSG00000204764.14",1,3,"VVMVVVVVV",0,8,0.882815734989648,108,114,133,136,147,153,166,169,"TTGATGA","CAGT","TTGAAAA","TTGA",2.27954242058876,19,11,13,52,2.33134028705301,4.38207243941119,7.91333537936979,101,"ENSG00000079974.19"
"12385","ENSG00000138035.15_24800",24792,24800,9,"ENSG00000138035.15",1,7,"VVVVVVMVV",0,8,0.885300207039338,114,120,133,136,144,150,160,163,"ATTATGA","TTAA","ATAAAGT","ATGA",2.17096509887115,13,8,10,40,3.01535129197326,4.37211298777856,7.91331381593591,101,"ENSG00000079974.19"
"17106","ENSG00000153113.24_76309",76301,76309,9,"ENSG00000153113.24",1,6,"VVVVVMVVV",0,8,0.902691511387163,107,113,133,136,185,191,202,205,"ATTATTA","GTTA","CTGGTGA","CTGA",2.35994250343053,20,49,11,89,1.47723715384687,4.30254679417927,7.91331283972792,101,"ENSG00000079974.19"
"38941","ENSG00000251314.2_639575",639567,639575,9,"ENSG00000251314.2",1,6,"VVVVVMVVV",0,8,0.902691511387163,107,113,133,136,185,191,202,205,"ATTATTA","GTTA","CTGGTGA","CTGA",2.35994250343053,20,49,11,89,1.47723715384687,4.30254679417927,7.91331283972792,101,"ENSG00000079974.19"
"45580","ENSG00000285713.1_618925",618917,618925,9,"ENSG00000285713.1",1,3,"VVMVVUVVV",1,7,0.804968944099379,79,85,100,103,115,121,133,136,"GTGAAGA","TGGA","TTGAATA","CTGA",2.4207442598156,15,12,12,48,2.6352298265801,4.69338122300437,7.91325699940188,101,"ENSG00000079974.19"
"45665","ENSG00000285783.1_391704",391696,391704,9,"ENSG00000285783.1",1,3,"VVMVVUVVV",1,7,0.804968944099379,79,85,100,103,115,121,133,136,"GTGAAGA","TGGA","TTGAATA","CTGA",2.4207442598156,15,12,12,48,2.6352298265801,4.69338122300437,7.91325699940188,101,"ENSG00000079974.19"
"39651","ENSG00000254031.6_23581",23573,23581,9,"ENSG00000254031.6",1,2,"VMVVVVVVV",0,8,0.884057971014493,101,107,133,136,137,143,157,160,"ATGTTGT","CAGG","ATGATAA","CTGA",2.42647761282849,26,1,14,50,1.33141942220733,4.37698421026599,7.91321609432396,101,"ENSG00000079974.19"
"45440","ENSG00000285579.1_509666",509658,509666,9,"ENSG00000285579.1",1,2,"VMVVVVVVV",0,8,0.884057971014493,101,107,133,136,137,143,157,160,"ATGTTGT","CAGG","ATGATAA","CTGA",2.42647761282849,26,1,14,50,1.33141942220733,4.37698421026599,7.91321609432396,101,"ENSG00000079974.19"
"40531","ENSG00000256915.2_9116",9108,9116,9,"ENSG00000256915.2",1,8,"VVVVVUVMV",1,7,0.806211180124224,109,115,133,136,157,163,196,199,"ATGCTGC","CTGA","GTGATGT","CTGA",2.665915452326,18,21,33,81,0.98070345730234,4.68836828486892,7.91321300536582,101,"ENSG00000079974.19"
"3919","ENSG00000091009.8_29660",29652,29660,9,"ENSG00000091009.8",0,NA,"UVVVVVVVV",1,8,0.902691511387163,115,121,133,136,164,170,185,188,"ATCATAG","GAGA","GTGATGC","CTGA",2.29786364183593,12,28,15,64,1.89058946026008,4.30242010145824,7.91318614700689,101,"ENSG00000079974.19"
"43942","ENSG00000275740.1_29715",29707,29715,9,"ENSG00000275740.1",0,NA,"UVVVVVVVV",1,8,0.902691511387163,115,121,133,136,164,170,185,188,"ATCATAG","GAGA","GTGATGC","CTGA",2.29786364183593,12,28,15,64,1.89058946026008,4.30242010145824,7.91318614700689,101,"ENSG00000079974.19"
"32469","ENSG00000227042.1_107492",107484,107492,9,"ENSG00000227042.1",1,8,"VVVVVVVMV",0,8,0.884057971014493,115,121,133,136,146,152,170,173,"GTGTTCA","ATGC","CTGTTGG","CTGA",2.24582426669827,12,10,18,49,2.53562605218515,4.3769469575434,7.91317884160137,101,"ENSG00000079974.19"
"32226","ENSG00000226412.1_8519",8511,8519,9,"ENSG00000226412.1",0,NA,"UVVVVVVVV",1,8,0.902691511387163,87,93,133,136,153,159,172,175,"ATGTTGA","CAGC","ATTCTGG","CTGA",2.37912107329082,40,17,13,79,1.34870988767324,4.30237926073634,7.913145306285,101,"ENSG00000079974.19"
"16053","ENSG00000150672.19_159144",159136,159144,9,"ENSG00000150672.19",0,NA,"VVVVUVVVV",1,8,0.889855072463768,111,117,133,136,156,162,177,180,"GTGGTAA","GTCA","ATGAGGA","CTGA",2.32228743548907,16,20,15,60,1.93297899991128,4.35372380912627,7.91314409898134,101,"ENSG00000079974.19"
"6167","ENSG00000108370.17_86650",86642,86650,9,"ENSG00000108370.17",0,NA,"VVVVVVUVV",1,8,0.886128364389234,113,119,133,136,152,158,174,177,"AAGATTT","ATGA","GGGAAGC","CTGA",2.28943435454136,14,16,16,55,2.2110983432234,4.36849851004145,7.91301196759839,101,"ENSG00000079974.19"
"32184","ENSG00000226296.1_16464",16456,16464,9,"ENSG00000226296.1",1,2,"UMVVVVVVV",1,7,0.786749482401656,114,120,133,136,146,152,170,173,"ATAATGA","TTTA","TTGAAGG","CTGA",2.47999850536888,13,10,18,50,2.53065735172939,4.76599518021381,7.91299310982044,101,"ENSG00000079974.19"
"7086","ENSG00000112701.18_41555",41547,41555,9,"ENSG00000112701.18",1,5,"VVVVMVVVV",0,8,0.886542443064182,94,100,107,110,114,120,133,136,"TTGAGGA","TTGA","TTGGTAA","TTGA",2.23353452051335,7,4,13,33,2.57688492756612,4.36677876608045,7.91294853833718,101,"ENSG00000079974.19"
"14624","ENSG00000145526.12_327153",327145,327153,9,"ENSG00000145526.12",1,6,"VVVVVMVVV",0,8,0.902691511387163,45,51,68,71,79,85,133,136,"ATGGTGT","CTGA","ATAATCA","GTGA",2.31948404117269,17,8,48,82,1.74547711270373,4.30217601346375,7.9129420590124,101,"ENSG00000079974.19"
"3703","ENSG00000088367.23_124553",124545,124553,9,"ENSG00000088367.23",1,6,"VVVVVMUVV",1,7,0.788819875776397,78,84,95,98,100,106,133,136,"AGCATGA","CTGA","GTGAGGG","CTGA",2.59887508583036,11,2,27,49,1.70480235647046,4.75765906550155,7.91293856860714,101,"ENSG00000079974.19"
"39424","ENSG00000253557.6_69861",69853,69861,9,"ENSG00000253557.6",1,2,"VMVVVVVVV",0,8,0.884057971014493,82,88,133,136,146,152,177,180,"TTGAAGA","ATAA","GTGATAA","CTGA",2.45028048995864,45,10,25,89,1.17155551104198,4.37668969435822,7.91292157841619,101,"ENSG00000079974.19"
"29054","ENSG00000197085.11_325855",325847,325855,9,"ENSG00000197085.11",0,NA,"VVVVVVUVV",1,8,0.886128364389234,51,57,71,74,110,116,133,136,"ATGATGA","CTGA","ATGTTGT","CAGG",2.36935931467181,14,36,17,76,1.67789831956349,4.36840677101056,7.9129202285675,101,"ENSG00000079974.19"
"17703","ENSG00000154920.15_2401",2393,2401,9,"ENSG00000154920.15",1,8,"VVVVVVVMV",0,8,0.884057971014493,112,118,133,136,147,153,200,203,"ATCATGT","CTTT","CTGAAGT","CTGA",2.3635987294045,15,11,47,82,1.74936896900489,4.37667345792539,7.91290534198336,101,"ENSG00000079974.19"
"40778","ENSG00000257612.2_23162",23154,23162,9,"ENSG00000257612.2",1,8,"VVVVVUVMV",1,7,0.806211180124224,110,116,133,136,171,177,185,188,"TTGTTCA","CTGA","TTGATGA","CTGA",2.54957150384329,17,35,8,69,1.75501648093414,4.68803995997236,7.91288468046925,101,"ENSG00000079974.19"
"40910","ENSG00000258081.4_296499",296491,296499,9,"ENSG00000258081.4",1,8,"VVVVVUVMV",1,7,0.806211180124224,110,116,133,136,171,177,185,188,"TTGTTCA","CTGA","TTGATGA","CTGA",2.54957150384329,17,35,8,69,1.75501648093414,4.68803995997236,7.91288468046925,101,"ENSG00000079974.19"
"4827","ENSG00000101972.20_401344",401336,401344,9,"ENSG00000101972.20",1,8,"VVVVVVVMV",0,8,0.884057971014493,83,89,133,136,142,148,184,187,"GTAATGA","TAGA","GTGAACA","CTGA",2.47171561070098,44,6,36,95,1.02832439304267,4.37660711609564,7.91283900015361,101,"ENSG00000079974.19"
"26353","ENSG00000183918.18_133688",133680,133688,9,"ENSG00000183918.18",1,8,"VVVVVVVMV",0,8,0.884057971014493,83,89,133,136,142,148,184,187,"GTAATGA","TAGA","GTGAACA","CTGA",2.47171561070098,44,6,36,95,1.02832439304267,4.37660711609564,7.91283900015361,101,"ENSG00000079974.19"
"33495","ENSG00000230013.2_17272",17264,17272,9,"ENSG00000230013.2",1,6,"VVVVVMVVV",0,8,0.902691511387163,116,122,133,136,142,148,167,170,"ATTATGA","ATTA","GTGAGTT","CTCA",2.2002472599098,11,6,19,45,2.53991395977249,4.30205725645946,7.91282330200811,101,"ENSG00000079974.19"
"36077","ENSG00000237844.2_519612",519604,519612,9,"ENSG00000237844.2",0,NA,"VVUVVVVVV",1,8,0.883643892339545,43,49,63,66,116,122,133,136,"TTGATGT","CAAA","ATCATTT","CTGA",2.33425231657827,14,50,11,84,1.95052286964765,4.37805124504237,7.91262681440055,101,"ENSG00000079974.19"
"43631","ENSG00000272975.1_159356",159348,159356,9,"ENSG00000272975.1",1,8,"VVVVVVVMV",0,8,0.884057971014493,96,102,112,115,116,122,133,136,"ATGATGT","TTTA","GTGACAT","ATGA",2.24440387126507,10,1,11,31,2.54248420840125,4.37629417087543,7.9125260549334,101,"ENSG00000079974.19"
"6446","ENSG00000109911.19_232238",232230,232238,9,"ENSG00000109911.19",1,7,"VVVVVVMVV",0,8,0.885300207039338,94,100,133,136,145,151,195,198,"AGGAGGA","TTGA","TAGATGA","CTGA",2.47629060408079,33,9,44,95,0.976638526060324,4.3713106383164,7.91251146647375,101,"ENSG00000079974.19"
"14144","ENSG00000144455.14_357432",357424,357432,9,"ENSG00000144455.14",1,7,"VVVVVVMVV",0,8,0.885300207039338,94,100,133,136,145,151,195,198,"AGGAGGA","TTGA","TAGATGA","CTGA",2.47629060408079,33,9,44,95,0.976638526060324,4.3713106383164,7.91251146647375,101,"ENSG00000079974.19"
"22789","ENSG00000171444.19_17727",17719,17727,9,"ENSG00000171444.19",1,7,"VVVVVVMVV",0,8,0.885300207039338,94,100,133,136,145,151,195,198,"AGGAGGA","TTGA","TAGATGA","CTGA",2.47629060408079,33,9,44,95,0.976638526060324,4.3713106383164,7.91251146647375,101,"ENSG00000079974.19"
"39194","ENSG00000253288.2_268674",268666,268674,9,"ENSG00000253288.2",1,7,"VVVVVVMVV",0,8,0.885300207039338,94,100,133,136,145,151,195,198,"AGGAGGA","TTGA","TAGATGA","CTGA",2.47629060408079,33,9,44,95,0.976638526060324,4.3713106383164,7.91251146647375,101,"ENSG00000079974.19"
"18053","ENSG00000156076.10_55812",55804,55812,9,"ENSG00000156076.10",1,6,"UVVVVMVVV",1,7,0.805383022774327,115,121,133,136,143,149,159,162,"TTTATGA","CTTT","GTTATGT","CTGA",2.35559206801481,12,7,10,38,3.05995008775671,4.69097430196387,7.91250639306118,101,"ENSG00000079974.19"
"37244","ENSG00000246273.9_43781",43773,43781,9,"ENSG00000246273.9",1,2,"UMVVVVVVV",1,7,0.786749482401656,54,60,75,78,84,90,133,136,"ATGAGGA","CAGA","GTGAATC","CTGA",2.57361586950142,15,6,43,73,1.90444368840952,4.76547070460475,7.91246863421138,101,"ENSG00000079974.19"
"7994","ENSG00000116254.18_42905",42897,42905,9,"ENSG00000116254.18",1,5,"VVVVMVVVV",0,8,0.886542443064182,98,104,133,136,150,156,164,167,"AGGATGA","CAGA","GTGGTGG","CTGT",2.37052607868227,29,14,8,60,1.66151009941268,4.36625432265696,7.91242409491369,101,"ENSG00000079974.19"
"17894","ENSG00000155761.14_118087",118079,118087,9,"ENSG00000155761.14",1,5,"VVVVMUVVV",1,7,0.808695652173913,110,116,133,136,142,148,175,178,"ATGAAGA","CCGC","CTGATGC","CTGA",2.51517580313215,17,6,27,59,1.942345507058,4.67754604865142,7.91232865734707,101,"ENSG00000079974.19"
"9799","ENSG00000127328.22_14176",14168,14176,9,"ENSG00000127328.22",1,8,"VVVVVVVMV",0,8,0.884057971014493,116,122,133,136,148,154,181,184,"TTTATGT","AGGA","TTGAAGA","CTGA",2.33402641173339,11,12,27,59,1.94419800259401,4.37609352020415,7.91232540426212,101,"ENSG00000079974.19"
"30791","ENSG00000213551.7_8048",8040,8048,9,"ENSG00000213551.7",0,NA,"VVUVVVVVV",1,8,0.883643892339545,113,119,133,136,145,151,161,164,"ATCAACA","TAGA","TTGAGGG","CTGA",2.18683570168117,14,9,10,42,2.93186797411539,4.37769316299746,7.91226873235563,101,"ENSG00000079974.19"
"36856","ENSG00000243276.6_62264",62256,62264,9,"ENSG00000243276.6",1,8,"VVVUVVVMV",1,7,0.764803312629399,112,118,133,136,142,148,167,170,"ATGATGC","AAGA","GTGATAG","CTGA",2.54129812835147,15,6,19,49,2.46976436755127,4.8529379724736,7.9121512229912,101,"ENSG00000079974.19"
"3521","ENSG00000085377.15_3423",3415,3423,9,"ENSG00000085377.15",1,8,"VVVVVVVMV",0,8,0.884057971014493,65,71,91,94,108,114,133,136,"CTGATGA","CTTA","CTGACCA","CAGA",2.37227715940723,20,14,19,62,1.68842002879523,4.37590027287753,7.9121321569355,101,"ENSG00000079974.19"
"25816","ENSG00000182901.18_232341",232333,232341,9,"ENSG00000182901.18",1,1,"MVUVVVVVV",1,7,0.789648033126294,76,82,97,100,115,121,133,136,"ATGAGGA","CTGA","CTCATGA","ATGA",2.48884132929431,15,15,12,51,2.42184094375225,4.75352911809525,7.91212125060042,101,"ENSG00000079974.19"
"14218","ENSG00000144619.15_627664",627656,627664,9,"ENSG00000144619.15",1,3,"VVMVVUVVV",1,7,0.804968944099379,116,122,133,136,141,147,158,161,"AGAAAGA","CTTA","ATGAGGA","CTGA",2.36615401889476,11,5,11,36,2.9946049370839,4.69224126576224,7.91211704215976,101,"ENSG00000079974.19"
"14816","ENSG00000145934.17_394194",394186,394194,9,"ENSG00000145934.17",1,8,"VVVVVVVMV",0,8,0.884057971014493,46,52,65,68,113,119,133,136,"ATTATGT","TTGA","GTGAAGA","CAGA",2.34504612600432,13,45,14,81,1.86959497114287,4.37580895279291,7.91204083685088,101,"ENSG00000079974.19"
"26653","ENSG00000184719.12_164865",164857,164865,9,"ENSG00000184719.12",1,8,"VVVVVUVMV",1,7,0.806211180124224,115,121,133,136,150,156,182,185,"ATCATGA","CTCT","ATGAAGA","CTGA",2.53333365555029,12,14,26,61,1.85927556532144,4.68704165058084,7.91188637107773,101,"ENSG00000079974.19"
"42248","ENSG00000261285.7_12184",12176,12184,9,"ENSG00000261285.7",1,8,"VVVVVVVMV",0,8,0.884057971014493,89,95,133,136,141,147,185,188,"ATAATGA","TTCA","ATGTTGG","CTGA",2.48067026990563,38,5,38,90,0.964731287265229,4.37563327165903,7.911865155717,101,"ENSG00000079974.19"
"13002","ENSG00000139865.17_238219",238211,238219,9,"ENSG00000139865.17",1,2,"VMVVVVVVV",0,8,0.884057971014493,90,96,133,136,142,148,158,161,"ATGATGG","CTTA","TTCATGT","CTCA",2.32717360269244,37,6,10,62,1.98802183449202,4.37562812977707,7.91186001383504,101,"ENSG00000079974.19"
"39161","ENSG00000253161.7_12969",12961,12969,9,"ENSG00000253161.7",1,8,"VVVVVUVMV",1,7,0.806211180124224,79,85,98,101,105,111,133,136,"ATGATCT","ATGA","ATTAGGA","CTGA",2.47578041302045,13,4,22,48,2.24281891569753,4.6870054172918,7.91185013778869,101,"ENSG00000079974.19"
"33499","ENSG00000230021.10_187009",187001,187009,9,"ENSG00000230021.10",0,NA,"VVVVUVVVV",1,8,0.889855072463768,98,104,133,136,153,159,168,171,"GTGATGT","TTGG","GTCTTCA","CTGA",2.38864172828485,29,17,9,64,1.4853199772376,4.35239954145082,7.91181983130589,101,"ENSG00000079974.19"
"33574","ENSG00000230423.3_73893",73885,73893,9,"ENSG00000230423.3",0,NA,"VVVVUVVVV",1,8,0.889855072463768,98,104,133,136,153,159,168,171,"GTGATGT","TTGG","GTCTTCA","CTGA",2.38864172828485,29,17,9,64,1.4853199772376,4.35239954145082,7.91181983130589,101,"ENSG00000079974.19"
"36155","ENSG00000238009.6_39025",39017,39025,9,"ENSG00000238009.6",0,NA,"VVVVUVVVV",1,8,0.889855072463768,98,104,133,136,153,159,168,171,"GTGATGT","TTGG","GTCTTCA","CTGA",2.38864172828485,29,17,9,64,1.4853199772376,4.35239954145082,7.91181983130589,101,"ENSG00000079974.19"
"42154","ENSG00000260923.7_39009",39001,39009,9,"ENSG00000260923.7",0,NA,"VVVVUVVVV",1,8,0.889855072463768,98,104,133,136,153,159,168,171,"GTGATGT","TTGG","GTCTTCA","CTGA",2.38864172828485,29,17,9,64,1.4853199772376,4.35239954145082,7.91181983130589,101,"ENSG00000079974.19"
"48083","ENSG00000290385.1_117891",117883,117891,9,"ENSG00000290385.1",0,NA,"VVVVUVVVV",1,8,0.889855072463768,98,104,133,136,153,159,168,171,"GTGATGT","TTGG","GTCTTCA","CTGA",2.38864172828485,29,17,9,64,1.4853199772376,4.35239954145082,7.91181983130589,101,"ENSG00000079974.19"
"48474","ENSG00000291147.1_68252",68244,68252,9,"ENSG00000291147.1",0,NA,"VVVVUVVVV",1,8,0.889855072463768,98,104,133,136,153,159,168,171,"GTGATGT","TTGG","GTCTTCA","CTGA",2.38864172828485,29,17,9,64,1.4853199772376,4.35239954145082,7.91181983130589,101,"ENSG00000079974.19"
"15841","ENSG00000149972.12_1081655",1081647,1081655,9,"ENSG00000149972.12",0,NA,"UVVVVVVVV",1,8,0.902691511387163,111,117,133,136,141,147,175,178,"CTGGTGC","GTCA","CTGATAA","CTGA",2.28904784003617,16,5,28,58,1.94385415611282,4.30104327242183,7.91180931797048,101,"ENSG00000079974.19"
"32093","ENSG00000225885.7_67235",67227,67235,9,"ENSG00000225885.7",0,NA,"UVVVVVVVV",1,8,0.902691511387163,115,121,133,136,162,168,177,180,"AGGTGGA","TGGA","GTGATAA","CTGA",2.26511563586703,12,26,9,56,2.10311469882405,4.30097140115106,7.91173744669971,101,"ENSG00000079974.19"
"25720","ENSG00000182621.18_90082",90074,90082,9,"ENSG00000182621.18",0,NA,"UVVVVVVVV",1,8,0.902691511387163,102,108,133,136,144,150,188,191,"TTTATTA","CTGA","GAGAAAA","CTGA",2.40221239676515,25,8,38,80,1.18865581955039,4.30085128282951,7.91161732837817,101,"ENSG00000079974.19"
"46357","ENSG00000286494.1_34397",34389,34397,9,"ENSG00000286494.1",1,6,"VVVVUMVVV",1,7,0.792546583850932,83,89,133,136,166,172,182,185,"ATCATGA","CTGA","CGGAAGA","CTGA",2.68709796820462,44,30,10,93,1.05144069491576,4.74135678740331,7.91154312280703,101,"ENSG00000079974.19"
"19803","ENSG00000163705.13_18200",18192,18200,9,"ENSG00000163705.13",1,8,"VVVVVVVMV",0,8,0.884057971014493,110,116,133,136,144,150,160,163,"GTTATGG","ATGA","GTGAGAA","TTGA",2.21260981649263,17,8,10,44,2.7503009857581,4.37525827392724,7.91149015798521,101,"ENSG00000079974.19"
"22119","ENSG00000169855.21_503873",503865,503873,9,"ENSG00000169855.21",1,6,"VVVVVMVVV",0,8,0.902691511387163,86,92,133,136,147,153,163,166,"AGGATGA","TGGA","CTGATGT","TTGA",2.30501740863864,41,11,10,71,1.83605265377188,4.30070884450737,7.91147489005602,101,"ENSG00000079974.19"
"3268","ENSG00000082805.21_392432",392424,392432,9,"ENSG00000082805.21",0,NA,"UVVVVUVVV",2,7,0.824844720496894,89,95,103,106,116,122,133,136,"TTGATGA","TTGA","CTAATAA","CAGA",2.36601317191402,8,10,11,38,2.67493665756754,4.61208945091526,7.91146833290283,101,"ENSG00000079974.19"
"17154","ENSG00000153283.13_215441",215433,215441,9,"ENSG00000153283.13",0,NA,"UVVVVVVVV",1,8,0.902691511387163,116,122,133,136,149,155,166,169,"CTGATAT","TGGA","ATCCTCA","CTGA",2.18090532287231,11,13,11,44,2.6634266443293,4.30069886586951,7.91146491141816,101,"ENSG00000079974.19"
"34361","ENSG00000232855.7_121198",121190,121198,9,"ENSG00000232855.7",1,3,"VVMVVVVVV",0,8,0.882815734989648,104,110,133,136,139,145,196,199,"TTGATGA","TTGG","ATGAACG","CTGA",2.48171700627986,23,3,51,86,0.975837755531536,4.38015444934931,7.9114173893079,101,"ENSG00000079974.19"
"36088","ENSG00000237877.8_244058",244050,244058,9,"ENSG00000237877.8",1,2,"VMVVVVUVV",1,7,0.770186335403727,41,47,69,72,112,118,133,136,"CTGATGA","TTGA","CTGAAGA","CTGA",2.72414454703221,22,40,15,86,1.16155268242746,4.83062908232721,7.91137442394212,101,"ENSG00000079974.19"
"47667","ENSG00000288895.2_11184",11176,11184,9,"ENSG00000288895.2",1,7,"UVVVVVMVV",1,7,0.787991718426501,108,114,133,136,150,156,212,215,"ATGATGA","TAGA","GTGGAGA","CTGA",2.67552874369989,19,14,56,98,1.20022161008152,4.75926997535354,7.91123684905954,101,"ENSG00000079974.19"
"26247","ENSG00000183715.14_886102",886094,886102,9,"ENSG00000183715.14",1,7,"VVVVVVMVV",0,8,0.885300207039338,52,58,64,67,113,119,133,136,"CTGATGC","CTGA","ATGAAGT","CTTA",2.41788950805579,6,46,14,75,1.36087949223713,4.37003571981894,7.91123654797629,101,"ENSG00000079974.19"
"4886","ENSG00000102271.14_113237",113229,113237,9,"ENSG00000102271.14",0,NA,"VVVVUVVVV",1,8,0.889855072463768,109,115,133,136,145,151,167,170,"ATTATGA","TTGC","GTGACAA","GTGA",2.25470012932669,18,9,16,52,2.37574389218883,4.35176952192502,7.91118981178009,101,"ENSG00000079974.19"
"23698","ENSG00000173575.24_95992",95984,95992,9,"ENSG00000173575.24",1,7,"VVVVVVMVV",0,8,0.885300207039338,83,89,100,103,115,121,133,136,"TTGATGG","CAGA","GGGATAC","CAGA",2.21587579738348,11,12,12,44,2.70740943193863,4.36997868695713,7.91117951511448,101,"ENSG00000079974.19"
"44481","ENSG00000282527.2_16667",16659,16667,9,"ENSG00000282527.2",0,NA,"VVVVVVUVV",1,8,0.886128364389234,87,93,133,136,144,150,164,167,"AAAATGA","ATAA","TTTATGA","CTGA",2.34106999815067,40,8,14,71,1.85942000568116,4.3666383316714,7.91115178922834,101,"ENSG00000079974.19"
"42089","ENSG00000260661.1_88038",88030,88038,9,"ENSG00000260661.1",1,7,"VVVVVVMVV",0,8,0.885300207039338,64,70,84,87,96,102,133,136,"ATGCTGC","ATGC","ATCATAA","CTGA",2.31869722345884,14,9,31,63,2.02162420252838,4.36990142306349,7.91110225122084,101,"ENSG00000079974.19"
"141","ENSG00000005483.23_166725",166717,166725,9,"ENSG00000005483.23",0,NA,"VVVUVVVVV",1,8,0.880745341614907,105,111,133,136,159,165,180,183,"ACAATGT","CTGA","GTGAACT","CTGA",2.43375147818955,22,23,15,69,1.32722243040784,4.38805807125121,7.91103943771084,101,"ENSG00000079974.19"
"26149","ENSG00000183570.17_182290",182282,182290,9,"ENSG00000183570.17",1,8,"VVVVVVVMV",0,8,0.884057971014493,114,120,133,136,144,150,160,163,"AAGAGGA","GTGA","GTGCAGT","CTGT",2.17253889665774,13,8,10,40,3.01535129197326,4.37473598408955,7.91096786814752,101,"ENSG00000079974.19"
"17530","ENSG00000154310.17_353993",353985,353993,9,"ENSG00000154310.17",1,8,"VVVVVVVMV",0,8,0.884057971014493,70,76,96,99,111,117,133,136,"ATCATGG","CTGA","GTGAAAT","CTGG",2.32262172414122,20,12,16,57,2.01472867253681,4.37471837503624,7.91095025909421,101,"ENSG00000079974.19"
"13210","ENSG00000140575.13_78068",78060,78068,9,"ENSG00000140575.13",0,NA,"UVVVVUVVV",2,7,0.824844720496894,112,118,133,136,169,175,196,199,"TTAATGA","GTGA","CTGATGT","CTGA",2.55708599164062,15,33,21,78,1.39898082298331,4.61155519181352,7.9109340738011,101,"ENSG00000079974.19"
"33385","ENSG00000229618.3_193520",193512,193520,9,"ENSG00000229618.3",1,1,"MVUVVVVVV",1,7,0.789648033126294,114,120,133,136,145,151,193,196,"ATCATGA","CTCT","TTGATGA","CTGA",2.55740460149623,13,9,42,73,1.95990010449409,4.75231602861725,7.91090816112242,101,"ENSG00000079974.19"
"25275","ENSG00000180318.4_17163",17155,17163,9,"ENSG00000180318.4",1,7,"VVVVVVMVV",0,8,0.885300207039338,113,119,133,136,147,153,183,186,"ATGAGGA","CTGG","CTGGAGA","CCGA",2.33291750921999,14,11,30,64,1.92557547378869,4.36958971714716,7.91079054530451,101,"ENSG00000079974.19"
"8999","ENSG00000121988.18_356246",356238,356246,9,"ENSG00000121988.18",0,NA,"VVVVVUUVV",2,7,0.808281573498965,84,90,102,105,114,120,133,136,"ATGAAGA","CTGC","CTGCTGA","CTGT",2.37425625963908,12,9,13,43,2.88224643401867,4.6776553745698,7.91078166856566,101,"ENSG00000079974.19"
"26784","ENSG00000185010.15_14726",14718,14726,9,"ENSG00000185010.15",1,2,"VMVVVVVVV",0,8,0.884057971014493,109,115,133,136,145,151,165,168,"ATGATTT","CTTA","GTGGAGA","CTAA",2.251341882652,18,9,14,50,2.48905424386845,4.37450003205378,7.91073191611175,101,"ENSG00000079974.19"
"12497","ENSG00000138411.13_362319",362311,362319,9,"ENSG00000138411.13",1,5,"VVVVMVVVV",0,8,0.886542443064182,81,87,102,105,116,122,133,136,"TTGATGA","CTGA","GTAAGAA","TTAA",2.20856615954093,15,11,11,46,2.73446683986213,4.36456030920041,7.91073008145714,101,"ENSG00000079974.19"
"26588","ENSG00000184588.18_184894",184886,184894,9,"ENSG00000184588.18",1,8,"VVVVVVVMV",0,8,0.884057971014493,92,98,133,136,141,147,156,159,"ATAATGA","TTGA","ATCATTA","TTGA",2.33389643853582,35,5,9,58,1.93868041641021,4.37449750166225,7.91072938572022,101,"ENSG00000079974.19"
"20044","ENSG00000164181.14_78322",78314,78322,9,"ENSG00000164181.14",1,8,"VVVVVUVMV",1,7,0.806211180124224,113,119,133,136,148,154,166,169,"GTGATTT","ATGA","CAGAGGA","CTGA",2.40792108182969,14,12,12,47,2.69058290894004,4.6858475302845,7.91069225078139,101,"ENSG00000079974.19"
"2734","ENSG00000077942.19_68389",68381,68389,9,"ENSG00000077942.19",1,1,"MVVVUVVVV",1,7,0.795859213250517,80,86,92,95,103,109,133,136,"GAGATGA","TTGA","GTGACAA","CTGA",2.56773897950279,6,8,24,47,1.79066841203544,4.72723206884684,7.91066892184891,101,"ENSG00000079974.19"
"33097","ENSG00000228669.2_659",651,659,9,"ENSG00000228669.2",1,8,"VVUVVVVMV",1,7,0.767701863354037,115,121,133,136,142,148,156,159,"TTGATGA","CTTG","GAGATCT","CTGA",2.43954435803712,12,6,8,35,3.09576072844806,4.83984744550721,7.91065489892336,101,"ENSG00000079974.19"
"9942","ENSG00000128573.28_190819",190811,190819,9,"ENSG00000128573.28",1,1,"MVVVUVVVV",1,7,0.795859213250517,108,114,133,136,143,149,161,164,"ATCAGGA","CTGA","GTGATGA","TTGA",2.45565092877306,19,7,12,47,2.53766267098616,4.72716721570164,7.91060406870371,101,"ENSG00000079974.19"
"34624","ENSG00000233635.2_126220",126212,126220,9,"ENSG00000233635.2",0,NA,"UVVVVUVVV",2,7,0.824844720496894,41,47,59,62,98,104,133,136,"ATAATGA","CTGA","ATGATGA","TTGA",2.59189947442528,12,36,29,86,1.16553536759491,4.61121629927419,7.91059518126177,101,"ENSG00000079974.19"
"40577","ENSG00000257060.8_123547",123539,123547,9,"ENSG00000257060.8",1,1,"MVUVVVVVV",1,7,0.789648033126294,79,85,103,106,113,119,133,136,"ATGATGG","CTGA","GTGTGGT","CAGA",2.47025469223004,18,7,14,48,2.53954124045307,4.75197646383,7.91056859633517,101,"ENSG00000079974.19"
"5531","ENSG00000105726.17_14406",14398,14406,9,"ENSG00000105726.17",1,7,"VVVVVVMVV",0,8,0.885300207039338,94,100,133,136,142,148,186,189,"ATGAAGA","CACA","CTGAGCA","CTGA",2.46695727405865,33,6,38,86,1.03100047787191,4.36934557623239,7.91054640438974,101,"ENSG00000079974.19"
"46047","ENSG00000286134.2_39074",39066,39074,9,"ENSG00000286134.2",1,8,"VVVVVVVMV",0,8,0.884057971014493,88,94,105,108,114,120,133,136,"ATGGTCA","ATGA","CTGATAT","CTTA",2.18620810366603,11,6,13,39,2.9225369314352,4.37431440563551,7.91054628969349,101,"ENSG00000079974.19"
"15488","ENSG00000148498.17_172508",172500,172508,9,"ENSG00000148498.17",0,NA,"VVUVUVVVV",2,7,0.773498964803312,110,116,133,136,146,152,163,166,"GTGATGG","CTGT","AGGAGGT","CTGA",2.49366489638016,17,10,11,47,2.64175466940634,4.81654682798519,7.91054268719843,101,"ENSG00000079974.19"
"24386","ENSG00000176124.15_602347",602339,602347,9,"ENSG00000176124.15",0,NA,"VVUVVVVVV",1,8,0.883643892339545,106,112,133,136,144,150,165,168,"ATAACCA","CAGA","CTGGGGA","CTGA",2.29352308926529,21,8,15,53,2.21369505163349,4.3759622450172,7.91053781437537,101,"ENSG00000079974.19"
"42238","ENSG00000261259.1_11805",11797,11805,9,"ENSG00000261259.1",1,8,"VVVVVVVMV",0,8,0.884057971014493,102,108,133,136,146,152,162,165,"ATGATTT","CAGG","ATGTGCA","CTGA",2.31401331587452,25,10,10,54,2.07002668363077,4.37419553069855,7.91042741475652,101,"ENSG00000079974.19"
"26959","ENSG00000185345.24_603534",603526,603534,9,"ENSG00000185345.24",0,NA,"VVVVUVVVV",1,8,0.889855072463768,114,120,133,136,146,152,188,191,"ATGCTAA","CCCA","GTGTTGG","CTGA",2.31990890256293,13,10,36,68,1.93793254193788,4.35099797308935,7.91041826294442,101,"ENSG00000079974.19"
"31747","ENSG00000224610.2_31377",31369,31377,9,"ENSG00000224610.2",0,NA,"VVVVVVUVV",1,8,0.886128364389234,111,117,133,136,140,146,160,163,"AAGCTGT","ATGA","GTGATGA","ATGA",2.23559206646742,16,4,14,43,2.55940020810682,4.36583682947241,7.91035028702935,101,"ENSG00000079974.19"
"33614","ENSG00000230461.10_81226",81218,81226,9,"ENSG00000230461.10",1,8,"VVVUVVVMV",1,7,0.764803312629399,84,90,133,136,146,152,170,173,"ATGCTGA","CTGA","CAGAAGA","CTGA",2.68046310248145,43,10,18,80,1.534773187474,4.85113180100425,7.91034505152185,101,"ENSG00000079974.19"
"35838","ENSG00000237352.6_290453",290445,290453,9,"ENSG00000237352.6",1,1,"MVVVVUVVV",1,7,0.82815734989648,83,89,100,103,111,117,133,136,"ATCATGG","TTGC","CTGATAC","CTGA",2.34930943344001,11,8,16,44,2.72866022066996,4.5976807775675,7.91031017715342,101,"ENSG00000079974.19"
"120","ENSG00000005108.17_42470",42462,42470,9,"ENSG00000005108.17",0,NA,"VVUVVVVVV",1,8,0.883643892339545,58,64,89,92,108,114,133,136,"ATGATGA","CTAA","TTTTTGA","ATGA",2.44006647728096,25,16,19,69,1.23568278803156,4.37569815914283,7.91027372850101,101,"ENSG00000079974.19"
"28837","ENSG00000196569.14_400431",400423,400431,9,"ENSG00000196569.14",1,7,"VVVVVVMVV",0,8,0.885300207039338,109,115,133,136,155,161,174,177,"GTGATGA","AGGA","CTGAAAA","TTGA",2.33519872418724,18,19,13,59,1.90819649387491,4.36904699711412,7.91024782527147,101,"ENSG00000079974.19"
"44549","ENSG00000282987.1_199793",199785,199793,9,"ENSG00000282987.1",1,8,"VVVVVVUMV",1,7,0.770186335403727,84,90,106,109,114,120,133,136,"AAGATGG","TTGA","TTGAAGT","CTGA",2.49255039112613,16,5,13,43,2.70086535882246,4.82946699158249,7.9102123331974,101,"ENSG00000079974.19"
"22554","ENSG00000170820.12_152265",152257,152265,9,"ENSG00000170820.12",1,7,"VVVVVVMVV",0,8,0.885300207039338,91,97,106,109,114,120,133,136,"AAGATGA","GTGG","ATTTTGA","ATGA",2.20296679748216,9,5,13,36,2.78941286543395,4.36896454549542,7.91016537365277,101,"ENSG00000079974.19"
"32831","ENSG00000228043.5_43015",43007,43015,9,"ENSG00000228043.5",0,NA,"UVVVVUVVV",2,7,0.824844720496894,89,95,110,113,116,122,133,136,"CTGATGA","CTGC","TTGTTGG","CTGT",2.3680690230906,15,3,11,38,2.65595836413498,4.61077129618475,7.91015017817233,101,"ENSG00000079974.19"
"2960","ENSG00000079739.17_52515",52507,52515,9,"ENSG00000079739.17",0,NA,"VVVVUVVVV",1,8,0.889855072463768,114,120,133,136,141,147,185,188,"GAGATGC","CACA","GTGGGGA","CTGA",2.31684384685233,13,5,38,65,1.95728141479308,4.35072676511882,7.91014705497389,101,"ENSG00000079974.19"
"19234","ENSG00000162600.12_72598",72590,72598,9,"ENSG00000162600.12",0,NA,"VVVUVVVVV",1,8,0.880745341614907,110,116,133,136,155,161,177,180,"ATGTTGT","CTAT","GTGCTGC","CTGA",2.35684031282511,17,19,16,61,1.83624132891959,4.38712752027174,7.91010888673137,101,"ENSG00000079974.19"
"23628","ENSG00000173406.16_72530",72522,72530,9,"ENSG00000173406.16",0,NA,"VVVUVVVVV",1,8,0.880745341614907,110,116,133,136,155,161,177,180,"ATGTTGT","CTAT","GTGCTGC","CTGA",2.35684031282511,17,19,16,61,1.83624132891959,4.38712752027174,7.91010888673137,101,"ENSG00000079974.19"
"42656","ENSG00000265533.1_163802",163794,163802,9,"ENSG00000265533.1",1,2,"VMVVUVVVV",1,7,0.773913043478261,115,121,133,136,149,155,165,168,"AAGATGA","ATAA","ATGATAT","CTGA",2.48321371870608,12,13,10,44,2.70297930414941,4.81443435721416,7.9100865311272,101,"ENSG00000079974.19"
"32346","ENSG00000226822.4_30760",30752,30760,9,"ENSG00000226822.4",0,NA,"UVVVVUVVV",2,7,0.824844720496894,68,74,93,96,113,119,133,136,"ATAATAA","CTGA","GTCCTGG","CTGA",2.48497670659368,19,17,14,59,1.87629318879513,4.61070114152158,7.91008002350916,101,"ENSG00000079974.19"
"13265","ENSG00000140836.17_423032",423024,423032,9,"ENSG00000140836.17",1,2,"VMVVVUVVV",1,7,0.806211180124223,112,118,133,136,141,147,171,174,"ATGAAGA","GTGC","GTGATTG","CTGA",2.48786865399302,15,5,24,53,2.15491927742682,4.68517757601174,7.91002229650864,101,"ENSG00000079974.19"
"847","ENSG00000037749.13_56257",56249,56257,9,"ENSG00000037749.13",1,2,"VMVVVVVVV",0,8,0.884057971014493,47,53,63,66,71,77,133,136,"AAGATGT","CTGA","GGGATAA","CTAA",2.34657582414176,10,5,56,80,1.85127816460214,4.37377924805348,7.91001113211145,101,"ENSG00000079974.19"
"44313","ENSG00000280776.2_49307",49299,49307,9,"ENSG00000280776.2",1,8,"VVVVVUVMV",1,7,0.806211180124224,108,114,133,136,162,168,180,183,"ATGATAA","CAGG","GTGAGGA","CTGA",2.56514103145177,19,26,12,66,1.63921907356815,4.68503982081166,7.90988454130855,101,"ENSG00000079974.19"
"15953","ENSG00000150394.14_342644",342636,342644,9,"ENSG00000150394.14",1,3,"VVMVVVVVV",0,8,0.882815734989648,87,93,108,111,115,121,133,136,"ATTATGA","TTGA","CTGATGA","CCAA",2.21638969301875,15,4,12,40,2.73842218679623,4.37858836839698,7.90985130835557,101,"ENSG00000079974.19"
"33772","ENSG00000231131.10_57205",57197,57205,9,"ENSG00000231131.10",1,8,"VVVVVVVMV",0,8,0.884057971014493,104,110,133,136,154,160,168,171,"ATGATAA","GTGA","AAGATGA","CAGA",2.38024175007447,23,18,8,58,1.62590557844729,4.37354597806927,7.90977786212724,101,"ENSG00000079974.19"
"36699","ENSG00000242715.8_31108",31100,31108,9,"ENSG00000242715.8",1,8,"VVVVUVVMV",1,7,0.773913043478261,82,88,133,136,174,180,191,194,"ATGATGA","ATGA","ATAAGGA","CTGA",2.73886805297162,45,38,11,103,0.997138785395722,4.81406478463496,7.90971695854801,101,"ENSG00000079974.19"
"38648","ENSG00000250709.1_31110",31102,31110,9,"ENSG00000250709.1",1,8,"VVVVUVVMV",1,7,0.773913043478261,82,88,133,136,174,180,191,194,"ATGATGA","ATGA","ATAAGGA","CTGA",2.73886805297162,45,38,11,103,0.997138785395722,4.81406478463496,7.90971695854801,101,"ENSG00000079974.19"
"35116","ENSG00000234984.1_102",94,102,9,"ENSG00000234984.1",1,8,"VVVVVVVMV",0,8,0.884057971014493,87,93,104,107,120,126,159,162,"ATGTTTT","ATGA","GTGGAGA","CTGA",2.36233025900263,11,13,33,66,1.74486831378787,4.37343417678469,7.90966606084266,101,"ENSG00000079974.19"
"14061","ENSG00000144331.20_233906",233898,233906,9,"ENSG00000144331.20",1,8,"VVVVVVVMV",0,8,0.884057971014493,33,39,56,59,106,112,133,136,"TTGATCA","TTGA","GTAAATA","CTGA",2.44148073025142,17,47,21,94,1.21704043902709,4.37339466017581,7.90962654423378,101,"ENSG00000079974.19"
"29762","ENSG00000198677.13_8981",8973,8981,9,"ENSG00000198677.13",1,1,"MVVUVVVVV",1,7,0.786749482401656,88,94,133,136,137,143,152,155,"GTGATGA","ATGA","GAAATGA","CTGA",2.65861755944704,39,1,9,58,1.32636248790148,4.76261988772044,7.90961781732707,101,"ENSG00000079974.19"
"34506","ENSG00000233290.4_107455",107447,107455,9,"ENSG00000233290.4",1,7,"VVVVVVMVV",0,8,0.885300207039338,98,104,133,136,173,179,196,199,"ATGAAGA","CATA","GTGAGAA","CTGA",2.50555915817054,29,37,17,92,0.769732828174038,4.36836513732775,7.9095659654851,101,"ENSG00000079974.19"
"28672","ENSG00000196338.15_18076",18068,18076,9,"ENSG00000196338.15",1,2,"UMVVVVVVV",1,7,0.786749482401656,82,88,104,107,116,122,133,136,"AAGTTGA","ATGA","CTGGGGA","CTGA",2.44047194823951,16,9,11,45,2.78027541315198,4.76252210035384,7.90952002996046,101,"ENSG00000079974.19"
"44913","ENSG00000284418.3_562589",562581,562589,9,"ENSG00000284418.3",1,8,"VVVVVVVMV",0,8,0.884057971014493,113,119,133,136,148,154,209,212,"GGGATAA","CTCA","GAGTTGA","CTGA",2.36437961814131,14,12,55,90,1.73047904850228,4.37325245902775,7.90948434308572,101,"ENSG00000079974.19"
"16115","ENSG00000150760.13_123911",123903,123911,9,"ENSG00000150760.13",1,1,"MVVVVUVVV",1,7,0.82815734989648,11,17,60,63,111,117,133,136,"ATGTTGA","CTGA","GGGCAGA","CTGA",2.64400665662134,43,48,16,116,0.760467718687456,4.59679469070742,7.90942409029334,101,"ENSG00000079974.19"
"11201","ENSG00000134247.10_41561",41553,41561,9,"ENSG00000134247.10",1,5,"VVVVMVVVV",0,8,0.886542443064182,76,82,98,101,109,115,133,136,"CTGATGC","CTGC","CTGCTGC","CTCA",2.24876147911276,16,8,18,51,2.46106634516174,4.3632023848117,7.90937215706843,101,"ENSG00000079974.19"
"35410","ENSG00000235978.8_26704",26696,26704,9,"ENSG00000235978.8",1,3,"UVMVVVVVV",1,7,0.785507246376811,63,69,82,85,92,98,133,136,"AAGATTT","CTGA","TTGATGA","CTGA",2.55310008535353,13,7,35,64,2.04862799739136,4.76732380827038,7.90935279377763,101,"ENSG00000079974.19"
"14500","ENSG00000145216.17_24070",24062,24070,9,"ENSG00000145216.17",1,8,"VVVVVVVMV",0,8,0.884057971014493,109,115,133,136,140,146,160,163,"ATGTAGA","GTTA","ATGAATC","CTGA",2.26660347588852,18,4,14,45,2.3814967845591,4.37304665595397,7.90927854001194,101,"ENSG00000079974.19"
"44451","ENSG00000282278.1_23800",23792,23800,9,"ENSG00000282278.1",1,8,"VVVVVVVMV",0,8,0.884057971014493,109,115,133,136,140,146,160,163,"ATGTAGA","GTTA","ATGAATC","CTGA",2.26660347588852,18,4,14,45,2.3814967845591,4.37304665595397,7.90927854001194,101,"ENSG00000079974.19"
"27527","ENSG00000186439.14_290973",290965,290973,9,"ENSG00000186439.14",1,7,"VVVVVVMVV",0,8,0.885300207039338,113,119,133,136,144,150,196,199,"ATGGTGC","CTCT","GTCAGGA","CTGA",2.327323801748,14,8,46,77,1.95646786535796,4.36798996925283,7.90919079741018,101,"ENSG00000079974.19"
"27272","ENSG00000185811.21_45931",45923,45931,9,"ENSG00000185811.21",0,NA,"VVVVUVVVV",1,8,0.889855072463768,73,79,87,90,102,108,133,136,"TTTATAA","CAGA","TTGAAAA","CTGA",2.34432900059299,8,12,25,54,1.77010810975656,4.34974202842746,7.90916231828253,101,"ENSG00000079974.19"
"47697","ENSG00000289084.1_104028",104020,104028,9,"ENSG00000289084.1",1,3,"VVMVVVVVV",0,8,0.882815734989648,94,100,133,136,163,169,185,188,"ATGATGT","GTGT","GTGTAGT","CTGA",2.49726277790996,33,27,16,85,0.863103236672702,4.37788043901811,7.9091433789767,101,"ENSG00000079974.19"
"27249","ENSG00000185774.16_538042",538034,538042,9,"ENSG00000185774.16",1,5,"VVVVMVVVV",0,8,0.886542443064182,88,94,107,110,114,120,133,136,"TTGCTGC","CACA","CTCATTA","CTGA",2.19818128653266,13,4,13,39,2.79731102162552,4.36296323296081,7.90913300521754,101,"ENSG00000079974.19"
"14116","ENSG00000144451.20_449992",449984,449992,9,"ENSG00000144451.20",1,8,"VVVVVVVMV",0,8,0.884057971014493,116,122,133,136,145,151,175,178,"ACCAAGA","TTGA","TTGATAG","CTGA",2.2878104094366,11,9,24,53,2.23936289252484,4.37285807219222,7.90908995625019,101,"ENSG00000079974.19"
"26270","ENSG00000183762.13_32603",32595,32603,9,"ENSG00000183762.13",1,6,"VVVVUMVVV",1,7,0.792546583850932,99,105,133,136,151,157,175,178,"ATGATGT","TGGA","ATGATGA","CTGA",2.65314069117993,28,15,18,70,1.26787439788817,4.73886975143859,7.90905608684231,101,"ENSG00000079974.19"
"11257","ENSG00000134369.16_157609",157601,157609,9,"ENSG00000134369.16",1,8,"VVVVVVVMV",0,8,0.884057971014493,104,110,133,136,142,148,198,201,"GTCATGT","CGGA","GAGAAGA","CTGA",2.43479863418186,23,6,50,88,1.25928656371327,4.37281936456475,7.90905124862272,101,"ENSG00000079974.19"
"24627","ENSG00000177182.11_83837",83829,83837,9,"ENSG00000177182.11",1,8,"VVVUVVVMV",1,7,0.764803312629399,116,122,133,136,140,146,160,163,"GTGGTGA","GAGA","GTGATCA","CTGA",2.49830405887612,11,4,14,38,2.74374898397205,4.84977734411988,7.90899059463748,101,"ENSG00000079974.19"
"24813","ENSG00000178031.18_958210",958202,958210,9,"ENSG00000178031.18",1,8,"VVVVVVVMV",0,8,0.884057971014493,111,117,133,136,143,149,172,175,"GTGAAGT","AGGA","TTGGTGG","CTGA",2.29416029517576,16,7,23,55,2.19661432262783,4.37275407261655,7.90898595667452,101,"ENSG00000079974.19"
"905","ENSG00000040341.18_129875",129867,129875,9,"ENSG00000040341.18",1,8,"VVVVVVVMV",0,8,0.884057971014493,110,116,133,136,144,150,168,171,"GTAATTA","CGGT","ATGTTGT","CTGA",2.26693585742311,17,8,18,52,2.37797578627502,4.37272037560727,7.90895225966524,101,"ENSG00000079974.19"
"2402","ENSG00000074211.14_79733",79725,79733,9,"ENSG00000074211.14",1,2,"VMVVVVVVV",0,8,0.884057971014493,109,115,133,136,149,155,173,176,"TTGAAGA","TTGT","GTCAAAA","CTGA",2.32414044581562,18,13,18,58,1.99654613853968,4.37270394432762,7.90893582838559,101,"ENSG00000079974.19"
"43826","ENSG00000274102.3_307",299,307,9,"ENSG00000274102.3",1,3,"VVMVVVVVV",0,8,0.882815734989648,106,112,133,136,142,148,178,181,"ATGATGG","CAGA","GTGGTAA","CTTA",2.3985680837885,21,6,30,66,1.52020069966266,4.3776636478965,7.90892658785509,101,"ENSG00000079974.19"
"44299","ENSG00000280709.2_75166",75158,75166,9,"ENSG00000280709.2",1,3,"VVMVVVVVV",0,8,0.882815734989648,106,112,133,136,142,148,178,181,"ATGATGG","CAGA","GTGGTAA","CTTA",2.3985680837885,21,6,30,66,1.52020069966266,4.3776636478965,7.90892658785509,101,"ENSG00000079974.19"
"45353","ENSG00000285472.1_55315",55307,55315,9,"ENSG00000285472.1",1,3,"VVMVVVVVV",0,8,0.882815734989648,106,112,133,136,142,148,178,181,"ATGATGG","CAGA","GTGGTAA","CTTA",2.3985680837885,21,6,30,66,1.52020069966266,4.3776636478965,7.90892658785509,101,"ENSG00000079974.19"
"4949","ENSG00000102466.16_29739",29731,29739,9,"ENSG00000102466.16",1,8,"UVVVVVVMV",1,7,0.786749482401656,86,92,133,136,145,151,192,195,"ATGACGA","CTGA","CTGTAGA","CTGA",2.71186896803296,41,9,41,100,0.968431795637956,4.76188956229775,7.90888749190438,101,"ENSG00000079974.19"
"36887","ENSG00000243319.7_21801",21793,21801,9,"ENSG00000243319.7",1,8,"UVVVVVVMV",1,7,0.786749482401656,86,92,133,136,145,151,192,195,"ATGACGA","CTGA","CTGTAGA","CTGA",2.71186896803296,41,9,41,100,0.968431795637956,4.76188956229775,7.90888749190438,101,"ENSG00000079974.19"
"6430","ENSG00000109819.9_21677",21669,21677,9,"ENSG00000109819.9",1,8,"VVVVVVVMV",0,8,0.884057971014493,106,112,133,136,186,192,213,216,"ATGATTC","CTGA","ATTACTA","CTGA",2.49292376356597,21,50,21,101,0.871026706808272,4.37262961597868,7.90886150003665,101,"ENSG00000079974.19"
"29677","ENSG00000198589.15_744885",744877,744885,9,"ENSG00000198589.15",1,3,"VVMVVVVVV",0,8,0.882815734989648,111,117,133,136,154,160,168,171,"AAGATGT","TTTA","ATATGGA","CTGA",2.29783846512398,16,18,8,51,2.19128641146447,4.37755237807274,7.90881531803134,101,"ENSG00000079974.19"
"33990","ENSG00000231689.3_320762",320754,320762,9,"ENSG00000231689.3",1,2,"VMVVVVVVV",0,8,0.884057971014493,53,59,77,80,116,122,133,136,"ATGAAGA","CTTA","AAGATGA","GTGA",2.37321584383216,18,36,11,74,1.66850404208592,4.37248575024174,7.90871763429971,101,"ENSG00000079974.19"
"20665","ENSG00000165275.10_24924",24916,24924,9,"ENSG00000165275.10",1,5,"VVVVMVVVV",0,8,0.886542443064182,95,101,133,136,149,155,166,169,"CTGATCA","TTGC","GTTCTGA","CTGA",2.36202365171615,32,13,11,65,1.70330647597829,4.36253270518816,7.90870247744488,101,"ENSG00000079974.19"
"7842","ENSG00000115896.16_440004",439996,440004,9,"ENSG00000115896.16",1,8,"VVVVVVVMV",0,8,0.884057971014493,100,106,133,136,186,192,206,209,"ATGATCA","TAGA","TTGATTT","CTGA",2.47719683292532,27,50,14,100,0.974927451441434,4.37239325106923,7.9086251351272,101,"ENSG00000079974.19"
"10469","ENSG00000131149.19_56881",56873,56881,9,"ENSG00000131149.19",1,2,"UMVVVVVVV",1,7,0.786749482401656,115,121,133,136,142,148,193,196,"ATTATGA","TTAA","GTGATGG","CTGA",2.5582720486781,12,6,45,72,1.99129244324766,4.76160985860874,7.90860778821537,101,"ENSG00000079974.19"
"9316","ENSG00000124143.11_36783",36775,36783,9,"ENSG00000124143.11",1,6,"VVVVUMVVV",1,7,0.792546583850932,73,79,95,98,110,116,133,136,"ATGATGA","CTTA","ATGAGAA","CTCA",2.49781538729638,16,12,17,54,2.30144443589389,4.73838675446744,7.90857308987117,101,"ENSG00000079974.19"
"43884","ENSG00000274949.1_1076",1068,1076,9,"ENSG00000274949.1",1,6,"VVVVVMUVV",1,7,0.788819875776397,116,122,133,136,146,152,202,205,"CTGATGT","CTCA","CTGCTGA","CTGA",2.57059063685233,11,10,50,80,1.87545075567976,4.75318041700715,7.90845992011274,101,"ENSG00000079974.19"
"10595","ENSG00000131773.15_187717",187709,187717,9,"ENSG00000131773.15",1,1,"MVVVVUVVV",1,7,0.82815734989648,114,120,133,136,148,154,174,177,"GAGATGG","CTTA","GGGAAGA","CTGA",2.41573535746692,13,12,20,54,2.27795983930753,4.59571555560509,7.90834495519101,101,"ENSG00000079974.19"
"31921","ENSG00000225249.6_505954",505946,505954,9,"ENSG00000225249.6",0,NA,"VVVVVVUVV",1,8,0.886128364389234,110,116,133,136,160,166,187,190,"ATCATGG","CTTC","ATGAGGA","CTGA",2.41397800141349,17,24,21,71,1.36200110152543,4.36379694440383,7.90831040196077,101,"ENSG00000079974.19"
"34584","ENSG00000233491.8_180014",180006,180014,9,"ENSG00000233491.8",0,NA,"VVVVVVUVV",1,8,0.886128364389234,110,116,133,136,160,166,187,190,"ATCATGG","CTTC","ATGAGGA","CTGA",2.41397800141349,17,24,21,71,1.36200110152543,4.36379694440383,7.90831040196077,101,"ENSG00000079974.19"
"37890","ENSG00000249052.1_5810",5802,5810,9,"ENSG00000249052.1",0,NA,"VVVVVVUVV",1,8,0.886128364389234,110,116,133,136,160,166,187,190,"ATCATGG","CTTC","ATGAGGA","CTGA",2.41397800141349,17,24,21,71,1.36200110152543,4.36379694440383,7.90831040196077,101,"ENSG00000079974.19"
"17658","ENSG00000154678.18_469205",469197,469205,9,"ENSG00000154678.18",0,NA,"UVVVVUVVV",2,7,0.824844720496894,79,85,99,102,111,117,133,136,"AGGAAGA","CTCA","AAGTAGA","CTGA",2.36412153101396,14,9,16,48,2.67484456445411,4.60891369280345,7.90829257479103,101,"ENSG00000079974.19"
"41589","ENSG00000259334.1_8608",8600,8608,9,"ENSG00000259334.1",1,7,"VVVVVVMVV",0,8,0.885300207039338,75,81,96,99,108,114,133,136,"GGGATAG","CAGA","TTGTTTA","CTGA",2.25489853272216,15,9,19,52,2.43562425526398,4.3670702850196,7.90827111317695,101,"ENSG00000079974.19"
"21106","ENSG00000166444.19_149988",149980,149988,9,"ENSG00000166444.19",1,8,"UVVVVVVMV",1,7,0.786749482401656,113,119,133,136,146,152,187,190,"GTGAAGA","CTTA","CTGATTA","CTGA",2.56947958775932,14,10,35,68,1.91513983734197,4.76125093893436,7.90824886854098,101,"ENSG00000079974.19"
"26116","ENSG00000183454.18_135328",135320,135328,9,"ENSG00000183454.18",1,1,"MVVVUVVVV",1,7,0.795859213250517,75,81,96,99,112,118,133,136,"AAGATGA","GGGA","TTGCAGA","CTGA",2.47173505449745,15,13,15,52,2.42101182640713,4.72481138076419,7.90824823376626,101,"ENSG00000079974.19"
"20324","ENSG00000164654.16_20615",20607,20615,9,"ENSG00000164654.16",0,NA,"UVVVVVUVV",2,7,0.788819875776397,109,115,133,136,140,146,161,164,"ATGTTAA","CTGA","GGGAAGT","CTGA",2.50296829998665,18,4,15,46,2.32532772751302,4.75294576518934,7.90822526829493,101,"ENSG00000079974.19"
"39092","ENSG00000251600.8_611072",611064,611072,9,"ENSG00000251600.8",0,NA,"VVVVUVVVV",1,8,0.889855072463768,105,111,133,136,146,152,203,206,"AGGTTGA","CTTA","GAGATAA","CTGA",2.42368241443921,22,10,51,92,1.23721331946113,4.3487740205973,7.90819431045237,101,"ENSG00000079974.19"
"42093","ENSG00000260676.5_33926",33918,33926,9,"ENSG00000260676.5",1,3,"VVMVVVVVV",0,8,0.882815734989648,116,122,133,136,153,159,174,177,"ATGGTGG","ATCA","TTCCTGA","CTGA",2.29307432954624,11,17,15,52,2.22030615060405,4.37686708689474,7.90813002685333,101,"ENSG00000079974.19"
"10939","ENSG00000133135.14_61464",61456,61464,9,"ENSG00000133135.14",1,8,"VVVVVUVMV",1,7,0.806211180124224,116,122,133,136,151,157,185,188,"GTAATGA","ATGA","GTAAAGA","CTGA",2.55448059564838,11,15,28,63,1.70313127533511,4.68325047824775,7.90809519874464,101,"ENSG00000079974.19"
"18739","ENSG00000158321.19_427547",427539,427547,9,"ENSG00000158321.19",1,7,"VVVVVVMVV",0,8,0.885300207039338,91,97,103,106,111,117,133,136,"ATGCTGA","CTGA","GTGCTGA","CACA",2.27813443452778,6,5,16,36,2.27999430220081,4.36688929976317,7.90809012792053,101,"ENSG00000079974.19"
"17183","ENSG00000153339.15_25959",25951,25959,9,"ENSG00000153339.15",1,8,"VVVVVVVMV",0,8,0.884057971014493,80,86,101,104,109,115,133,136,"AGGCTGA","TTGA","GTGAAGT","GTGA",2.25113510892816,15,5,18,47,2.47977441635378,4.37183545230205,7.90806733636002,101,"ENSG00000079974.19"
"14579","ENSG00000145414.9_23036",23028,23036,9,"ENSG00000145414.9",1,8,"VVVVVVVMV",0,8,0.884057971014493,111,117,133,136,141,147,157,160,"TTGATGG","CAAA","TTGATAA","TTGA",2.20269661829379,16,5,10,40,2.8024502429619,4.37177359123013,7.9080054752881,101,"ENSG00000079974.19"
"18297","ENSG00000156958.15_102639",102631,102639,9,"ENSG00000156958.15",1,7,"VVVVVVMVV",0,8,0.885300207039338,85,91,103,106,108,114,133,136,"GTGATGG","GTGA","AAGATAA","TTGA",2.30230143861925,12,2,19,42,2.11808248297106,4.36668968510818,7.90789051326554,101,"ENSG00000079974.19"
"178","ENSG00000006071.16_47201",47193,47201,9,"ENSG00000006071.16",1,2,"VMVVVUVVV",1,7,0.806211180124223,113,119,133,136,157,163,172,175,"ATGATTC","CAGA","CTGAAAA","CTGA",2.47966500261478,14,21,9,53,2.2010604195607,4.68304010924814,7.90788482974503,101,"ENSG00000079974.19"
"23751","ENSG00000173848.19_13209",13201,13209,9,"ENSG00000173848.19",1,5,"VVVVMUVVV",1,7,0.808695652173913,46,52,85,88,99,105,133,136,"ATTATGA","CTGT","ATGACGA","CTGA",2.64984396712345,33,11,28,81,1.02657609346874,4.6730506352396,7.90783324393526,101,"ENSG00000079974.19"
"15939","ENSG00000150347.17_154679",154671,154679,9,"ENSG00000150347.17",1,8,"VVVVUVVMV",1,7,0.773913043478261,115,121,133,136,144,150,164,167,"CTGATAA","CTCA","GTGAGAT","CTGA",2.45672354993478,12,8,14,43,2.87053339400649,4.81217259839292,7.90782477230597,101,"ENSG00000079974.19"
"41811","ENSG00000259768.8_133993",133985,133993,9,"ENSG00000259768.8",1,5,"VVVVMVVVV",0,8,0.886542443064182,108,114,133,136,187,193,208,211,"ATGTTCA","TTTA","GTGAGGA","CTGA",2.40776629609539,19,51,15,94,1.39463524978866,4.36160263927281,7.90777241152954,101,"ENSG00000079974.19"
"27980","ENSG00000187772.8_77380",77372,77380,9,"ENSG00000187772.8",1,7,"VVVVVUMVV",1,7,0.807453416149068,34,40,58,61,74,80,133,136,"GTGGTGA","CTGA","GTGTTCT","CTGA",2.60246297373591,18,13,53,93,1.36173698251865,4.67787253518951,7.90768619978579,101,"ENSG00000079974.19"
"1659","ENSG00000064763.12_86483",86475,86483,9,"ENSG00000064763.12",1,5,"UVVVMVVVV",1,7,0.789233954451346,110,116,133,136,142,148,162,165,"GTGAGCA","CTGA","GTGGACA","CTGA",2.458207766694,17,6,14,46,2.61427567441327,4.75058186309333,7.90751768089871,101,"ENSG00000079974.19"
"11699","ENSG00000135862.6_104452",104444,104452,9,"ENSG00000135862.6",0,NA,"UVVVUVVVV",2,7,0.792546583850932,111,117,133,136,164,170,223,226,"ATGATGA","TAGA","TTGAAGA","CTGA",2.705511851808,16,28,53,106,0.91253385303317,4.7373198829383,7.90750621834203,101,"ENSG00000079974.19"
"40393","ENSG00000255910.2_133087",133079,133087,9,"ENSG00000255910.2",1,7,"VVVVVVMVV",0,8,0.885300207039338,109,115,133,136,146,152,161,164,"TTTATGT","AAGA","ACAATGA","CTGA",2.23464859994162,18,10,9,46,2.56730584202412,4.36624079374206,7.90744162189941,101,"ENSG00000079974.19"
"306","ENSG00000008086.13_124347",124339,124347,9,"ENSG00000008086.13",1,1,"MVVUVVVVV",1,7,0.786749482401656,110,116,133,136,151,157,165,168,"ATGCTGT","CTGC","CTGGTGA","CTGA",2.51272919957417,17,15,8,49,2.29017095760742,4.76042473869214,7.90742266829877,101,"ENSG00000079974.19"
"24426","ENSG00000176225.15_63140",63132,63140,9,"ENSG00000176225.15",0,NA,"VVVVVVUVV",1,8,0.886128364389234,93,99,133,136,146,152,161,164,"TTGATGA","GTGT","TTGAAGA","CAGA",2.33130498516031,34,10,9,62,1.90893212375823,4.36274133954007,7.90725479709701,101,"ENSG00000079974.19"
"48452","ENSG00000291118.1_58061",58053,58061,9,"ENSG00000291118.1",1,6,"VVVVVMUVV",1,7,0.788819875776397,87,93,107,110,113,119,133,136,"TTGATGG","TTGA","GAGTTAA","CTGA",2.46579247804367,14,3,14,40,2.56925200422459,4.75196713112893,7.90724663423453,101,"ENSG00000079974.19"
"34305","ENSG00000232611.1_6134",6126,6134,9,"ENSG00000232611.1",1,2,"VMVVUVVVV",1,7,0.773913043478261,81,87,99,102,109,115,133,136,"ATGATGA","GTGA","CTGAGCA","CTGT",2.49090486539642,12,7,18,46,2.64032688451767,4.81158983012345,7.90724200403649,101,"ENSG00000079974.19"
"17437","ENSG00000154162.15_681045",681037,681045,9,"ENSG00000154162.15",1,8,"UVVVVVVMV",1,7,0.786749482401656,115,121,133,136,143,149,160,163,"ATAAAGA","TGGA","ATGATGC","CTGA",2.40150305981179,12,7,11,39,3.03072645176272,4.760186712627,7.90718464223362,101,"ENSG00000079974.19"
"38549","ENSG00000250387.3_41034",41026,41034,9,"ENSG00000250387.3",1,8,"UVVVVVVMV",1,7,0.786749482401656,115,121,133,136,143,149,160,163,"ATAAAGA","TGGA","ATGATGC","CTGA",2.40150305981179,12,7,11,39,3.03072645176272,4.760186712627,7.90718464223362,101,"ENSG00000079974.19"
"5002","ENSG00000102683.8_110910",110902,110910,9,"ENSG00000102683.8",1,8,"VVVVVVVMV",0,8,0.884057971014493,116,122,133,136,141,147,162,165,"GGGCTGG","CTCA","ATGTAGC","CTGA",2.20907375211297,11,5,15,40,2.75647791890888,4.37090906658216,7.90714095064013,101,"ENSG00000079974.19"
"32986","ENSG00000228414.8_12973",12965,12973,9,"ENSG00000228414.8",1,1,"MVVVVUVVV",1,7,0.82815734989648,112,118,133,136,152,158,171,174,"AAGATGT","TTGG","TTGGTGA","CTGA",2.40909081180733,15,16,13,53,2.31740464751081,4.59450251488992,7.90713191447584,101,"ENSG00000079974.19"
"36883","ENSG00000243305.1_7667",7659,7667,9,"ENSG00000243305.1",1,2,"VMVVVVVVV",0,8,0.884057971014493,115,121,133,136,148,154,162,165,"CTGATGA","TTGG","GCGGTGG","CTGT",2.20697555321271,12,12,8,41,2.77032832616766,4.37087467022977,7.90710655428774,101,"ENSG00000079974.19"
"9220","ENSG00000123124.14_117362",117354,117362,9,"ENSG00000123124.14",1,5,"UVVVMVVVV",1,7,0.789233954451346,99,105,133,136,147,153,180,183,"GTGATGA","TTGT","CTGATGA","CTGA",2.68248607752708,28,11,27,75,1.11667001859081,4.7499776338595,7.90691345166488,101,"ENSG00000079974.19"
"44695","ENSG00000283380.1_5946",5938,5946,9,"ENSG00000283380.1",1,1,"MVVVVUVVV",1,7,0.82815734989648,91,97,133,136,158,164,179,182,"GTCATGA","GTGA","ATGATGC","CTGA",2.60251826671739,36,22,15,82,1.02676071519253,4.59422062332711,7.90685002291303,101,"ENSG00000079974.19"
"34722","ENSG00000233891.8_377505",377497,377505,9,"ENSG00000233891.8",0,NA,"VVVUVVVVV",1,8,0.880745341614907,116,122,133,136,148,154,171,174,"ATTATAT","TTGG","CTGATTA","CTGA",2.26439065778952,11,12,17,49,2.43946780781975,4.38385138160413,7.90683274806376,101,"ENSG00000079974.19"
"43498","ENSG00000271955.2_744309",744301,744309,9,"ENSG00000271955.2",0,NA,"VVVUVVVVV",1,8,0.880745341614907,116,122,133,136,148,154,171,174,"ATTATAT","TTGG","CTGATTA","CTGA",2.26439065778952,11,12,17,49,2.43946780781975,4.38385138160413,7.90683274806376,101,"ENSG00000079974.19"
"35906","ENSG00000237461.3_330360",330352,330360,9,"ENSG00000237461.3",1,8,"VVUVVVVMV",1,7,0.767701863354037,113,119,133,136,155,161,174,177,"GTAATGA","CTGC","TTGATAA","CTGA",2.57074247705419,14,19,13,55,2.2058007096983,4.8360209725149,7.90682842593105,101,"ENSG00000079974.19"
"40166","ENSG00000255145.3_417044",417036,417044,9,"ENSG00000255145.3",1,8,"VVUVVVVMV",1,7,0.767701863354037,113,119,133,136,155,161,174,177,"GTAATGA","CTGC","TTGATAA","CTGA",2.57074247705419,14,19,13,55,2.2058007096983,4.8360209725149,7.90682842593105,101,"ENSG00000079974.19"
"153","ENSG00000005810.20_147259",147251,147259,9,"ENSG00000005810.20",0,NA,"VVVVVVUVV",1,8,0.886128364389234,113,119,133,136,153,159,169,172,"ACCATGC","AAGA","AAGATGA","CTGA",2.25840513258577,14,17,10,50,2.39276196570938,4.36219904573696,7.90671250329389,101,"ENSG00000079974.19"
"41329","ENSG00000258859.1_123276",123268,123276,9,"ENSG00000258859.1",1,5,"VVVVMVVVV",0,8,0.886542443064182,86,92,133,136,137,143,152,155,"ATGTTGT","TTGA","ATAAATA","CTGA",2.41753167533906,41,1,9,60,1.32527342559108,4.36053781529621,7.90670758755294,101,"ENSG00000079974.19"
"48432","ENSG00000291102.1_174313",174305,174313,9,"ENSG00000291102.1",1,2,"VMVVVVVVV",0,8,0.884057971014493,105,111,133,136,143,149,168,171,"TTGATTA","GTAA","TAGAAGA","CTGA",2.33517252597834,22,7,19,57,1.91228668807709,4.37002588198317,7.90625776604114,101,"ENSG00000079974.19"
"15420","ENSG00000148219.18_111406",111398,111406,9,"ENSG00000148219.18",1,2,"VMVVVVVVV",0,8,0.884057971014493,64,70,94,97,101,107,133,136,"CTGTTGA","CTGA","CTGAAGA","GTGA",2.42818729938856,24,4,26,63,1.29210344693693,4.3700046940485,7.90623657810647,101,"ENSG00000079974.19"
"8478","ENSG00000119125.17_102472",102464,102472,9,"ENSG00000119125.17",1,3,"VVMVVVVVV",0,8,0.882815734989648,111,117,133,136,148,154,164,167,"ATGATGG","ATAA","ATCATGG","CTTA",2.23398048696138,16,12,10,47,2.60649490525957,4.3749245379172,7.90618747787579,101,"ENSG00000079974.19"
"40796","ENSG00000257683.1_20321",20313,20321,9,"ENSG00000257683.1",0,NA,"VVVVUVUVV",2,7,0.775983436853002,76,82,102,105,113,119,133,136,"ATGGTAA","CTGA","CTGTTCA","CTGA",2.52900619170688,20,8,14,51,2.34882965321937,4.80221773281631,7.90615148022832,101,"ENSG00000079974.19"
"11861","ENSG00000136237.19_7118",7110,7118,9,"ENSG00000136237.19",1,2,"VMVVVVVVV",0,8,0.884057971014493,69,75,87,90,109,115,133,136,"ATGATCT","TTGA","ATGAAGA","ATGA",2.32808886083891,12,19,18,58,1.95893987613236,4.36988307043127,7.90611495448924,101,"ENSG00000079974.19"
"27834","ENSG00000187398.12_25603",25595,25603,9,"ENSG00000187398.12",1,7,"VVVVVVMVV",0,8,0.885300207039338,106,112,133,136,141,147,161,164,"ATCCTGT","CAGG","GTGCTGA","CTGA",2.28685635121755,21,5,14,49,2.2138187781879,4.36488194657623,7.90608277473358,101,"ENSG00000079974.19"
"20639","ENSG00000165209.19_85051",85043,85051,9,"ENSG00000165209.19",1,3,"UVMVVVVVV",1,7,0.785507246376811,76,82,91,94,101,107,133,136,"GTGATGT","CTCA","CTGGTGC","CTGA",2.54746620905473,9,7,26,51,2.07307388412708,4.76404548612299,7.90607447163024,101,"ENSG00000079974.19"
"47792","ENSG00000289347.1_1117",1109,1117,9,"ENSG00000289347.1",1,8,"VVVVVVVMV",0,8,0.884057971014493,99,105,133,136,144,150,177,180,"AAGATGA","ATGT","TTAATAA","CTGA",2.43164746612685,28,8,27,72,1.26819827139634,4.36979534472716,7.90602722878513,101,"ENSG00000079974.19"
"5451","ENSG00000104728.16_5341",5333,5341,9,"ENSG00000104728.16",0,NA,"VVVVUVUVV",2,7,0.775983436853002,84,90,102,105,114,120,133,136,"TTAATGA","CAGA","ATGTTTT","CTGA",2.44891657378722,12,9,13,43,2.88224643401867,4.80208923148337,7.90602297889537,101,"ENSG00000079974.19"
"44650","ENSG00000283239.1_65379",65371,65379,9,"ENSG00000283239.1",0,NA,"VVVVUVUVV",2,7,0.775983436853002,84,90,102,105,114,120,133,136,"TTAATGA","CAGA","ATGTTTT","CTGA",2.44891657378722,12,9,13,43,2.88224643401867,4.80208923148337,7.90602297889537,101,"ENSG00000079974.19"
"17859","ENSG00000155545.20_46880",46872,46880,9,"ENSG00000155545.20",1,8,"VVVVVUVMV",1,7,0.806211180124224,110,116,133,136,147,153,169,172,"CTGATTA","TTTA","ATGAAGA","CTGA",2.45635581716197,17,11,16,53,2.34877699722068,4.68112061124179,7.90596533173868,101,"ENSG00000079974.19"
"22253","ENSG00000170044.9_250721",250713,250721,9,"ENSG00000170044.9",1,7,"UVVVVVMVV",1,7,0.787991718426501,52,58,73,76,86,92,133,136,"TAGATGA","CTGA","TTTAAGA","CTGA",2.57872372637281,15,10,41,75,1.82446878476078,4.75399007347821,7.90595694718421,101,"ENSG00000079974.19"
"8033","ENSG00000116641.18_56969",56961,56969,9,"ENSG00000116641.18",1,6,"UVVVVMVVV",1,7,0.805383022774327,110,116,133,136,145,151,165,168,"ATAATCA","CTGT","ATAAAGA","CTGA",2.42392951615166,17,9,14,49,2.57813038670168,4.68441512359485,7.90594721469216,101,"ENSG00000079974.19"
"26309","ENSG00000183826.18_241261",241253,241261,9,"ENSG00000183826.18",1,8,"VVUVVVVMV",1,7,0.767701863354037,69,75,86,89,98,104,133,136,"GTTATGA","CTTA","ATGATGG","CTGA",2.58989439874179,11,9,29,58,2.07431633065007,4.83506974723217,7.90587720064832,101,"ENSG00000079974.19"
"40565","ENSG00000257022.1_7984",7976,7984,9,"ENSG00000257022.1",0,NA,"VVVUVVVVV",1,8,0.880745341614907,115,121,133,136,160,166,218,221,"ATGTTGA","ATGG","TTGAGCA","CTGA",2.45746488565763,12,24,52,97,1.14842804826258,4.38288182149503,7.90586318795466,101,"ENSG00000079974.19"
"32756","ENSG00000227742.2_17003",16995,17003,9,"ENSG00000227742.2",1,7,"UVVVVVMVV",1,7,0.787991718426501,115,121,133,136,142,148,161,164,"ATAAAGA","CAGA","GTGTTAC","CTGA",2.41190193255813,12,6,13,40,2.93620699704671,4.75388830352523,7.90585517723123,101,"ENSG00000079974.19"
"16091","ENSG00000150672.19_617075",617067,617075,9,"ENSG00000150672.19",1,8,"VVVVVVVMV",0,8,0.884057971014493,63,69,102,105,115,121,133,136,"ATGAGGA","CAGA","GTTATTA","CTAA",2.34077923822729,33,10,12,64,1.87316244962224,4.36958934278438,7.90582122684235,101,"ENSG00000079974.19"
"12629","ENSG00000138722.10_33680",33672,33680,9,"ENSG00000138722.10",1,7,"UVVVVVMVV",1,7,0.787991718426501,113,119,133,136,142,148,158,161,"TTGGTGA","CTGG","ATTTAGA","CTGA",2.40343013105142,14,6,10,39,2.9924830300038,4.75383764258665,7.90580451629265,101,"ENSG00000079974.19"
"24792","ENSG00000178031.18_415439",415431,415439,9,"ENSG00000178031.18",1,2,"VMVVVVVVV",0,8,0.884057971014493,108,114,133,136,141,147,166,169,"ATAATAA","CCAA","TTGAAAA","CTGA",2.30914564242563,19,5,19,52,2.08386099082364,4.3695413184153,7.90577320247327,101,"ENSG00000079974.19"
"436","ENSG00000011405.14_125833",125825,125833,9,"ENSG00000011405.14",1,8,"UVVVVVVMV",1,7,0.786749482401656,112,118,133,136,147,153,161,164,"GTCATAA","CTGA","AACATGA","CTGA",2.44469425318049,15,11,8,43,2.73711088358685,4.7587681428642,7.90576607247082,101,"ENSG00000079974.19"
"3705","ENSG00000088367.23_39154",39146,39154,9,"ENSG00000088367.23",0,NA,"VVUVVVVVV",1,8,0.883643892339545,79,85,97,100,116,122,133,136,"ATGATGA","GTGA","ATGCTGG","GTGG",2.2512511491802,12,16,11,48,2.47640955718845,4.37118763793078,7.90576320728896,101,"ENSG00000079974.19"
"34189","ENSG00000232072.1_128842",128834,128842,9,"ENSG00000232072.1",1,8,"VVVVVVVMV",0,8,0.884057971014493,106,112,133,136,151,157,204,207,"GTAATGA","CTTG","GTGATCA","CTGA",2.47642906163627,21,15,47,92,0.96846692210904,4.36949849992105,7.90573038397902,101,"ENSG00000079974.19"
"8373","ENSG00000118482.12_61918",61910,61918,9,"ENSG00000118482.12",1,2,"VMVVVVVVV",0,8,0.884057971014493,114,120,133,136,153,159,178,181,"ATGAAGA","TAGA","ATGAGGA","CTGG",2.32180275235922,13,17,19,58,1.99900404459419,4.36942226508059,7.90565414913856,101,"ENSG00000079974.19"
"30535","ENSG00000205639.12_26427",26419,26427,9,"ENSG00000205639.12",1,2,"VMVVVVVVV",0,8,0.884057971014493,105,111,133,136,145,151,202,205,"GTGATGA","TTGA","CTGGTAA","CTGG",2.42821606518056,22,9,51,91,1.28957870432019,4.36942145138098,7.90565333543895,101,"ENSG00000079974.19"
"38750","ENSG00000250979.1_22239",22231,22239,9,"ENSG00000250979.1",1,2,"UMVVVVVVV",1,7,0.786749482401656,73,79,97,100,107,113,133,136,"CTGATGA","CTCC","GTGACAA","CTGA",2.52772292202798,18,7,20,54,2.18283306324305,4.75857980252406,7.90557773213069,101,"ENSG00000079974.19"
"14250","ENSG00000144642.22_176962",176954,176962,9,"ENSG00000144642.22",1,8,"VVVVVVVMV",0,8,0.884057971014493,114,120,133,136,139,145,154,157,"CTATTGA","CAGG","CAGATGG","CTGA",2.19230139356053,13,3,9,34,2.86183285417471,4.36929386947789,7.90552575353586,101,"ENSG00000079974.19"
"44793","ENSG00000283563.1_402575",402567,402575,9,"ENSG00000283563.1",1,8,"VVVVVVVMV",0,8,0.884057971014493,114,120,133,136,139,145,154,157,"CTATTGA","CAGG","CAGATGG","CTGA",2.19230139356053,13,3,9,34,2.86183285417471,4.36929386947789,7.90552575353586,101,"ENSG00000079974.19"
"12403","ENSG00000138095.20_8440",8432,8440,9,"ENSG00000138095.20",1,2,"VMVUVVVVV",1,7,0.764803312629399,116,122,133,136,187,193,205,208,"GTGATAA","ATGA","ATGAAGA","CTGA",2.61766366227182,11,51,12,83,1.93352024828362,4.84615283252393,7.90536608304153,101,"ENSG00000079974.19"
"45388","ENSG00000285540.1_7683",7675,7683,9,"ENSG00000285540.1",1,8,"UVVVVVVMV",1,7,0.786749482401656,115,121,133,136,139,145,153,156,"AAGATGA","CATA","AGGAAGT","CTGA",2.41434860437398,12,3,8,32,2.93775089458213,4.75835206426883,7.90534999387546,101,"ENSG00000079974.19"
"10261","ENSG00000130234.13_109",101,109,9,"ENSG00000130234.13",1,2,"VMVVVVVVV",0,8,0.884057971014493,89,95,111,114,120,126,137,140,"ATGTTGA","CTTC","AGGAAGA","ATGA",2.19771814624881,16,6,11,42,2.82489093175048,4.36908631001898,7.90531819407695,101,"ENSG00000079974.19"
"45459","ENSG00000285602.1_68481",68473,68481,9,"ENSG00000285602.1",1,2,"VMVVVVVVV",0,8,0.884057971014493,111,117,133,136,142,148,159,162,"ATGTTGA","CTTC","AGGAAGA","ATGA",2.19771814624881,16,6,11,42,2.82489093175048,4.36908631001898,7.90531819407695,101,"ENSG00000079974.19"
"5290","ENSG00000104237.11_64709",64701,64709,9,"ENSG00000104237.11",1,8,"UVVVVVVMV",1,7,0.786749482401656,114,120,133,136,139,145,156,159,"AGGAGGA","CTGG","ATGCTGC","CTGA",2.4372621944133,13,3,11,36,2.78483965074055,4.75831357004064,7.90531149964726,101,"ENSG00000079974.19"
"37403","ENSG00000248118.2_11853",11845,11853,9,"ENSG00000248118.2",1,8,"VVVVVUVMV",1,7,0.806211180124224,115,121,133,136,141,147,156,159,"ATAATGG","CTGA","GTCAGGA","CTGG",2.34895435970551,12,5,9,35,3.06188807165969,4.68039595075743,7.90524067125433,101,"ENSG00000079974.19"
"42261","ENSG00000261371.6_73915",73907,73915,9,"ENSG00000261371.6",1,8,"VVVVVVVMV",0,8,0.884057971014493,89,95,133,136,159,165,179,182,"GTGCTGG","CTGT","CTGAGGA","CTGA",2.46424624210485,38,23,14,84,1.04748757065654,4.36894896283889,7.90518084689686,101,"ENSG00000079974.19"
"17209","ENSG00000153707.19_1067222",1067214,1067222,9,"ENSG00000153707.19",1,2,"VMUVVVVVV",1,7,0.767701863354037,116,122,133,136,144,150,165,168,"ATGAACA","CAGA","ATAATGA","CTGA",2.48198063423087,11,8,15,43,2.79091879929339,4.83436409020812,7.90517154362427,101,"ENSG00000079974.19"
"12105","ENSG00000137261.15_89345",89337,89345,9,"ENSG00000137261.15",0,NA,"VVUVUVVVV",2,7,0.773498964803312,86,92,133,136,172,178,190,193,"GTGATGA","CTTA","CTGAAGA","CTGA",2.74035084937026,41,36,12,98,0.975504759046671,4.81112760537876,7.90512346459201,101,"ENSG00000079974.19"
"899","ENSG00000039560.14_167413",167405,167413,9,"ENSG00000039560.14",1,8,"VVVVUVVMV",1,7,0.773913043478261,104,110,133,136,142,148,203,206,"GTGATGA","ATGA","ATGATAG","CTGA",2.6970466135011,23,6,55,93,1.25755811530443,4.8094672179946,7.90511939190765,101,"ENSG00000079974.19"
"38654","ENSG00000250723.7_4534",4526,4534,9,"ENSG00000250723.7",0,NA,"VVVUVVVVV",1,8,0.880745341614907,116,122,133,136,187,193,203,206,"AAGATGT","ATCA","GTGTACA","CTGA",2.33296577798126,11,51,10,81,1.97542732851881,4.38213312876514,7.90511449522477,101,"ENSG00000079974.19"
"21440","ENSG00000167632.18_346572",346564,346572,9,"ENSG00000167632.18",1,8,"VVVVVUVMV",1,7,0.806211180124224,84,90,133,136,141,147,182,185,"TTGATGA","GTGA","TTTATGA","CTGA",2.66037836084468,43,5,35,92,0.985040044108906,4.68022394576837,7.90506866626526,101,"ENSG00000079974.19"
"21735","ENSG00000168827.15_21408",21400,21408,9,"ENSG00000168827.15",1,2,"VMVVVVVVV",0,8,0.884057971014493,112,118,133,136,140,146,191,194,"TTGATAT","AAGA","GTGATTA","CTGA",2.35808696420567,15,4,45,73,1.75457668588941,4.36878911181514,7.90502099587311,101,"ENSG00000079974.19"
"16918","ENSG00000152689.18_126487",126479,126487,9,"ENSG00000152689.18",1,8,"VVVVVUVMV",1,7,0.806211180124224,48,54,75,78,87,93,133,136,"AGGATGG","CTGA","ATGTTGG","CTGA",2.6009326303191,21,9,40,79,1.38087914269804,4.68010750287301,7.9049522233699,101,"ENSG00000079974.19"
"7164","ENSG00000113083.15_12548",12540,12548,9,"ENSG00000113083.15",1,3,"VVMVVVVVV",0,8,0.882815734989648,96,102,133,136,158,164,175,178,"TTGATGA","TTTA","AAGATAC","CTGA",2.44098830824515,31,22,11,73,1.22139265270352,4.37366201025113,7.90492495020972,101,"ENSG00000079974.19"
"15561","ENSG00000148680.16_93462",93454,93462,9,"ENSG00000148680.16",1,2,"VMVVVUVVV",1,7,0.806211180124223,108,114,133,136,145,151,169,172,"ATGATGA","CTAA","CTGAAAA","CTGC",2.48350277071726,19,9,18,55,2.1635125557618,4.68004942346921,7.90489414396611,101,"ENSG00000079974.19"
"22327","ENSG00000170325.16_21272",21264,21272,9,"ENSG00000170325.16",1,7,"VVVVVUMVV",1,7,0.807453416149068,104,110,133,136,142,148,161,164,"ATGATTG","ATGA","CTGCAGA","CTGA",2.47856930371071,23,6,13,51,2.17641568243738,4.6750527601272,7.90486642472348,101,"ENSG00000079974.19"
"1665","ENSG00000064886.14_34442",34434,34442,9,"ENSG00000064886.14",1,8,"VVVVVVUMV",1,7,0.770186335403727,71,77,104,107,116,122,133,136,"AGGAGGA","CTGA","CTAATGA","CTGA",2.58860107240268,27,9,11,56,2.03901558767135,4.82408901758897,7.90483435920387,101,"ENSG00000079974.19"
"20567","ENSG00000165091.18_13397",13389,13397,9,"ENSG00000165091.18",1,8,"UVVVVVVMV",1,7,0.786749482401656,74,80,93,96,114,120,133,136,"ATGATCA","CAAA","TTGATGC","CTGA",2.51147532292972,13,18,13,53,2.28767203702123,4.75771021413818,7.9047081437448,101,"ENSG00000079974.19"
"38781","ENSG00000251026.2_178425",178417,178425,9,"ENSG00000251026.2",0,NA,"VVVVUVVVV",1,8,0.889855072463768,88,94,133,136,152,158,167,170,"CTGATGG","TGGA","CTAATAA","CTGA",2.38370965110668,39,16,9,73,1.48934030498244,4.34518449475675,7.90460478461182,101,"ENSG00000079974.19"
"28177","ENSG00000188352.13_110968",110960,110968,9,"ENSG00000188352.13",0,NA,"UVUVVVVVV",2,7,0.786335403726708,107,113,133,136,159,165,185,188,"ATGGTGA","CTGC","TTGATGA","CTGA",2.67855286109738,20,23,20,72,1.17988172917551,4.75922520078951,7.90456681569634,101,"ENSG00000079974.19"
"699","ENSG00000026508.21_93470",93462,93470,9,"ENSG00000026508.21",1,7,"VVVVVUMVV",1,7,0.807453416149068,90,96,104,107,116,122,133,136,"ATAATGA","ATGA","TTGCTGA","CTTA",2.39287539419226,8,9,11,37,2.7463316740588,4.67470857550181,7.90452224009808,101,"ENSG00000079974.19"
"6978","ENSG00000112406.5_19740",19732,19740,9,"ENSG00000112406.5",1,1,"MVVUVVVVV",1,7,0.786749482401656,116,122,133,136,147,153,163,166,"ACTATGA","TTGA","ATTTTGA","CTGA",2.42940427924148,11,11,10,41,2.83404292477404,4.75751786326265,7.90451579286927,101,"ENSG00000079974.19"
"11574","ENSG00000135365.17_176808",176800,176808,9,"ENSG00000135365.17",1,6,"VVVVVMUVV",1,7,0.788819875776397,51,57,70,73,80,86,133,136,"CTGATGT","GTGA","GGGAGGA","CTGA",2.54946467280944,13,7,47,76,2.000383254709,4.74920360169298,7.90448310479857,101,"ENSG00000079974.19"
"27617","ENSG00000186814.14_3794",3786,3794,9,"ENSG00000186814.14",1,2,"VMVVVVVVV",0,8,0.884057971014493,71,77,88,91,95,101,133,136,"ATGGTGA","TTGA","TTGAACA","CTGC",2.33548504527064,11,4,32,56,1.90293514780207,4.36820886240159,7.90444074645956,101,"ENSG00000079974.19"
"43100","ENSG00000268573.1_3750",3742,3750,9,"ENSG00000268573.1",1,2,"VMVVVVVVV",0,8,0.884057971014493,71,77,88,91,95,101,133,136,"ATGGTGA","TTGA","TTGAACA","CTGC",2.33548504527064,11,4,32,56,1.90293514780207,4.36820886240159,7.90444074645956,101,"ENSG00000079974.19"
"1355","ENSG00000054282.16_98042",98034,98042,9,"ENSG00000054282.16",1,6,"UVVVVMVVV",1,7,0.805383022774327,116,122,133,136,141,147,167,170,"ACCATGA","ATGA","CTGATTT","CTGA",2.44541762477349,11,5,20,45,2.42869259692044,4.68286919051925,7.90440128161656,101,"ENSG00000079974.19"
"46299","ENSG00000286469.1_8461",8453,8461,9,"ENSG00000286469.1",1,2,"VMVVVVVVV",0,8,0.884057971014493,81,87,98,101,106,112,133,136,"AAGATGC","CTGA","ATCAATA","CTTA",2.26529862324014,11,5,21,46,2.37068326431302,4.36816852147848,7.90440040553645,101,"ENSG00000079974.19"
"3579","ENSG00000086102.19_15710",15702,15710,9,"ENSG00000086102.19",1,1,"MVVVVUVVV",1,7,0.82815734989648,115,121,133,136,139,145,171,174,"GTGATTA","GTGT","GAGATGA","CTGA",2.46432388674286,12,3,26,50,1.93814182990544,4.59174193538112,7.90437133496705,101,"ENSG00000079974.19"
"25328","ENSG00000180861.9_594",586,594,9,"ENSG00000180861.9",1,1,"MVVVVUVVV",1,7,0.82815734989648,23,29,45,48,87,93,133,136,"GTGATTA","CTGA","CTGCTCA","CTGA",2.62485605533197,16,39,40,104,0.867503006847191,4.59163584393175,7.90426524351767,101,"ENSG00000079974.19"
"4487","ENSG00000100678.20_33663",33655,33663,9,"ENSG00000100678.20",1,3,"VVMVVVVVV",0,8,0.882815734989648,79,85,96,99,104,110,133,136,"ATGAACA","CTGA","CAGAGGA","TTGA",2.2837589415141,11,5,23,48,2.26679467221333,4.37296357057684,7.90422651053543,101,"ENSG00000079974.19"
"30504","ENSG00000205339.10_58636",58628,58636,9,"ENSG00000205339.10",0,NA,"UVVVVUVVV",2,7,0.824844720496894,109,115,133,136,142,148,201,204,"GTGATGG","CTGT","ATGTAAA","CTGA",2.51520205854232,18,6,53,86,1.65136160950686,4.60484383328058,7.90422271526816,101,"ENSG00000079974.19"
"24623","ENSG00000177182.11_360136",360128,360136,9,"ENSG00000177182.11",0,NA,"VVVVVVUVV",1,8,0.886128364389234,86,92,133,136,150,156,171,174,"ATTAAGA","CTAA","TTTAAGA","CTGA",2.39962679592959,41,14,15,79,1.44090983658226,4.35960545236154,7.90411890991848,101,"ENSG00000079974.19"
"46021","ENSG00000286122.1_291045",291037,291045,9,"ENSG00000286122.1",0,NA,"VVVVUVVVV",1,8,0.889855072463768,12,18,33,36,79,85,133,136,"ATGATGA","CTCA","CTGTTTA","GTGA",2.46916765376363,15,43,48,115,0.917407824398877,4.34463137903911,7.90405166889418,101,"ENSG00000079974.19"
"32700","ENSG00000227579.6_527207",527199,527207,9,"ENSG00000227579.6",1,8,"VVVVVVVMV",0,8,0.884057971014493,90,96,133,136,144,150,167,170,"ATTATGC","CAGT","CTGAAGT","CTGA",2.36739228574654,37,8,17,71,1.68852596755964,4.36778530146748,7.90401718552545,101,"ENSG00000079974.19"
"9701","ENSG00000126653.18_68128",68120,68128,9,"ENSG00000126653.18",1,2,"VMVVUVVVV",1,7,0.773913043478261,89,95,105,108,116,122,133,136,"TTGTTGC","GTGA","GTGATTA","CTGA",2.4422866916349,10,8,11,38,2.95154406691556,4.80836383612038,7.90401601003342,101,"ENSG00000079974.19"
"47865","ENSG00000289526.2_19040",19032,19040,9,"ENSG00000289526.2",0,NA,"VVUVVVVVV",1,8,0.883643892339545,110,116,133,136,160,166,187,190,"ATCATGG","CTTC","ATGAAGA","CTGA",2.41735637979186,17,24,21,71,1.36200110152543,4.36942757503446,7.90400314439264,101,"ENSG00000079974.19"
"33917","ENSG00000231482.3_100069",100061,100069,9,"ENSG00000231482.3",1,8,"VVVVVUVMV",1,7,0.806211180124224,115,121,133,136,148,154,171,174,"CAGATGG","GTGA","GAGATGA","CTGA",2.43783126143405,12,12,17,50,2.46438680404,4.67914880340009,7.90399352389698,101,"ENSG00000079974.19"
"46174","ENSG00000286251.2_189576",189568,189576,9,"ENSG00000286251.2",1,8,"UVVVVVVMV",1,7,0.786749482401656,109,115,133,136,180,186,200,203,"ATGTTCA","CTGA","ATGAGGA","CTGA",2.62303961071163,18,44,14,85,1.54096641124949,4.75697428733176,7.90397221693838,101,"ENSG00000079974.19"
"3141","ENSG00000081760.17_59079",59071,59079,9,"ENSG00000081760.17",0,NA,"VVVUVVVVV",1,8,0.880745341614907,109,115,133,136,146,152,164,167,"GTGCTGA","GTCA","GTGAGGA","GTGA",2.25001727097407,18,10,12,49,2.5238215176267,4.38098416436346,7.90396553082308,101,"ENSG00000079974.19"
"16903","ENSG00000152601.18_173248",173240,173248,9,"ENSG00000152601.18",1,5,"UVVVMVVVV",1,7,0.789233954451346,112,118,133,136,175,181,228,231,"GTGATGA","CAGA","TTAATGA","CTGA",2.70970020498369,15,39,47,110,0.923399960601928,4.74701699845664,7.90395281626202,101,"ENSG00000079974.19"
"41153","ENSG00000258583.7_93908",93900,93908,9,"ENSG00000258583.7",0,NA,"VVVUVVVVV",1,8,0.880745341614907,97,103,133,136,147,153,162,165,"GTGGTGA","CTTA","GTGCTGA","ATGA",2.3469904749319,30,11,9,59,1.87725557319027,4.38096468485074,7.90394605131037,101,"ENSG00000079974.19"
"43961","ENSG00000276076.6_21469",21461,21469,9,"ENSG00000276076.6",1,8,"VVVVVVVMV",0,8,0.884057971014493,45,51,73,76,81,87,133,136,"TTGAGGA","CTGA","ATGATGG","GTGA",2.42945985370011,22,5,46,82,1.27444106684685,4.36771002287855,7.90394190693653,101,"ENSG00000079974.19"
"46393","ENSG00000286549.1_21046",21038,21046,9,"ENSG00000286549.1",1,8,"VVVVVVVMV",0,8,0.884057971014493,45,51,73,76,81,87,133,136,"TTGAGGA","CTGA","ATGATGG","GTGA",2.42945985370011,22,5,46,82,1.27444106684685,4.36771002287855,7.90394190693653,101,"ENSG00000079974.19"
"8517","ENSG00000119403.15_4592",4584,4592,9,"ENSG00000119403.15",1,7,"VVVVVVMVV",0,8,0.885300207039338,115,121,133,136,175,181,197,200,"ATGAAAA","TTAA","GTGAGGC","CTGA",2.35247766484472,12,39,16,76,1.76772587188689,4.36272757604626,7.90392840420361,101,"ENSG00000079974.19"
"2480","ENSG00000075213.11_450924",450916,450924,9,"ENSG00000075213.11",1,8,"VVVVVVVMV",0,8,0.884057971014493,109,115,133,136,163,169,182,185,"TTGCTGA","CTCT","CAGATGA","CTGA",2.36961581809392,18,27,13,67,1.6730729493113,4.36762793415102,7.90385981820899,101,"ENSG00000079974.19"
"14498","ENSG00000145147.20_85851",85843,85851,9,"ENSG00000145147.20",0,NA,"VVVVUVVVV",1,8,0.889855072463768,116,122,133,136,139,145,156,159,"ATACTGA","CAGA","TTGATCT","CAGA",2.18242669240342,11,3,11,34,2.8281652332091,4.34441912897463,7.90383941882971,101,"ENSG00000079974.19"
"1851","ENSG00000066651.20_145991",145983,145991,9,"ENSG00000066651.20",0,NA,"VVVUVVVVV",1,8,0.880745341614907,88,94,109,112,116,122,133,136,"CTGTTGA","TTGA","TGGTTGA","ATGA",2.21184087546822,15,4,11,39,2.77782053741616,4.38085659346774,7.90383795992736,101,"ENSG00000079974.19"
"21609","ENSG00000168502.18_11129",11121,11129,9,"ENSG00000168502.18",1,2,"VMVVVVVVV",0,8,0.884057971014493,113,119,133,136,151,157,177,180,"AGCATGA","AGGA","AGGACGA","CTGA",2.31533178423715,14,15,20,58,2.03410966238244,4.36741372265753,7.9036456067155,101,"ENSG00000079974.19"
"12040","ENSG00000136928.7_348271",348263,348271,9,"ENSG00000136928.7",1,5,"VVVVMVVVV",0,8,0.886542443064182,65,71,78,81,91,97,133,136,"CTGATGT","CTGA","ATCATGG","CTGC",2.38137592710414,7,10,36,62,1.55403683978628,4.35746908845347,7.9036388607102,101,"ENSG00000079974.19"
"4486","ENSG00000100678.20_112559",112551,112559,9,"ENSG00000100678.20",1,7,"VVVVVVMVV",0,8,0.885300207039338,116,122,133,136,140,146,163,166,"GTAATTT","CTAA","ATAATTA","CTGA",2.23730638403922,11,4,17,41,2.53435147947551,4.36243184326758,7.90363267142493,101,"ENSG00000079974.19"
"36219","ENSG00000238755.3_411093",411085,411093,9,"ENSG00000238755.3",1,7,"VVVVVVMVV",0,8,0.885300207039338,67,73,86,89,98,104,133,136,"ATGATTA","CAGA","TCGATAA","CTCA",2.30318345392853,13,9,29,60,2.09512994249798,4.36242157550537,7.90362240366272,101,"ENSG00000079974.19"
"19487","ENSG00000163116.10_20663",20655,20663,9,"ENSG00000163116.10",1,8,"VVVVVVVMV",0,8,0.884057971014493,91,97,133,136,183,189,198,201,"ATAATGA","CAGG","CTGATAC","CTGA",2.46944107293645,36,47,9,101,1.00647709959797,4.36735439646024,7.90358628051821,101,"ENSG00000079974.19"
"12737","ENSG00000138814.17_35463",35455,35463,9,"ENSG00000138814.17",1,8,"VVVVVUVMV",1,7,0.806211180124224,96,102,108,111,116,122,133,136,"CTGATGA","CTGG","GTGCTTA","CTTA",2.3997638207624,6,5,11,31,2.71637404355486,4.67869987882605,7.90354459932295,101,"ENSG00000079974.19"
"19563","ENSG00000163297.18_1176",1168,1176,9,"ENSG00000163297.18",1,2,"VMUVVVVVV",1,7,0.767701863354037,95,101,110,113,116,122,133,136,"ATGATGT","CTGA","GTGTGGT","CTTA",2.48266222449135,9,3,11,32,2.7794809799021,4.83264061912778,7.90344807254393,101,"ENSG00000079974.19"
"14529","ENSG00000145348.17_488",480,488,9,"ENSG00000145348.17",0,NA,"VVVVVVUVV",1,8,0.886128364389234,81,87,105,108,114,120,133,136,"GTGAGGG","CTGA","GGGTAGA","CGGA",2.2292919565712,18,6,13,46,2.57340124586314,4.35883690575112,7.90335036330806,101,"ENSG00000079974.19"
"15774","ENSG00000149503.13_22103",22095,22103,9,"ENSG00000149503.13",1,3,"VVMVVVVVV",0,8,0.882815734989648,114,120,133,136,142,148,189,192,"TTAATGT","CAGT","CTGATGC","CTGA",2.32381937047065,13,6,41,69,1.99618075779322,4.37207747356605,7.90334041352464,101,"ENSG00000079974.19"
"36786","ENSG00000243004.7_176368",176360,176368,9,"ENSG00000243004.7",1,2,"VMVVVVVVV",0,8,0.884057971014493,98,104,133,136,146,152,207,210,"ATGTAGA","CTAA","GAGATGA","CTGA",2.47660679507128,29,10,55,103,0.957579874468135,4.3670729604025,7.90330484446047,101,"ENSG00000079974.19"
"24435","ENSG00000176294.6_54671",54663,54671,9,"ENSG00000176294.6",1,3,"VVMVVVVVV",0,8,0.882815734989648,106,112,133,136,142,148,178,181,"ATGATGG","CAGA","GTGGTTA","CTTA",2.39518970541012,21,6,30,66,1.52020069966266,4.37203301726587,7.90329595722446,101,"ENSG00000079974.19"
"24436","ENSG00000176299.5_182",174,182,9,"ENSG00000176299.5",1,3,"VVMVVVVVV",0,8,0.882815734989648,106,112,133,136,142,148,178,181,"ATGATGG","CAGA","GTGGTTA","CTTA",2.39518970541012,21,6,30,66,1.52020069966266,4.37203301726587,7.90329595722446,101,"ENSG00000079974.19"
"22390","ENSG00000170448.12_41740",41732,41740,9,"ENSG00000170448.12",1,3,"VVMVVVVVV",0,8,0.882815734989648,99,105,133,136,150,156,169,172,"ATTTTGA","ATGA","ATGCTAC","CTGA",2.38022231301854,28,14,13,64,1.6198853768018,4.37200853256468,7.90327147252328,101,"ENSG00000079974.19"
"7437","ENSG00000114248.10_5356",5348,5356,9,"ENSG00000114248.10",0,NA,"VVUVVVVVV",1,8,0.883643892339545,27,33,47,50,86,92,133,136,"ATGATGA","TTGA","TTGCTCA","CTGC",2.47160603746962,14,36,41,100,0.997130411825587,4.36862599873909,7.90320156809727,101,"ENSG00000079974.19"
"14042","ENSG00000144290.17_187518",187510,187518,9,"ENSG00000144290.17",1,8,"VVVUVVVMV",1,7,0.764803312629399,110,116,133,136,154,160,172,175,"TTGAAGA","CTGA","GGGATCA","CTGA",2.59349846935856,17,18,12,56,2.08582511341122,4.84395372728374,7.90316697780134,101,"ENSG00000079974.19"
"29749","ENSG00000198673.11_393016",393008,393016,9,"ENSG00000198673.11",1,8,"VVVVVUVMV",1,7,0.806211180124224,87,93,106,109,116,122,133,136,"CTAATGA","CTGA","AAGAGGA","CTGG",2.35478426777165,13,7,11,40,3.01450882069823,4.67826765146065,7.90311237195754,101,"ENSG00000079974.19"
"30406","ENSG00000204929.13_364259",364251,364259,9,"ENSG00000204929.13",1,8,"VVUVVVVMV",1,7,0.767701863354037,115,121,133,136,147,153,162,165,"TTAATGA","TTGA","ATGTAGT","CTGA",2.47064189344355,12,11,9,41,2.85804558259554,4.83224788472146,7.90305533813761,101,"ENSG00000079974.19"
"16203","ENSG00000151136.15_113817",113809,113817,9,"ENSG00000151136.15",0,NA,"VVVVVUUVV",2,7,0.808281573498965,114,120,133,136,152,158,168,171,"ATACTGA","CTAA","CTGAGGC","CTGA",2.42903740360854,13,16,10,48,2.48607452033256,4.66991430276404,7.9030405967599,101,"ENSG00000079974.19"
"27037","ENSG00000185448.12_2158",2150,2158,9,"ENSG00000185448.12",1,8,"VVVVVVVMV",0,8,0.884057971014493,83,89,133,136,149,155,180,183,"AAGATGA","AAGA","TTGATTG","CTGA",2.47492950363995,44,13,25,91,0.96760501997773,4.36678376106102,7.90301564511899,101,"ENSG00000079974.19"
"460","ENSG00000012223.13_16320",16312,16320,9,"ENSG00000012223.13",1,8,"VVVVUUVMV",2,6,0.696066252587992,69,75,86,89,115,121,133,136,"ATGATGA","CTGT","GTGTGGA","CTGA",2.76567203937354,11,26,12,58,2.03717116337747,5.11874618980027,7.90301120015224,101,"ENSG00000079974.19"
"15529","ENSG00000148655.15_27438",27430,27438,9,"ENSG00000148655.15",1,2,"VMVVVVVVV",0,8,0.884057971014493,114,120,133,136,148,154,166,169,"AAGATGA","CAGG","AAGATGG","TTGA",2.21150225414614,13,12,12,46,2.7236491260237,4.36674937174949,7.90298125580746,101,"ENSG00000079974.19"
"48158","ENSG00000290551.1_236453",236445,236453,9,"ENSG00000290551.1",0,NA,"UVVVUVVVV",2,7,0.792546583850932,113,119,133,136,144,150,172,175,"GCGATGG","CTGG","ATGAGGA","CTGA",2.48588598801989,14,8,22,53,2.35829086724585,4.73271603017795,7.90290236558167,101,"ENSG00000079974.19"
"4823","ENSG00000101972.20_380704",380696,380704,9,"ENSG00000101972.20",0,NA,"VVUVVVVVV",1,8,0.883643892339545,108,114,133,136,176,182,194,197,"TTTATGA","CATA","TTCATGA","CTGA",2.38958356498738,19,40,12,80,1.54230317574889,4.36821506891619,7.90279063827437,101,"ENSG00000079974.19"
"26349","ENSG00000183918.18_113048",113040,113048,9,"ENSG00000183918.18",0,NA,"VVUVVVVVV",1,8,0.883643892339545,108,114,133,136,176,182,194,197,"TTTATGA","CATA","TTCATGA","CTGA",2.38958356498738,19,40,12,80,1.54230317574889,4.36821506891619,7.90279063827437,101,"ENSG00000079974.19"
"2736","ENSG00000077943.8_139424",139416,139424,9,"ENSG00000077943.8",0,NA,"UVVVUVVVV",2,7,0.792546583850932,48,54,73,76,85,91,133,136,"TTGATGA","CTGG","TTGCTAA","CTGA",2.60838558270985,19,9,42,79,1.54114105760098,4.73259456891667,7.90278090432039,101,"ENSG00000079974.19"
"15324","ENSG00000147724.12_271434",271426,271434,9,"ENSG00000147724.12",1,7,"VVVVVUMVV",1,7,0.807453416149068,111,117,133,136,150,156,171,174,"ATGAGGG","CAGA","CTGCTCA","CTGA",2.4620957065191,16,14,15,54,2.27787128706874,4.67296066596569,7.90277433056196,101,"ENSG00000079974.19"
"23248","ENSG00000172379.22_96622",96614,96622,9,"ENSG00000172379.22",1,2,"VMVVVVVVV",0,8,0.884057971014493,114,120,133,136,143,149,183,186,"AAAATTA","TTGA","GTGGTCA","CTGA",2.31103676078795,13,7,34,63,2.05915348148094,4.36651630501683,7.9027481890748,101,"ENSG00000079974.19"
"44898","ENSG00000284377.2_32124",32116,32124,9,"ENSG00000284377.2",1,8,"UVVVVVVMV",1,7,0.786749482401656,103,109,133,136,147,153,168,171,"ATGATGA","TAGA","ATCTGGA","CTGA",2.57291050045665,24,11,15,59,1.87017893974065,4.75572890236291,7.90272683196954,101,"ENSG00000079974.19"
"6761","ENSG00000111817.19_140016",140008,140016,9,"ENSG00000111817.19",0,NA,"VVVVVVUVV",1,8,0.886128364389234,111,117,133,136,148,154,170,173,"AAGATCA","TTTA","ACGAAGT","CTGA",2.26054606730979,16,12,16,53,2.36243376153692,4.35818521923388,7.90269867679082,101,"ENSG00000079974.19"
"7681","ENSG00000115353.11_24530",24522,24530,9,"ENSG00000115353.11",1,2,"VMVVVVVVV",0,8,0.884057971014493,112,118,133,136,149,155,170,173,"ATTATTT","ATAA","CTGATCA","CTGA",2.25672706532723,15,13,15,52,2.42101182640713,4.36646473214716,7.90269661620513,101,"ENSG00000079974.19"
"35273","ENSG00000235531.11_74037",74029,74037,9,"ENSG00000235531.11",0,NA,"VVVVVVUVV",1,8,0.886128364389234,110,116,133,136,161,167,188,191,"ATCATGG","CTTC","ATGAGGA","CTGA",2.41397800141349,17,25,21,72,1.33921580078476,4.35810061921867,7.9026140767756,101,"ENSG00000079974.19"
"46940","ENSG00000287390.1_198120",198112,198120,9,"ENSG00000287390.1",0,NA,"VVVVVVUVV",1,8,0.886128364389234,110,116,133,136,161,167,188,191,"ATCATGG","CTTC","ATGAGGA","CTGA",2.41397800141349,17,25,21,72,1.33921580078476,4.35810061921867,7.9026140767756,101,"ENSG00000079974.19"
"41351","ENSG00000258902.2_126482",126474,126482,9,"ENSG00000258902.2",1,2,"VMVVVVVVV",0,8,0.884057971014493,81,87,99,102,109,115,133,136,"ATAATGA","CCCA","ATGACAA","TTGA",2.22373498249279,12,7,18,46,2.64032688451767,4.36630669195074,7.90253857600871,101,"ENSG00000079974.19"
"43528","ENSG00000272168.10_629658",629650,629658,9,"ENSG00000272168.10",1,8,"VVVVVVVMV",0,8,0.884057971014493,109,115,133,136,164,170,183,186,"GGGAGGA","CTGG","GTAATTA","CTGA",2.37094751169953,18,28,13,68,1.6588320271627,4.36628719295657,7.90251907701454,101,"ENSG00000079974.19"
"6816","ENSG00000111961.19_17163",17155,17163,9,"ENSG00000111961.19",0,NA,"VVUVVVVVV",1,8,0.883643892339545,109,115,133,136,143,149,160,163,"CTGTTGA","GTGA","CAGAGGA","CTTA",2.22203014741046,18,7,11,45,2.65814522852365,4.36791988614835,7.90249545550652,101,"ENSG00000079974.19"
"27911","ENSG00000187672.15_316340",316332,316340,9,"ENSG00000187672.15",1,1,"MVVVVUVVV",1,7,0.82815734989648,112,118,133,136,157,163,174,177,"TTTATGA","ATGA","GAGATCT","CTGA",2.43386241439373,15,21,11,56,2.13363582382532,4.58984631327922,7.90247571286514,101,"ENSG00000079974.19"
"13172","ENSG00000140470.15_289332",289324,289332,9,"ENSG00000140470.15",1,7,"VVVVVVMVV",0,8,0.885300207039338,116,122,133,136,151,157,178,181,"ATTCTGA","GTTA","GAGAGGA","CTGA",2.31840716516354,11,15,21,56,1.98893751341155,4.36124632029212,7.90244714844947,101,"ENSG00000079974.19"
"11284","ENSG00000134490.14_188372",188364,188372,9,"ENSG00000134490.14",1,2,"VMUVVVVVV",1,7,0.767701863354037,51,57,69,72,96,102,133,136,"GAGATGA","CTGA","TTGAAGA","CTGA",2.71087715052738,12,24,31,76,1.25404295177956,4.83163932215719,7.90244677557334,101,"ENSG00000079974.19"
"15638","ENSG00000148948.8_660616",660608,660616,9,"ENSG00000148948.8",1,2,"UMVVVVVVV",1,7,0.786749482401656,115,121,133,136,140,146,173,176,"CTGATGA","GTCA","ATGAAGT","CTGA",2.54697999590411,12,4,27,52,2.04177102644943,4.75540941645254,7.90240734605917,101,"ENSG00000079974.19"
"43247","ENSG00000270321.2_4126",4118,4126,9,"ENSG00000270321.2",1,2,"VMVVVVVVV",0,8,0.884057971014493,116,122,133,136,142,148,160,163,"GGGAAGA","CAGT","GACCTGA","CTGA",2.17320377604771,11,6,12,38,2.97649584985615,4.36613025587689,7.90236213993486,101,"ENSG00000079974.19"
"19395","ENSG00000162852.14_93359",93351,93359,9,"ENSG00000162852.14",1,8,"VVVVVVVMV",0,8,0.884057971014493,114,120,133,136,177,183,197,200,"CTGATGA","GTGG","ATGACGA","CTGT",2.3386054622206,13,41,14,77,1.87300776904485,4.36592771262887,7.90215959668684,101,"ENSG00000079974.19"
"30932","ENSG00000214814.7_191199",191191,191199,9,"ENSG00000214814.7",1,5,"VVVVMVVVV",0,8,0.886542443064182,116,122,133,136,145,151,162,165,"AGGATGG","ATTA","CTGATGT","CTTA",2.17192470958324,11,9,11,40,2.94427865833799,4.35594418055656,7.90211395281329,101,"ENSG00000079974.19"
"36583","ENSG00000241956.11_472257",472249,472257,9,"ENSG00000241956.11",1,3,"VVMVVVVVV",0,8,0.882815734989648,113,119,133,136,183,189,229,232,"AAGATGA","GAGA","AAGATGT","CTGA",2.47455318865162,14,47,40,110,0.986155184138957,4.37079411045411,7.90205705041271,101,"ENSG00000079974.19"
"21839","ENSG00000169087.11_9695",9687,9695,9,"ENSG00000169087.11",0,NA,"VVUVVVVVV",1,8,0.883643892339545,110,116,133,136,148,154,162,165,"TTGATTA","TTGA","ATGGTGG","CTGT",2.24471407405242,17,12,8,46,2.50511453636657,4.36746875751235,7.90204432687053,101,"ENSG00000079974.19"
"4359","ENSG00000100320.24_262876",262868,262876,9,"ENSG00000100320.24",1,2,"VMVVVVVVV",0,8,0.884057971014493,65,71,88,91,103,109,133,136,"CTGAAGG","CTTA","TTGTTTA","CTGA",2.34425952825027,17,12,24,62,1.83464355852504,4.36576010338171,7.90199198743968,101,"ENSG00000079974.19"
"16370","ENSG00000151414.15_32008",32000,32008,9,"ENSG00000151414.15",0,NA,"UVVVVUVVV",2,7,0.824844720496894,116,122,133,136,144,150,166,169,"TGAATGA","ATGA","GTTATGG","CTGA",2.35226307290334,11,8,16,44,2.72866022066996,4.60260351000639,7.90198239199396,101,"ENSG00000079974.19"
"46860","ENSG00000287292.1_195464",195456,195464,9,"ENSG00000287292.1",1,2,"UMVVVVVVV",1,7,0.786749482401656,61,67,79,82,90,96,133,136,"TTAATGA","GTGA","TTGATGT","CTGA",2.54948464028927,12,8,37,66,2.02334133328472,4.75497640046996,7.90197433007658,101,"ENSG00000079974.19"
"10855","ENSG00000132972.19_109991",109983,109991,9,"ENSG00000132972.19",1,6,"VVVUVMVVV",1,7,0.78343685300207,107,113,133,136,185,191,208,211,"ATGATGA","AAGA","TTGATTA","CTGA",2.68253496769611,20,49,17,95,1.18910230073697,4.76816718801109,7.90191460001937,101,"ENSG00000079974.19"
"26102","ENSG00000183340.7_23604",23596,23604,9,"ENSG00000183340.7",0,NA,"VVVUVVVVV",1,8,0.880745341614907,116,122,133,136,140,146,196,199,"CTGCTGA","CTTG","CTGAATA","CTGA",2.35509950165992,11,4,50,74,1.81497763656881,4.37891024524207,7.9018916117017,101,"ENSG00000079974.19"
"26325","ENSG00000183840.7_79381",79373,79381,9,"ENSG00000183840.7",1,6,"UVVVVMVVV",1,7,0.805383022774327,82,88,106,109,112,118,133,136,"ATAATTA","ATGA","GTGCAGA","CTGA",2.47961804343491,18,3,15,45,2.19034904039094,4.68028399915592,7.90181609025323,101,"ENSG00000079974.19"
"2638","ENSG00000077092.20_355207",355199,355207,9,"ENSG00000077092.20",0,NA,"VVUVVVVVV",1,8,0.883643892339545,116,122,133,136,155,161,174,177,"GTGTTGT","CTTG","ATGTTGC","CTGA",2.28777303396075,11,19,13,52,2.2169553654535,4.36719389796462,7.9017694673228,101,"ENSG00000079974.19"
"33117","ENSG00000228714.4_313404",313396,313404,9,"ENSG00000228714.4",1,2,"VMVVVVVVV",0,8,0.884057971014493,115,121,133,136,149,155,166,169,"AGAATGT","CTTT","ATGATTT","CTGA",2.21640442854048,12,13,11,45,2.68610849742335,4.36553450525663,7.9017663893146,101,"ENSG00000079974.19"
"33454","ENSG00000229912.1_5379",5371,5379,9,"ENSG00000229912.1",1,8,"UVVVVVVMV",1,7,0.786749482401656,105,111,133,136,145,151,168,171,"GAGATGA","TTGA","GTCAAGA","CTGA",2.55507006058387,22,9,17,57,1.98521013848261,4.75475263559377,7.90175056520039,101,"ENSG00000079974.19"
"35151","ENSG00000235126.1_7048",7040,7048,9,"ENSG00000235126.1",1,8,"UVVVVVVMV",1,7,0.786749482401656,105,111,133,136,145,151,168,171,"GAGATGA","TTGA","GTCAAGA","CTGA",2.55507006058387,22,9,17,57,1.98521013848261,4.75475263559377,7.90175056520039,101,"ENSG00000079974.19"
"5801","ENSG00000106723.17_79359",79351,79359,9,"ENSG00000106723.17",1,2,"VMVVVVVVV",0,8,0.884057971014493,94,100,133,136,141,147,161,164,"GTGAAGA","ATGC","ATAAAAA","CTGA",2.34633907005137,33,5,14,61,1.81969938180521,4.36548996220359,7.90172184626156,101,"ENSG00000079974.19"
"4969","ENSG00000102471.16_66718",66710,66718,9,"ENSG00000102471.16",1,7,"VVVVVVMVV",0,8,0.885300207039338,95,101,133,136,145,151,164,167,"GTGATTA","CTTC","GTCAGCA","CTGA",2.332344089361,32,9,13,63,1.89307594701549,4.36050913568886,7.90170996384621,101,"ENSG00000079974.19"
"16155","ENSG00000150995.21_232423",232415,232423,9,"ENSG00000150995.21",0,NA,"UVVVVUVVV",2,7,0.824844720496894,97,103,133,136,138,144,152,155,"TTGCTGA","CTGA","GAGCTGG","CTGA",2.52886999561311,30,2,8,49,1.55014267063884,4.60231899368157,7.90169787566915,101,"ENSG00000079974.19"
"21104","ENSG00000166441.13_8673",8665,8673,9,"ENSG00000166441.13",1,8,"VVVVUVVMV",1,7,0.773913043478261,105,111,133,136,143,149,166,169,"ATCATGT","CTGA","GTGAAAG","CTGA",2.5784233201091,22,7,17,55,2.03466826570025,4.8060392666069,7.90169144051994,101,"ENSG00000079974.19"
"21105","ENSG00000166441.13_8706",8698,8706,9,"ENSG00000166441.13",1,8,"VVVVUVVMV",1,7,0.773913043478261,72,78,100,103,110,116,133,136,"ATCATGT","CTGA","GTGAAAG","CTGA",2.5784233201091,22,7,17,55,2.03466826570025,4.8060392666069,7.90169144051994,101,"ENSG00000079974.19"
"39579","ENSG00000253853.3_69832",69824,69832,9,"ENSG00000253853.3",1,3,"VVMVVUVVV",1,7,0.804968944099379,70,76,99,102,110,116,133,136,"TTAATGA","CTAA","GTGAGGC","CTGA",2.51547781588038,23,8,17,57,1.95724851515062,4.68177515525495,7.90165093165246,101,"ENSG00000079974.19"
"11974","ENSG00000136754.18_97800",97792,97800,9,"ENSG00000136754.18",1,2,"VMVVVVVVV",0,8,0.884057971014493,70,76,82,85,90,96,133,136,"GGGATGA","CTGA","ATAAGGA","TTGA",2.40087387313591,6,5,37,57,1.45544624205023,4.36531801573908,7.90154989979705,101,"ENSG00000079974.19"
"6921","ENSG00000112249.14_35849",35841,35849,9,"ENSG00000112249.14",1,7,"VVVVUVMVV",1,7,0.775155279503105,115,121,133,136,140,146,156,159,"ATTAAGA","CTAA","CTGAAAA","CTGA",2.43509976890256,12,4,10,35,2.9695409736259,4.80088485824407,7.90150597625649,101,"ENSG00000079974.19"
"27087","ENSG00000185532.20_696356",696348,696356,9,"ENSG00000185532.20",1,7,"VVVVVVMVV",0,8,0.885300207039338,102,108,133,136,142,148,176,179,"ATGATTA","CAAA","GTATAGA","CTGA",2.41660297175003,25,6,28,68,1.33008581610508,4.36019307360965,7.901393901767,101,"ENSG00000079974.19"
"15311","ENSG00000147684.10_16122",16114,16122,9,"ENSG00000147684.10",1,8,"VVVVVVVMV",0,8,0.884057971014493,108,114,133,136,154,160,171,174,"ATGATGC","GTGA","TTTATTA","TTGA",2.32876430983556,19,18,11,57,1.9353658228657,4.36511530544236,7.90134718950033,101,"ENSG00000079974.19"
"38118","ENSG00000249614.2_72134",72126,72134,9,"ENSG00000249614.2",1,8,"VVVVVVVMV",0,8,0.884057971014493,77,83,95,98,112,118,133,136,"GCGATGA","ATGG","GTGATGG","CAGA",2.25293081594294,12,14,15,50,2.44081365521485,4.36508810704195,7.90131999109992,101,"ENSG00000079974.19"
"21459","ENSG00000167767.14_3309",3301,3309,9,"ENSG00000167767.14",1,3,"VVMVVVVVV",0,8,0.882815734989648,113,119,133,136,146,152,205,208,"ATGAGCA","TGGA","ATGGAGA","CTGA",2.34250332922376,14,10,53,86,1.86331165294429,4.370000128609,7.90126306856759,101,"ENSG00000079974.19"
"34802","ENSG00000234172.1_12471",12463,12471,9,"ENSG00000234172.1",1,7,"VVVVVVMVV",0,8,0.885300207039338,43,49,58,61,71,77,133,136,"TTGATGA","AAGA","ATGATCA","TTGA",2.35577897472738,9,10,56,84,1.73500030849668,4.36004836833648,7.90124919649383,101,"ENSG00000079974.19"
"47959","ENSG00000289828.1_41469",41461,41469,9,"ENSG00000289828.1",1,7,"VVVVVVMVV",0,8,0.885300207039338,43,49,58,61,71,77,133,136,"TTGATGA","AAGA","ATGATCA","TTGA",2.35577897472738,9,10,56,84,1.73500030849668,4.36004836833648,7.90124919649383,101,"ENSG00000079974.19"
"27026","ENSG00000185420.19_89562",89554,89562,9,"ENSG00000185420.19",1,5,"VVVVMVVVV",0,8,0.886542443064182,95,101,109,112,116,122,133,136,"ATTATGA","CTGA","CTGCTAA","CAGT",2.19133288334837,8,4,11,32,2.8112293139677,4.3550288007392,7.90119857299593,101,"ENSG00000079974.19"
"27267","ENSG00000185787.15_76872",76864,76872,9,"ENSG00000185787.15",0,NA,"VVVVUVVVV",1,8,0.889855072463768,113,119,133,136,140,146,159,162,"ATGTTGA","CTTT","TTGATTT","GTGA",2.19194147711365,14,4,13,40,2.753905864183,4.34171226123517,7.90113255109024,101,"ENSG00000079974.19"
"2114","ENSG00000070269.14_74511",74503,74511,9,"ENSG00000070269.14",1,1,"MVVVVUVVV",1,7,0.82815734989648,86,92,133,136,144,150,166,169,"ATGATGT","GAGA","ATGAAAC","CTGA",2.49113603163928,41,8,16,74,1.74615721044487,4.58843268867669,7.90106208826261,101,"ENSG00000079974.19"
"38582","ENSG00000250488.2_4037",4029,4037,9,"ENSG00000250488.2",1,2,"VMVVVVVVV",0,8,0.884057971014493,104,110,133,136,144,150,160,163,"ATGCTGA","ATGT","TTGAAGA","CTTA",2.27971844579186,23,8,10,50,2.26038443108461,4.36462685075759,7.90085873481556,101,"ENSG00000079974.19"
"4945","ENSG00000102466.16_26012",26004,26012,9,"ENSG00000102466.16",1,8,"VVVUVVVMV",1,7,0.764803312629399,42,48,61,64,72,78,133,136,"ATGATGA","CTGA","TTGAAAA","CAGA",2.60753499034749,13,8,55,85,1.98296466383371,4.84163281653758,7.90084606705518,101,"ENSG00000079974.19"
"36886","ENSG00000243319.7_18074",18066,18074,9,"ENSG00000243319.7",1,8,"VVVUVVVMV",1,7,0.764803312629399,42,48,61,64,72,78,133,136,"ATGATGA","CTGA","TTGAAAA","CAGA",2.60753499034749,13,8,55,85,1.98296466383371,4.84163281653758,7.90084606705518,101,"ENSG00000079974.19"
"6713","ENSG00000111666.11_10301",10293,10301,9,"ENSG00000111666.11",1,8,"VVVVVVVMV",0,8,0.884057971014493,91,97,103,106,112,118,133,136,"TTGCTGA","GTGA","GTGTTTA","ATGA",2.26012235135702,6,6,15,36,2.39090942076842,4.36459794078714,7.90082982484511,101,"ENSG00000079974.19"
"16212","ENSG00000151150.22_110482",110474,110482,9,"ENSG00000151150.22",1,5,"VVVVMVVVV",0,8,0.886542443064182,110,116,133,136,176,182,194,197,"ATGAATA","CTCT","TTGAGGA","CTGA",2.35471083945614,17,40,12,78,1.72045300399779,4.35463131675968,7.90080108901641,101,"ENSG00000079974.19"
"27972","ENSG00000187736.14_64893",64885,64893,9,"ENSG00000187736.14",1,3,"VVMVVUVVV",1,7,0.804968944099379,115,121,133,136,155,161,175,178,"TTGATGA","TTGT","ATGAGTC","CTGA",2.47938670742656,12,19,14,54,2.1943386975864,4.68089585344086,7.90077162983838,101,"ENSG00000079974.19"
"44270","ENSG00000280537.2_74851",74843,74851,9,"ENSG00000280537.2",1,3,"VVMVVUVVV",1,7,0.804968944099379,115,121,133,136,155,161,175,178,"TTGATGA","TTGT","ATGAGTC","CTGA",2.47938670742656,12,19,14,54,2.1943386975864,4.68089585344086,7.90077162983838,101,"ENSG00000079974.19"
"27593","ENSG00000186628.12_30981",30973,30981,9,"ENSG00000186628.12",1,2,"VMVVVUVVV",1,7,0.806211180124223,112,118,133,136,151,157,172,175,"ATGATTT","CTGC","TTGAGTA","CTGA",2.46347061892224,15,15,15,54,2.28048408464936,4.67590538603275,7.90075010652964,101,"ENSG00000079974.19"
"23164","ENSG00000172264.19_625820",625812,625820,9,"ENSG00000172264.19",1,3,"VVMVVVVVV",0,8,0.882815734989648,61,67,76,79,114,120,133,136,"ATGAGGA","CTGG","TTAATGA","TTGA",2.35538975825474,9,35,13,66,1.77524431665858,4.36946067625588,7.90072361621447,101,"ENSG00000079974.19"
"32795","ENSG00000227927.2_66805",66797,66805,9,"ENSG00000227927.2",1,3,"VVMVVVVVV",0,8,0.882815734989648,61,67,76,79,114,120,133,136,"ATGAGGA","CTGG","TTAATGA","TTGA",2.35538975825474,9,35,13,66,1.77524431665858,4.36946067625588,7.90072361621447,101,"ENSG00000079974.19"
"12553","ENSG00000138640.15_144392",144384,144392,9,"ENSG00000138640.15",0,NA,"VVVUVVVVV",1,8,0.880745341614907,114,120,133,136,149,155,164,167,"ATGCGGC","AAGA","GAGAAGA","CTGA",2.22206491533959,13,13,9,44,2.69709426529491,4.3777150918897,7.90069645834933,101,"ENSG00000079974.19"
"9960","ENSG00000128578.10_50058",50050,50058,9,"ENSG00000128578.10",0,NA,"UVVUVVVVV",2,7,0.78343685300207,115,121,133,136,177,183,227,230,"ATGATGC","CAGA","ATGAAGA","CTGA",2.70783548078525,12,41,44,106,1.01534457439113,4.76689527823987,7.90064269024815,101,"ENSG00000079974.19"
"12096","ENSG00000137251.16_31033",31025,31033,9,"ENSG00000137251.16",1,2,"VMVVVVVVV",0,8,0.884057971014493,20,26,61,64,77,83,133,136,"ATGATGT","CTGA","ATGAACA","CTGC",2.51282631715545,35,13,50,107,0.705318319729318,4.36437344185807,7.90060532591604,101,"ENSG00000079974.19"
"41169","ENSG00000258631.3_158343",158335,158343,9,"ENSG00000258631.3",1,1,"MVVVVVUVV",1,7,0.792132505175983,88,94,133,136,140,146,157,160,"ATGATGA","CAAA","ATGACTG","CTGA",2.56538155802862,39,4,11,63,1.82557376187791,4.73202937051717,7.9005593912211,101,"ENSG00000079974.19"
"870","ENSG00000038427.16_96748",96740,96748,9,"ENSG00000038427.16",1,2,"VMVVVVVVV",0,8,0.884057971014493,70,76,93,96,104,110,133,136,"ATGATCA","GTGA","GTGGGTA","CAGA",2.30352252025891,17,8,23,57,2.10031096129025,4.36428194075408,7.90051382481205,101,"ENSG00000079974.19"
"43138","ENSG00000269113.4_142953",142945,142953,9,"ENSG00000269113.4",1,8,"VVVVVVVMV",0,8,0.884057971014493,106,112,133,136,146,152,176,179,"ATTATGT","TTAA","CTGAAGC","CTGA",2.37527307625825,21,10,24,64,1.62181877637301,4.36424315452367,7.90047503858164,101,"ENSG00000079974.19"
"20619","ENSG00000165181.17_3688",3680,3688,9,"ENSG00000165181.17",0,NA,"UVVVUVVVV",2,7,0.792546583850932,115,121,133,136,150,156,168,171,"ATTATGA","TTAA","AGGTTGA","CTGA",2.45058623786729,12,14,12,47,2.58378750295285,4.73025727218369,7.90044360758742,101,"ENSG00000079974.19"
"37878","ENSG00000249019.2_242",234,242,9,"ENSG00000249019.2",0,NA,"VVVVUVVVV",1,8,0.889855072463768,87,93,102,105,114,120,133,136,"ATGTTGA","CTGA","CTGGTGT","CAGG",2.1936869172391,9,9,13,40,2.73908658668804,4.34091650873717,7.90033679859224,101,"ENSG00000079974.19"
"35343","ENSG00000235750.10_20353",20345,20353,9,"ENSG00000235750.10",1,8,"VVVVVVVMV",0,8,0.884057971014493,48,54,82,85,110,116,133,136,"ATGATGT","CTGA","CAGAAGA","CTTA",2.48350681908595,28,25,17,79,0.899539041329537,4.3640627921423,7.90029467620027,101,"ENSG00000079974.19"
"24945","ENSG00000178776.5_21951",21943,21951,9,"ENSG00000178776.5",1,1,"MVVVVVUVV",1,7,0.792132505175983,98,104,133,136,143,149,166,169,"ATCATGA","TTGA","TTGCTTA","CTGA",2.57563209447733,29,7,17,62,1.75617238635324,4.73176325405052,7.90029327475445,101,"ENSG00000079974.19"
"31026","ENSG00000215262.8_82555",82547,82555,9,"ENSG00000215262.8",1,3,"VVMVVVVVV",0,8,0.882815734989648,115,121,133,136,163,169,184,187,"GAGAAGA","CCCA","GTGATGG","CTGA",2.33569274833531,12,27,15,63,1.90483090107503,4.36902897249427,7.90029191245286,101,"ENSG00000079974.19"
"10165","ENSG00000129636.13_101411",101403,101411,9,"ENSG00000129636.13",1,8,"UVVVVVVMV",1,7,0.786749482401656,104,110,133,136,143,149,168,171,"ATTATGA","CTAA","TTGTGGA","CTGA",2.5747210305135,23,7,19,58,1.84826147546047,4.75326708638762,7.90026501599424,101,"ENSG00000079974.19"
"33389","ENSG00000229618.3_247436",247428,247436,9,"ENSG00000229618.3",1,1,"MVVVVVUVV",1,7,0.792132505175983,112,118,133,136,152,158,168,171,"ATAATGA","CTGA","ATGAATA","CTTA",2.47917626013956,15,16,10,50,2.3988585400963,4.73167506859001,7.90020508929395,101,"ENSG00000079974.19"
"7240","ENSG00000113391.19_217047",217039,217047,9,"ENSG00000113391.19",1,2,"VMVUVVVVV",1,7,0.764803312629399,103,109,133,136,145,151,197,200,"ATGATGA","CATA","TTGATGA","CTGA",2.72837298734905,24,9,46,88,1.17457414971875,4.84093184967811,7.9001451001957,101,"ENSG00000079974.19"
"24104","ENSG00000175161.14_521379",521371,521379,9,"ENSG00000175161.14",1,7,"VVVVVVMVV",0,8,0.885300207039338,112,118,133,136,146,152,160,163,"ATAATGA","AGGA","TTTATGT","CTGC",2.19454705121045,15,10,8,42,2.8052555133981,4.35889229703361,7.90009312519096,101,"ENSG00000079974.19"
"41163","ENSG00000258616.5_7628",7620,7628,9,"ENSG00000258616.5",1,8,"VVVVVVVMV",0,8,0.884057971014493,109,115,133,136,150,156,164,167,"ATGGGGA","TTAA","GTGCTAT","CTGA",2.27772538080345,18,14,8,49,2.27050048107152,4.36383408827363,7.9000659723316,101,"ENSG00000079974.19"
"26412","ENSG00000184220.12_20651",20643,20651,9,"ENSG00000184220.12",1,8,"VVVVVUVMV",1,7,0.806211180124224,116,122,133,136,139,145,154,157,"GTGGGGA","CTGC","ATGTTTA","CTGA",2.36549794397136,11,3,9,32,2.93087201071515,4.67521457596439,7.90005929646128,101,"ENSG00000079974.19"
"10986","ENSG00000133422.14_10428",10420,10428,9,"ENSG00000133422.14",1,3,"VVMVVVVVV",0,8,0.882815734989648,111,117,133,136,163,169,182,185,"AAGATAA","AGGA","TTAATGA","CTGA",2.3445865263646,16,27,13,65,1.84460729250439,4.36879603373377,7.90005897369236,101,"ENSG00000079974.19"
"7555","ENSG00000114805.18_181229",181221,181229,9,"ENSG00000114805.18",1,3,"UVMVVVVVV",1,7,0.785507246376811,111,117,133,136,144,150,162,165,"ATGAAGT","ATGA","GTTAGGC","CTGA",2.43651808921111,16,8,12,45,2.7886146674117,4.75801714887143,7.90004613437868,101,"ENSG00000079974.19"
"23082","ENSG00000172260.15_10612",10604,10612,9,"ENSG00000172260.15",1,8,"VVVVVVVMV",0,8,0.884057971014493,110,116,133,136,160,166,187,190,"ATCATGG","CTTC","ATGAGGA","CTGA",2.41397800141349,17,24,21,71,1.36200110152543,4.36379694440383,7.9000288284618,101,"ENSG00000079974.19"
"31730","ENSG00000224578.5_87609",87601,87609,9,"ENSG00000224578.5",1,8,"VVVVVVVMV",0,8,0.884057971014493,110,116,133,136,160,166,187,190,"ATCATGG","CTTC","ATGAGGA","CTGA",2.41397800141349,17,24,21,71,1.36200110152543,4.36379694440383,7.9000288284618,101,"ENSG00000079974.19"
"8040","ENSG00000116667.15_159489",159481,159489,9,"ENSG00000116667.15",1,8,"VVVVVVVMV",0,8,0.884057971014493,116,122,133,136,145,151,175,178,"ATTGTGA","ATGG","CTAATGG","CTGA",2.28237065107372,11,9,24,53,2.23936289252484,4.36379180825407,7.90002369231204,101,"ENSG00000079974.19"
"39626","ENSG00000253939.1_75733",75725,75733,9,"ENSG00000253939.1",1,2,"VMVVVVVVV",0,8,0.884057971014493,108,114,133,136,141,147,155,158,"CTTATGC","CCTA","CTGAGCA","CTGA",2.24138154999284,19,5,8,41,2.51261823371336,4.36379047508307,7.90002235914104,101,"ENSG00000079974.19"
"39830","ENSG00000254287.1_1375",1367,1375,9,"ENSG00000254287.1",1,2,"VMVVVVVVV",0,8,0.884057971014493,108,114,133,136,141,147,155,158,"CTTATGC","CCTA","CTGAGCA","CTGA",2.24138154999284,19,5,8,41,2.51261823371336,4.36379047508307,7.90002235914104,101,"ENSG00000079974.19"
"23109","ENSG00000172264.19_1003638",1003630,1003638,9,"ENSG00000172264.19",1,8,"VVVVVVVMV",0,8,0.884057971014493,114,120,133,136,160,166,217,220,"GTGCTGA","TTTA","GTGAAAA","CTGA",2.44659469974604,13,24,51,97,1.14430714905008,4.36373462017258,7.89996650423055,101,"ENSG00000079974.19"
"20999","ENSG00000166206.15_146734",146726,146734,9,"ENSG00000166206.15",0,NA,"VVUVVVVVV",1,8,0.883643892339545,85,91,105,108,113,119,133,136,"ATGATGT","CTCT","GGGAAAA","ATGA",2.20160544079455,14,5,14,42,2.78412916957926,4.36537469371907,7.89995026307725,101,"ENSG00000079974.19"
"27976","ENSG00000187764.12_38746",38738,38746,9,"ENSG00000187764.12",1,8,"VVVVVVVMV",0,8,0.884057971014493,97,103,133,136,145,151,167,170,"TTGATGC","TTCA","ATGAATG","CTGA",2.35532188208591,30,9,16,64,1.75265288622078,4.36369969169839,7.89993157575636,101,"ENSG00000079974.19"
"44337","ENSG00000281016.1_31013",31005,31013,9,"ENSG00000281016.1",1,8,"VVVVVVVMV",0,8,0.884057971014493,79,85,95,98,106,112,133,136,"CTGATGT","GTGA","TTAAGGA","CTAA",2.26299628477855,10,8,21,48,2.36808438130664,4.36368156995757,7.89991345401554,101,"ENSG00000079974.19"
"9131","ENSG00000122786.20_192894",192886,192894,9,"ENSG00000122786.20",1,2,"VMVVVUVVV",1,7,0.806211180124223,83,89,133,136,142,148,180,183,"ATGATGA","CTGG","ATATTTA","CTGA",2.64384693282143,44,6,32,91,1.07457311049955,4.67505483232727,7.89989955282417,101,"ENSG00000079974.19"
"19498","ENSG00000163116.10_628461",628453,628461,9,"ENSG00000163116.10",1,7,"UVVVVVMVV",1,7,0.787991718426501,90,96,104,107,115,121,133,136,"AGGGTGA","CAGA","TTGATTT","CTGA",2.43553925636747,8,8,12,37,2.75467092831852,4.74789982602541,7.89986669973142,101,"ENSG00000079974.19"
"39656","ENSG00000254044.5_118808",118800,118808,9,"ENSG00000254044.5",1,7,"UVVVVVMVV",1,7,0.787991718426501,90,96,104,107,115,121,133,136,"AGGGTGA","CAGA","TTGATTT","CTGA",2.43553925636747,8,8,12,37,2.75467092831852,4.74789982602541,7.89986669973142,101,"ENSG00000079974.19"
"2856","ENSG00000078589.13_7310",7302,7310,9,"ENSG00000078589.13",1,2,"VMVVVUVVV",1,7,0.806211180124223,97,103,133,136,147,153,177,180,"TTGATGA","ATGA","GTGAAAG","CTGA",2.62612629745463,30,11,24,74,1.19249995775098,4.67500215186214,7.89984687235903,101,"ENSG00000079974.19"
"20850","ENSG00000165868.16_2993",2985,2993,9,"ENSG00000165868.16",0,NA,"VVUVVVVVV",1,8,0.883643892339545,91,97,104,107,114,120,133,136,"TTGATGA","GAGA","AGGAGGG","TTGA",2.2240682002796,7,7,13,36,2.63343184141058,4.36513829415197,7.89971386351015,101,"ENSG00000079974.19"
"17915","ENSG00000155816.21_444805",444797,444805,9,"ENSG00000155816.21",1,8,"VVVVVVVMV",0,8,0.884057971014493,27,33,60,63,71,77,133,136,"GTGATGA","CTAA","GTGAACA","CTTA",2.45459156290697,27,8,56,100,1.08988480597681,4.36345713967248,7.89968902373045,101,"ENSG00000079974.19"
"10557","ENSG00000131558.15_440012",440004,440012,9,"ENSG00000131558.15",0,NA,"UVVVUVVVV",2,7,0.792546583850932,108,114,133,136,153,159,182,185,"ATGAAGG","CTGA","GTGAAGT","CTGA",2.63314911594728,19,17,23,68,1.3636548859702,4.72949558140468,7.89968191680841,101,"ENSG00000079974.19"
"47003","ENSG00000287474.1_33004",32996,33004,9,"ENSG00000287474.1",1,2,"VMVVVVVVV",0,8,0.884057971014493,98,104,133,136,148,154,168,171,"TTGAAGA","GGGA","GAGCTGA","CTGA",2.36363290683108,29,12,14,64,1.69577900962185,4.36333293045726,7.89956481451523,101,"ENSG00000079974.19"
"4106","ENSG00000095110.9_239",231,239,9,"ENSG00000095110.9",1,8,"VVVVVUVMV",1,7,0.806211180124224,110,116,133,136,144,150,164,167,"AAGATAA","CAGA","GTGGGAA","CTGA",2.41259066160121,17,8,14,48,2.61482619096146,4.67469098374239,7.89953570423929,101,"ENSG00000079974.19"
"20573","ENSG00000165091.18_308981",308973,308981,9,"ENSG00000165091.18",1,2,"VMVVVUVVV",1,7,0.806211180124223,61,67,75,78,115,121,133,136,"AAGATGA","ATGA","GTCAAGC","CTGA",2.54942137269925,8,37,12,66,1.70260741065741,4.67468747382977,7.89953219432667,101,"ENSG00000079974.19"
"14035","ENSG00000144283.23_207632",207624,207632,9,"ENSG00000144283.23",0,NA,"VVVVVVUVV",1,8,0.886128364389234,86,92,103,106,114,120,133,136,"AAAATGA","GTGA","TTCAAGA","TTGA",2.17726209970377,11,8,13,41,2.90473314802163,4.35495345317835,7.89946691073528,101,"ENSG00000079974.19"
"25740","ENSG00000182667.15_45936",45928,45936,9,"ENSG00000182667.15",0,NA,"VVVVUVVVV",1,8,0.889855072463768,78,84,102,105,116,122,133,136,"ATTATTA","CTGC","CTGCTGA","ATGA",2.23075010982559,18,11,11,49,2.48842074557501,4.34002203610306,7.89944232595814,101,"ENSG00000079974.19"
"35690","ENSG00000236780.7_203254",203246,203254,9,"ENSG00000236780.7",1,7,"VVVVVVMVV",0,8,0.885300207039338,94,100,133,136,146,152,196,199,"AGGAGGA","TTGA","TAGATGA","CTGA",2.47629060408079,33,10,44,96,0.924273141201259,4.35821929210163,7.89942012025898,101,"ENSG00000079974.19"
"39343","ENSG00000253496.3_235273",235265,235273,9,"ENSG00000253496.3",0,NA,"UVVUVVVVV",2,7,0.78343685300207,68,74,93,96,112,118,133,136,"ATGATGT","ATGA","ATAAAGG","CTGA",2.57698394541664,19,16,15,59,1.88254678810279,4.76560993938677,7.89935735139505,101,"ENSG00000079974.19"
"3093","ENSG00000081026.19_69724",69716,69724,9,"ENSG00000081026.19",1,2,"VMVVVVVVV",0,8,0.884057971014493,67,73,86,89,98,104,133,136,"ATGATTA","CAGA","TTAATAA","CTCA",2.30360575122582,13,9,29,60,2.09512994249798,4.3631254043342,7.89935728839217,101,"ENSG00000079974.19"
"17091","ENSG00000153107.13_109289",109281,109289,9,"ENSG00000153107.13",1,2,"VMVVVVVVV",0,8,0.884057971014493,91,97,133,136,142,148,165,168,"CTGAAAA","CAGA","ATGTGGA","CTGA",2.36474947399512,36,6,17,68,1.68750418980816,4.36312517077724,7.89935705483521,101,"ENSG00000079974.19"
"12209","ENSG00000137672.13_165804",165796,165804,9,"ENSG00000137672.13",1,3,"VVMVVVVVV",0,8,0.882815734989648,112,118,133,136,145,151,161,164,"ATTATTA","GTGA","ATGCTGG","CTGT",2.18998063930017,15,9,10,43,2.87242091295343,4.36807296040531,7.8993359003639,101,"ENSG00000079974.19"
"31329","ENSG00000223396.4_6675",6667,6675,9,"ENSG00000223396.4",1,2,"VMVVVUVVV",1,7,0.806211180124223,115,121,133,136,175,181,224,227,"ATGAAGA","ATGA","GTTATGA","CTGA",2.65161165622554,12,39,43,103,1.02044694393268,4.67446449635908,7.89930921685597,101,"ENSG00000079974.19"
"31719","ENSG00000224536.2_18137",18129,18137,9,"ENSG00000224536.2",1,2,"VMVVVUVVV",1,7,0.806211180124223,115,121,133,136,175,181,224,227,"ATGAAGA","ATGA","GTTATGA","CTGA",2.65161165622554,12,39,43,103,1.02044694393268,4.67446449635908,7.89930921685597,101,"ENSG00000079974.19"
"20197","ENSG00000164418.22_266259",266251,266259,9,"ENSG00000164418.22",0,NA,"VVVUVVVVV",1,8,0.880745341614907,92,98,133,136,146,152,167,170,"ATGATGA","GTGC","GAGATGG","CTAA",2.36720396000551,35,10,15,69,1.72392756148678,4.37632182371421,7.89930319017384,101,"ENSG00000079974.19"
"12124","ENSG00000137393.10_79766",79758,79766,9,"ENSG00000137393.10",0,NA,"VVUVVVVVV",1,8,0.883643892339545,113,119,133,136,148,154,166,169,"CTCATTA","TTTA","GGGATTA","CTGA",2.21524432590713,14,12,12,47,2.69058290894004,4.36471960374689,7.89929517310507,101,"ENSG00000079974.19"
"47408","ENSG00000288088.1_49277",49269,49277,9,"ENSG00000288088.1",1,3,"VVMVVVVVV",0,8,0.882815734989648,113,119,133,136,155,161,209,212,"TTGGAGA","CTGG","TTGATGA","CTGA",2.42723792349453,14,19,48,90,1.29052218912806,4.36802708643957,7.89929002639816,101,"ENSG00000079974.19"
"30214","ENSG00000204138.13_3436",3428,3436,9,"ENSG00000204138.13",1,3,"VVMVVVVVV",0,8,0.882815734989648,71,77,89,92,99,105,133,136,"ATGATTA","TTGA","GTCTTGT","ATGA",2.29459386045744,12,7,28,56,2.17467289191879,4.3679913237421,7.89925426370069,101,"ENSG00000079974.19"
"28913","ENSG00000196678.14_60528",60520,60528,9,"ENSG00000196678.14",1,1,"MVVVVVUVV",1,7,0.792132505175983,113,119,133,136,138,144,155,158,"GTGAGGA","CTTA","AAGAGAA","CTGA",2.45180318252557,14,2,11,36,2.57747349206256,4.73070701055826,7.89923703126219,101,"ENSG00000079974.19"
"8153","ENSG00000117020.19_86192",86184,86192,9,"ENSG00000117020.19",1,8,"VVVVVUVMV",1,7,0.806211180124224,88,94,133,136,145,151,166,169,"ATGATTA","TTGA","ATGTTTG","CTGA",2.5391643237779,39,9,15,72,1.76974726484344,4.6743773558407,7.89922207633759,101,"ENSG00000079974.19"
"8050","ENSG00000116675.16_125978",125970,125978,9,"ENSG00000116675.16",1,2,"VMVVVVVVV",0,8,0.884057971014493,98,104,133,136,143,149,157,160,"ATGCTGT","TTGA","ATGATGT","CTAA",2.31194540884397,29,7,8,53,2.03889014702559,4.36296488482967,7.89919676888764,101,"ENSG00000079974.19"
"45762","ENSG00000285876.1_94316",94308,94316,9,"ENSG00000285876.1",1,1,"MVVVVUVVV",1,7,0.82815734989648,114,120,133,136,140,146,174,177,"CTGAAGA","CAGG","ATGATGT","CTGA",2.45073273642421,13,4,28,54,2.00798598432285,4.58655105678773,7.89918045637365,101,"ENSG00000079974.19"
"19945","ENSG00000164038.16_46521",46513,46521,9,"ENSG00000164038.16",1,6,"VVVVUMVVV",1,7,0.792546583850932,80,86,95,98,113,119,133,136,"ATGATGA","CTGA","AAAATAA","CTAA",2.49773769305019,9,15,14,47,2.26421847451343,4.72895077371201,7.89913710911574,101,"ENSG00000079974.19"
"10171","ENSG00000129636.13_43401",43393,43401,9,"ENSG00000129636.13",0,NA,"VVUVVVVVV",1,8,0.883643892339545,82,88,133,136,149,155,170,173,"TTCATGC","CAGA","GTGGTGG","CTGA",2.39198899077019,45,13,15,82,1.51151296716963,4.36452655974272,7.8991021291009,101,"ENSG00000079974.19"
"20113","ENSG00000164308.17_1650",1642,1650,9,"ENSG00000164308.17",1,2,"VMVVVVVVV",0,8,0.884057971014493,109,115,133,136,139,145,188,191,"ATGAAGC","TTGC","ATGATCA","CTGA",2.41094785158645,18,3,43,73,1.37838682205802,4.36284312482526,7.89907500888323,101,"ENSG00000079974.19"
"37027","ENSG00000244358.1_21345",21337,21345,9,"ENSG00000244358.1",1,7,"VVVVVVMVV",0,8,0.885300207039338,114,120,133,136,149,155,164,167,"ATAATCT","TTTA","GTAATAA","CTGA",2.21015410866095,13,13,9,44,2.69709426529491,4.35786374742531,7.89906457558266,101,"ENSG00000079974.19"
"30160","ENSG00000203867.8_97784",97776,97784,9,"ENSG00000203867.8",1,2,"UMVVVVVVV",1,7,0.786749482401656,109,115,133,136,145,151,168,171,"ATGATGT","ATAA","AGGAGGA","CTGA",2.50401953466672,18,9,17,53,2.31470959797641,4.7520432906053,7.89904122021192,101,"ENSG00000079974.19"
"25390","ENSG00000181234.10_106569",106561,106569,9,"ENSG00000181234.10",0,NA,"VVVVUUVVV",2,7,0.812008281573499,111,117,133,136,153,159,169,172,"ATGGGGA","CTCA","GTGAACA","CTGA",2.45065850244198,16,17,10,52,2.26627847465706,4.65100045606757,7.89903358236156,101,"ENSG00000079974.19"
"17889","ENSG00000155719.18_30509",30501,30509,9,"ENSG00000155719.18",1,2,"VMVVVVVVV",0,8,0.884057971014493,114,120,133,136,145,151,170,173,"ATAATAA","CTTT","GGGCTGT","CTGA",2.23932441318638,13,9,19,50,2.52224550927215,4.36276873262867,7.89900061668664,101,"ENSG00000079974.19"
"40152","ENSG00000255132.1_5673",5665,5673,9,"ENSG00000255132.1",1,7,"UVVVVVMVV",1,7,0.787991718426501,115,121,133,136,141,147,157,160,"ATGTTAA","CATA","GTGTTGA","CTGA",2.39308115220056,12,5,10,36,3.03415759690402,4.74700798622695,7.89897485993295,101,"ENSG00000079974.19"
"2004","ENSG00000068796.19_76374",76366,76374,9,"ENSG00000068796.19",0,NA,"VVVVVVUVV",1,8,0.886128364389234,84,90,133,136,144,150,167,170,"ATGATGT","TTGA","GTGTTTT","CAGA",2.35994514420035,43,8,17,77,1.68473933139168,4.35442673984851,7.89894019740544,101,"ENSG00000079974.19"
"47538","ENSG00000288643.1_76330",76322,76330,9,"ENSG00000288643.1",0,NA,"VVVVVVUVV",1,8,0.886128364389234,84,90,133,136,144,150,167,170,"ATGATGT","TTGA","GTGTTTT","CAGA",2.35994514420035,43,8,17,77,1.68473933139168,4.35442673984851,7.89894019740544,101,"ENSG00000079974.19"
"34287","ENSG00000232517.2_37452",37444,37452,9,"ENSG00000232517.2",1,8,"VVVVVVVMV",0,8,0.884057971014493,112,118,133,136,152,158,177,180,"ATTATGG","CTCT","CTGGTGG","CTGA",2.32159015481596,15,16,19,59,1.97337449047515,4.36266054731206,7.89889243137003,101,"ENSG00000079974.19"
"41240","ENSG00000258733.7_104452",104444,104452,9,"ENSG00000258733.7",0,NA,"UVVUVVVVV",2,7,0.78343685300207,111,117,133,136,146,152,172,175,"ATCATGA","CTGC","GGGAGCA","CTGA",2.52119749717665,16,10,20,55,2.25254508643806,4.76513210023726,7.89887951224554,101,"ENSG00000079974.19"
"37153","ENSG00000245729.2_106509",106501,106509,9,"ENSG00000245729.2",1,5,"VVVVMVVVV",0,8,0.886542443064182,101,107,133,136,146,152,170,173,"GTTATGT","GTCA","TTGAAGA","CTGA",2.36143055046361,26,10,18,63,1.66784795686181,4.35267957332147,7.8988493455782,101,"ENSG00000079974.19"
"47327","ENSG00000288002.1_15388",15380,15388,9,"ENSG00000288002.1",1,5,"VVVVMVVVV",0,8,0.886542443064182,101,107,133,136,146,152,170,173,"GTTATGT","GTCA","TTGAAGA","CTGA",2.36143055046361,26,10,18,63,1.66784795686181,4.35267957332147,7.8988493455782,101,"ENSG00000079974.19"
"46711","ENSG00000287092.1_200369",200361,200369,9,"ENSG00000287092.1",1,8,"VVVVVVVMV",0,8,0.884057971014493,115,121,133,136,138,144,185,188,"CTGCTGG","ATGA","GTGGTCA","CTGA",2.3862423591762,12,2,41,64,1.54212188631192,4.36260107020498,7.89883295426295,101,"ENSG00000079974.19"
"6431","ENSG00000109819.9_28141",28133,28141,9,"ENSG00000109819.9",1,8,"VVVVVVVMV",0,8,0.884057971014493,104,110,133,136,153,159,174,177,"ATAATGG","CATA","GTGAACA","CTGA",2.38982734705456,23,17,15,64,1.51821413590674,4.36259911240095,7.89883099645892,101,"ENSG00000079974.19"
"26706","ENSG00000184903.10_778886",778878,778886,9,"ENSG00000184903.10",1,3,"VVMVVVVVV",0,8,0.882815734989648,93,99,108,111,115,121,133,136,"ATATTGA","CAGA","CTGATAT","GTGA",2.20068791063596,9,4,12,34,2.79879425326128,4.36751174770859,7.89877468766719,101,"ENSG00000079974.19"
"28902","ENSG00000196660.12_242779",242771,242779,9,"ENSG00000196660.12",1,2,"VMVVVVVVV",0,8,0.884057971014493,115,121,133,136,172,178,191,194,"TTTATTA","CTTT","ATGATGA","CTGA",2.32716821146596,12,36,13,70,1.9356397542498,4.36252362433904,7.89875550839702,101,"ENSG00000079974.19"
"30481","ENSG00000205138.4_922",914,922,9,"ENSG00000205138.4",0,NA,"VVVVUVUVV",2,7,0.775983436853002,113,119,133,136,185,191,224,227,"CTGATGA","CGGA","ATGAGGA","CTGA",2.72071595808657,14,49,33,105,1.04098331700593,4.79477242606243,7.89870617347444,101,"ENSG00000079974.19"
"509","ENSG00000015153.15_56926",56918,56926,9,"ENSG00000015153.15",0,NA,"VVUVVVVVV",1,8,0.883643892339545,89,95,133,136,143,149,171,174,"CTGATCA","GTGG","AGGATGA","CTGA",2.40686380241128,38,7,22,76,1.41059055019736,4.3640873082348,7.89866287759298,101,"ENSG00000079974.19"
"15927","ENSG00000150275.20_655061",655053,655061,9,"ENSG00000150275.20",1,2,"VMVVVVVVV",0,8,0.884057971014493,69,75,89,92,103,109,133,136,"ATAATAA","TTTA","CTAAGGA","CTGA",2.30053109468014,14,11,24,58,2.1127909417063,4.36241622656014,7.89864811061811,101,"ENSG00000079974.19"
"44316","ENSG00000280780.4_60509",60501,60509,9,"ENSG00000280780.4",0,NA,"VVVUVVVVV",1,8,0.880745341614907,116,122,133,136,145,151,160,163,"AGAATAA","AGGA","GTTATAA","CTGA",2.1778220091127,11,9,9,38,2.98383488654197,4.37566207015666,7.89864343661629,101,"ENSG00000079974.19"
"9566","ENSG00000125485.18_52670",52662,52670,9,"ENSG00000125485.18",1,5,"VVVVMVVVV",0,8,0.886542443064182,116,122,133,136,141,147,197,200,"ACGTTGA","GTGT","CTGAAGG","CTGA",2.3251389294673,11,5,50,75,1.90867907393099,4.35240131759492,7.89857108985165,101,"ENSG00000079974.19"
"37178","ENSG00000245768.7_39153",39145,39153,9,"ENSG00000245768.7",1,3,"VVMVVVVVV",0,8,0.882815734989648,92,98,133,136,151,157,172,175,"TTGATCA","CCTA","TTGAGGA","CTGA",2.41341777994191,35,15,15,74,1.3795641971387,4.36725401585453,7.89851695581312,101,"ENSG00000079974.19"
"42252","ENSG00000261307.1_4604",4596,4604,9,"ENSG00000261307.1",1,5,"VVVVMVVVV",0,8,0.886542443064182,94,100,133,136,159,165,180,183,"TTGCTGA","ATGA","GTGAGTC","CTGA",2.4603056161523,33,23,15,80,1.00714839365209,4.35229645866686,7.89846623092359,101,"ENSG00000079974.19"
"43051","ENSG00000267761.3_220051",220043,220051,9,"ENSG00000267761.3",1,5,"VVVVMVVVV",0,8,0.886542443064182,94,100,133,136,159,165,180,183,"TTGCTGA","ATGA","GTGAGTC","CTGA",2.4603056161523,33,23,15,80,1.00714839365209,4.35229645866686,7.89846623092359,101,"ENSG00000079974.19"
"36907","ENSG00000243547.1_95",87,95,9,"ENSG00000243547.1",1,5,"VVVVMVVVV",0,8,0.886542443064182,47,53,97,100,102,108,116,119,"ATGGTGA","TTTA","AAGATCT","CTGA",2.38551447696857,44,2,8,63,1.50567056801932,4.35227510361911,7.89844487587584,101,"ENSG00000079974.19"
"17134","ENSG00000153237.18_234251",234243,234251,9,"ENSG00000153237.18",0,NA,"VVVVVUUVV",2,7,0.808281573498965,70,76,87,90,94,100,133,136,"TTGAAGA","TTTA","GTGATGA","CTGA",2.51589407366124,11,4,33,57,1.88847299356484,4.6652750378266,7.89840133182246,101,"ENSG00000079974.19"
"37714","ENSG00000248692.5_63776",63768,63776,9,"ENSG00000248692.5",0,NA,"VVUVVVVVV",1,8,0.883643892339545,110,116,133,136,160,166,187,190,"ATCATGG","CTTC","ATGAGGA","CTGA",2.41397800141349,17,24,21,71,1.36200110152543,4.36379694440383,7.89837251376201,101,"ENSG00000079974.19"
"32828","ENSG00000228035.1_83589",83581,83589,9,"ENSG00000228035.1",0,NA,"UVVUVVVVV",2,7,0.78343685300207,74,80,99,102,115,121,133,136,"TTTATGA","CTGA","ATCCTGT","CTGA",2.52438625331401,19,13,12,53,2.22921042219788,4.76461302773948,7.89836043974776,101,"ENSG00000079974.19"
"31826","ENSG00000224935.2_36338",36330,36338,9,"ENSG00000224935.2",0,NA,"VVVUVVVVV",1,8,0.880745341614907,116,122,133,136,149,155,175,178,"TTGATTT","ATAA","ATAATGA","CTGA",2.29739784151979,11,13,20,53,2.18552182653994,4.37537685916798,7.8983582256276,101,"ENSG00000079974.19"
"20386","ENSG00000164761.9_22268",22260,22268,9,"ENSG00000164761.9",1,3,"VVMVVVVVV",0,8,0.882815734989648,115,121,133,136,149,155,166,169,"ATCATGA","CTTG","CTGAAGT","CTGC",2.21730396592861,12,13,11,45,2.68610849742335,4.36703373423685,7.89829667419544,101,"ENSG00000079974.19"
"32565","ENSG00000227240.2_152227",152219,152227,9,"ENSG00000227240.2",1,8,"VVVVVVVMV",0,8,0.884057971014493,97,103,111,114,116,122,133,136,"TTGTTGG","CTGA","GTTTTGA","CTCA",2.22491486360466,8,2,11,30,2.6154655359637,4.36205782333202,7.89828970738999,101,"ENSG00000079974.19"
"38652","ENSG00000250723.7_28585",28577,28585,9,"ENSG00000250723.7",1,2,"UMVVVVVVV",1,7,0.786749482401656,90,96,133,136,144,150,169,172,"ATGATTA","CAGA","ATGTAGA","CTGA",2.61583427439185,37,8,19,73,1.56619864595445,4.75127345214169,7.89827138174831,101,"ENSG00000079974.19"
"143","ENSG00000005483.23_33116",33108,33116,9,"ENSG00000005483.23",1,8,"VVVVVVUMV",1,7,0.770186335403727,115,121,133,136,145,151,169,172,"GTGATGT","CTGG","GGGTTGG","CTGA",2.50221908849863,12,9,18,48,2.5886365687257,4.81752428967915,7.89826963129406,101,"ENSG00000079974.19"
"45776","ENSG00000285894.2_95996",95988,95996,9,"ENSG00000285894.2",1,2,"VMVVVVVVV",0,8,0.884057971014493,111,117,133,136,141,147,155,158,"ATGATCA","TAGA","TTTATAA","CTAA",2.195796012462,16,5,8,38,2.80933269521274,4.36199319457319,7.89822507863116,101,"ENSG00000079974.19"
"35372","ENSG00000235884.4_9395",9387,9395,9,"ENSG00000235884.4",1,7,"VVVVVVMVV",0,8,0.885300207039338,109,115,133,136,139,145,198,201,"GGGATTA","CAGA","ATGAACA","CTGA",2.40893184443896,18,3,53,83,1.36841925318206,4.35699122069378,7.89819204885113,101,"ENSG00000079974.19"
"37252","ENSG00000246331.2_9488",9480,9488,9,"ENSG00000246331.2",1,7,"VVVVVVMVV",0,8,0.885300207039338,109,115,133,136,139,145,198,201,"GGGATTA","CAGA","ATGAACA","CTGA",2.40893184443896,18,3,53,83,1.36841925318206,4.35699122069378,7.89819204885113,101,"ENSG00000079974.19"
"28133","ENSG00000188176.12_20509",20501,20509,9,"ENSG00000188176.12",0,NA,"UVVVVUVVV",2,7,0.824844720496894,76,82,96,99,113,119,133,136,"GTAATGT","CTGG","GTGAGTC","CTGA",2.39048077334862,14,14,14,51,2.45852857315324,4.59876676553601,7.89814564752359,101,"ENSG00000079974.19"
"6610","ENSG00000111058.8_151443",151435,151443,9,"ENSG00000111058.8",1,8,"UVVVVVVMV",1,7,0.786749482401656,116,122,133,136,147,153,161,164,"GTTAGGA","TTGA","GTGGAGA","CTGA",2.42544505581552,11,11,8,39,2.83485122318002,4.7511212321542,7.89811916176082,101,"ENSG00000079974.19"
"15282","ENSG00000147548.17_85820",85812,85820,9,"ENSG00000147548.17",1,8,"UVVVVVVMV",1,7,0.786749482401656,59,65,79,82,89,95,133,136,"ATGATAA","TTGA","GTGTTCC","CTGA",2.55154982369207,14,7,38,68,1.99410376554281,4.75110898087249,7.89810691047912,101,"ENSG00000079974.19"
"3668","ENSG00000087303.19_58448",58440,58448,9,"ENSG00000087303.19",1,2,"UMVVVUVVV",2,6,0.708902691511387,111,117,133,136,144,150,162,165,"GTGATGT","CAGA","GTGAGAA","CTGA",2.61918434067196,16,8,12,45,2.7886146674117,5.06246090130619,7.89807166735174,101,"ENSG00000079974.19"
"6851","ENSG00000112137.19_363341",363333,363341,9,"ENSG00000112137.19",1,3,"VVMVVVVVV",0,8,0.882815734989648,113,119,133,136,153,159,175,178,"ATTTTGA","CAGT","ATTATGG","CTGA",2.29748375468549,14,17,16,56,2.15055376380129,4.3667780320928,7.8980409720514,101,"ENSG00000079974.19"
"5172","ENSG00000103550.14_5267",5259,5267,9,"ENSG00000103550.14",1,2,"VMVVVVUVV",1,7,0.770186335403727,112,118,133,136,140,146,186,189,"ATGATGG","CAGA","CTGCTGT","CTGA",2.62522107606649,15,4,40,68,1.76769161859455,4.81729136475946,7.89803670637436,101,"ENSG00000079974.19"
"37164","ENSG00000245750.11_288356",288348,288356,9,"ENSG00000245750.11",1,7,"VVVVVVMVV",0,8,0.885300207039338,114,120,133,136,141,147,160,163,"TTGATTG","CTTG","ATGGGGC","CTGA",2.1822016898573,13,5,13,40,2.87932552744932,4.35683419829116,7.89803502644851,101,"ENSG00000079974.19"
"11272","ENSG00000134443.10_9518",9510,9518,9,"ENSG00000134443.10",1,5,"VVVVMVVVV",0,8,0.886542443064182,75,81,96,99,116,122,133,136,"CTGATAT","CTGA","GGGAAGA","CTTA",2.26253834267022,15,17,11,52,2.32366327493513,4.35181305651749,7.89798282877422,101,"ENSG00000079974.19"
"26370","ENSG00000184005.11_344429",344421,344429,9,"ENSG00000184005.11",1,8,"VVVVVVVMV",0,8,0.884057971014493,107,113,133,136,158,164,180,183,"GTGATCA","GTGC","ATCAAGA","CTGA",2.3991608896832,20,22,16,67,1.45241214119048,4.36170451810295,7.89793640216092,101,"ENSG00000079974.19"
"37983","ENSG00000249307.8_102813",102805,102813,9,"ENSG00000249307.8",1,8,"VVVVVVVMV",0,8,0.884057971014493,108,114,133,136,140,146,156,159,"GAGCTGT","CTCA","TTGAGAA","CTGA",2.25216506369625,19,4,10,42,2.43198864982891,4.36160560195098,7.89783748600895,101,"ENSG00000079974.19"
"36028","ENSG00000237761.3_36416",36408,36416,9,"ENSG00000237761.3",1,5,"VVVVMVVVV",0,8,0.886542443064182,95,101,133,136,149,155,175,178,"ATCTTGA","CACA","CTGATGA","CTGA",2.42585883617122,32,13,20,74,1.23397329264871,4.35159138344754,7.89776115570427,101,"ENSG00000079974.19"
"2093","ENSG00000070081.18_120304",120296,120304,9,"ENSG00000070081.18",1,2,"VMVVVVVVV",0,8,0.884057971014493,97,103,133,136,145,151,172,175,"ATGGTGT","CTAG","CTGATGT","CTGA",2.39872201691215,30,9,21,69,1.45444955527268,4.36148241700509,7.89771430106306,101,"ENSG00000079974.19"
"42549","ENSG00000264151.6_215104",215096,215104,9,"ENSG00000264151.6",0,NA,"VVVVUUVVV",2,7,0.812008281573499,83,89,100,103,116,122,133,136,"CTGATGA","CTCA","ATGATAT","CTGC",2.39029327722584,11,13,11,44,2.6634266443293,4.64967878979206,7.89771191608605,101,"ENSG00000079974.19"
"2538","ENSG00000075568.17_144841",144833,144841,9,"ENSG00000075568.17",1,8,"VVVVVVVMV",0,8,0.884057971014493,103,109,133,136,143,149,157,160,"TGGATGA","CAGG","GCTATGG","CTGA",2.28688704749251,24,7,8,48,2.19999661235613,4.36147756557655,7.89770944963452,101,"ENSG00000079974.19"
"36972","ENSG00000243970.6_19002",18994,19002,9,"ENSG00000243970.6",1,2,"VMVVVVVVV",0,8,0.884057971014493,107,113,133,136,145,151,159,162,"ATGATGT","CTTG","CTGAGCA","ATGA",2.25309505619218,20,9,8,46,2.42521160456746,4.36146132812882,7.89769321218679,101,"ENSG00000079974.19"
"48459","ENSG00000291129.1_19993",19985,19993,9,"ENSG00000291129.1",1,2,"VMVVVVVVV",0,8,0.884057971014493,107,113,133,136,145,151,159,162,"ATGATGT","CTTG","CTGAGCA","ATGA",2.25309505619218,20,9,8,46,2.42521160456746,4.36146132812882,7.89769321218679,101,"ENSG00000079974.19"
"11453","ENSG00000134996.12_43356",43348,43356,9,"ENSG00000134996.12",0,NA,"VVUVVVVVV",1,8,0.883643892339545,92,98,106,109,113,119,133,136,"GTGATTC","CTGA","ATGCAGT","CGGA",2.23208084726147,8,4,14,35,2.57189071626303,4.36310742450153,7.89768299385971,101,"ENSG00000079974.19"
"3794","ENSG00000089094.20_92618",92610,92618,9,"ENSG00000089094.20",1,3,"VVMVVVVVV",0,8,0.882815734989648,114,120,133,136,179,185,199,202,"ATGCTGT","TTTA","ATTATGG","CTGA",2.3392009505805,13,43,14,79,1.87096871632241,4.3664104300481,7.89767337000669,101,"ENSG00000079974.19"
"10842","ENSG00000132958.19_20429",20421,20429,9,"ENSG00000132958.19",1,1,"MVVVUVVVV",1,7,0.795859213250517,115,121,133,136,178,184,195,198,"ATCATGT","CTGT","CTGATGG","CTGA",2.52990617029345,12,42,11,74,1.9908253367033,4.71421661799824,7.89765347100031,101,"ENSG00000079974.19"
"30335","ENSG00000204634.13_163990",163982,163990,9,"ENSG00000204634.13",1,1,"MVVVVUVVV",1,7,0.82815734989648,109,115,133,136,145,151,183,186,"ATGATGC","ATCA","ATGGTGG","CTGA",2.49491783457208,18,9,32,68,1.70729928736748,4.58502121279534,7.89765061238126,101,"ENSG00000079974.19"
"45962","ENSG00000286074.1_51",43,51,9,"ENSG00000286074.1",1,3,"VVMVVVVVV",0,8,0.882815734989648,19,25,53,56,62,68,77,80,"ATGCTGT","GGGA","GCGAGGG","CTGA",2.31067289185845,28,6,9,52,2.06069254667,4.36629462309825,7.89755756305684,101,"ENSG00000079974.19"
"4794","ENSG00000101916.12_7461",7453,7461,9,"ENSG00000101916.12",1,8,"VVVVVVVMV",0,8,0.884057971014493,110,116,133,136,152,158,167,170,"TTGATGA","TAGA","CAGAAGA","GTGA",2.28036058856901,17,16,9,51,2.24273407616384,4.36128449998931,7.89751638404728,101,"ENSG00000079974.19"
"3615","ENSG00000086848.15_46844",46836,46844,9,"ENSG00000086848.15",1,1,"MVVVVVUVV",1,7,0.792132505175983,108,114,133,136,186,192,206,209,"GTGATGA","TTGC","CTGATAA","CTGA",2.6200014049634,19,50,14,92,1.44907597562729,4.72893800217915,7.89746802288309,101,"ENSG00000079974.19"
"39917","ENSG00000254450.1_4475",4467,4475,9,"ENSG00000254450.1",1,1,"MVVVVVUVV",1,7,0.792132505175983,108,114,133,136,186,192,206,209,"GTGATGA","TTGC","CTGATAA","CTGA",2.6200014049634,19,50,14,92,1.44907597562729,4.72893800217915,7.89746802288309,101,"ENSG00000079974.19"
"41087","ENSG00000258529.5_54688",54680,54688,9,"ENSG00000258529.5",1,1,"MVVVVVUVV",1,7,0.792132505175983,108,114,133,136,186,192,206,209,"GTGATGA","TTGC","CTGATAA","CTGA",2.6200014049634,19,50,14,92,1.44907597562729,4.72893800217915,7.89746802288309,101,"ENSG00000079974.19"
"18533","ENSG00000157601.15_31399",31391,31399,9,"ENSG00000157601.15",1,7,"VVVVVVMVV",0,8,0.885300207039338,113,119,133,136,183,189,231,234,"GTGATGT","ATAA","GAGAAGA","CTGA",2.46684336546646,14,47,42,112,0.979392386084895,4.356253705632,7.89745453378935,101,"ENSG00000079974.19"
"41216","ENSG00000258700.6_347575",347567,347575,9,"ENSG00000258700.6",1,2,"UMVVVVVVV",1,7,0.786749482401656,112,118,133,136,146,152,168,171,"TTGAAAA","CTGA","ATGAACA","CTGA",2.46512903164279,15,10,16,50,2.56698142449996,4.75029374219631,7.89729167180294,101,"ENSG00000079974.19"
"27390","ENSG00000186094.18_1421615",1421607,1421615,9,"ENSG00000186094.18",1,8,"VVVUVVVMV",1,7,0.764803312629399,80,86,107,110,115,121,133,136,"AAGATGA","CTCA","ATAATGG","CTGA",2.55750210283489,21,5,12,47,2.30209702743305,4.83802776158309,7.89724101210068,101,"ENSG00000079974.19"
"25017","ENSG00000179134.16_31192",31184,31192,9,"ENSG00000179134.16",1,8,"VVVVVVVMV",0,8,0.884057971014493,71,77,87,90,101,107,133,136,"ATGAAGG","CTGA","TTGGCGA","CAGA",2.31796451170018,10,11,26,56,1.99075121902914,4.36096199092425,7.89719387498222,101,"ENSG00000079974.19"
"41896","ENSG00000259929.5_208953",208945,208953,9,"ENSG00000259929.5",1,6,"UVVVVMVVV",1,7,0.805383022774327,97,103,133,136,139,145,161,164,"ATAATGA","CGGA","GTCCTGA","CTGA",2.57995506001489,30,3,16,58,1.50294305731296,4.67566086435306,7.89719295545037,101,"ENSG00000079974.19"
"14315","ENSG00000144668.12_47909",47901,47909,9,"ENSG00000144668.12",1,8,"VVVVVUVMV",1,7,0.806211180124224,82,88,133,136,138,144,156,159,"GTGCTGA","CTGC","CTGAGGA","CTGA",2.58084930009106,45,2,12,68,1.48349962945882,4.67229040751648,7.89713512801337,101,"ENSG00000079974.19"
"348","ENSG00000009335.18_70828",70820,70828,9,"ENSG00000009335.18",1,2,"VMVVVUVVV",1,7,0.806211180124223,19,25,64,67,78,84,133,136,"ATGATGT","CTGT","CTGTTGA","CTGA",2.67726766154829,39,11,49,108,0.840330612426954,4.67219542235389,7.89704014285079,101,"ENSG00000079974.19"
"7846","ENSG00000115896.16_500669",500661,500669,9,"ENSG00000115896.16",1,5,"VVVVMUVVV",1,7,0.808695652173913,105,111,133,136,140,146,159,162,"GTAAGGA","CTGG","TTGATGA","CTGA",2.48298951135621,22,4,13,48,2.09575265771992,4.66225401669033,7.89703662538598,101,"ENSG00000079974.19"
"36906","ENSG00000243521.2_399",391,399,9,"ENSG00000243521.2",0,NA,"VVVVVUUVV",2,7,0.808281573498965,84,90,101,104,108,114,133,136,"ATGATGG","GTGA","GAGATGA","TTGA",2.43829517538707,11,4,19,43,2.40023112652195,4.66388307394227,7.89700936793813,101,"ENSG00000079974.19"
"23655","ENSG00000173482.17_391670",391662,391670,9,"ENSG00000173482.17",1,1,"MVVVVUUVV",2,6,0.714285714285714,113,119,133,136,144,150,182,185,"ATGAGGA","CTGA","ATGGGGA","CTGA",2.71778679261477,14,8,32,63,2.04088035654689,5.03986474349468,7.89700760063754,101,"ENSG00000079974.19"
"36062","ENSG00000237819.7_22238",22230,22238,9,"ENSG00000237819.7",0,NA,"VVVUVVVVV",1,8,0.880745341614907,103,109,133,136,144,150,161,164,"ATGATGT","GTGA","AAGCTTA","CTGG",2.29577992772561,24,8,11,52,2.19070867343377,4.37397704790112,7.89695841436075,101,"ENSG00000079974.19"
"30138","ENSG00000203799.14_119804",119796,119804,9,"ENSG00000203799.14",0,NA,"VVVVVVUVV",1,8,0.886128364389234,23,29,47,50,82,88,133,136,"ATTATGC","GTGA","GTGTGGA","CTGA",2.50507547503721,18,32,45,104,0.7090314925312,4.35238366486148,7.89689712241842,101,"ENSG00000079974.19"
"15357","ENSG00000148053.18_317041",317033,317041,9,"ENSG00000148053.18",1,8,"VVVVVVVMV",0,8,0.884057971014493,89,95,133,136,149,155,163,166,"CTGATAA","CTGT","ACCATCA","CTGA",2.36480491430917,38,13,8,68,1.67727243041987,4.36065963145358,7.89689151551155,101,"ENSG00000079974.19"
"9181","ENSG00000123094.16_84324",84316,84324,9,"ENSG00000123094.16",0,NA,"VVUVVVVVV",1,8,0.883643892339545,101,107,133,136,141,147,185,188,"TTGATTA","TTGC","GTGATAA","CTGA",2.45308966480051,26,5,38,78,1.09530815745334,4.36230981403085,7.89688538338903,101,"ENSG00000079974.19"
"31311","ENSG00000222042.2_170517",170509,170517,9,"ENSG00000222042.2",1,8,"VVUVVVVMV",1,7,0.767701863354037,106,112,133,136,181,187,196,199,"ATGATGA","ATGA","GGGATCT","CTGA",2.68396940432297,21,45,9,84,1.41105861131731,4.82604699336761,7.89685444678376,101,"ENSG00000079974.19"
"6239","ENSG00000108684.15_877983",877975,877983,9,"ENSG00000108684.15",1,8,"VVVVUVVMV",1,7,0.773913043478261,114,120,133,136,163,169,178,181,"CTGATGA","TTAA","TTGATTA","CTGA",2.56840986601201,13,27,9,58,2.08182344212483,4.80113897055123,7.89679114446428,101,"ENSG00000079974.19"
"2742","ENSG00000078018.22_129831",129823,129831,9,"ENSG00000078018.22",1,3,"VVMVVVVVV",0,8,0.882815734989648,84,90,99,102,111,117,133,136,"ATGCTGG","CTGT","GTGGGGA","CTAA",2.23564659084179,9,9,16,43,2.55775406998457,4.36551616889912,7.89677910885771,101,"ENSG00000079974.19"
"19586","ENSG00000163377.16_8407",8399,8407,9,"ENSG00000163377.16",1,7,"VVVVVVMVV",0,8,0.885300207039338,114,120,133,136,152,158,183,186,"CTGTGGA","CTGG","GTGTTAA","CTGA",2.34969674876299,13,16,25,63,1.75729249462899,4.35548437159557,7.89668519975292,101,"ENSG00000079974.19"
"19592","ENSG00000163393.13_88070",88062,88070,9,"ENSG00000163393.13",1,1,"MVVVVUVVV",1,7,0.82815734989648,107,113,133,136,141,147,161,164,"ATGCTTA","GTGA","CAGATGT","CTGA",2.40615598391588,20,5,14,48,2.29501880158712,4.58401467358992,7.89664407317584,101,"ENSG00000079974.19"
"46452","ENSG00000286687.1_9673",9665,9673,9,"ENSG00000286687.1",1,7,"VVVVVVMVV",0,8,0.885300207039338,91,97,133,136,140,146,155,158,"TTAATGA","TTTA","ATGAAAC","CTGA",2.33685134444649,36,4,9,58,1.842447666584,4.35536415739015,7.8965649855475,101,"ENSG00000079974.19"
"35749","ENSG00000236975.2_1574",1566,1574,9,"ENSG00000236975.2",1,3,"VVMVVVVVV",0,8,0.882815734989648,111,117,133,136,158,164,175,178,"ATGCTGG","CAAA","GTGTGTA","CTGA",2.31506774077099,16,22,11,58,2.02717516853455,4.36524002675196,7.89650296671055,101,"ENSG00000079974.19"
"2443","ENSG00000074771.4_21610",21602,21610,9,"ENSG00000074771.4",1,8,"VVVVVUVMV",1,7,0.806211180124224,92,98,109,112,115,121,133,136,"GTAATTA","CTGT","GTGGTAA","CTGA",2.3881647795555,11,3,12,35,2.76538674811928,4.67162131962232,7.89646604011922,101,"ENSG00000079974.19"
"2048","ENSG00000069667.16_263075",263067,263075,9,"ENSG00000069667.16",1,1,"MVVVVVUVV",1,7,0.792132505175983,115,121,133,136,146,152,163,166,"GTAATTA","GTGA","GTGCTAA","CTGA",2.40152501870579,12,10,11,42,2.90155585125339,4.72793066065633,7.89646068136026,101,"ENSG00000079974.19"
"11405","ENSG00000134852.15_115250",115242,115250,9,"ENSG00000134852.15",1,3,"VVMVVVVVV",0,8,0.882815734989648,108,114,133,136,186,192,222,225,"TTGATGA","TTCA","CTGTTGG","CTGA",2.51345061332244,19,50,30,108,0.704382790625727,4.36518005319384,7.89644299315243,101,"ENSG00000079974.19"
"32163","ENSG00000226197.4_341655",341647,341655,9,"ENSG00000226197.4",1,6,"UVVVVMVVV",1,7,0.805383022774327,75,81,97,100,108,114,133,136,"AAGAAGA","CTCA","TAGATGA","CTGA",2.44490786825098,16,8,19,52,2.40009446565695,4.67487006349921,7.89640215459651,101,"ENSG00000079974.19"
"2431","ENSG00000074603.19_22565",22557,22565,9,"ENSG00000074603.19",1,7,"VVVVUVMVV",1,7,0.775155279503105,116,122,133,136,144,150,158,161,"GTGAGGA","GTGT","CTGAAGC","CTGA",2.42083858996054,11,8,8,36,3.0441558848178,4.79576995447202,7.89639107248444,101,"ENSG00000079974.19"
"27116","ENSG00000185565.12_703798",703790,703798,9,"ENSG00000185565.12",1,8,"VVVVVVVMV",0,8,0.884057971014493,110,116,133,136,142,148,193,196,"GTGAAGA","CTTT","GTGTCTA","CTGA",2.35415500551124,17,6,45,77,1.74615252314374,4.360129806638,7.89636169069597,101,"ENSG00000079974.19"
"16623","ENSG00000151914.22_270813",270805,270813,9,"ENSG00000151914.22",1,5,"VVVVMVVVV",0,8,0.886542443064182,52,58,68,71,81,87,133,136,"ATGTTTA","CTGA","GTGAGGC","GTGA",2.33653477883696,10,10,46,75,1.8234435641204,4.35008552242503,7.89625529468176,101,"ENSG00000079974.19"
"18019","ENSG00000156011.18_313873",313865,313873,9,"ENSG00000156011.18",0,NA,"VVVUVVVVV",1,8,0.880745341614907,114,120,133,136,145,151,169,172,"TGGATGC","CAGG","GTGTGGT","CTGA",2.23644412706679,13,9,18,49,2.58346073828107,4.37327206301493,7.89625342947455,101,"ENSG00000079974.19"
"32368","ENSG00000226846.2_148472",148464,148472,9,"ENSG00000226846.2",1,7,"UVVVVVMVV",1,7,0.787991718426501,87,93,133,136,142,148,177,180,"ATGATGA","ATGT","TTGATGT","CTGA",2.67641509234516,40,6,29,84,1.13424237220485,4.74425241362648,7.89621928733248,101,"ENSG00000079974.19"
"26511","ENSG00000184347.15_237855",237847,237855,9,"ENSG00000184347.15",0,NA,"VVVVUVVVV",1,8,0.889855072463768,107,113,133,136,147,153,162,165,"ATCAAGG","ATCA","CTGACGA","CTGA",2.25327675806862,20,11,9,49,2.32528055912106,4.33678140322797,7.89620169308304,101,"ENSG00000079974.19"
"10202","ENSG00000129682.16_67694",67686,67694,9,"ENSG00000129682.16",1,5,"VVVVMVVVV",0,8,0.886542443064182,51,57,65,68,108,114,133,136,"ATGATTA","CTGT","GTGATGG","CTGG",2.41292385850036,8,40,19,76,1.31379365019228,4.34998817671534,7.89615794897207,101,"ENSG00000079974.19"
"41261","ENSG00000258754.8_233580",233572,233580,9,"ENSG00000258754.8",1,8,"VVVUVVVMV",1,7,0.764803312629399,116,122,133,136,142,148,179,182,"ATGATGG","CAGA","CTCATTA","CTGA",2.5922818868773,11,6,31,57,2.06576099462834,4.83691006011926,7.89612331063685,101,"ENSG00000079974.19"
"29438","ENSG00000197980.14_182539",182531,182539,9,"ENSG00000197980.14",1,8,"VVVVVUVMV",1,7,0.806211180124224,82,88,99,102,108,114,133,136,"AAGATGA","GAGA","ATGGCCA","CTGA",2.42176602648946,11,6,19,45,2.53991395977249,4.67125520075889,7.89609992125579,101,"ENSG00000079974.19"
"3103","ENSG00000081087.16_16715",16707,16715,9,"ENSG00000081087.16",1,5,"VVVVMVVVV",0,8,0.886542443064182,80,86,101,104,115,121,133,136,"AGGCTGA","TTGA","TTGAGGC","ATGA",2.20410928846484,15,11,12,47,2.70540742960106,4.349867338175,7.89603711043173,101,"ENSG00000079974.19"
"28002","ENSG00000187912.12_22389",22381,22389,9,"ENSG00000187912.12",1,3,"VVMVVVVVV",0,8,0.882815734989648,109,115,133,136,140,146,154,157,"GTGATTT","CAGA","TTGATGT","GTGA",2.23949962504974,18,4,8,39,2.52906923516199,4.3647666838734,7.89602962383199,101,"ENSG00000079974.19"
"9625","ENSG00000125851.10_44861",44853,44861,9,"ENSG00000125851.10",1,3,"VVMVVVVVV",0,8,0.882815734989648,98,104,133,136,151,157,169,172,"ATGAGGA","CTCT","GAGATTC","CTGA",2.3832792367172,29,15,12,65,1.57046133991692,4.36474739617456,7.89601033613315,101,"ENSG00000079974.19"
"2655","ENSG00000077097.17_31444",31436,31444,9,"ENSG00000077097.17",1,2,"UMVVVVVVV",1,7,0.786749482401656,63,69,84,87,110,116,133,136,"GAGAGGA","CTGA","GTGATAA","CTGA",2.58238015935837,15,23,17,64,1.78017640558774,4.74901103366089,7.89600896326751,101,"ENSG00000079974.19"
"37198","ENSG00000245832.7_737904",737896,737904,9,"ENSG00000245832.7",1,2,"VMVVVVVVV",0,8,0.884057971014493,102,108,133,136,173,179,192,195,"ATGATTA","CTAT","ATGTTTA","CTGA",2.45017904234503,25,37,13,84,1.10438114148002,4.35972702261173,7.8959589066697,101,"ENSG00000079974.19"
"17955","ENSG00000155897.10_63491",63483,63491,9,"ENSG00000155897.10",1,8,"VVVVVVVMV",0,8,0.884057971014493,113,119,133,136,155,161,182,185,"ATGAAAA","AAGA","TGGATGA","CTGA",2.35373345755859,14,19,21,63,1.74692701457884,4.35962084957569,7.89585273363366,101,"ENSG00000079974.19"
"35510","ENSG00000236212.2_9415",9407,9415,9,"ENSG00000236212.2",1,2,"VMVVVVVVV",0,8,0.884057971014493,80,86,103,106,113,119,133,136,"ATGGTGA","CTCA","ACCAAGA","CTGC",2.22134902642952,17,7,14,47,2.62911784223265,4.3595278379407,7.89575972199867,101,"ENSG00000079974.19"
"7338","ENSG00000113583.8_3863",3855,3863,9,"ENSG00000113583.8",0,NA,"VVVVVVUVV",1,8,0.886128364389234,87,93,102,105,116,122,133,136,"ATAATGG","ATGA","GTGGAGG","CTCA",2.20718172734894,9,11,11,40,2.6902513741115,4.35119905577611,7.89571251333305,101,"ENSG00000079974.19"
"8089","ENSG00000116750.14_39526",39518,39526,9,"ENSG00000116750.14",1,3,"VVMVVVVVV",0,8,0.882815734989648,112,118,133,136,147,153,172,175,"TTGTTGA","GTTA","AAGTTCA","CTGA",2.27067892792842,15,11,19,54,2.31993672684517,4.364449061592,7.89571200155059,101,"ENSG00000079974.19"
"14929","ENSG00000146151.14_57784",57776,57784,9,"ENSG00000146151.14",1,2,"VMVVVVVVV",0,8,0.884057971014493,88,94,133,136,141,147,162,165,"TTGATCA","CAGT","GTGAAAT","CTGA",2.35307947699566,39,5,15,68,1.75061026310359,4.359451694102,7.89568357815997,101,"ENSG00000079974.19"
"41986","ENSG00000260234.5_23888",23880,23888,9,"ENSG00000260234.5",0,NA,"UVVUVVVVV",2,7,0.78343685300207,109,115,133,136,150,156,168,171,"ATGATGG","AGGA","TTGAAGT","CTGA",2.52005477866772,18,14,12,53,2.24737198526487,4.76193429409574,7.89568170610403,101,"ENSG00000079974.19"
"28221","ENSG00000188517.17_450812",450804,450812,9,"ENSG00000188517.17",1,2,"VMVVVVVVV",0,8,0.884057971014493,114,120,133,136,146,152,166,169,"ATTATAA","CTAA","ATGAAAA","TTGA",2.2002427607514,13,10,14,46,2.76930580185127,4.35939771838181,7.89562960243979,101,"ENSG00000079974.19"
"16406","ENSG00000151474.23_170722",170714,170722,9,"ENSG00000151474.23",1,1,"MVVVVUVVV",1,7,0.82815734989648,89,95,105,108,115,121,133,136,"ATGATGA","TTTA","GTAGTGT","CTGG",2.309219928627,10,7,12,38,2.9371858392292,4.5829963408523,7.89562574043822,101,"ENSG00000079974.19"
"14465","ENSG00000145075.13_185620",185612,185620,9,"ENSG00000145075.13",0,NA,"VVVUVVVVV",1,8,0.880745341614907,115,121,133,136,157,163,183,186,"GTTAAGA","CTAA","ATAAGGA","CTGA",2.36033914024285,12,21,20,62,1.75491556311294,4.37262745784965,7.89560882430928,101,"ENSG00000079974.19"
"5010","ENSG00000102753.10_57138",57130,57138,9,"ENSG00000102753.10",1,2,"VMVVVVVVV",0,8,0.884057971014493,89,95,133,136,144,150,183,186,"ATGCTGA","CTAG","CTGAAGG","CTGA",2.45573751644485,38,8,33,88,1.0656062704652,4.35929742835772,7.89552931241569,101,"ENSG00000079974.19"
"11172","ENSG00000134138.22_63686",63678,63686,9,"ENSG00000134138.22",1,8,"VVVVVVUMV",1,7,0.770186335403727,114,120,133,136,145,151,161,164,"TTAATGC","CAGA","ATGTTGA","CTGA",2.44323716687501,13,9,10,41,2.97034679915309,4.81464864457996,7.89539398619487,101,"ENSG00000079974.19"
"32049","ENSG00000225718.2_171038",171030,171038,9,"ENSG00000225718.2",0,NA,"VVVVVUUVV",2,7,0.808281573498965,112,118,133,136,150,156,166,169,"ATGAAGA","CGGA","GTGATAA","CTGT",2.41723861934547,15,14,10,48,2.53409257691444,4.66225417647105,7.89538047046691,101,"ENSG00000079974.19"
"32028","ENSG00000225689.2_249501",249493,249501,9,"ENSG00000225689.2",1,1,"MVVVUVVVV",1,7,0.795859213250517,113,119,133,136,162,168,222,225,"ATGAAGC","CTGA","GTGATGG","CTGA",2.66677703417956,14,26,54,103,1.06922984689361,4.71193585202267,7.89537270502474,101,"ENSG00000079974.19"
"26372","ENSG00000184005.11_421388",421380,421388,9,"ENSG00000184005.11",1,1,"MVVVVUVVV",1,7,0.82815734989648,90,96,133,136,155,161,169,172,"AGGATGA","GTGA","ATGGAAA","CTGA",2.55356277452795,37,19,8,73,1.30717810627604,4.58273248411559,7.89536188370151,101,"ENSG00000079974.19"
"22828","ENSG00000171502.15_16345",16337,16345,9,"ENSG00000171502.15",1,2,"VMVVVVVVV",0,8,0.884057971014493,92,98,133,136,151,157,177,180,"TTCATGA","CTGT","TCGAAGA","CTGA",2.45362622503415,35,15,20,79,1.07889510892368,4.3591008189545,7.89533270301247,101,"ENSG00000079974.19"
"22696","ENSG00000171132.14_255800",255792,255800,9,"ENSG00000171132.14",1,3,"VVMVVVVVV",0,8,0.882815734989648,110,116,133,136,157,163,215,218,"CTGAGGA","AGGA","GTGATGG","CTGA",2.46917823610539,17,21,52,99,0.994962487425897,4.36403768203213,7.89530062199072,101,"ENSG00000079974.19"
"41833","ENSG00000259805.1_48777",48769,48777,9,"ENSG00000259805.1",0,NA,"VVVUVVVVV",1,8,0.880745341614907,73,79,97,100,113,119,133,136,"GGGATGA","CTGG","GAGAAGA","CTGT",2.28859749514654,18,13,14,54,2.23194495999371,4.37231539857599,7.89529676503562,101,"ENSG00000079974.19"
"7464","ENSG00000114346.14_53682",53674,53682,9,"ENSG00000114346.14",1,8,"VVVVVVVMV",0,8,0.884057971014493,115,121,133,136,138,144,177,180,"ATCATGT","CAAA","GTAAAGA","CTGA",2.37522379705664,12,2,33,56,1.60131279126588,4.3590345262442,7.89526641030217,101,"ENSG00000079974.19"
"11043","ENSG00000133710.17_111328",111320,111328,9,"ENSG00000133710.17",1,7,"VVVVVUMVV",1,7,0.807453416149068,114,120,133,136,142,148,158,161,"AGGAAGA","ATGA","AAAATAA","CTGA",2.34337188195939,13,6,10,38,3.03922922923171,4.66542711057358,7.89524077516986,101,"ENSG00000079974.19"
"9882","ENSG00000127989.14_160978",160970,160978,9,"ENSG00000127989.14",1,8,"UVVVVVVMV",1,7,0.786749482401656,113,119,133,136,145,151,172,175,"ATAATGA","TTTA","ATGCAGA","CTGA",2.4926674242878,14,9,21,53,2.37494295172615,4.74818144507787,7.89517937468449,101,"ENSG00000079974.19"
"14235","ENSG00000144642.22_1067266",1067258,1067266,9,"ENSG00000144642.22",1,7,"VVVVVVMVV",0,8,0.885300207039338,91,97,133,136,150,156,180,183,"ATGAAGA","ATAA","CTGAACA","CTGA",2.47096143466481,36,14,24,83,0.942761604224938,4.35395945883092,7.89516028698827,101,"ENSG00000079974.19"
"44785","ENSG00000283563.1_1292879",1292871,1292879,9,"ENSG00000283563.1",1,7,"VVVVVVMVV",0,8,0.885300207039338,91,97,133,136,150,156,180,183,"ATGAAGA","ATAA","CTGAACA","CTGA",2.47096143466481,36,14,24,83,0.942761604224938,4.35395945883092,7.89516028698827,101,"ENSG00000079974.19"
"31449","ENSG00000223779.6_14308",14300,14308,9,"ENSG00000223779.6",0,NA,"VVUVVVUVV",2,7,0.769772256728778,92,98,133,136,139,145,153,156,"CTGATGA","GGGA","TTGATGA","CTGA",2.63615026363743,35,3,8,55,1.6896778975847,4.81600324712522,7.89509227404033,101,"ENSG00000079974.19"
"33937","ENSG00000231551.9_12486",12478,12486,9,"ENSG00000231551.9",0,NA,"VVUVVVUVV",2,7,0.769772256728778,92,98,133,136,139,145,153,156,"CTGATGA","GGGA","TTGATGA","CTGA",2.63615026363743,35,3,8,55,1.6896778975847,4.81600324712522,7.89509227404033,101,"ENSG00000079974.19"
"48521","ENSG00000291232.1_25228",25220,25228,9,"ENSG00000291232.1",0,NA,"VVUVVVUVV",2,7,0.769772256728778,92,98,133,136,139,145,153,156,"CTGATGA","GGGA","TTGATGA","CTGA",2.63615026363743,35,3,8,55,1.6896778975847,4.81600324712522,7.89509227404033,101,"ENSG00000079974.19"
"34530","ENSG00000233290.4_591587",591579,591587,9,"ENSG00000233290.4",1,3,"VVMVVVVVV",0,8,0.882815734989648,113,119,133,136,137,143,151,154,"ATAATAA","CTAT","CATATGA","CTGA",2.2393397406227,14,1,8,32,2.52632127629989,4.36381322011281,7.8950761600714,101,"ENSG00000079974.19"
"6807","ENSG00000111911.7_18643",18635,18643,9,"ENSG00000111911.7",0,NA,"VVVVVVUVV",1,8,0.886128364389234,106,112,133,136,162,168,177,180,"TTGATGA","CTTA","GTCAGGA","CTGC",2.38341460668287,21,26,9,65,1.5127472896835,4.35054450022566,7.89505795778259,101,"ENSG00000079974.19"
"7099","ENSG00000112773.16_55789",55781,55789,9,"ENSG00000112773.16",0,NA,"UVVVVVUVV",2,7,0.788819875776397,106,112,133,136,155,161,216,219,"GTGATGA","CTCA","ATGATAA","CTGA",2.73384355985296,21,19,55,104,0.733334992784815,4.73973968128446,7.89501918439005,101,"ENSG00000079974.19"
"14520","ENSG00000145321.13_58172",58164,58172,9,"ENSG00000145321.13",1,2,"VMVUVVVVV",1,7,0.764803312629399,112,118,133,136,144,150,169,172,"ATAATGA","TTTA","CTGATGC","CTGA",2.53067418104456,15,8,19,51,2.47186958003076,4.83575769674862,7.89497094726621,101,"ENSG00000079974.19"
"6120","ENSG00000108018.16_578099",578091,578099,9,"ENSG00000108018.16",1,1,"MVUVVVVVV",1,7,0.789648033126294,107,113,133,136,138,144,158,161,"GAGATTA","CTGA","ATGATTA","CTGA",2.55787559127582,20,2,14,45,1.89297719538453,4.73637028430583,7.89496241681101,101,"ENSG00000079974.19"
"17714","ENSG00000154928.19_395692",395684,395692,9,"ENSG00000154928.19",0,NA,"VVVVVVUVV",1,8,0.886128364389234,113,119,133,136,146,152,186,189,"ATGATTC","GTGT","GTGCAGT","CTGA",2.32141186524712,14,10,34,67,1.9256648027652,4.35043597610317,7.8949494336601,101,"ENSG00000079974.19"
"47101","ENSG00000287677.2_23336",23328,23336,9,"ENSG00000287677.2",0,NA,"VVVUVVUVV",2,7,0.766873706004141,115,121,133,136,152,158,171,174,"GTGATGT","CTGG","GTGAGCC","CTGA",2.53515827768782,12,16,13,50,2.40868406116155,4.82743481143676,7.89492963545332,101,"ENSG00000079974.19"
"11067","ENSG00000133805.16_64881",64873,64881,9,"ENSG00000133805.16",1,8,"VVVVVVVMV",0,8,0.884057971014493,67,73,85,88,95,101,133,136,"ATTATGA","CTGC","GAAATGA","CTTA",2.30158468066016,12,7,32,60,2.09048802973514,4.35859647520072,7.89482835925869,101,"ENSG00000079974.19"
"26310","ENSG00000183826.18_24626",24618,24626,9,"ENSG00000183826.18",1,5,"VVVVMVVVV",0,8,0.886542443064182,43,49,62,65,103,109,133,136,"ATGGTGA","ATGA","ATGATAA","TTGA",2.41111458007767,13,38,24,84,1.32051838247154,4.34865389574733,7.89482366800406,101,"ENSG00000079974.19"
"43476","ENSG00000271955.2_187787",187779,187787,9,"ENSG00000271955.2",1,5,"VVVVMVVVV",0,8,0.886542443064182,90,96,133,136,144,150,162,165,"CTAATGA","TTGT","ATAAAAA","CTGA",2.31684516314763,37,8,12,66,1.94894962854841,4.34864601238315,7.89481578463988,101,"ENSG00000079974.19"
"27541","ENSG00000186471.13_12933",12925,12933,9,"ENSG00000186471.13",1,2,"VMVVVVVVV",0,8,0.884057971014493,108,114,133,136,146,152,203,206,"ATGAAGC","CAAA","CTGCTGA","CTGA",2.39347615977574,19,10,51,89,1.47701155903296,4.35837982271781,7.89461170677578,101,"ENSG00000079974.19"
"37214","ENSG00000246022.4_10912",10904,10912,9,"ENSG00000246022.4",1,8,"VVVVVVVMV",0,8,0.884057971014493,41,47,86,89,104,110,133,136,"ATTATGA","CTGA","GTGACAA","CTGC",2.47780127137925,39,15,23,86,0.914649448355554,4.35833114772098,7.89456303177895,101,"ENSG00000079974.19"
"26120","ENSG00000183454.18_152284",152276,152284,9,"ENSG00000183454.18",1,2,"VMVVVVVVV",0,8,0.884057971014493,90,96,133,136,144,150,199,202,"AAGATGA","CAAA","GTCTTGA","CTGA",2.46588420208057,37,8,49,103,0.994058066223251,4.35832152002343,7.8945534040814,101,"ENSG00000079974.19"
"12465","ENSG00000138336.9_28199",28191,28199,9,"ENSG00000138336.9",0,NA,"VVUVVVUVV",2,7,0.769772256728778,112,118,133,136,139,145,155,158,"ATGAGGA","CAAA","ATGGAGA","CTGA",2.48587105334609,15,3,10,37,2.68918365767444,4.8154143366621,7.89450336357721,101,"ENSG00000079974.19"
"34392","ENSG00000232939.3_1586",1578,1586,9,"ENSG00000232939.3",1,2,"UMVVVVVVV",1,7,0.786749482401656,30,36,52,55,73,79,133,136,"ATTATGA","TTGA","ATGTTGA","CTGA",2.66670943240099,16,18,54,97,1.21163783221782,4.74742517872278,7.8944231083294,101,"ENSG00000079974.19"
"1342","ENSG00000054267.22_53427",53419,53427,9,"ENSG00000054267.22",1,2,"VMVVVVVVV",0,8,0.884057971014493,115,121,133,136,146,152,165,168,"ATCAGGG","GTCA","TTGCAGA","CTGA",2.19096728108979,12,10,13,44,2.82618681826955,4.35815883971704,7.89439072377501,101,"ENSG00000079974.19"
"5340","ENSG00000104343.21_94852",94844,94852,9,"ENSG00000104343.21",1,2,"VMVVVVVVV",0,8,0.884057971014493,83,89,133,136,148,154,186,189,"ATGATAA","ATGT","GTGGTGG","CTGA",2.48639024922399,44,12,32,97,0.856642689439551,4.35814442106653,7.8943763051245,101,"ENSG00000079974.19"
"41202","ENSG00000258677.2_94796",94788,94796,9,"ENSG00000258677.2",1,2,"VMVVVVVVV",0,8,0.884057971014493,83,89,133,136,148,154,186,189,"ATGATAA","ATGT","GTGGTGG","CTGA",2.48639024922399,44,12,32,97,0.856642689439551,4.35814442106653,7.8943763051245,101,"ENSG00000079974.19"
"36499","ENSG00000241399.7_12185",12177,12185,9,"ENSG00000241399.7",1,2,"UMVVVVVVV",1,7,0.786749482401656,111,117,133,136,166,172,193,196,"ATGATGA","CATA","GTGCTGT","CTGA",2.64602501437608,16,30,21,76,1.34928825902028,4.74736375538187,7.89436168498849,101,"ENSG00000079974.19"
"37683","ENSG00000248672.5_118640",118632,118640,9,"ENSG00000248672.5",1,2,"UMVVVVVVV",1,7,0.786749482401656,111,117,133,136,166,172,193,196,"ATGATGA","CATA","GTGCTGT","CTGA",2.64602501437608,16,30,21,76,1.34928825902028,4.74736375538187,7.89436168498849,101,"ENSG00000079974.19"
"33748","ENSG00000231029.2_198",190,198,9,"ENSG00000231029.2",1,3,"VVMVVUUVV",2,6,0.691097308488613,115,121,133,136,145,151,187,190,"AGGATGA","CTGA","ATGATGC","CTGA",2.77875346897709,12,9,36,66,1.99482879132742,5.12996297946034,7.89435221341479,101,"ENSG00000079974.19"
"36160","ENSG00000238042.5_15674",15666,15674,9,"ENSG00000238042.5",0,NA,"VVVVVVUVV",1,8,0.886128364389234,64,70,84,87,111,117,133,136,"AAGATGT","TTTA","ATGAGTT","CTGA",2.32951076242127,14,24,16,63,1.86909602874448,4.34979194455491,7.89430540211185,101,"ENSG00000079974.19"
"9266","ENSG00000123572.17_109738",109730,109738,9,"ENSG00000123572.17",0,NA,"VVVVVVUVV",1,8,0.886128364389234,85,91,133,136,145,151,160,163,"CTGATGG","CTGC","TTGATGT","CTGT",2.31735967091909,42,9,9,69,1.94987238365264,4.34973421411165,7.89424767166858,101,"ENSG00000079974.19"
"19663","ENSG00000163590.14_156496",156488,156496,9,"ENSG00000163590.14",1,6,"VVVVVMUVV",1,7,0.788819875776397,113,119,133,136,148,154,169,172,"ATAATGG","ATAA","TTGATGA","CTGA",2.46122624517045,14,12,15,50,2.54760906120203,4.73894600725125,7.89422551035684,101,"ENSG00000079974.19"
"13362","ENSG00000141127.15_2087",2079,2087,9,"ENSG00000141127.15",1,8,"UVVVVVVMV",1,7,0.786749482401656,102,108,133,136,140,146,164,167,"ATGATGA","CTTT","TTGAATA","CTGA",2.60147608497108,25,4,18,56,1.64558680177377,4.74719017539524,7.89418810500186,101,"ENSG00000079974.19"
"17698","ENSG00000154874.18_21651",21643,21651,9,"ENSG00000154874.18",1,8,"UVVVVVVMV",1,7,0.786749482401656,102,108,133,136,140,146,164,167,"ATGATGA","CTTT","TTGAATA","CTGA",2.60147608497108,25,4,18,56,1.64558680177377,4.74719017539524,7.89418810500186,101,"ENSG00000079974.19"
"17700","ENSG00000154898.16_21152",21144,21152,9,"ENSG00000154898.16",1,8,"UVVVVVVMV",1,7,0.786749482401656,102,108,133,136,140,146,164,167,"ATGATGA","CTTT","TTGAATA","CTGA",2.60147608497108,25,4,18,56,1.64558680177377,4.74719017539524,7.89418810500186,101,"ENSG00000079974.19"
"22286","ENSG00000170160.19_22086",22078,22086,9,"ENSG00000170160.19",1,8,"UVVVVVVMV",1,7,0.786749482401656,102,108,133,136,140,146,164,167,"ATGATGA","CTTT","TTGAATA","CTGA",2.60147608497108,25,4,18,56,1.64558680177377,4.74719017539524,7.89418810500186,101,"ENSG00000079974.19"
"38393","ENSG00000250111.3_6465",6457,6465,9,"ENSG00000250111.3",1,8,"UVVVVVVMV",1,7,0.786749482401656,102,108,133,136,140,146,164,167,"ATGATGA","CTTT","TTGAATA","CTGA",2.60147608497108,25,4,18,56,1.64558680177377,4.74719017539524,7.89418810500186,101,"ENSG00000079974.19"
"42748","ENSG00000266302.6_21362",21354,21362,9,"ENSG00000266302.6",1,8,"UVVVVVVMV",1,7,0.786749482401656,102,108,133,136,140,146,164,167,"ATGATGA","CTTT","TTGAATA","CTGA",2.60147608497108,25,4,18,56,1.64558680177377,4.74719017539524,7.89418810500186,101,"ENSG00000079974.19"
"48419","ENSG00000291090.1_21857",21849,21857,9,"ENSG00000291090.1",1,8,"UVVVVVVMV",1,7,0.786749482401656,102,108,133,136,140,146,164,167,"ATGATGA","CTTT","TTGAATA","CTGA",2.60147608497108,25,4,18,56,1.64558680177377,4.74719017539524,7.89418810500186,101,"ENSG00000079974.19"
"1149","ENSG00000048162.22_1599",1591,1599,9,"ENSG00000048162.22",0,NA,"VVUVVVVVV",1,8,0.883643892339545,114,120,133,136,145,151,159,162,"GTGTTGG","CAGA","TTGAGGC","TTGA",2.17006435306287,13,9,8,39,2.97115509755907,4.35956269616121,7.89413826551939,101,"ENSG00000079974.19"
"4237","ENSG00000099715.15_49804",49796,49804,9,"ENSG00000099715.15",1,2,"VMVVVVVVV",0,8,0.884057971014493,116,122,133,136,156,162,172,175,"AATATGT","GAGA","TTGTTGA","CTGA",2.27665519803574,11,20,10,50,2.25355634868482,4.35781441723078,7.89404630128875,101,"ENSG00000079974.19"
"4898","ENSG00000102290.23_49328",49320,49328,9,"ENSG00000102290.23",1,2,"VMVVVVVVV",0,8,0.884057971014493,116,122,133,136,156,162,172,175,"AATATGT","GAGA","TTGTTGA","CTGA",2.27665519803574,11,20,10,50,2.25355634868482,4.35781441723078,7.89404630128875,101,"ENSG00000079974.19"
"21347","ENSG00000167257.11_31167",31159,31167,9,"ENSG00000167257.11",1,2,"VMVVVVVVV",0,8,0.884057971014493,93,99,107,110,114,120,133,136,"ATGGTGA","TTGC","GTTATGT","CTGT",2.21645957424267,8,4,13,34,2.65472149562475,4.35777966431064,7.89401154836861,101,"ENSG00000079974.19"
"12676","ENSG00000138771.16_199055",199047,199055,9,"ENSG00000138771.16",1,5,"VVVVMVVVV",0,8,0.886542443064182,116,122,133,136,181,187,230,233,"CTGAGGA","CTCA","TTGGTGG","CTGA",2.46039667215722,11,45,43,108,0.988667799901157,4.34782807023732,7.89399784249404,101,"ENSG00000079974.19"
"41283","ENSG00000258766.1_94435",94427,94435,9,"ENSG00000258766.1",1,5,"VVVVMVVVV",0,8,0.886542443064182,109,115,133,136,141,147,170,173,"AAGATTC","CTCA","ATGCAGA","CTGA",2.31520627180626,18,5,23,55,1.95653934419286,4.34781195572532,7.89398172798205,101,"ENSG00000079974.19"
"32846","ENSG00000228065.13_191167",191159,191167,9,"ENSG00000228065.13",0,NA,"VVUVVVVVV",1,8,0.883643892339545,110,116,133,136,161,167,188,191,"ATTATGG","CTTC","ATGAGGA","CTGA",2.41468371771553,17,25,21,72,1.33921580078476,4.35927681305541,7.89385238241359,101,"ENSG00000079974.19"
"43308","ENSG00000271147.8_45704",45696,45704,9,"ENSG00000271147.8",0,NA,"VVUVVVVVV",1,8,0.883643892339545,110,116,133,136,161,167,188,191,"ATTATGG","CTTC","ATGAGGA","CTGA",2.41468371771553,17,25,21,72,1.33921580078476,4.35927681305541,7.89385238241359,101,"ENSG00000079974.19"
"37186","ENSG00000245832.7_346708",346700,346708,9,"ENSG00000245832.7",1,1,"MVVUVVVVV",1,7,0.786749482401656,116,122,133,136,143,149,159,162,"AAGATGA","AAGA","AGAATGT","CTGA",2.3900477468832,11,7,10,37,3.05362272147605,4.74681859184101,7.89381652144763,101,"ENSG00000079974.19"
"7663","ENSG00000115295.21_70024",70016,70024,9,"ENSG00000115295.21",1,2,"VMVVVUVVV",1,7,0.806211180124223,62,68,99,102,108,114,133,136,"GTAATAA","CTGA","ATGATAA","CTGA",2.56266540225829,31,6,19,65,1.59114549334361,4.66889537709972,7.89374009759662,101,"ENSG00000079974.19"
"20210","ENSG00000164418.22_843029",843021,843029,9,"ENSG00000164418.22",1,5,"UVVVMVVVV",1,7,0.789233954451346,107,113,133,136,144,150,164,167,"ATTATAA","CTGA","GTCATTT","CTGA",2.48975519273684,20,8,14,51,2.34882965321937,4.73679940119958,7.89373521900497,101,"ENSG00000079974.19"
"33176","ENSG00000228956.9_470950",470942,470950,9,"ENSG00000228956.9",0,NA,"VVVVUVVVV",1,8,0.889855072463768,107,113,133,136,141,147,163,166,"ATGACCA","CTAT","GTGTAGC","CTGA",2.27338995615228,20,5,16,50,2.18111372367942,4.33426169117365,7.89368198102872,101,"ENSG00000079974.19"
"35497","ENSG00000236204.7_10248",10240,10248,9,"ENSG00000236204.7",1,1,"MVVUVVVVV",1,7,0.786749482401656,107,113,133,136,147,153,170,173,"ATGAGGA","GTGA","GTGCTCC","CTGA",2.5445386657332,20,11,17,57,2.02306098158582,4.74666302161845,7.89366095122508,101,"ENSG00000079974.19"
"5203","ENSG00000103888.17_43268",43260,43268,9,"ENSG00000103888.17",1,8,"VVVVVUVMV",1,7,0.806211180124224,77,83,97,100,108,114,133,136,"TTGATTT","CAGA","GTGAATA","CTGA",2.42228949240096,14,8,19,50,2.52657795670927,4.66879364317892,7.89363836367582,101,"ENSG00000079974.19"
"45964","ENSG00000286076.2_77725",77717,77725,9,"ENSG00000286076.2",1,5,"VVVVMVVVV",0,8,0.886542443064182,42,48,91,94,111,117,133,136,"TTCATGA","TTGA","GTCATTC","CTGA",2.43037344706845,43,17,16,85,1.18717234488667,4.34741549800241,7.89358527025914,101,"ENSG00000079974.19"
"15982","ENSG00000150477.15_288688",288680,288688,9,"ENSG00000150477.15",1,3,"VVMVVVVVV",0,8,0.882815734989648,90,96,109,112,114,120,133,136,"GTGATGC","TTGA","ATCCTGT","CAGA",2.23953110807531,13,2,13,37,2.51883054643972,4.36225948340211,7.8935224233607,101,"ENSG00000079974.19"
"2571","ENSG00000075884.14_417612",417604,417612,9,"ENSG00000075884.14",1,1,"MVVVVUVVV",1,7,0.82815734989648,85,91,103,106,115,121,133,136,"CTGAAGA","CTGA","GAGAAAA","CTGG",2.30958713212154,12,9,12,42,2.92620981779387,4.58086434131769,7.89349374090361,101,"ENSG00000079974.19"
"28726","ENSG00000196376.11_249726",249718,249726,9,"ENSG00000196376.11",1,3,"VVMVVVVVV",0,8,0.882815734989648,110,116,133,136,141,147,160,163,"AAGATGA","TAGA","ATAATTA","TTGA",2.22519282597579,17,5,13,44,2.61427522123416,4.36222351526819,7.89348645522678,101,"ENSG00000079974.19"
"36342","ENSG00000240086.7_103533",103525,103533,9,"ENSG00000240086.7",1,2,"VMVVVVVVV",0,8,0.884057971014493,72,78,100,103,108,114,133,136,"ATAATGA","ATGA","CTGATTC","CTGC",2.3377354328023,22,5,19,55,1.8438000214881,4.35717572670919,7.89340761076717,101,"ENSG00000079974.19"
"20233","ENSG00000164494.12_104338",104330,104338,9,"ENSG00000164494.12",0,NA,"VVVVUVVVV",1,8,0.889855072463768,88,94,133,136,148,154,186,189,"ATGAAGT","TAGA","GTGATGG","CTGA",2.47157405020965,39,12,32,92,0.858371010163418,4.33388283622361,7.89330312607868,101,"ENSG00000079974.19"
"5384","ENSG00000104408.11_137626",137618,137626,9,"ENSG00000104408.11",1,7,"VVVVVVMVV",0,8,0.885300207039338,114,120,133,136,139,145,154,157,"AGCATAA","GGGA","TTGAGGT","CTGA",2.18194076126279,13,3,9,34,2.86183285417471,4.35202614898165,7.893226977139,101,"ENSG00000079974.19"
"19448","ENSG00000163032.12_10634",10626,10634,9,"ENSG00000163032.12",1,2,"VMVUVVVVV",1,7,0.764803312629399,93,99,108,111,115,121,133,136,"ATGTTAA","CTGA","GTCCTGT","CTGA",2.48058654322989,9,4,12,34,2.79879425326128,4.83400946869847,7.89322271921607,101,"ENSG00000079974.19"
"14203","ENSG00000144619.15_127593",127585,127593,9,"ENSG00000144619.15",1,8,"VVVVVVVMV",0,8,0.884057971014493,70,76,83,86,116,122,133,136,"TTGATGA","GTGA","TGGAAGA","CTGG",2.36688173922306,7,30,11,57,1.64856673496087,4.35694458244532,7.89317646650329,101,"ENSG00000079974.19"
"4071","ENSG00000092969.12_14681",14673,14681,9,"ENSG00000092969.12",0,NA,"VVUVVVVVV",1,8,0.883643892339545,113,119,133,136,184,190,198,201,"ATGAGGT","TTGC","ATGCAAA","CTGA",2.32329985381804,14,48,8,79,1.94538698554542,4.35851316941642,7.8930887387746,101,"ENSG00000079974.19"
"27369","ENSG00000186090.11_3360",3352,3360,9,"ENSG00000186090.11",1,1,"MVVVVUVVV",1,7,0.82815734989648,116,122,133,136,143,149,160,163,"GTGAGGA","ATGA","ATGCTGT","CTGC",2.29520261461008,11,7,11,38,3.0203974279366,4.58043704800095,7.89306644758687,101,"ENSG00000079974.19"
"27425","ENSG00000186132.15_979",971,979,9,"ENSG00000186132.15",1,1,"MVUVVVVVV",1,7,0.789648033126294,101,107,133,136,144,150,204,207,"ATGCTGA","TTGA","ATGAGGA","CTGA",2.67246006659199,26,8,54,97,1.12120639085132,4.73440170869949,7.89299384120466,101,"ENSG00000079974.19"
"15571","ENSG00000148737.18_106269",106261,106269,9,"ENSG00000148737.18",1,7,"VVVVVVMVV",0,8,0.885300207039338,107,113,133,136,144,150,161,164,"TTCATGT","CAAA","ATCATGC","CTGA",2.24136717667479,20,8,11,48,2.46461261679429,4.35176511532322,7.89296594348057,101,"ENSG00000079974.19"
"35540","ENSG00000236276.2_7972",7964,7972,9,"ENSG00000236276.2",1,2,"VMVVVVVVV",0,8,0.884057971014493,23,29,48,51,99,105,133,136,"CTGGTGA","CTTA","GTGATTT","CTGA",2.50108739307699,19,48,28,104,0.752798133119812,4.3566785217416,7.89291040579957,101,"ENSG00000079974.19"
"16512","ENSG00000151718.16_134906",134898,134906,9,"ENSG00000151718.16",0,NA,"VVVVUVVVV",1,8,0.889855072463768,110,116,133,136,160,166,185,188,"ATTATAA","CTGG","TTAATCA","CTGA",2.37853455799071,17,24,19,69,1.47696959355389,4.33346666170632,7.89288695156139,101,"ENSG00000079974.19"
"40633","ENSG00000257242.9_18410",18402,18410,9,"ENSG00000257242.9",1,8,"VVVVVVVMV",0,8,0.884057971014493,72,78,90,93,97,103,133,136,"ATGAGTA","CTGA","ATGCAGA","CTAA",2.31927968317016,12,4,30,55,1.96454947209589,4.35660350664091,7.89283539069888,101,"ENSG00000079974.19"
"17579","ENSG00000154493.20_360218",360210,360218,9,"ENSG00000154493.20",1,7,"VVVVVVMVV",0,8,0.885300207039338,67,73,87,90,110,116,133,136,"AATATGT","CTGT","ATGCTCA","CTGA",2.32005034145827,14,20,17,60,1.93950290275123,4.35162629478492,7.89282712294227,101,"ENSG00000079974.19"
"45967","ENSG00000286084.3_126915",126907,126915,9,"ENSG00000286084.3",1,8,"VVVVUVVMV",1,7,0.773913043478261,114,120,133,136,143,149,158,161,"ATGAGGC","GTGA","GGGAGGG","CTGA",2.42019371828045,13,7,9,38,3.05406504890221,4.79717245935964,7.89282463327269,101,"ENSG00000079974.19"
"18988","ENSG00000160111.15_101194",101186,101194,9,"ENSG00000160111.15",1,8,"VVVVVVVMV",0,8,0.884057971014493,105,111,133,136,142,148,165,168,"ATTTTAA","TTGA","ATGAAAA","CTGA",2.31114732698224,22,6,17,54,2.01853088251265,4.35654493226522,7.89277681632319,101,"ENSG00000079974.19"
"39403","ENSG00000253554.7_259881",259873,259881,9,"ENSG00000253554.7",0,NA,"VVUVVVVVV",1,8,0.883643892339545,111,117,133,136,146,152,168,171,"ATAATTC","CCCA","GAGATGA","CTGA",2.24063919972671,16,10,16,51,2.4951072073571,4.35817546805046,7.89275103740864,101,"ENSG00000079974.19"
"17427","ENSG00000154162.15_162618",162610,162618,9,"ENSG00000154162.15",1,5,"VVVVMVVVV",0,8,0.886542443064182,116,122,133,136,145,151,188,191,"AAGGTAA","CAGA","GTGATTT","CTGA",2.3136318315644,11,9,37,66,1.96193366279356,4.34653646830573,7.89270624056246,101,"ENSG00000079974.19"
"43309","ENSG00000271147.8_47622",47614,47622,9,"ENSG00000271147.8",0,NA,"VVUVVVVVV",1,8,0.883643892339545,110,116,133,136,161,167,188,191,"ATCATGG","CTTC","ATGAGGA","CTGA",2.41397800141349,17,25,21,72,1.33921580078476,4.35810061921867,7.89267618857684,101,"ENSG00000079974.19"
"20252","ENSG00000164532.11_41178",41170,41178,9,"ENSG00000164532.11",1,8,"VVVVVVVMV",0,8,0.884057971014493,107,113,133,136,145,151,201,204,"AAGGTGA","CTCA","CAGAGGA","CTGA",2.39731016468997,20,9,50,88,1.44341357450745,4.35637033477682,7.89260221883479,101,"ENSG00000079974.19"
"38187","ENSG00000249753.2_98871",98863,98871,9,"ENSG00000249753.2",1,8,"VVVVVVVMV",0,8,0.884057971014493,107,113,133,136,145,151,201,204,"AAGGTGA","CTCA","CAGAGGA","CTGA",2.39731016468997,20,9,50,88,1.44341357450745,4.35637033477682,7.89260221883479,101,"ENSG00000079974.19"
"40331","ENSG00000255583.3_28088",28080,28088,9,"ENSG00000255583.3",1,8,"VVVVVVVMV",0,8,0.884057971014493,107,113,133,136,145,151,201,204,"AAGGTGA","CTCA","CAGAGGA","CTGA",2.39731016468997,20,9,50,88,1.44341357450745,4.35637033477682,7.89260221883479,101,"ENSG00000079974.19"
"48294","ENSG00000290896.1_18629",18621,18629,9,"ENSG00000290896.1",1,8,"VVVVVVVMV",0,8,0.884057971014493,107,113,133,136,145,151,201,204,"AAGGTGA","CTCA","CAGAGGA","CTGA",2.39731016468997,20,9,50,88,1.44341357450745,4.35637033477682,7.89260221883479,101,"ENSG00000079974.19"
"41848","ENSG00000259849.2_148207",148199,148207,9,"ENSG00000259849.2",1,5,"VVVVMVVVV",0,8,0.886542443064182,111,117,133,136,144,150,176,179,"AGGTTGA","CTTT","GTAATAA","CTGA",2.29872945381275,16,8,26,59,2.0608509265638,4.34642848799553,7.89259826025226,101,"ENSG00000079974.19"
"38386","ENSG00000250102.6_150863",150855,150863,9,"ENSG00000250102.6",1,2,"VMVVVVUVV",1,7,0.770186335403727,114,120,133,136,142,148,172,175,"AGGATGG","CTGA","GTTAAAA","CTGA",2.54307790058937,13,6,24,52,2.29353035600265,4.81184575664961,7.89259109826452,101,"ENSG00000079974.19"
"20477","ENSG00000164930.12_26645",26637,26645,9,"ENSG00000164930.12",1,8,"VVVVVVVMV",0,8,0.884057971014493,110,116,133,136,153,159,172,175,"GTGAAGC","GTGT","ATGGGGA","CTGA",2.29846058828208,17,17,13,56,2.10224843032083,4.35632975471701,7.89256163877498,101,"ENSG00000079974.19"
"30350","ENSG00000204740.11_140119",140111,140119,9,"ENSG00000204740.11",0,NA,"VVVVVVUVV",1,8,0.886128364389234,35,41,60,63,72,78,133,136,"ATGATGG","GTGA","GAGATGG","TTGA",2.37959585106275,19,9,55,92,1.52815494733787,4.34803182193904,7.89254527949598,101,"ENSG00000079974.19"
"9555","ENSG00000125409.13_19684",19676,19684,9,"ENSG00000125409.13",0,NA,"VVUVVVVVV",1,8,0.883643892339545,113,119,133,136,183,189,200,203,"GTGATGG","GTGA","GTAACGA","ATGA",2.3219985911289,14,47,11,81,1.95136206074911,4.35783816706878,7.89241373642696,101,"ENSG00000079974.19"
"7142","ENSG00000112964.14_164339",164331,164339,9,"ENSG00000112964.14",0,NA,"VVVVUVVVV",1,8,0.889855072463768,112,118,133,136,142,148,165,168,"GTGAAAA","TAGA","GGGACCA","CTGA",2.21073349679456,15,6,17,47,2.59367527348776,4.33297464636287,7.89239493621794,101,"ENSG00000079974.19"
"36797","ENSG00000243055.1_18723",18715,18723,9,"ENSG00000243055.1",1,2,"VMVVVVVVV",0,8,0.884057971014493,65,71,103,106,114,120,133,136,"GTGACGA","CAGA","GTGAGGG","CTGT",2.32432013826762,32,8,13,62,1.92912761535259,4.35614880095084,7.89238068500881,101,"ENSG00000079974.19"
"23663","ENSG00000173482.17_534877",534869,534877,9,"ENSG00000173482.17",1,7,"VVVVVUMVV",1,7,0.807453416149068,29,35,59,62,71,77,133,136,"GTGATGT","ATGA","ATCATGA","CTGA",2.62215574918936,24,9,56,98,1.16918043350469,4.66255469035844,7.89236835495471,101,"ENSG00000079974.19"
"7945","ENSG00000116117.19_972613",972605,972613,9,"ENSG00000116117.19",1,6,"VVVUVMVVV",1,7,0.78343685300207,79,85,100,103,113,119,133,136,"GTGATGA","CTGT","GTGGAGA","CTGT",2.4530373759648,15,10,14,48,2.68088650240767,4.75861725220991,7.89236466421819,101,"ENSG00000079974.19"
"26256","ENSG00000183722.9_311367",311359,311367,9,"ENSG00000183722.9",1,3,"VVMVVVVVV",0,8,0.882815734989648,116,122,133,136,158,164,180,183,"AGGAAGA","TTCA","TTGAAAA","CTGA",2.32613538701639,11,22,16,58,1.93683415865543,4.36110085135784,7.89236379131643,101,"ENSG00000079974.19"
"40629","ENSG00000257239.1_40117",40109,40117,9,"ENSG00000257239.1",1,8,"VVVVVVVMV",0,8,0.884057971014493,83,89,102,105,113,119,133,136,"CTTAAGA","CTGA","TGGAAGA","CAGA",2.18431769886758,13,8,14,44,2.86230846435328,4.35610661420096,7.89233849825893,101,"ENSG00000079974.19"
"41803","ENSG00000259754.2_48176",48168,48176,9,"ENSG00000259754.2",1,7,"VVVVVUMVV",1,7,0.807453416149068,47,53,67,70,77,83,133,136,"ATGAGCA","CTGA","GTGGTTC","CTGA",2.50256298994831,14,7,50,80,1.96632807775789,4.66252033601999,7.89233400061626,101,"ENSG00000079974.19"
"7525","ENSG00000114648.12_7138",7130,7138,9,"ENSG00000114648.12",1,2,"VMVVVVVVV",0,8,0.884057971014493,109,115,133,136,148,154,184,187,"ATCATTT","CTGA","ATTAAGG","CTGA",2.37981365274943,18,12,30,69,1.55880648004184,4.35605770792618,7.89228959198415,101,"ENSG00000079974.19"
"7506","ENSG00000114487.10_128831",128823,128831,9,"ENSG00000114487.10",1,2,"VMVVVVVVV",0,8,0.884057971014493,114,120,133,136,173,179,188,191,"ATGATAT","CAGG","GTTAAGC","CTGA",2.31246300497787,13,37,9,68,2.00767780647373,4.35602445991489,7.89225634397286,101,"ENSG00000079974.19"
"4055","ENSG00000092758.18_21066",21058,21066,9,"ENSG00000092758.18",1,2,"VMVVVVVVV",0,8,0.884057971014493,85,91,104,107,109,115,133,136,"GAGGTGA","ATGA","ACGGTCA","CTGA",2.28744177886759,13,2,18,42,2.17432901152422,4.35598521766038,7.89221710171835,101,"ENSG00000079974.19"
"43511","ENSG00000272145.2_1226",1218,1226,9,"ENSG00000272145.2",1,5,"VVVVMVVVV",0,8,0.886542443064182,82,88,133,136,139,145,155,158,"GTCTTGA","CAGA","GGAATGA","CTGA",2.35246023521505,45,3,10,67,1.70105470257245,4.34603073433487,7.8922005065916,101,"ENSG00000079974.19"
"24110","ENSG00000175161.14_865496",865488,865496,9,"ENSG00000175161.14",1,1,"MVVUVVVVV",1,7,0.786749482401656,114,120,133,136,150,156,176,179,"GTGATGG","ATGA","GGGAGGT","CTGA",2.52682712619445,13,14,20,56,2.13482934952756,4.74508588103931,7.89208381064594,101,"ENSG00000079974.19"
"28442","ENSG00000189108.13_761878",761870,761878,9,"ENSG00000189108.13",0,NA,"UVVVVUVVV",2,7,0.824844720496894,77,83,99,102,115,121,133,136,"ATGATGT","CAGA","GTTGTGA","CTTA",2.38198792299962,16,13,12,50,2.49087202509275,4.59269787793923,7.8920767599268,101,"ENSG00000079974.19"
"24588","ENSG00000177103.15_26922",26914,26922,9,"ENSG00000177103.15",1,2,"VMVVVVVVV",0,8,0.884057971014493,109,115,133,136,151,157,166,169,"ATGAACA","CAGC","CTTATAA","CTGA",2.28060719022992,18,15,9,51,2.21927917386254,4.35583177718217,7.89206366124014,101,"ENSG00000079974.19"
"11833","ENSG00000136155.17_73436",73428,73436,9,"ENSG00000136155.17",1,8,"UVVVVVVMV",1,7,0.786749482401656,52,58,74,77,116,122,133,136,"ATGATGT","TTGA","AGGAACA","CTGA",2.57208920790692,16,39,11,75,1.8327098842479,4.7449928175735,7.89199074718013,101,"ENSG00000079974.19"
"3968","ENSG00000091436.17_17817",17809,17817,9,"ENSG00000091436.17",1,5,"VVVVMVVVV",0,8,0.886542443064182,68,74,90,93,109,115,133,136,"TTTATGA","CTGG","GTGATAA","CTGG",2.31308115910841,16,16,18,59,1.96257125560613,4.34577807908222,7.89194785133895,101,"ENSG00000079974.19"
"37526","ENSG00000248373.7_153628",153620,153628,9,"ENSG00000248373.7",1,7,"VVVVVVMVV",0,8,0.885300207039338,53,59,75,78,83,89,133,136,"AAGATGA","CTCA","ATGCAGA","CTCA",2.34366884993914,16,5,44,74,1.77841943279712,4.35071960809785,7.8919204362552,101,"ENSG00000079974.19"
"24429","ENSG00000176230.7_9208",9200,9208,9,"ENSG00000176230.7",1,3,"VVMVVVVVV",0,8,0.882815734989648,110,116,133,136,151,157,211,214,"GAGATGA","GTAA","GTCAAGA","CTGA",2.41990109938237,17,15,54,95,1.30979062171063,4.36061615439827,7.89187909435686,101,"ENSG00000079974.19"
"34435","ENSG00000233008.8_33008",33000,33008,9,"ENSG00000233008.8",0,NA,"VVVVVVUVV",1,8,0.886128364389234,111,117,133,136,152,158,206,209,"AAGATGG","CAGC","CTGTTGA","CTGA",2.40880973557696,16,16,48,89,1.33041039587095,4.34728549159601,7.89179894915294,101,"ENSG00000079974.19"
"14011","ENSG00000144229.13_692184",692176,692184,9,"ENSG00000144229.13",0,NA,"VVVVVVUVV",1,8,0.886128364389234,116,122,133,136,148,154,167,170,"ATAAAGA","CTCC","GCATTGA","CTGA",2.20848941099401,11,12,13,45,2.66580334278561,4.34726652068642,7.89177997824336,101,"ENSG00000079974.19"
"32021","ENSG00000225689.2_1016986",1016978,1016986,9,"ENSG00000225689.2",1,2,"VMVVVVVVV",0,8,0.884057971014493,79,85,99,102,111,117,133,136,"AAGATGA","TAGA","CTAATTA","GTGA",2.21210160975957,14,9,16,48,2.67484456445411,4.35554715737948,7.89177904143745,101,"ENSG00000079974.19"
"26874","ENSG00000185104.21_179066",179058,179066,9,"ENSG00000185104.21",1,2,"VMVVUVVVV",1,7,0.773913043478261,72,78,88,91,100,106,133,136,"ATCATGA","GTGA","GTGGAGG","CTGA",2.56663700348521,10,9,27,55,2.07348963389476,4.7961007476157,7.89175292152875,101,"ENSG00000079974.19"
"16972","ENSG00000152894.15_541022",541014,541022,9,"ENSG00000152894.15",0,NA,"VVVVVVUVV",1,8,0.886128364389234,107,113,133,136,145,151,181,184,"GTGGTCA","CTCA","GTGATCG","CTGA",2.37320822444698,20,9,30,68,1.5675417221644,4.34723247128606,7.891745928843,101,"ENSG00000079974.19"
"47409","ENSG00000288091.1_37337",37329,37337,9,"ENSG00000288091.1",1,7,"VVVVVUMVV",1,7,0.807453416149068,113,119,133,136,150,156,165,168,"GTGATGA","CTAA","ATAAGGA","CTGT",2.40874214205755,14,14,9,46,2.5894393111255,4.66193006454395,7.89174372914023,101,"ENSG00000079974.19"
"28215","ENSG00000188517.17_121629",121621,121629,9,"ENSG00000188517.17",0,NA,"VVVVVVUVV",1,8,0.886128364389234,112,118,133,136,153,159,172,175,"TTGGTGG","TTAA","GTGCTGT","CTGA",2.26979829131099,15,17,13,54,2.25681095909287,4.3471998919582,7.89171334951514,101,"ENSG00000079974.19"
"43546","ENSG00000272274.4_132026",132018,132026,9,"ENSG00000272274.4",1,2,"VMVVVVVVV",0,8,0.884057971014493,98,104,133,136,145,151,170,173,"ATGATGA","AAGA","ATTATGG","TTGA",2.37561532483896,29,9,19,66,1.58443911467926,4.35546865340142,7.89170053745939,101,"ENSG00000079974.19"
"23884","ENSG00000174469.23_576266",576258,576266,9,"ENSG00000174469.23",1,3,"VVMVVVVVV",0,8,0.882815734989648,112,118,133,136,148,154,165,168,"GTGGTGA","TTTA","TTGATGT","TTGA",2.21667204328955,15,12,11,47,2.66387970553764,4.36042333186699,7.89168627182559,101,"ENSG00000079974.19"
"13636","ENSG00000142856.17_6310",6302,6310,9,"ENSG00000142856.17",1,1,"MVVVVVUVV",1,7,0.792132505175983,111,117,133,136,142,148,203,206,"ATGAGGC","TTGA","GTGATAA","CTGA",2.56052326873203,16,6,55,86,1.82241438565625,4.72314237763412,7.89167239833805,101,"ENSG00000079974.19"
"40080","ENSG00000254951.7_46887",46879,46887,9,"ENSG00000254951.7",0,NA,"VVVVVVUVV",1,8,0.886128364389234,110,116,133,136,150,156,164,167,"CAGATGG","TTGC","CTGTTGC","CTGA",2.25432115166847,17,14,8,48,2.35978375389363,4.34714785792085,7.89166131547779,101,"ENSG00000079974.19"
"43377","ENSG00000271758.2_23879",23871,23879,9,"ENSG00000271758.2",0,NA,"VVVVVVUVV",1,8,0.886128364389234,110,116,133,136,150,156,164,167,"CAGATGG","TTGC","CTGTTGC","CTGA",2.25432115166847,17,14,8,48,2.35978375389363,4.34714785792085,7.89166131547779,101,"ENSG00000079974.19"
"22372","ENSG00000170417.16_15238",15230,15238,9,"ENSG00000170417.16",1,8,"VVVVVVVMV",0,8,0.884057971014493,114,120,133,136,176,182,191,194,"GTGCTTA","CTGC","AAAATGA","CTGA",2.31298287597464,13,40,9,71,2.00161497079151,4.35537520265561,7.89160708671358,101,"ENSG00000079974.19"
"468","ENSG00000012660.14_4805",4797,4805,9,"ENSG00000012660.14",1,1,"MVVVVVUVV",1,7,0.792132505175983,40,46,58,61,108,114,133,136,"ATTATGA","CAGA","GAGATGG","CTGA",2.59726451815007,12,47,19,87,1.57714881791547,4.72306140139565,7.89159142209959,101,"ENSG00000079974.19"
"21080","ENSG00000166402.9_40320",40312,40320,9,"ENSG00000166402.9",1,8,"VVVVVVUMV",1,7,0.770186335403727,94,100,133,136,143,149,161,164,"ATGGTGA","TTGA","GAGACGA","CTGA",2.59025097191157,33,7,12,61,1.97493496932602,4.81081869551745,7.89156403713236,101,"ENSG00000079974.19"
"22649","ENSG00000171055.15_86721",86713,86721,9,"ENSG00000171055.15",1,2,"VMVVVVVVV",0,8,0.884057971014493,53,59,72,75,86,92,133,136,"GTGAGGA","CTGA","ACGAGGT","CTGG",2.33601602881993,13,11,41,74,1.84748944201563,4.35523240853712,7.89146429259509,101,"ENSG00000079974.19"
"8356","ENSG00000118420.17_148732",148724,148732,9,"ENSG00000118420.17",1,8,"VVVVVVVMV",0,8,0.884057971014493,77,83,107,110,115,121,133,136,"ATTATGA","CTGG","ATGAATT","CTCA",2.2968714184864,24,5,12,50,2.10829792229732,4.355193511385,7.89142539544297,101,"ENSG00000079974.19"
"14995","ENSG00000146555.20_288653",288645,288653,9,"ENSG00000146555.20",1,5,"VVVVMVVVV",0,8,0.886542443064182,107,113,133,136,148,154,197,200,"GTGAGGA","ATAA","TTGAGGT","CTGA",2.41703791428487,20,12,43,84,1.26741724602978,4.34525083531556,7.89142060757229,101,"ENSG00000079974.19"
"27654","ENSG00000187068.3_8673",8665,8673,9,"ENSG00000187068.3",1,8,"VVVVVVVMV",0,8,0.884057971014493,98,104,133,136,146,152,160,163,"AGGATCA","GTGG","GTAATGT","CTGA",2.32255752630454,29,10,8,56,1.9369522467575,4.35516727219694,7.89139915625491,101,"ENSG00000079974.19"
"42070","ENSG00000260618.1_19884",19876,19884,9,"ENSG00000260618.1",1,2,"VMVVVUVVV",1,7,0.806211180124223,70,76,91,94,104,110,133,136,"ATGAAGA","ATGA","ATGATGA","CTAA",2.47494056549195,15,10,23,57,2.16637127273645,4.6664937606707,7.8913384811676,101,"ENSG00000079974.19"
"27863","ENSG00000187498.16_13397",13389,13397,9,"ENSG00000187498.16",0,NA,"VVVVVVUVV",1,8,0.886128364389234,33,39,49,52,98,104,133,136,"ATGTTGG","CTGG","CTGTTAA","CTGA",2.44744829132531,10,46,29,94,1.07042128281998,4.34668580624718,7.89119926380412,101,"ENSG00000079974.19"
"11192","ENSG00000134215.16_267249",267241,267249,9,"ENSG00000134215.16",1,7,"VVVVVVMVV",0,8,0.885300207039338,104,110,133,136,152,158,172,175,"ATGATGA","CAGT","GTAATCA","CTCA",2.36501583633741,23,16,14,62,1.632984502591,4.3499391862101,7.89114001436745,101,"ENSG00000079974.19"
"7802","ENSG00000115762.17_184816",184808,184816,9,"ENSG00000115762.17",1,8,"VVVVUVVMV",1,7,0.773913043478261,112,118,133,136,144,150,199,202,"ATCATGT","CTGA","CTGGTGT","CTGA",2.59235913091991,15,8,49,81,1.89918485841733,4.79539476613752,7.89104694005056,101,"ENSG00000079974.19"
"44542","ENSG00000282944.1_1737",1729,1737,9,"ENSG00000282944.1",1,8,"VVVVUVVMV",1,7,0.773913043478261,112,118,133,136,144,150,199,202,"ATCATGT","CTGA","CTGGTGT","CTGA",2.59235913091991,15,8,49,81,1.89918485841733,4.79539476613752,7.89104694005056,101,"ENSG00000079974.19"
"48205","ENSG00000290599.1_2863",2855,2863,9,"ENSG00000290599.1",1,8,"VVVVUVVMV",1,7,0.773913043478261,112,118,133,136,144,150,199,202,"ATCATGT","CTGA","CTGGTGT","CTGA",2.59235913091991,15,8,49,81,1.89918485841733,4.79539476613752,7.89104694005056,101,"ENSG00000079974.19"
"48220","ENSG00000290654.1_10373",10365,10373,9,"ENSG00000290654.1",1,8,"VVVVUVVMV",1,7,0.773913043478261,112,118,133,136,144,150,199,202,"ATCATGT","CTGA","CTGGTGT","CTGA",2.59235913091991,15,8,49,81,1.89918485841733,4.79539476613752,7.89104694005056,101,"ENSG00000079974.19"
"48228","ENSG00000290699.1_2915",2907,2915,9,"ENSG00000290699.1",1,8,"VVVVUVVMV",1,7,0.773913043478261,112,118,133,136,144,150,199,202,"ATCATGT","CTGA","CTGGTGT","CTGA",2.59235913091991,15,8,49,81,1.89918485841733,4.79539476613752,7.89104694005056,101,"ENSG00000079974.19"
"21167","ENSG00000166716.10_56806",56798,56806,9,"ENSG00000166716.10",1,5,"VVVVMVVVV",0,8,0.886542443064182,103,109,133,136,147,153,167,170,"ATCATCA","TTTA","ATGCTGC","CTGA",2.31825625632732,24,11,14,58,1.92444443990568,4.34487153718862,7.89104130944535,101,"ENSG00000079974.19"
"28937","ENSG00000196781.16_5815",5807,5815,9,"ENSG00000196781.16",0,NA,"VVVVVVUVV",1,8,0.886128364389234,114,120,133,136,143,149,163,166,"TTGAAAA","GAGA","ATGTTCT","CTGA",2.17600390056679,13,7,14,43,2.87935588587557,4.3465121390802,7.89102559663714,101,"ENSG00000079974.19"
"20538","ENSG00000165061.15_317327",317319,317327,9,"ENSG00000165061.15",1,8,"VVVVVVVMV",0,8,0.884057971014493,108,114,133,136,147,153,161,164,"ATGCTAA","AAGA","AAGTTGT","CTGA",2.25363201084017,19,11,8,47,2.39485585863489,4.354767316059,7.89099920011697,101,"ENSG00000079974.19"
"39048","ENSG00000251567.5_215468",215460,215468,9,"ENSG00000251567.5",1,8,"VVVVVVVMV",0,8,0.884057971014493,115,121,133,136,154,160,175,178,"GTTAAGA","TTGC","ATGAATA","CTGA",2.28431558461588,12,18,15,54,2.19009893408361,4.35471737454737,7.89094925860534,101,"ENSG00000079974.19"
"7161","ENSG00000113013.16_4748",4740,4748,9,"ENSG00000113013.16",1,8,"VVVVVVVMV",0,8,0.884057971014493,72,78,89,92,100,106,133,136,"ATGATGA","CAGA","GTGAGTA","GTTA",2.28805036067043,11,8,27,55,2.16504047686188,4.35467738699952,7.8909092710575,101,"ENSG00000079974.19"
"22878","ENSG00000171634.19_84189",84181,84189,9,"ENSG00000171634.19",0,NA,"UVUVVVVVV",2,7,0.786335403726708,115,121,133,136,165,171,184,187,"AAGATGA","CAGA","ATGGATA","CTGA",2.55025063985752,12,29,13,63,1.98053223319445,4.74555079139448,7.89089240630132,101,"ENSG00000079974.19"
"21387","ENSG00000167346.9_105581",105573,105581,9,"ENSG00000167346.9",1,6,"VVUVVMVVV",1,7,0.786335403726708,65,71,98,101,107,113,133,136,"CTGCTGA","CTGA","ATGTTAA","CTGA",2.60686744215987,27,6,20,62,1.60284548478234,4.74549044146204,7.89083205636887,101,"ENSG00000079974.19"
"20314","ENSG00000164627.18_394571",394563,394571,9,"ENSG00000164627.18",1,8,"VVVVVVVMV",0,8,0.884057971014493,93,99,133,136,141,147,180,183,"ATGTTGA","GTGT","TTGAATA","CTGA",2.45982583938357,34,5,33,81,1.01955231051097,4.3545978099337,7.89082969399167,101,"ENSG00000079974.19"
"7176","ENSG00000113163.19_94642",94634,94642,9,"ENSG00000113163.19",0,NA,"VVUVVVVVV",1,8,0.883643892339545,35,41,58,61,107,113,133,136,"ATTATGA","TTGA","ATGATAA","TTGA",2.42271208684115,17,46,20,92,1.27355250644416,4.35624160467962,7.8908171740378,101,"ENSG00000079974.19"
"41854","ENSG00000259867.6_194430",194422,194430,9,"ENSG00000259867.6",1,8,"VVVVVVVMV",0,8,0.884057971014493,113,119,133,136,148,154,162,165,"TTATTGA","AGGA","TTGATCC","CTGA",2.20439544652329,14,12,8,43,2.72228636292583,4.35456400160361,7.89079588566158,101,"ENSG00000079974.19"
"31989","ENSG00000225539.9_230045",230037,230045,9,"ENSG00000225539.9",0,NA,"VVVVUVUVV",2,7,0.775983436853002,112,118,133,136,142,148,171,174,"ATCATGA","TTGT","TTGAGGA","CTGA",2.53429399871573,15,6,23,53,2.25213989393559,4.78685830467678,7.89079205208879,101,"ENSG00000079974.19"
"41619","ENSG00000259363.6_30548",30540,30548,9,"ENSG00000259363.6",1,2,"VMVVVVVVV",0,8,0.884057971014493,93,99,133,136,145,151,167,170,"ATGTTGG","CTGA","ATGAAGC","CTAA",2.35454851101353,34,9,16,68,1.72122590640977,4.35455399495833,7.8907858790163,101,"ENSG00000079974.19"
"39027","ENSG00000251513.2_237922",237914,237922,9,"ENSG00000251513.2",1,3,"VVMVVVVVV",0,8,0.882815734989648,113,119,133,136,155,161,178,181,"TTGATCA","ATTA","TTCATTA","CTGA",2.31807478362895,14,19,17,59,1.98423313516299,4.35951625650567,7.89077919646426,101,"ENSG00000079974.19"
"25606","ENSG00000182197.13_39277",39269,39277,9,"ENSG00000182197.13",1,7,"UVVVVVMVV",1,7,0.787991718426501,72,78,100,103,113,119,133,136,"ATTATGT","CTGC","TTGATGT","CTGA",2.52724883565344,22,10,14,55,2.10662779549726,4.73873834163005,7.89070521533606,101,"ENSG00000079974.19"
"44079","ENSG00000277654.6_158908",158900,158908,9,"ENSG00000277654.6",1,2,"UMVVVUVVV",2,6,0.708902691511387,116,122,133,136,141,147,158,161,"ATTATGA","ATAA","CTGATGA","CTGA",2.58385935375539,11,5,11,36,2.9946049370839,5.05508349052996,7.89069425657551,101,"ENSG00000079974.19"
"46116","ENSG00000286201.1_30176",30168,30176,9,"ENSG00000286201.1",1,8,"VVVVVVUMV",1,7,0.770186335403727,68,74,88,91,98,104,133,136,"ATGAAGA","CTGT","TTGATTT","CTGA",2.56904064262747,14,7,29,59,2.11282036450435,4.8099394955052,7.8906848371201,101,"ENSG00000079974.19"
"13322","ENSG00000140945.17_8091",8083,8091,9,"ENSG00000140945.17",1,8,"VVVVVUVMV",1,7,0.806211180124224,114,120,133,136,140,146,156,159,"GTGATGA","CAGC","GTGAGGT","CTAA",2.35910499457348,13,4,10,36,2.93592546001572,4.6658230226264,7.89066774312329,101,"ENSG00000079974.19"
"5344","ENSG00000104361.10_11059",11051,11059,9,"ENSG00000104361.10",1,7,"VVVVVVMVV",0,8,0.885300207039338,113,119,133,136,145,151,183,186,"TTGACAA","CTCA","GTTATTA","CTGA",2.30892277412368,14,9,32,64,2.00482910595128,4.34941190002729,7.89061272818464,101,"ENSG00000079974.19"
"13411","ENSG00000141376.23_44277",44269,44277,9,"ENSG00000141376.23",1,3,"VVMVVVVVV",0,8,0.882815734989648,95,101,133,136,138,144,152,155,"CTGATAA","CAAA","CTGAAGT","CTGA",2.38622051404533,32,2,8,51,1.52924773964199,4.35934612498604,7.89060906494463,101,"ENSG00000079974.19"
"31728","ENSG00000224577.4_71468",71460,71468,9,"ENSG00000224577.4",1,2,"VMVVVVVVV",0,8,0.884057971014493,101,107,133,136,159,165,178,181,"GGGATGG","CTTT","GTGATGA","CTGA",2.42874605960344,26,23,13,71,1.22582816434732,4.35436714042589,7.89059902448387,101,"ENSG00000079974.19"
"47509","ENSG00000288602.1_42184",42176,42184,9,"ENSG00000288602.1",1,8,"VVVVVVVMV",0,8,0.884057971014493,116,122,133,136,150,156,165,168,"CTGAAGA","CTAT","CTGATGA","CTCA",2.22131623757913,11,14,9,43,2.60861207307167,4.35434674756647,7.89057863162444,101,"ENSG00000079974.19"
"32104","ENSG00000225937.3_142954",142946,142954,9,"ENSG00000225937.3",1,5,"VVVVMUVVV",1,7,0.808695652173913,70,76,88,91,105,111,133,136,"ATCATGA","CAGA","AAATTGA","CTGA",2.48887299103721,12,14,22,57,2.03053853817762,4.65575628627309,7.89053889496875,101,"ENSG00000079974.19"
"6907","ENSG00000112234.9_60126",60118,60126,9,"ENSG00000112234.9",1,8,"VVVVVUVMV",1,7,0.806211180124224,108,114,133,136,141,147,158,161,"CTGATGA","ATGA","GTGTTAA","CTCA",2.42398981542997,19,5,11,44,2.50276775571577,4.66567496464555,7.89051968514245,101,"ENSG00000079974.19"
"25229","ENSG00000180071.21_23553",23545,23553,9,"ENSG00000180071.21",1,7,"VVVVUVMVV",1,7,0.775155279503105,65,71,85,88,101,107,133,136,"GTGTTGA","CAGA","CTGATGG","CTGA",2.58977105079422,14,13,26,62,1.89437506752263,4.78987885153769,7.89049996955011,101,"ENSG00000079974.19"
"1344","ENSG00000054277.14_58284",58276,58284,9,"ENSG00000054277.14",1,1,"MVVVVUVVV",1,7,0.82815734989648,115,121,133,136,142,148,176,179,"GTGTTGA","CCGT","ATGAAGG","CTGA",2.42292979229542,12,6,28,55,2.15851611547114,4.57784534936015,7.89047474894607,101,"ENSG00000079974.19"
"2328","ENSG00000073282.14_179708",179700,179708,9,"ENSG00000073282.14",1,8,"VVUVVVVMV",1,7,0.767701863354037,116,122,133,136,166,172,183,186,"GTGATGA","CTGA","TTGATCA","CTTA",2.59005597365689,11,30,11,61,2.01160992953454,4.81966243847845,7.8904698918946,101,"ENSG00000079974.19"
"42906","ENSG00000267316.5_7112",7104,7112,9,"ENSG00000267316.5",1,2,"VMVVVVVVV",0,8,0.884057971014493,114,120,133,136,142,148,161,164,"ATTATGA","CAGC","GGGGAGA","ATGA",2.17412466488272,13,6,13,41,2.9227224780417,4.35422172764828,7.89045361170626,101,"ENSG00000079974.19"
"24442","ENSG00000176406.25_115615",115607,115615,9,"ENSG00000176406.25",1,2,"VMVVVVVVV",0,8,0.884057971014493,100,106,133,136,143,149,161,164,"AGGATGC","ATAA","TTCATCA","CTGA",2.30342027185415,27,7,12,55,2.0607414158775,4.35421914039296,7.89045102445093,101,"ENSG00000079974.19"
"40353","ENSG00000255690.3_3332",3324,3332,9,"ENSG00000255690.3",0,NA,"VVVVVVUVV",1,8,0.886128364389234,54,60,82,85,90,96,133,136,"ATGTTGG","CTTA","TTAATAA","CTGA",2.41178716085818,22,5,37,73,1.30506537688235,4.34591161231755,7.89042506987448,101,"ENSG00000079974.19"
"16289","ENSG00000151304.6_111096",111088,111096,9,"ENSG00000151304.6",1,8,"VVVVVVVMV",0,8,0.884057971014493,104,110,133,136,147,153,203,206,"ATGATGT","ATGG","GTCACCA","CTGA",2.44591533769753,23,11,50,93,1.11059528503521,4.35417438408802,7.89040626814599,101,"ENSG00000079974.19"
"18211","ENSG00000156521.14_3173",3165,3173,9,"ENSG00000156521.14",0,NA,"VVUVVVVVV",1,8,0.883643892339545,114,120,133,136,138,144,155,158,"ACGATTT","TTGT","ATGCTGC","CTGA",2.21772480513966,13,2,11,35,2.63827653205076,4.35577714157879,7.89035271093696,101,"ENSG00000079974.19"
"41271","ENSG00000258763.5_85180",85172,85180,9,"ENSG00000258763.5",1,8,"VVVVVUVMV",1,7,0.806211180124224,110,116,133,136,140,146,154,157,"TTAATAA","CTGC","GTGGTGA","CTGA",2.40439191248115,17,4,8,38,2.63273535038935,4.66550369173259,7.89034841222949,101,"ENSG00000079974.19"
"11204","ENSG00000134248.14_179",171,179,9,"ENSG00000134248.14",1,2,"VMVUVVVVV",1,7,0.764803312629399,110,116,133,136,146,152,207,210,"GTGATGT","CGGA","GTGATCA","CTGA",2.65057228759886,17,10,55,91,1.65393939065,4.83110532699393,7.89031857751153,101,"ENSG00000079974.19"
"31949","ENSG00000225431.2_4079",4071,4079,9,"ENSG00000225431.2",1,2,"VMVVVVVVV",0,8,0.884057971014493,115,121,133,136,144,150,175,178,"AAGAGGT","TAGA","GTGAGAA","CTGA",2.27340366740624,12,8,25,54,2.25992402015852,4.35398711738337,7.89021900144134,101,"ENSG00000079974.19"
"21170","ENSG00000166734.20_77024",77016,77024,9,"ENSG00000166734.20",1,3,"VVMVVVUVV",1,7,0.768944099378882,86,92,105,108,111,117,133,136,"AGGATGA","CAGA","ATTTTTA","CTGA",2.5167615999178,13,3,16,41,2.4791944645903,4.81440128267723,7.89017768019276,101,"ENSG00000079974.19"
"23186","ENSG00000172292.15_165813",165805,165813,9,"ENSG00000172292.15",1,5,"VVVVMVVVV",0,8,0.886542443064182,92,98,108,111,115,121,133,136,"ATAATGA","CAGT","GAGAAAA","CAGA",2.17937549416037,10,4,12,35,2.84677672509838,4.34398667154188,7.89015644379861,101,"ENSG00000079974.19"
"15835","ENSG00000149970.16_220309",220301,220309,9,"ENSG00000149970.16",1,2,"VMVVVVVVV",0,8,0.884057971014493,100,106,133,136,147,153,166,169,"ATGATAA","CTCA","ATGGGGA","CTCA",2.3338001465498,27,11,13,60,1.85684916508817,4.35387920218837,7.89011108624634,101,"ENSG00000079974.19"
"35438","ENSG00000236052.2_142996",142988,142996,9,"ENSG00000236052.2",1,8,"VVVVVVVMV",0,8,0.884057971014493,96,102,133,136,143,149,174,177,"ATCAGGA","CTGG","CTGTTCA","CTGA",2.41655263958677,31,7,25,72,1.30513073263494,4.35387041580336,7.89010229986133,101,"ENSG00000079974.19"
"45824","ENSG00000285939.2_70696",70688,70696,9,"ENSG00000285939.2",1,2,"VMVVVUVVV",1,7,0.806211180124223,57,63,75,78,88,94,133,136,"ATGTTGA","CTGA","GTCATGA","TTGA",2.51065120295338,12,10,39,70,1.92326793747596,4.66523565595796,7.89008037645485,101,"ENSG00000079974.19"
"13544","ENSG00000141965.5_8285",8277,8285,9,"ENSG00000141965.5",1,8,"VVVVVVVMV",0,8,0.884057971014493,80,86,97,100,111,117,133,136,"ATGTTCA","ATGA","TTGATCA","CAGA",2.22662170808479,11,11,16,47,2.57119737585519,4.35383552410512,7.89006740816309,101,"ENSG00000079974.19"
"46754","ENSG00000287144.1_63246",63238,63246,9,"ENSG00000287144.1",1,1,"MVVVVUVVV",1,7,0.82815734989648,47,53,96,99,110,116,133,136,"CTGATGT","ATGA","ATTATCA","CTGA",2.51647950131128,43,11,17,80,1.53321108340346,4.57743527303633,7.89006467262225,101,"ENSG00000079974.19"
"39779","ENSG00000254186.3_82607",82599,82607,9,"ENSG00000254186.3",1,2,"UMVVVVVVV",1,7,0.786749482401656,88,94,133,136,148,154,168,171,"ATGATAA","ATGA","GTTAGGA","CTGA",2.59994118282342,39,12,14,74,1.63928813979743,4.74305733965506,7.89005526926168,101,"ENSG00000079974.19"
"25764","ENSG00000182674.6_364689",364681,364689,9,"ENSG00000182674.6",1,2,"VMVVVUVVV",1,7,0.806211180124223,115,121,133,136,142,148,166,169,"CTGTTGA","ATGT","GTGAATA","CTGA",2.40518757513141,12,6,18,45,2.62604818500165,4.66515800480275,7.89000272529965,101,"ENSG00000079974.19"
"32776","ENSG00000227835.9_31064",31056,31064,9,"ENSG00000227835.9",1,8,"VVVVVVVMV",0,8,0.884057971014493,83,89,99,102,116,122,133,136,"TCGATGG","CTGA","AAGAGGA","CTAA",2.23169427004003,10,14,11,44,2.53657634997689,4.35363453756093,7.88986642161891,101,"ENSG00000079974.19"
"23474","ENSG00000173011.12_5918",5910,5918,9,"ENSG00000173011.12",0,NA,"VVVVVVUVV",1,8,0.886128364389234,111,117,133,136,172,178,207,210,"GGGAGGA","CTGG","GTGATCA","CTGA",2.45667386305089,16,36,29,90,1.003291359784,4.34527927836414,7.88979273592108,101,"ENSG00000079974.19"
"28248","ENSG00000188580.15_302461",302453,302461,9,"ENSG00000188580.15",1,2,"VMVVVUVVV",1,7,0.806211180124223,90,96,106,109,113,119,133,136,"TTGATGA","CTGG","GAGAAGA","CAGA",2.39286314062491,10,4,14,37,2.70727844521543,4.66492484567871,7.8897695661756,101,"ENSG00000079974.19"
"10983","ENSG00000133401.16_261543",261535,261543,9,"ENSG00000133401.16",1,3,"VVMVVVVVV",0,8,0.882815734989648,113,119,133,136,138,144,154,157,"GTGATTT","CTTC","GTTATTT","CTGA",2.22198025207629,14,2,10,35,2.62075396881685,4.35848891233136,7.88975185228995,101,"ENSG00000079974.19"
"40014","ENSG00000254695.2_18260",18252,18260,9,"ENSG00000254695.2",1,8,"VVVVVVVMV",0,8,0.884057971014493,109,115,133,136,161,167,222,225,"AGGATGA","GAGA","TTGAAAA","CTGA",2.49342901357676,18,25,55,107,0.791052500084535,4.35347814764907,7.88971003170704,101,"ENSG00000079974.19"
"5313","ENSG00000104321.11_20636",20628,20636,9,"ENSG00000104321.11",1,2,"UMVVVVVVV",1,7,0.786749482401656,73,79,89,92,107,113,133,136,"CTGATGA","ATAA","GTGACAA","CTGA",2.54712217108931,10,15,20,54,1.98962137527278,4.74260896230038,7.889606891907,101,"ENSG00000079974.19"
"33545","ENSG00000230250.3_7808",7800,7808,9,"ENSG00000230250.3",1,1,"MVVVVUVVV",1,7,0.82815734989648,114,120,133,136,144,150,158,161,"ATGTTGC","CTCT","ATAGTGA","CTGA",2.29283996408183,13,8,8,38,3.0222337442241,4.5769583761924,7.88958777577832,101,"ENSG00000079974.19"
"3658","ENSG00000087274.19_54450",54442,54450,9,"ENSG00000087274.19",1,8,"UVVVVVVMV",1,7,0.786749482401656,89,95,109,112,116,122,133,136,"ATCATGA","CTGG","ATGAAGA","TTGA",2.41845093384458,14,4,11,38,2.84726313322388,4.74256733971361,7.88956526932024,101,"ENSG00000079974.19"
"2065","ENSG00000069667.16_652408",652400,652408,9,"ENSG00000069667.16",1,8,"VVVVVVVMV",0,8,0.884057971014493,84,90,133,136,141,147,172,175,"ATGATGG","TTTA","ATTAGTA","CTGA",2.43123017105009,43,5,25,82,1.20501977749248,4.3533052294566,7.88953711351457,101,"ENSG00000079974.19"
"16119","ENSG00000150760.13_344899",344891,344899,9,"ENSG00000150760.13",0,NA,"VVVVVVUVV",1,8,0.886128364389234,100,106,133,136,153,159,170,173,"TTGATAA","ATGA","AAAATTA","CTGA",2.37951361649562,27,17,11,64,1.51653981924651,4.34499098230433,7.88950443986127,101,"ENSG00000079974.19"
"26184","ENSG00000183638.6_96955",96947,96955,9,"ENSG00000183638.6",0,NA,"VVVVVVUVV",1,8,0.886128364389234,82,88,133,136,159,165,180,183,"ATGATGG","CAGA","GTGATCA","CTGG",2.45841364363406,45,23,15,92,0.99049746185873,4.34498043818811,7.88949389574505,101,"ENSG00000079974.19"
"13543","ENSG00000141905.19_20523",20515,20523,9,"ENSG00000141905.19",1,7,"VVVVVVMVV",0,8,0.885300207039338,113,119,133,136,171,177,195,198,"GAGATTA","CTGG","GGGATGC","CTGA",2.3659961727459,14,35,18,76,1.61985928610175,4.34829177610194,7.88949260425929,101,"ENSG00000079974.19"
"24394","ENSG00000176142.13_2405",2397,2405,9,"ENSG00000176142.13",1,6,"VVUVVMVVV",1,7,0.786335403726708,112,118,133,136,143,149,158,161,"ATGATAC","CTTA","ATGGAGC","CTGA",2.40530249826686,15,7,9,40,2.94121729565198,4.74414182102443,7.88948343593126,101,"ENSG00000079974.19"
"36672","ENSG00000242537.1_198",190,198,9,"ENSG00000242537.1",1,8,"VVVVVVVMV",0,8,0.884057971014493,52,58,82,85,106,112,133,136,"TTGATGA","ATGA","GTGGTGA","CTCA",2.47437074726159,24,21,21,75,0.916723392733268,4.35313209361929,7.88936397767726,101,"ENSG00000079974.19"
"20075","ENSG00000164236.12_93088",93080,93088,9,"ENSG00000164236.12",1,8,"VVUVVVVMV",1,7,0.767701863354037,111,117,133,136,150,156,186,189,"CTGATGA","ATGA","ATGACCA","CTGA",2.65302577102842,16,14,30,69,1.58729619798919,4.818533667878,7.88934112129415,101,"ENSG00000079974.19"
"38578","ENSG00000250481.2_26203",26195,26203,9,"ENSG00000250481.2",1,1,"MVVVVUVVV",1,7,0.82815734989648,87,93,133,136,172,178,194,197,"AAAATGA","CTGA","CTGAAGA","CTGA",2.62955824782086,40,36,16,101,0.77642899884055,4.57670432941157,7.8893337289975,101,"ENSG00000079974.19"
"36480","ENSG00000241322.11_47272",47264,47272,9,"ENSG00000241322.11",1,8,"UVVVVVVMV",1,7,0.786749482401656,104,110,133,136,139,145,161,164,"ATGCTGA","GTAA","ATGATGA","CTGA",2.58543299728238,23,3,16,51,1.73288766898598,4.74227691271714,7.88927484232376,101,"ENSG00000079974.19"
"39036","ENSG00000251537.4_79221",79213,79221,9,"ENSG00000251537.4",1,8,"UVVVVVVMV",1,7,0.786749482401656,104,110,133,136,139,145,161,164,"ATGCTGA","GTAA","ATGATGA","CTGA",2.58543299728238,23,3,16,51,1.73288766898598,4.74227691271714,7.88927484232376,101,"ENSG00000079974.19"
"4375","ENSG00000100346.18_86960",86952,86960,9,"ENSG00000100346.18",1,3,"VVMVVVVVV",0,8,0.882815734989648,114,120,133,136,151,157,165,168,"GTGATGG","TAGA","GTGGTAA","CTAA",2.23445186132427,13,15,8,45,2.53562321786192,4.35799224000594,7.88925517996453,101,"ENSG00000079974.19"
"28651","ENSG00000196284.17_218089",218081,218089,9,"ENSG00000196284.17",1,8,"VVVVVVVMV",0,8,0.884057971014493,115,121,133,136,147,153,161,164,"GTCTTCA","CAGA","TTTTTGA","CTGA",2.18453372984589,12,11,8,40,2.84852128879153,4.35301987194103,7.889251755999,101,"ENSG00000079974.19"
"38907","ENSG00000251279.3_1877",1869,1877,9,"ENSG00000251279.3",1,7,"VVVVVVMVV",0,8,0.885300207039338,64,70,97,100,109,115,133,136,"ATCATGA","CGGA","GTGCTGC","CAGA",2.35541417155485,27,9,18,63,1.68927860490899,4.348009937152,7.88921076530935,101,"ENSG00000079974.19"
"29999","ENSG00000198947.18_388954",388946,388954,9,"ENSG00000198947.18",0,NA,"UVVVVUVVV",2,7,0.824844720496894,116,122,133,136,139,145,179,182,"CTGATGG","CAGT","ATGAAGA","CTGA",2.49297313079413,11,3,34,57,1.73922582890189,4.58976167521569,7.88914055720327,101,"ENSG00000079974.19"
"24366","ENSG00000176092.17_25091",25083,25091,9,"ENSG00000176092.17",1,2,"VMVVVVVVV",0,8,0.884057971014493,99,105,133,136,140,146,154,157,"ATAATGC","CTGA","CTGTTGG","CTGT",2.32714067562118,28,4,8,49,1.89708863250334,4.3528399508278,7.88907183488577,101,"ENSG00000079974.19"
"4744","ENSG00000101846.9_526062",526054,526062,9,"ENSG00000101846.9",1,2,"VMVVVVVVV",0,8,0.884057971014493,107,113,133,136,146,152,163,166,"ATGTTGA","CTAA","ATAAAAA","CTAA",2.25543534432701,20,10,11,50,2.37511342598283,4.35283726370739,7.88906914776536,101,"ENSG00000079974.19"
"17263","ENSG00000153707.19_998677",998669,998677,9,"ENSG00000153707.19",1,2,"VMVVUVVVV",1,7,0.773913043478261,106,112,133,136,141,147,159,162,"ATGATGC","TTGC","ATGAAGT","CTGA",2.53072114022442,21,5,12,47,2.30209702743305,4.79339282389896,7.889044997812,101,"ENSG00000079974.19"
"36925","ENSG00000243629.2_26747",26739,26747,9,"ENSG00000243629.2",1,7,"VVVVVVMVV",0,8,0.885300207039338,113,119,133,136,140,146,178,181,"ATTTTGA","CCAA","ATGAAAA","CTGA",2.32489819587887,14,4,32,59,1.89200152104658,4.34783070672643,7.88903153488378,101,"ENSG00000079974.19"
"39587","ENSG00000253875.2_13091",13083,13091,9,"ENSG00000253875.2",1,8,"VVVVVVVMV",0,8,0.884057971014493,109,115,133,136,168,174,189,192,"TTGATGA","CAGA","TTGTTTA","TTGA",2.38380281364766,18,32,15,74,1.51868956293721,4.35267708014706,7.88890896420503,101,"ENSG00000079974.19"
"18221","ENSG00000156599.11_18354",18346,18354,9,"ENSG00000156599.11",1,1,"MVUVVUVVV",2,6,0.711801242236025,115,121,133,136,146,152,206,209,"ATGATGA","CAGA","ATAAGGA","CTGA",2.74011961742719,12,10,54,85,1.89929386346861,5.04168949491247,7.88889446385657,101,"ENSG00000079974.19"
"979","ENSG00000042781.14_366189",366181,366189,9,"ENSG00000042781.14",1,1,"MVVVVUVVV",1,7,0.82815734989648,96,102,133,136,152,158,182,185,"ATGATGT","TTCA","TTGATGA","CTGA",2.62055826128445,31,16,24,80,0.834578963249362,4.57624184295309,7.88887124253901,101,"ENSG00000079974.19"
"41049","ENSG00000258484.4_102268",102260,102268,9,"ENSG00000258484.4",1,8,"VVVVVVVMV",0,8,0.884057971014493,66,72,99,102,109,115,133,136,"ATGCTGA","CAGA","GTAAGGA","CTAA",2.35075284539127,27,7,18,61,1.73868516173639,4.35259269941954,7.88882458347751,101,"ENSG00000079974.19"
"1381","ENSG00000054654.20_161499",161491,161499,9,"ENSG00000054654.20",1,2,"VMVVVUVVV",1,7,0.806211180124223,75,81,97,100,108,114,133,136,"CTCATGT","CTGG","ATGCTGA","CTGA",2.4383705385549,16,8,19,52,2.40009446565695,4.66397451400574,7.88881923450263,101,"ENSG00000079974.19"
"20086","ENSG00000164270.18_164701",164693,164701,9,"ENSG00000164270.18",0,NA,"VVVVVVUVV",1,8,0.886128364389234,112,118,133,136,143,149,167,170,"AAGATAC","ATGC","GTGATAT","CTGA",2.22455651650276,15,7,18,49,2.54673175462944,4.34427713282863,7.88879059038557,101,"ENSG00000079974.19"
"42206","ENSG00000261115.7_251565",251557,251565,9,"ENSG00000261115.7",1,5,"VVVVMVVVV",0,8,0.886542443064182,81,87,102,105,115,121,133,136,"ATGATGC","CTGA","GAGAAGG","TGGA",2.19008555447776,15,10,12,46,2.76986761191382,4.34260949377472,7.88877926603144,101,"ENSG00000079974.19"
"7302","ENSG00000113448.20_917058",917050,917058,9,"ENSG00000113448.20",1,1,"MVVVVUVVV",1,7,0.82815734989648,90,96,108,111,115,121,133,136,"ATGTTTA","GTTA","GGGAGGA","CTGA",2.31445628635601,12,4,12,37,2.87483027044181,4.57613471153713,7.88876411112306,101,"ENSG00000079974.19"
"12675","ENSG00000138771.16_159770",159762,159770,9,"ENSG00000138771.16",0,NA,"VVVVVVUVV",1,8,0.886128364389234,45,51,61,64,74,80,133,136,"ATGAAGA","ATGA","GTGAAAT","CTTA",2.33374244773134,10,10,53,82,1.81870340855252,4.34424659835702,7.88876005591396,101,"ENSG00000079974.19"
"33431","ENSG00000229739.4_7794",7786,7794,9,"ENSG00000229739.4",0,NA,"UVVVUVVVV",2,7,0.792546583850932,104,110,133,136,187,193,202,205,"ATGATGA","TTGC","GTGGTAA","CTGA",2.64028568227176,23,51,9,92,1.27232970816599,4.71855856416109,7.88874489956482,101,"ENSG00000079974.19"
"39673","ENSG00000254087.8_56133",56125,56133,9,"ENSG00000254087.8",1,8,"VVVVVUVMV",1,7,0.806211180124224,109,115,133,136,143,149,165,168,"TTGATAA","TTCA","CTGAAGA","CTGA",2.43448995939046,18,7,16,50,2.42563616254537,4.66389230628711,7.888737026784,101,"ENSG00000079974.19"
"21457","ENSG00000167766.21_89477",89469,89477,9,"ENSG00000167766.21",1,7,"VVVVVVMVV",0,8,0.885300207039338,109,115,133,136,151,157,210,213,"AGGCTGA","CTGG","GGGATGC","CTGA",2.42527634211781,18,15,53,95,1.22141919395035,4.34748203535061,7.88868286350796,101,"ENSG00000079974.19"
"32384","ENSG00000226913.2_818",810,818,9,"ENSG00000226913.2",1,1,"MVVVVUVVV",1,7,0.82815734989648,112,118,133,136,177,183,217,220,"ATCATGA","GTGA","ATGTTGC","CTGA",2.5987315980798,15,41,34,99,0.979159503069471,4.57600920590037,7.88863860548629,101,"ENSG00000079974.19"
"2094","ENSG00000070087.15_75317",75309,75317,9,"ENSG00000070087.15",1,1,"MVVUVVVVV",1,7,0.786749482401656,50,56,73,76,83,89,133,136,"AAGATGA","CGGA","AAGAGGA","CTGA",2.58037169489253,17,7,44,77,1.76406445533485,4.74163560532127,7.88863353492789,101,"ENSG00000079974.19"
"9197","ENSG00000123104.12_67498",67490,67498,9,"ENSG00000123104.12",1,2,"VMVVVVVVV",0,8,0.884057971014493,92,98,107,110,114,120,133,136,"GAGATGT","CTCA","GTGAATA","TTGA",2.20270461565495,9,4,13,35,2.72479624215583,4.35237341996388,7.88860530402185,101,"ENSG00000079974.19"
"45899","ENSG00000286037.1_933",925,933,9,"ENSG00000286037.1",1,2,"VMVVVVVVV",0,8,0.884057971014493,108,114,133,136,143,149,185,188,"GAGATGC","CTTA","GTGTGTA","CTGA",2.36828219461812,19,7,36,71,1.62094268566041,4.3523726624453,7.88860454650327,101,"ENSG00000079974.19"
"20491","ENSG00000164961.16_29840",29832,29840,9,"ENSG00000164961.16",0,NA,"VVVUVVVVV",1,8,0.880745341614907,115,121,133,136,138,144,152,155,"TTGGTGA","CAGA","TTTTTGA","CAGA",2.19676483303169,12,2,8,31,2.81723734531405,4.365584058048,7.88856542450763,101,"ENSG00000079974.19"
"11686","ENSG00000135824.13_23336",23328,23336,9,"ENSG00000135824.13",1,7,"VVVVVVMVV",0,8,0.885300207039338,100,106,133,136,142,148,163,166,"ATGCTGG","CTTC","TTGCAGA","CTGA",2.32288367623086,27,6,15,57,1.90354473838358,4.34735897831399,7.88855980647134,101,"ENSG00000079974.19"
"12762","ENSG00000138944.8_18146",18138,18146,9,"ENSG00000138944.8",1,7,"VVVVVVMVV",0,8,0.885300207039338,114,120,133,136,153,159,203,206,"CTGAGTA","ATGA","TTGATAA","CTGA",2.39348668006731,13,17,44,83,1.43284666061253,4.34735613193198,7.88855696008934,101,"ENSG00000079974.19"
"35872","ENSG00000237361.5_2254",2246,2254,9,"ENSG00000237361.5",1,5,"VVVVMUVVV",1,7,0.808695652173913,110,116,133,136,148,154,177,180,"ACAATGA","CTGA","GGGAGGG","CTGA",2.51033153169048,17,12,23,61,1.87951510205764,4.65376466166521,7.88854727036086,101,"ENSG00000079974.19"
"2096","ENSG00000070159.14_106020",106012,106020,9,"ENSG00000070159.14",1,8,"VVVVVVVMV",0,8,0.884057971014493,113,119,133,136,144,150,171,174,"AGGATTA","GTCA","AAGAAAA","CTGA",2.2497059443296,14,8,21,52,2.41112108518388,4.35229017851197,7.88852206256994,101,"ENSG00000079974.19"
"3032","ENSG00000080493.19_189744",189736,189744,9,"ENSG00000080493.19",1,8,"VVVVVUVMV",1,7,0.806211180124224,86,92,104,107,115,121,133,136,"AAGCTGA","CTGA","CTGATGG","CTGT",2.35280454962221,12,8,12,41,2.9690210902687,4.66359618860419,7.88844090910109,101,"ENSG00000079974.19"
"580","ENSG00000020577.14_12132",12124,12132,9,"ENSG00000020577.14",1,8,"VVVVUVVMV",1,7,0.773913043478261,115,121,133,136,142,148,164,167,"TTGCTTA","CTGA","TGGATGA","CTGA",2.4624393823075,12,6,16,43,2.75487448034325,4.79278425726498,7.88843643117802,101,"ENSG00000079974.19"
"9435","ENSG00000124721.18_18235",18227,18235,9,"ENSG00000124721.18",1,6,"VVUVVMVVV",1,7,0.786335403726708,42,48,64,67,71,77,133,136,"ATGGTGG","CTGA","ATGAGTA","CTGA",2.59441965562952,16,4,56,85,1.67618988694369,4.74308023111845,7.88842184602528,101,"ENSG00000079974.19"
"13524","ENSG00000141668.10_10448",10440,10448,9,"ENSG00000141668.10",1,2,"VMVVVUVVV",1,7,0.806211180124223,115,121,133,136,141,147,173,176,"CTGTTGA","CTGT","ATCAAGA","CTGA",2.47290735999762,12,5,26,52,2.1682450082525,4.66357351872583,7.88841823922272,101,"ENSG00000079974.19"
"35463","ENSG00000236107.10_237909",237901,237909,9,"ENSG00000236107.10",1,8,"VVVVVVVMV",0,8,0.884057971014493,116,122,133,136,138,144,163,166,"ATGAAAA","ATCA","TTGTTGC","CTGA",2.29637343404947,11,2,19,41,2.09948608495473,4.3521605779878,7.88839246204577,101,"ENSG00000079974.19"
"21231","ENSG00000166862.7_136889",136881,136889,9,"ENSG00000166862.7",0,NA,"VVVVUUVVV",2,7,0.812008281573499,77,83,95,98,99,105,133,136,"AGGATGA","CTGA","GTGAAGA","CTGT",2.55903821801184,12,1,28,50,1.50114420167564,4.64034974710531,7.88838287339931,101,"ENSG00000079974.19"
"18210","ENSG00000156515.25_98823",98815,98823,9,"ENSG00000156515.25",1,6,"VVVVVMUVV",1,7,0.788819875776397,105,111,133,136,145,151,187,190,"ATGATGA","CAGC","GTGCTGC","CTGA",2.64009752477759,22,9,36,76,1.33174057226985,4.73309768436345,7.88837718746904,101,"ENSG00000079974.19"
"29866","ENSG00000198822.11_173049",173041,173049,9,"ENSG00000198822.11",1,8,"VVUVVVVMV",1,7,0.767701863354037,112,118,133,136,145,151,197,200,"ATGAAGA","CAGA","CTGAGGT","CTGA",2.61063349095138,15,9,46,79,1.86600257090399,4.8175564609783,7.88836391439445,101,"ENSG00000079974.19"
"15766","ENSG00000149403.13_453783",453775,453783,9,"ENSG00000149403.13",1,5,"UVVVMVVVV",1,7,0.789233954451346,116,122,133,136,143,149,173,176,"AAGATGT","CTTA","ATGAAGC","CTGA",2.49545298749992,11,7,24,51,2.28908886880327,4.73136052970069,7.88829634750607,101,"ENSG00000079974.19"
"8675","ENSG00000120251.22_135515",135507,135515,9,"ENSG00000120251.22",1,7,"VVVVVVMVV",0,8,0.885300207039338,116,122,133,136,166,172,181,184,"ATGTAGA","ATTA","TTGAGCA","CTGA",2.30456425033631,11,30,9,59,2.02445890032229,4.34705514230775,7.8882559704651,101,"ENSG00000079974.19"
"17388","ENSG00000154027.19_226474",226466,226474,9,"ENSG00000154027.19",1,2,"VMVVVVVVV",0,8,0.884057971014493,43,49,65,68,114,120,133,136,"ATGCTGA","CCGA","GTGCTGG","CTGC",2.34732376566564,16,46,13,84,1.75913880923466,4.35199097841807,7.88822286247604,101,"ENSG00000079974.19"
"28484","ENSG00000189337.17_10340",10332,10340,9,"ENSG00000189337.17",1,3,"VVMVVVVVV",0,8,0.882815734989648,55,61,77,80,85,91,133,136,"GGGATTA","CTGA","GTGATGT","TTGA",2.34668988145192,16,5,42,72,1.78304973083458,4.35691223512852,7.88817517508711,101,"ENSG00000079974.19"
"48060","ENSG00000290323.1_24282",24274,24282,9,"ENSG00000290323.1",0,NA,"UVVVVUVVV",2,7,0.824844720496894,112,118,133,136,144,150,173,176,"AACATGA","GAGA","GTGATCA","CTGA",2.41502953523462,15,8,23,55,2.25484159418093,4.58875962393627,7.88813850592385,101,"ENSG00000079974.19"
"23497","ENSG00000173068.19_76493",76485,76493,9,"ENSG00000173068.19",1,8,"VVVVVVVMV",0,8,0.884057971014493,112,118,133,136,180,186,196,199,"AAGATTA","CAGT","GTCATGT","CTGA",2.32423868754707,15,44,10,78,1.91268265852628,4.35190181054336,7.88813369460133,101,"ENSG00000079974.19"
"6248","ENSG00000108946.16_33721",33713,33721,9,"ENSG00000108946.16",1,8,"VVVVVVVMV",0,8,0.884057971014493,93,99,133,136,148,154,162,165,"ATTATGT","CTTT","ATGCTAA","CTGA",2.34741255381466,34,12,8,63,1.75810168120128,4.35187967665808,7.88811156071605,101,"ENSG00000079974.19"
"6019","ENSG00000107736.22_357893",357885,357893,9,"ENSG00000107736.22",1,7,"VVVVVUMVV",1,7,0.807453416149068,90,96,108,111,116,122,133,136,"ATGGTGG","CTGG","AGCATGC","CTGA",2.34553010196446,12,5,11,37,2.99624312688554,4.65827761832883,7.8880912829251,101,"ENSG00000079974.19"
"4090","ENSG00000094916.16_47538",47530,47538,9,"ENSG00000094916.16",1,3,"VVMVVVVVV",0,8,0.882815734989648,113,119,133,136,144,150,163,166,"ACTCTGA","CTGG","AACAAGA","CTGA",2.18232545854193,14,8,13,44,2.87835395180259,4.35679758552053,7.88806052547912,101,"ENSG00000079974.19"
"14403","ENSG00000144847.13_243667",243659,243667,9,"ENSG00000144847.13",1,3,"VVMVVVVVV",0,8,0.882815734989648,111,117,133,136,147,153,183,186,"ATAATTA","CAAA","GTGCTGT","CTGA",2.34413830524867,16,11,30,66,1.79957986881109,4.35679214261722,7.88805508257581,101,"ENSG00000079974.19"
"13267","ENSG00000140836.17_454324",454316,454324,9,"ENSG00000140836.17",1,2,"VMVVVVVVV",0,8,0.884057971014493,115,121,133,136,148,154,172,175,"CTGATGA","TTGG","TTAATGT","TTGA",2.25068332348298,12,12,18,51,2.40254296278273,4.35177461316732,7.88800649722529,101,"ENSG00000079974.19"
"14209","ENSG00000144619.15_276986",276978,276986,9,"ENSG00000144619.15",1,2,"VMVVVVVVV",0,8,0.884057971014493,110,116,133,136,142,148,162,165,"TAGAGGA","AAGA","ATCATAA","CTGA",2.21891035154855,17,6,14,46,2.61427567441327,4.35175283785091,7.88798472190888,101,"ENSG00000079974.19"
"44198","ENSG00000279401.1_2085",2077,2085,9,"ENSG00000279401.1",0,NA,"UVVUVVVVV",2,7,0.78343685300207,102,108,133,136,163,169,182,185,"ATGATGA","TTGT","CTGATTA","CTGA",2.67574332780841,25,27,13,74,1.17850726788601,4.75419902998552,7.8879464419938,101,"ENSG00000079974.19"
"25124","ENSG00000179603.18_194680",194672,194680,9,"ENSG00000179603.18",1,5,"VVVVMVVVV",0,8,0.886542443064182,116,122,133,136,148,154,170,173,"AAGGTGA","ATGA","GTGAAAA","CTAA",2.22987253300993,11,12,16,48,2.50101977283424,4.34170916489178,7.8878789371485,101,"ENSG00000079974.19"
"36106","ENSG00000237883.4_34706",34698,34706,9,"ENSG00000237883.4",1,8,"VVVVVVVMV",0,8,0.884057971014493,69,75,87,90,99,105,133,136,"ATGATGC","CTGA","CTGATGT","CTCT",2.29219100814571,12,9,28,58,2.12523523130903,4.35162715473678,7.88785903879475,101,"ENSG00000079974.19"
"24402","ENSG00000176177.10_83122",83114,83122,9,"ENSG00000176177.10",0,NA,"VVVUVVVVV",1,8,0.880745341614907,107,113,133,136,149,155,169,172,"GTGTTGA","CACA","GCTATGC","CTGA",2.31053740146905,20,13,14,56,2.05587729183541,4.36486499207393,7.88784635853356,101,"ENSG00000079974.19"
"1144","ENSG00000048052.24_77293",77285,77293,9,"ENSG00000048052.24",1,2,"VMVVVVVVV",0,8,0.884057971014493,45,51,59,62,74,80,133,136,"TTTATGA","CTGA","GTGATAG","ATGA",2.38623470891246,8,12,53,82,1.49816072388959,4.35159802915983,7.8878299132178,101,"ENSG00000079974.19"
"34239","ENSG00000232284.9_316101",316093,316101,9,"ENSG00000232284.9",0,NA,"VVVUVVVVV",1,8,0.880745341614907,82,88,133,136,144,150,161,164,"ATGAAGC","GTGC","TTGATCC","CTGA",2.32298316599974,45,8,11,73,1.97263823835189,4.36479816958754,7.88777953604716,101,"ENSG00000079974.19"
"31521","ENSG00000223959.10_20866",20858,20866,9,"ENSG00000223959.10",1,2,"UMVVVVVVV",1,7,0.786749482401656,112,118,133,136,139,145,172,175,"ATTATGA","ATGA","TAGAAGA","CTGA",2.57236430504585,15,3,27,54,1.81400738026675,4.74077568680978,7.8877736164164,101,"ENSG00000079974.19"
"40086","ENSG00000254968.8_135439",135431,135439,9,"ENSG00000254968.8",1,8,"VVVVVVVMV",0,8,0.884057971014493,87,93,133,136,141,147,155,158,"ATGATGA","GTGG","GTGTTTC","CTGT",2.32394098740704,40,5,8,62,1.91300386977547,4.3514859464556,7.88771783051357,101,"ENSG00000079974.19"
"17385","ENSG00000154027.19_124137",124129,124137,9,"ENSG00000154027.19",0,NA,"VVVVVVUVV",1,8,0.886128364389234,71,77,92,95,115,121,133,136,"CTGATGA","CTGA","ATGTAGA","GTGC",2.28405998639657,15,20,12,56,2.14555820052259,4.34315619412493,7.88766965168186,101,"ENSG00000079974.19"
"8427","ENSG00000118873.17_50596",50588,50596,9,"ENSG00000118873.17",1,7,"VVVVVUMVV",1,7,0.807453416149068,101,107,133,136,159,165,183,186,"ATGATGG","TTGA","GTGACTA","CTGA",2.65328085518228,26,23,18,76,0.942785576982282,4.6578311528827,7.88764481747898,101,"ENSG00000079974.19"
"23344","ENSG00000172687.14_3376",3368,3376,9,"ENSG00000172687.14",1,2,"VMVVVVVVV",0,8,0.884057971014493,116,122,133,136,144,150,195,198,"AAAAAGA","GTGA","GTGACCA","CTGA",2.31542196743646,11,8,45,73,1.96877241169088,4.35122971531681,7.88746159937478,101,"ENSG00000079974.19"
"36802","ENSG00000243069.9_44056",44048,44056,9,"ENSG00000243069.9",1,7,"VVVVVVMVV",0,8,0.885300207039338,110,116,133,136,145,151,175,178,"GTGATGT","CAGA","TTTAGGA","CAGA",2.30484433101945,17,9,24,59,2.0193696229663,4.34624962410732,7.88745045226467,101,"ENSG00000079974.19"
"40720","ENSG00000257470.2_40696",40688,40696,9,"ENSG00000257470.2",1,2,"VMVVVVVVV",0,8,0.884057971014493,112,118,133,136,145,151,160,163,"TTGATTA","CAGA","AGGTAGA","CTTA",2.17931114821849,15,9,9,42,2.87609901230305,4.35121000010658,7.88744188416455,101,"ENSG00000079974.19"
"40938","ENSG00000258131.1_79061",79053,79061,9,"ENSG00000258131.1",1,2,"VMVVVVVVV",0,8,0.884057971014493,112,118,133,136,145,151,160,163,"TTGATTA","CAGA","AGGTAGA","CTTA",2.17931114821849,15,9,9,42,2.87609901230305,4.35121000010658,7.88744188416455,101,"ENSG00000079974.19"
"29125","ENSG00000197256.11_6185",6177,6185,9,"ENSG00000197256.11",1,2,"VMVVVVVVV",0,8,0.884057971014493,113,119,133,136,161,167,176,179,"AAGAGCA","CAGA","GTCATGT","CTGA",2.29774606223827,14,25,9,57,2.08641123747203,4.35117957976512,7.88741146382309,101,"ENSG00000079974.19"
"214","ENSG00000006695.12_42927",42919,42927,9,"ENSG00000006695.12",0,NA,"UVVVVUVVV",2,7,0.824844720496894,81,87,99,102,112,118,133,136,"ATTCTGA","CAGA","GCCATTA","CTGA",2.34487289090179,12,10,15,46,2.71957890381417,4.58801621078987,7.88739509277744,101,"ENSG00000079974.19"
"12965","ENSG00000139734.19_100866",100858,100866,9,"ENSG00000139734.19",1,3,"VVMVVVVVV",0,8,0.882815734989648,87,93,133,136,148,154,210,213,"GTGATGA","ATCA","ATGCTAC","CTGA",2.49847174795971,40,12,56,117,0.767930605100807,4.35610223120805,7.88736517116665,101,"ENSG00000079974.19"
"18363","ENSG00000157168.20_1083291",1083283,1083291,9,"ENSG00000157168.20",1,5,"VVVVMVVVV",0,8,0.886542443064182,116,122,133,136,141,147,165,168,"ATATTTA","GAGA","TTGATTA","CTGA",2.22147611060322,11,5,18,43,2.55470979196342,4.34113763232955,7.88730740458628,101,"ENSG00000079974.19"
"24571","ENSG00000177030.19_25273",25265,25273,9,"ENSG00000177030.19",1,8,"VVVVVVVMV",0,8,0.884057971014493,108,114,133,136,144,150,165,168,"ATGTTGG","TTAA","ATCCTCA","CTGA",2.2534616145672,19,8,15,51,2.38104187765839,4.35102982702661,7.88726171108458,101,"ENSG00000079974.19"
"40226","ENSG00000255282.6_35869",35861,35869,9,"ENSG00000255282.6",1,2,"VMVVVUVVV",1,7,0.806211180124223,112,118,133,136,139,145,154,157,"TTGATGT","GTGA","TTGATGA","CTGT",2.39068778610824,15,3,9,36,2.71154812569429,4.6623666749373,7.88721139543419,101,"ENSG00000079974.19"
"26659","ENSG00000184788.14_80503",80495,80503,9,"ENSG00000184788.14",1,8,"UVVVVVVMV",1,7,0.786749482401656,116,122,133,136,144,150,162,165,"ATGCTGA","CATA","ATGCCTA","CTGA",2.40123473847915,11,8,12,40,2.95261791259771,4.74021237561468,7.8872103052213,101,"ENSG00000079974.19"
"11502","ENSG00000135205.15_87577",87569,87577,9,"ENSG00000135205.15",1,3,"VVMVVVVVV",0,8,0.882815734989648,95,101,108,111,113,119,133,136,"GTGATGA","CTGC","GTGAAGA","CTTG",2.27381766479108,7,2,14,32,2.26490501650252,4.35592236211076,7.88718530206935,101,"ENSG00000079974.19"
"25541","ENSG00000182132.14_300044",300036,300044,9,"ENSG00000182132.14",1,2,"VMVVVVVVV",0,8,0.884057971014493,79,85,105,108,114,120,133,136,"GTGATGT","CTCA","CAAATGA","CTAA",2.25128498318601,20,6,13,48,2.39513328501186,4.35092495989631,7.88715684395428,101,"ENSG00000079974.19"
"28893","ENSG00000196639.7_67117",67109,67117,9,"ENSG00000196639.7",1,5,"VVVVMVUVV",1,7,0.772670807453416,31,37,63,66,75,81,133,136,"AGGATGA","CTGA","GGGATGT","CTGA",2.7149865770852,26,9,52,96,1.08575335696739,4.79641596771718,7.88709919753085,101,"ENSG00000079974.19"
"8294","ENSG00000117971.12_99330",99322,99330,9,"ENSG00000117971.12",1,8,"VVVVVUVMV",1,7,0.806211180124224,86,92,101,104,115,121,133,136,"GTAATGC","CAGA","TTGGTGC","CTGA",2.39929261805661,9,11,12,41,2.65358613555105,4.66221756398212,7.88706228447901,101,"ENSG00000079974.19"
"30985","ENSG00000215039.9_1698",1690,1698,9,"ENSG00000215039.9",1,1,"MVVVVUVVV",1,7,0.82815734989648,116,122,133,136,138,144,158,161,"ATGAAAA","CTTA","ATGACTT","CTGA",2.37355658951407,11,2,14,36,2.47395934281073,4.5744174848928,7.88704688447872,101,"ENSG00000079974.19"
"33211","ENSG00000229011.1_534",526,534,9,"ENSG00000229011.1",1,2,"UMVVVVVVV",1,7,0.786749482401656,91,97,133,136,143,149,159,162,"TGGATGA","CTGA","ATCAGGG","CTGA",2.54312319994659,36,7,10,62,2.0060271252019,4.74004544787813,7.88704337748476,101,"ENSG00000079974.19"
"38635","ENSG00000250697.2_148421",148413,148421,9,"ENSG00000250697.2",1,8,"UVVVVVVMV",1,7,0.786749482401656,113,119,133,136,140,146,161,164,"ATGAGGA","GTGA","TTGATGA","CTGC",2.44855652287606,14,4,15,42,2.63617013465387,4.73997007179023,7.88696800139685,101,"ENSG00000079974.19"
"46613","ENSG00000286923.3_4696",4688,4696,9,"ENSG00000286923.3",1,2,"VMVVVVVVV",0,8,0.884057971014493,108,114,133,136,147,153,176,179,"TTAATAA","CTGT","GTGTTCA","CTGA",2.34483266612591,19,11,23,62,1.77060271841038,4.35070512314578,7.88693700720375,101,"ENSG00000079974.19"
"25102","ENSG00000179399.15_904634",904626,904634,9,"ENSG00000179399.15",1,8,"VVVVVVVMV",0,8,0.884057971014493,113,119,133,136,149,155,168,171,"CTCAAGA","CTAT","GTGGTGG","CTGA",2.22359881003085,14,13,13,49,2.57837416635746,4.35059155830745,7.88682344236542,101,"ENSG00000079974.19"
"45406","ENSG00000285549.1_9684",9676,9684,9,"ENSG00000285549.1",1,3,"VVMVVUVVV",1,7,0.804968944099379,116,122,133,136,145,151,162,165,"ATGATAT","CTCT","TTCATGA","CTGA",2.35834700693979,11,9,11,40,2.94427865833799,4.66664800948414,7.88652378588166,101,"ENSG00000079974.19"
"36774","ENSG00000242880.2_82106",82098,82106,9,"ENSG00000242880.2",1,2,"VMVVVVVVV",0,8,0.884057971014493,97,103,133,136,147,153,166,169,"ATGTTAA","CTTT","CTGATCA","CTGA",2.34050857414692,30,11,13,63,1.79776154613285,4.35028801011141,7.88651989416938,101,"ENSG00000079974.19"
"6392","ENSG00000109680.11_154658",154650,154658,9,"ENSG00000109680.11",0,NA,"UVVVVUVVV",2,7,0.824844720496894,83,89,133,136,177,183,192,195,"ATGAGGA","CTGG","ATGAGGG","CTGA",2.60149859030107,44,41,9,103,1.00506800014188,4.58709798387059,7.88647686585817,101,"ENSG00000079974.19"
"46997","ENSG00000287470.1_8782",8774,8782,9,"ENSG00000287470.1",1,8,"VVVVVVVMV",0,8,0.884057971014493,81,87,99,102,116,122,133,136,"ATGAAAA","TTGA","ATGTGGA","TTGA",2.21818459489967,12,14,11,46,2.61284691321392,4.35018605313626,7.88641793719423,101,"ENSG00000079974.19"
"32901","ENSG00000228255.1_32143",32135,32143,9,"ENSG00000228255.1",0,NA,"VVVVVVUVV",1,8,0.886128364389234,86,92,133,136,144,150,160,163,"TTCATGG","GTAA","ATGCTGA","CTGA",2.30699513369544,41,8,10,68,1.98758096200966,4.34188712999481,7.88640058755175,101,"ENSG00000079974.19"
"16046","ENSG00000150672.19_138766",138758,138766,9,"ENSG00000150672.19",1,3,"UVMVVVVVV",1,7,0.785507246376811,89,95,110,113,116,122,133,136,"CTGATGT","CTGA","TTGTTGA","CTGG",2.44821955644777,15,3,11,38,2.65595836413498,4.74435551844669,7.88638450395394,101,"ENSG00000079974.19"
"8038","ENSG00000116667.15_12751",12743,12751,9,"ENSG00000116667.15",1,2,"VMVVVVVVV",0,8,0.884057971014493,108,114,133,136,144,150,175,178,"CTGATCA","TTGA","GTGATTA","GTGA",2.33460245285995,19,8,25,61,1.83649876785412,4.35012878006345,7.88636066412142,101,"ENSG00000079974.19"
"4491","ENSG00000100697.17_29609",29601,29609,9,"ENSG00000100697.17",0,NA,"VVUVVUVVV",2,7,0.805797101449275,115,121,133,136,139,145,154,157,"GTGGTGA","GTGC","GTGCTTT","CTGA",2.36170964609663,12,3,9,33,2.90790712619639,4.66315952504348,7.88634793084058,101,"ENSG00000079974.19"
"12136","ENSG00000137460.10_29339",29331,29339,9,"ENSG00000137460.10",1,8,"UVVVVVVMV",1,7,0.786749482401656,115,121,133,136,183,189,197,200,"CTGTTGG","CTGA","CTGATGT","CTGA",2.54630637385798,12,47,8,76,1.98197419281925,4.73933750463478,7.8863354342414,101,"ENSG00000079974.19"
"19726","ENSG00000163630.11_220809",220801,220809,9,"ENSG00000163630.11",1,8,"VVVVVVVMV",0,8,0.884057971014493,109,115,133,136,149,155,211,214,"GAGAGGA","TTGA","GTAAAGA","CTGA",2.40588050184729,18,13,56,96,1.36108342107568,4.35007169168107,7.88630357573905,101,"ENSG00000079974.19"
"36234","ENSG00000239268.5_109620",109612,109620,9,"ENSG00000239268.5",0,NA,"VVUVVVVVV",1,8,0.883643892339545,104,110,133,136,151,157,167,170,"GTGGTTT","TTGA","ATGATTA","CTGA",2.33700670347235,23,15,10,57,1.8267996454819,4.35171108382439,7.88628665318257,101,"ENSG00000079974.19"
"28572","ENSG00000196141.14_111878",111870,111878,9,"ENSG00000196141.14",1,8,"VVVVVVVMV",0,8,0.884057971014493,105,111,133,136,187,193,205,208,"ATGATTG","GGGA","TTGAAGA","CTGA",2.41566339091431,22,51,12,94,1.29578926394179,4.3500529675093,7.88628485156728,101,"ENSG00000079974.19"
"2536","ENSG00000075539.15_52260",52252,52260,9,"ENSG00000075539.15",1,1,"MVUVVVVVV",1,7,0.789648033126294,111,117,133,136,180,186,200,203,"ATGATGT","CTGT","GGGAGGT","CTGA",2.57971698587262,16,44,14,83,1.71250045909053,4.72765342456033,7.8862455570655,101,"ENSG00000079974.19"
"16881","ENSG00000152578.14_21682",21674,21682,9,"ENSG00000152578.14",1,8,"VVVVVVVMV",0,8,0.884057971014493,92,98,110,113,116,122,133,136,"GTGAAGA","CTCA","GCAATGT","GTGA",2.18721819592541,12,3,11,35,2.81845516435072,4.34997745096337,7.88620933502134,101,"ENSG00000079974.19"
"38337","ENSG00000250025.2_66492",66484,66492,9,"ENSG00000250025.2",0,NA,"UVVUVVVVV",2,7,0.78343685300207,83,89,101,104,112,118,133,136,"ATGAAGA","CAAA","GTGACTC","CTGA",2.42956097209335,12,8,15,44,2.81258156631618,4.7524136784013,7.88616109040958,101,"ENSG00000079974.19"
"41719","ENSG00000259616.2_174816",174808,174816,9,"ENSG00000259616.2",1,2,"VMVVVVVVV",0,8,0.884057971014493,113,119,133,136,144,150,162,165,"ATTCTGA","CTGC","GTAATGG","CAGA",2.17181009009142,14,8,12,43,2.92097912702687,4.34992826524241,7.88616014930038,101,"ENSG00000079974.19"
"17957","ENSG00000155897.10_84318",84310,84318,9,"ENSG00000155897.10",1,8,"VVVUVVVMV",1,7,0.764803312629399,114,120,133,136,184,190,200,203,"AAGATGA","CCGA","ATGCTGT","CTGA",2.59662247712032,13,48,10,80,1.99693766479796,4.82693854473335,7.88615179525095,101,"ENSG00000079974.19"
"34445","ENSG00000233068.3_20952",20944,20952,9,"ENSG00000233068.3",1,2,"VMVVVVVVV",0,8,0.884057971014493,95,101,133,136,148,154,166,169,"ATGCTGC","CAGC","CTGAGGC","CTGA",2.34782040953603,32,12,12,65,1.74728926358762,4.34985633179029,7.88608821584826,101,"ENSG00000079974.19"
"36179","ENSG00000238158.6_20955",20947,20955,9,"ENSG00000238158.6",1,2,"VMVVVVVVV",0,8,0.884057971014493,95,101,133,136,148,154,166,169,"ATGCTGC","CAGC","CTGAGGC","CTGA",2.34782040953603,32,12,12,65,1.74728926358762,4.34985633179029,7.88608821584826,101,"ENSG00000079974.19"
"31699","ENSG00000224479.6_18124",18116,18124,9,"ENSG00000224479.6",1,7,"UVVVVVMVV",1,7,0.787991718426501,81,87,109,112,115,121,133,136,"ATGATGC","CTTA","GTTCTGT","CTGA",2.54042869273939,22,3,12,46,2.00007990726766,4.73406779804923,7.88603467175523,101,"ENSG00000079974.19"
"18953","ENSG00000159495.8_9620",9612,9620,9,"ENSG00000159495.8",1,8,"VVVVVVVMV",0,8,0.884057971014493,61,67,90,93,111,117,133,136,"AGGATGT","CTGA","GTGAGGT","CAGA",2.39923543285069,23,18,16,66,1.40429500585826,4.34979947288237,7.88603135694034,101,"ENSG00000079974.19"
"1914","ENSG00000067715.15_242550",242542,242550,9,"ENSG00000067715.15",1,2,"UMVVVVVVV",1,7,0.786749482401656,85,91,106,109,112,118,133,136,"ATAATGC","CTCA","ATGAAAA","CTGA",2.47665943942342,15,3,15,42,2.44486536556497,4.73898207376361,7.88598000337024,101,"ENSG00000079974.19"
"18535","ENSG00000157601.15_4194",4186,4194,9,"ENSG00000157601.15",0,NA,"VVUVVVVVV",1,8,0.883643892339545,89,95,104,107,112,118,133,136,"AGGATGT","CTGG","TTGACTA","CAGA",2.21411277107752,9,5,15,38,2.64464311629981,4.35134873087082,7.885924300229,101,"ENSG00000079974.19"
"20656","ENSG00000165259.14_113470",113462,113470,9,"ENSG00000165259.14",1,6,"VVVUVMVVV",1,7,0.78343685300207,112,118,133,136,147,153,165,168,"ATAAGGA","CTGG","GTCAAGA","CTGA",2.44541905893484,15,11,12,47,2.70540742960106,4.75205028895834,7.88579770096662,101,"ENSG00000079974.19"
"22371","ENSG00000170396.9_35539",35531,35539,9,"ENSG00000170396.9",1,8,"UVVVVVVMV",1,7,0.786749482401656,72,78,90,93,102,108,133,136,"CTGATGA","CTGA","CTGATAG","TTGA",2.50968739952398,12,9,25,55,2.22382057100596,4.73876747529146,7.88576540489809,101,"ENSG00000079974.19"
"23488","ENSG00000173068.19_290254",290246,290254,9,"ENSG00000173068.19",1,8,"VVVVVVVMV",0,8,0.884057971014493,113,119,133,136,174,180,194,197,"GTAATGT","ATGT","GTGATTG","CTGA",2.33267731125073,14,38,14,75,1.84629669918654,4.34936969354785,7.88560157760582,101,"ENSG00000079974.19"
"39409","ENSG00000253554.7_47538",47530,47538,9,"ENSG00000253554.7",1,7,"VVVVVVMVV",0,8,0.885300207039338,94,100,133,136,186,192,204,207,"AGGAGGA","TTGA","TTGAAGG","CTGA",2.46024330678349,33,50,12,104,0.97589839486474,4.344380110022,7.88558093817935,101,"ENSG00000079974.19"
"38913","ENSG00000251291.2_121073",121065,121073,9,"ENSG00000251291.2",1,2,"UMVVVVVVV",1,7,0.786749482401656,110,116,133,136,143,149,167,170,"GAGATGA","GTGA","GCGAGGC","CTGA",2.48441956418635,17,7,18,51,2.39152362909572,4.73858018091784,7.88557811052446,101,"ENSG00000079974.19"
"7339","ENSG00000113595.15_8118",8110,8118,9,"ENSG00000113595.15",0,NA,"VVVUVVVVV",1,8,0.880745341614907,100,106,133,136,142,148,161,164,"ATGTTTA","TTAA","CTGAGAA","CTGA",2.31670994802769,27,6,13,55,2.00562031178142,4.36258832465818,7.88556969111781,101,"ENSG00000079974.19"
"16563","ENSG00000151789.13_742585",742577,742585,9,"ENSG00000151789.13",1,1,"MVVUVVVVV",1,7,0.786749482401656,102,108,133,136,150,156,193,196,"ATGATGA","CTTT","CTGATGA","CTGA",2.71845243632243,25,14,37,85,0.83118576814738,4.73855050257423,7.88554843218085,101,"ENSG00000079974.19"
"26174","ENSG00000183580.10_429723",429715,429723,9,"ENSG00000183580.10",1,2,"VMVVVVVVV",0,8,0.884057971014493,115,121,133,136,142,148,174,177,"GTCAAGA","CTAT","GTGAACA","CTGA",2.27648789574677,12,6,26,53,2.22046831820732,4.34926357246312,7.88549545652109,101,"ENSG00000079974.19"
"46587","ENSG00000286863.2_206980",206972,206980,9,"ENSG00000286863.2",1,7,"VVVVVVMVV",0,8,0.885300207039338,107,113,133,136,142,148,165,168,"ATAATGT","TAGA","AACATAA","CTGA",2.28070699667058,20,6,17,52,2.17206925403466,4.34419564129296,7.88539646945032,101,"ENSG00000079974.19"
"7105","ENSG00000112782.19_94148",94140,94148,9,"ENSG00000112782.19",1,7,"VVUVVVMVV",1,7,0.768944099378882,114,120,133,136,160,166,178,181,"ATGATCA","CTGT","ATAAAGA","CTGA",2.57071850697735,13,24,12,58,2.10034910129747,4.80961812028662,7.88539451780214,101,"ENSG00000079974.19"
"3526","ENSG00000085382.12_70830",70822,70830,9,"ENSG00000085382.12",1,2,"VMVVVVVVV",0,8,0.884057971014493,113,119,133,136,153,159,199,202,"GTGATTT","TTGC","GTGATGT","CTGA",2.39759884626497,14,17,40,80,1.41252152735013,4.34912845894581,7.88536034300378,101,"ENSG00000079974.19"
"27714","ENSG00000187231.14_148005",147997,148005,9,"ENSG00000187231.14",0,NA,"UVVUVVVVV",2,7,0.78343685300207,82,88,103,106,111,117,133,136,"ATGATAG","ATGA","TTGATAC","CTGA",2.46012710092218,15,5,16,45,2.60549078817484,4.75158453191401,7.88533194392229,101,"ENSG00000079974.19"
"46382","ENSG00000286540.1_111572",111564,111572,9,"ENSG00000286540.1",1,6,"VVVVVMUVV",1,7,0.788819875776397,54,60,70,73,81,87,133,136,"ATGATGT","ATGA","ATTGTGC","CTGA",2.55122381028151,10,8,46,73,1.9118596237821,4.73000458974804,7.88528409285363,101,"ENSG00000079974.19"
"28172","ENSG00000188342.12_140995",140987,140995,9,"ENSG00000188342.12",1,2,"UMVVVVVVV",1,7,0.786749482401656,108,114,133,136,137,143,156,159,"ATGATGG","GTAA","CTGAAGA","CTGA",2.56709838046726,19,1,13,42,1.83907978352302,4.73826724665953,7.88526517626615,101,"ENSG00000079974.19"
"16290","ENSG00000151304.6_61766",61758,61766,9,"ENSG00000151304.6",1,6,"UVVVVMVVV",1,7,0.805383022774327,111,117,133,136,161,167,205,208,"ATGATGA","CAGC","GTGATTT","CTGA",2.64938806531813,16,25,38,88,0.992090612695791,4.66366942870417,7.88520151980148,101,"ENSG00000079974.19"
"46538","ENSG00000286785.1_90374",90366,90374,9,"ENSG00000286785.1",1,1,"MVUVVVVVV",1,7,0.789648033126294,103,109,133,136,145,151,174,177,"CTGATGT","CAGA","ATGATCA","CTGA",2.60683579549658,24,9,23,65,1.5272761636505,4.72654536674026,7.88513749924543,101,"ENSG00000079974.19"
"13908","ENSG00000143919.15_332198",332190,332198,9,"ENSG00000143919.15",0,NA,"VVVVVVUVV",1,8,0.886128364389234,113,119,133,136,144,150,185,188,"ACTATGA","CGCA","CTGATCT","CTGA",2.30383663556527,14,8,35,66,2.00355606054667,4.34061674107878,7.88513019863571,101,"ENSG00000079974.19"
"18618","ENSG00000157869.16_27921",27913,27921,9,"ENSG00000157869.16",0,NA,"VVVVVVUVV",1,8,0.886128364389234,82,88,95,98,111,117,133,136,"ATGTTGG","CTGA","ATGAGAT","CTGT",2.29376786429539,7,13,16,45,2.07045181611698,4.34055939452156,7.88507285207849,101,"ENSG00000079974.19"
"8507","ENSG00000119326.15_57324",57316,57324,9,"ENSG00000119326.15",1,8,"VVVVUVVMV",1,7,0.773913043478261,77,83,106,109,113,119,133,136,"ATTATGA","CTGG","TTGCAGA","CTGA",2.57616075246323,23,4,14,50,1.98289351584503,4.78932463306665,7.88497680697969,101,"ENSG00000079974.19"
"39167","ENSG00000253194.2_106648",106640,106648,9,"ENSG00000253194.2",0,NA,"VVVUVVVVV",1,8,0.880745341614907,115,121,133,136,142,148,193,196,"ATCAGGT","CTCA","ATGCTAA","CTGA",2.31849673366897,12,6,45,72,1.99129244324766,4.36198433359354,7.88496570005316,101,"ENSG00000079974.19"
"17796","ENSG00000155093.19_400249",400241,400249,9,"ENSG00000155093.19",1,8,"VVVVVUVMV",1,7,0.806211180124224,111,117,133,136,146,152,160,163,"GTGTTTA","CTTA","CTAATGA","CTGA",2.38676135214544,16,10,8,43,2.7286426117718,4.66009623985202,7.88494096034891,101,"ENSG00000079974.19"
"21416","ENSG00000167522.17_109102",109094,109102,9,"ENSG00000167522.17",0,NA,"VVVVVVUVV",1,8,0.886128364389234,93,99,133,136,187,193,209,212,"TTGATGA","CTTG","TTGGTGT","CTGA",2.48853084452361,34,51,16,110,0.77141402459344,4.3404049136877,7.88491837124464,101,"ENSG00000079974.19"
"47613","ENSG00000288715.1_36833",36825,36833,9,"ENSG00000288715.1",0,NA,"VVVVVVUVV",1,8,0.886128364389234,93,99,133,136,187,193,209,212,"TTGATGA","CTTG","TTGGTGT","CTGA",2.48853084452361,34,51,16,110,0.77141402459344,4.3404049136877,7.88491837124464,101,"ENSG00000079974.19"
"30889","ENSG00000214517.10_49368",49360,49368,9,"ENSG00000214517.10",0,NA,"UVVUVVVVV",2,7,0.78343685300207,100,106,133,136,144,150,158,161,"ATGCTGA","GTGA","GTTAGGT","CTGA",2.54015416478907,27,8,8,52,2.0697255810976,4.75102166992284,7.88476908193112,101,"ENSG00000079974.19"
"40969","ENSG00000258216.7_264241",264233,264241,9,"ENSG00000258216.7",0,NA,"VVVVVVUVV",1,8,0.886128364389234,111,117,133,136,151,157,171,174,"ATGATTT","CTTA","GTGAAGG","TTGA",2.26467441160953,16,15,14,54,2.26316121926427,4.34024765749862,7.88476111505556,101,"ENSG00000079974.19"
"1211","ENSG00000049323.16_407438",407430,407438,9,"ENSG00000049323.16",0,NA,"VVUVVVVVV",1,8,0.883643892339545,109,115,133,136,142,148,195,198,"ATAATGC","ATAA","CTGAGGT","CTGA",2.36183051475407,18,6,47,80,1.65494573767781,4.35012062567624,7.88469619503442,101,"ENSG00000079974.19"
"18171","ENSG00000156395.14_356599",356591,356599,9,"ENSG00000156395.14",1,8,"UVVVVVVMV",1,7,0.786749482401656,87,93,133,136,141,147,187,190,"ATGATGA","ATGA","TTAATCA","CTGA",2.69959440432297,40,5,40,94,0.953431453346377,4.73768187054155,7.88467980014817,101,"ENSG00000079974.19"
"10644","ENSG00000132170.24_146328",146320,146328,9,"ENSG00000132170.24",1,8,"VVVUVVVMV",1,7,0.764803312629399,64,70,84,87,93,99,133,136,"TTGATGC","CTGA","CAGATTA","CTGA",2.59357208081405,14,6,34,63,2.01124509657791,4.82543140883457,7.88464465935216,101,"ENSG00000079974.19"
"31434","ENSG00000223727.6_326102",326094,326102,9,"ENSG00000223727.6",1,7,"VVUVVVMVV",1,7,0.768944099378882,62,68,79,82,91,97,133,136,"ATGATGA","TTCA","TTTAGGA","CTGA",2.58987480127186,11,9,36,65,1.96947198235243,4.80882599770788,7.8846023952234,101,"ENSG00000079974.19"
"35297","ENSG00000235649.2_4336",4328,4336,9,"ENSG00000235649.2",1,3,"UVMVVVVVV",1,7,0.785507246376811,79,85,99,102,115,121,133,136,"TTGGTGA","ATGA","CTCTTGA","CTGA",2.4528431430935,14,13,12,48,2.61795024237316,4.74255946574912,7.88458845125637,101,"ENSG00000079974.19"
"21699","ENSG00000168702.18_715111",715103,715111,9,"ENSG00000168702.18",1,2,"VMVVVVVVV",0,8,0.884057971014493,114,120,133,136,146,152,161,164,"GTGATGT","ATAA","TTAATGT","CTAA",2.17150673419233,13,10,9,41,2.91662707420267,4.34833465887122,7.8845665429292,101,"ENSG00000079974.19"
"16316","ENSG00000151322.20_368074",368066,368074,9,"ENSG00000151322.20",1,2,"VMVVVVVVV",0,8,0.884057971014493,116,122,133,136,172,178,196,199,"AACATGG","GTGA","GTGAAAA","CTGA",2.36491002509538,11,36,18,74,1.62724016041294,4.34832674859554,7.88455863265351,101,"ENSG00000079974.19"
"36469","ENSG00000241231.2_20230",20222,20230,9,"ENSG00000241231.2",1,2,"UMVVVVVVV",1,7,0.786749482401656,100,106,133,136,144,150,161,164,"AAGATGT","CTGA","GAGACCA","CTGA",2.531270563524,27,8,11,55,2.07509964356386,4.73755918343097,7.8845571130376,101,"ENSG00000079974.19"
"48418","ENSG00000291089.1_12591",12583,12591,9,"ENSG00000291089.1",1,7,"VVVVVVMVV",0,8,0.885300207039338,108,114,133,136,142,148,165,168,"ATGAGGC","ATGA","TTGTTGA","CTGT",2.26715545797921,19,6,17,51,2.2587337274624,4.34327586183095,7.8844766899883,101,"ENSG00000079974.19"
"35212","ENSG00000235357.4_20650",20642,20650,9,"ENSG00000235357.4",1,8,"VVVVVUVMV",1,7,0.806211180124224,112,118,133,136,170,176,192,195,"GTGAGGT","CTGA","ATGCTGC","CTGA",2.54195286721089,15,34,16,74,1.69212185879851,4.65961857671778,7.88446329721468,101,"ENSG00000079974.19"
"46402","ENSG00000286592.2_134459",134451,134459,9,"ENSG00000286592.2",1,2,"VMVVVUVVV",1,7,0.806211180124223,79,85,101,104,114,120,133,136,"ATGATCT","AGGA","GTGATAT","CTGA",2.39720351791508,16,10,13,48,2.65706975281283,4.65960663472834,7.88445135522523,101,"ENSG00000079974.19"
"8687","ENSG00000120254.16_210620",210612,210620,9,"ENSG00000120254.16",1,5,"VVVVMUVVV",1,7,0.808695652173913,83,89,104,107,115,121,133,136,"AGGATGA","TTGA","TTGAGGC","GTGA",2.36036795239266,15,8,12,44,2.86287027441583,4.64966415592505,7.8844467646207,101,"ENSG00000079974.19"
"16040","ENSG00000150672.19_1268673",1268665,1268673,9,"ENSG00000150672.19",1,5,"VVVVMVVVV",0,8,0.886542443064182,56,62,73,76,81,87,133,136,"AGGATGA","CTCA","TTGATAG","CTGT",2.31612213625424,11,5,46,71,1.91217206219618,4.33824657597278,7.88441634822951,101,"ENSG00000079974.19"
"1566","ENSG00000060982.15_59623",59615,59623,9,"ENSG00000060982.15",1,8,"VVVVVVVMV",0,8,0.884057971014493,86,92,133,136,142,148,163,166,"ATGATGG","CTCC","TTGATGA","CTGG",2.33861598693481,41,6,15,71,1.8018845984991,4.34816446118279,7.88439634524076,101,"ENSG00000079974.19"
"25759","ENSG00000182674.6_233814",233806,233814,9,"ENSG00000182674.6",1,8,"VVVVVVVMV",0,8,0.884057971014493,100,106,133,136,151,157,174,177,"ATGATTA","CCCA","AACATGA","CTGA",2.40577651638352,27,15,17,68,1.35409871424522,4.34815220586718,7.88438408992515,101,"ENSG00000079974.19"
"7572","ENSG00000114861.24_277821",277813,277821,9,"ENSG00000114861.24",0,NA,"VVUVVUVVV",2,7,0.805797101449275,113,119,133,136,143,149,167,170,"GTGAGGA","CAGC","CTGATTG","CTGA",2.40643449954347,14,7,18,48,2.60179150803191,4.66117204291376,7.88436044871086,101,"ENSG00000079974.19"
"45551","ENSG00000285708.1_448072",448064,448072,9,"ENSG00000285708.1",0,NA,"VVUVVUVVV",2,7,0.805797101449275,113,119,133,136,143,149,167,170,"GTGAGGA","CAGC","CTGATTG","CTGA",2.40643449954347,14,7,18,48,2.60179150803191,4.66117204291376,7.88436044871086,101,"ENSG00000079974.19"
"32535","ENSG00000227117.6_70889",70881,70889,9,"ENSG00000227117.6",1,1,"MVUVVVVVV",1,7,0.789648033126294,93,99,133,136,166,172,180,183,"ATGAGAA","CTGA","ATGATGA","CTGA",2.67894438192603,34,30,8,81,1.0433794851685,4.72575217450218,7.88434430700736,101,"ENSG00000079974.19"
"44174","ENSG00000279159.1_18645",18637,18645,9,"ENSG00000279159.1",1,1,"MVUVVVVVV",1,7,0.789648033126294,93,99,133,136,166,172,180,183,"ATGAGAA","CTGA","ATGATGA","CTGA",2.67894438192603,34,30,8,81,1.0433794851685,4.72575217450218,7.88434430700736,101,"ENSG00000079974.19"
"36563","ENSG00000241754.2_7910",7902,7910,9,"ENSG00000241754.2",0,NA,"VVVVVVUVV",1,8,0.886128364389234,110,116,133,136,177,183,198,201,"GAGCTGA","CTCA","ATGATAC","CTGA",2.36717417125123,17,41,15,82,1.5781409562992,4.33982552449351,7.88433898205045,101,"ENSG00000079974.19"
"10032","ENSG00000128881.18_111376",111368,111376,9,"ENSG00000128881.18",1,2,"VMVVVVVVV",0,8,0.884057971014493,114,120,133,136,165,171,188,191,"TTTAGGA","TTGA","AAGAAGA","CTGA",2.34565649652581,13,29,17,68,1.75450777911827,4.34805443898925,7.88428632304722,101,"ENSG00000079974.19"
"39812","ENSG00000254254.7_66974",66966,66974,9,"ENSG00000254254.7",1,7,"VVVVVVMVV",0,8,0.885300207039338,116,122,133,136,142,148,163,166,"TTAATAA","GGGA","GTGTTCT","CTGA",2.18586601017083,11,6,15,41,2.79987486950126,4.3430787343267,7.88427956248405,101,"ENSG00000079974.19"
"23067","ENSG00000172164.15_3889",3881,3889,9,"ENSG00000172164.15",1,2,"VMVVVVVVV",0,8,0.884057971014493,81,87,107,110,114,120,133,136,"GTTATGT","CTGA","GTGAGTT","CTAA",2.27110947918001,20,4,13,46,2.25136752863391,4.34802434745849,7.88425623151646,101,"ENSG00000079974.19"
"46428","ENSG00000286642.2_682",674,682,9,"ENSG00000286642.2",1,2,"VMVVVVVVV",0,8,0.884057971014493,112,118,133,136,146,152,177,180,"ATGATAC","TGGA","GTTAGTA","CTGA",2.29668541356639,15,10,25,59,2.08071655644337,4.34798816172149,7.88422004577946,101,"ENSG00000079974.19"
"34607","ENSG00000233593.12_44567",44559,44567,9,"ENSG00000233593.12",1,2,"VMVVVVVVV",0,8,0.884057971014493,86,92,133,136,162,168,179,182,"AAGATGA","TAGA","GTAAAAA","CTGA",2.44511922558969,41,26,11,87,1.09115407854878,4.34798722895334,7.88421911301131,101,"ENSG00000079974.19"
"15203","ENSG00000147316.15_144115",144107,144115,9,"ENSG00000147316.15",0,NA,"VVUVUVVVV",2,7,0.773498964803312,40,46,62,65,81,87,133,136,"GTGGTGA","CTGA","GTGTGGA","CTGA",2.67425351427645,16,16,46,87,1.33251015772106,4.79021672989102,7.88421258910427,101,"ENSG00000079974.19"
"553","ENSG00000018408.15_51089",51081,51089,9,"ENSG00000018408.15",1,1,"MVUVVVVVV",1,7,0.789648033126294,110,116,133,136,144,150,200,203,"GTGATGA","AGGA","ATGATTC","CTGA",2.57370620488222,17,8,50,84,1.74408389649748,4.72553131559473,7.8841234480999,101,"ENSG00000079974.19"
"43477","ENSG00000271955.2_200893",200885,200893,9,"ENSG00000271955.2",0,NA,"VVVVUVVVV",1,8,0.889855072463768,110,116,133,136,143,149,162,165,"GTGGTAA","AGGA","GTCATAC","CTGA",2.19308401821072,17,7,13,46,2.67822954676562,4.3246974170426,7.88411770689767,101,"ENSG00000079974.19"
"18879","ENSG00000159128.16_57906",57898,57906,9,"ENSG00000159128.16",1,8,"VVVVUVVMV",1,7,0.773913043478261,116,122,133,136,146,152,162,165,"CAGATAA","CTGA","ATAATGG","CTGA",2.43713551898758,11,10,10,40,2.90610893538618,4.78841976549252,7.88407193940556,101,"ENSG00000079974.19"
"2855","ENSG00000078549.16_8679",8671,8679,9,"ENSG00000078549.16",0,NA,"VVVVVUUVV",2,7,0.808281573498965,70,76,88,91,98,104,133,136,"CTGCTGC","CTGA","CTGATTC","CTGA",2.46816438659902,12,7,29,57,2.14909010847978,4.65087983811831,7.88400613211417,101,"ENSG00000079974.19"
"14167","ENSG00000144460.13_79233",79225,79233,9,"ENSG00000144460.13",1,7,"VVVVVVMVV",0,8,0.885300207039338,93,99,133,136,140,146,154,157,"AAGATGA","TTGA","GTGAATT","CTGC",2.33114584368374,34,4,8,55,1.83006531996883,4.34275940279843,7.88396023095578,101,"ENSG00000079974.19"
"16375","ENSG00000151422.14_18067",18059,18067,9,"ENSG00000151422.14",1,7,"VVVVVUMVV",1,7,0.807453416149068,116,122,133,136,137,143,152,155,"ATGATGT","GTCA","AAAGTGA","CTGA",2.39154627840044,11,1,9,30,2.67246561923797,4.65402686881022,7.8838405334065,101,"ENSG00000079974.19"
"4069","ENSG00000092964.18_90075",90067,90075,9,"ENSG00000092964.18",1,6,"UVVVVMVVV",1,7,0.805383022774327,113,119,133,136,151,157,173,176,"TTGATTG","CTGA","ATAATCA","CTGA",2.4559290898167,14,15,16,54,2.27633435863697,4.66229873935375,7.88383083045106,101,"ENSG00000079974.19"
"34778","ENSG00000234129.10_3997",3989,3997,9,"ENSG00000234129.10",1,3,"UVMVVVVVV",1,7,0.785507246376811,78,84,103,106,109,115,133,136,"GTGAAGA","CAGA","ATGAGAA","CTGA",2.55783232175113,19,3,18,49,1.9149730414855,4.7417971299566,7.88382611546384,101,"ENSG00000079974.19"
"31905","ENSG00000225210.10_52041",52033,52041,9,"ENSG00000225210.10",0,NA,"VVVVVVUVV",1,8,0.886128364389234,76,82,94,97,102,108,133,136,"ATCATGA","CTGT","GTTATCT","ATGA",2.27281103074418,12,5,25,51,2.20514088557258,4.33930360596679,7.88381706352372,101,"ENSG00000079974.19"
"37017","ENSG00000244306.11_52097",52089,52097,9,"ENSG00000244306.11",0,NA,"VVVVVVUVV",1,8,0.886128364389234,76,82,94,97,102,108,133,136,"ATCATGA","CTGT","GTTATCT","ATGA",2.27281103074418,12,5,25,51,2.20514088557258,4.33930360596679,7.88381706352372,101,"ENSG00000079974.19"
"46767","ENSG00000287151.1_59930",59922,59930,9,"ENSG00000287151.1",0,NA,"VVVVVVUVV",1,8,0.886128364389234,76,82,94,97,102,108,133,136,"ATCATGA","CTGT","GTTATCT","ATGA",2.27281103074418,12,5,25,51,2.20514088557258,4.33930360596679,7.88381706352372,101,"ENSG00000079974.19"
"18637","ENSG00000157985.20_25469",25461,25469,9,"ENSG00000157985.20",1,5,"VVVVMVVVV",0,8,0.886542443064182,88,94,133,136,139,145,158,161,"GTGATAA","TAGA","ATACAGA","CTGA",2.35922300164874,39,3,13,64,1.62204067383987,4.3375485045412,7.88371827679793,101,"ENSG00000079974.19"
"25551","ENSG00000182150.19_207004",206996,207004,9,"ENSG00000182150.19",1,5,"VVVVMVVVV",0,8,0.886542443064182,114,120,133,136,150,156,172,175,"TGGTTGA","TTTA","GTGTTGG","CTGA",2.24592748789763,13,14,16,52,2.37723020157233,4.33752003022247,7.8836898024792,101,"ENSG00000079974.19"
"35802","ENSG00000237212.2_12528",12520,12528,9,"ENSG00000237212.2",1,5,"VVVVMVVVV",0,8,0.886542443064182,114,120,133,136,150,156,172,175,"TGGTTGA","TTTA","GTGTTGG","CTGA",2.24592748789763,13,14,16,52,2.37723020157233,4.33752003022247,7.8836898024792,101,"ENSG00000079974.19"
"41034","ENSG00000258416.1_46",38,46,9,"ENSG00000258416.1",1,5,"VVVVMVVVV",0,8,0.886542443064182,4,10,48,51,101,107,117,120,"AGAATGA","ATGA","TTGCAGA","CTGA",2.45191361220411,38,50,10,107,1.00388705531843,4.33749445083645,7.88366422309318,101,"ENSG00000079974.19"
"5374","ENSG00000104381.14_14433",14425,14433,9,"ENSG00000104381.14",0,NA,"VVVVUVVVV",1,8,0.889855072463768,63,69,106,109,116,122,133,136,"ATGATGG","CTTA","GAGTTCA","ATGA",2.29601409497043,37,7,11,64,1.99001475857051,4.32419384792668,7.88361413778175,101,"ENSG00000079974.19"
"35768","ENSG00000237031.7_28629",28621,28629,9,"ENSG00000237031.7",1,8,"VVVUVVVMV",1,7,0.764803312629399,114,120,133,136,143,149,158,161,"GCAATGA","CTAA","TTGAAGA","CTGA",2.43650851930787,13,7,9,38,3.05406504890221,4.82436379440533,7.88357704492293,101,"ENSG00000079974.19"
"5233","ENSG00000104047.15_31745",31737,31745,9,"ENSG00000104047.15",1,5,"VVVVMVVVV",0,8,0.886542443064182,113,119,133,136,147,153,168,171,"AGGGTGG","AAGA","CTGATTC","CTGA",2.20984660581623,14,11,15,49,2.61728620527664,4.33739922767955,7.88356899993627,101,"ENSG00000079974.19"
"39089","ENSG00000251600.8_300471",300463,300471,9,"ENSG00000251600.8",0,NA,"VVVVVUUVV",2,7,0.808281573498965,113,119,133,136,143,149,163,166,"ATGATGG","AAGA","GTGATGT","CTGG",2.36366683174081,14,7,14,44,2.84394342984433,4.65043057702911,7.88355687102497,101,"ENSG00000079974.19"
"16649","ENSG00000151952.16_697023",697015,697023,9,"ENSG00000151952.16",1,5,"VVVVMVVVV",0,8,0.886542443064182,96,102,133,136,141,147,156,159,"TTGATTA","CAGT","AAGAGGT","CTGA",2.30803820689705,31,5,9,54,1.96223732444314,4.33728967593921,7.88345944819593,101,"ENSG00000079974.19"
"31778","ENSG00000224812.4_8143",8135,8143,9,"ENSG00000224812.4",1,2,"VMVVVVVVV",0,8,0.884057971014493,116,122,133,136,139,145,155,158,"GTGAGGA","CAAA","ATGGGGA","CTCA",2.17574000962847,11,3,10,33,2.88390446837489,4.3472094664745,7.88344135053247,101,"ENSG00000079974.19"
"12358","ENSG00000137948.19_20354",20346,20354,9,"ENSG00000137948.19",1,2,"UMVVVVVVV",1,7,0.786749482401656,110,116,133,136,142,148,157,160,"ATGTTGC","TTGA","TTATTGA","CTGA",2.42762151111697,17,6,9,41,2.76159694676467,4.73643508855279,7.88343301815941,101,"ENSG00000079974.19"
"30155","ENSG00000203865.13_14193",14185,14193,9,"ENSG00000203865.13",1,6,"VVVVUMVVV",1,7,0.792546583850932,116,122,133,136,143,149,157,160,"AGGAAGA","GGGA","GTGTGGA","CTGA",2.36492542862245,11,7,8,35,3.08659389029706,4.71319085361169,7.88337718901541,101,"ENSG00000079974.19"
"7594","ENSG00000115020.17_70150",70142,70150,9,"ENSG00000115020.17",1,2,"VMVVVVVVV",0,8,0.884057971014493,115,121,133,136,179,185,217,220,"GTGAAGA","AAGA","ATGTTGT","CTGA",2.44408213147951,12,43,32,96,1.09458228696637,4.34711579087411,7.88334767493208,101,"ENSG00000079974.19"
"1514","ENSG00000058668.16_111138",111130,111138,9,"ENSG00000058668.16",0,NA,"VVVVUUVVV",2,7,0.812008281573499,104,110,133,136,142,148,164,167,"ATGAAGG","CTGG","GTGATCC","CTGA",2.47885415687682,23,6,16,54,2.01542541993535,4.63527994977854,7.88331307607254,101,"ENSG00000079974.19"
"39171","ENSG00000253194.2_71975",71967,71975,9,"ENSG00000253194.2",1,8,"VVVVVVVMV",0,8,0.884057971014493,112,118,133,136,144,150,158,161,"CTGATTA","CTCA","ATGACAG","CTGC",2.1718356368932,15,8,8,40,2.90938599097387,4.34707255923213,7.8833044432901,101,"ENSG00000079974.19"
"32242","ENSG00000226465.5_33558",33550,33558,9,"ENSG00000226465.5",1,7,"VVVVVVMVV",0,8,0.885300207039338,90,96,133,136,149,155,205,208,"ATGATCA","CAAA","GTGAATA","CTGA",2.50007329590269,37,13,50,109,0.700971877080244,4.34203179577455,7.8832326239319,101,"ENSG00000079974.19"
"34033","ENSG00000231772.5_246879",246871,246879,9,"ENSG00000231772.5",1,8,"VVVVVVVMV",0,8,0.884057971014493,79,85,96,99,108,114,133,136,"AGCATGA","TTGA","GTGATTT","CTGG",2.2327639418328,11,9,19,48,2.50250234349654,4.34689882226213,7.8831307063201,101,"ENSG00000079974.19"
"26483","ENSG00000184305.16_143077",143069,143077,9,"ENSG00000184305.16",1,2,"UMVVVVVVV",1,7,0.786749482401656,73,79,92,95,104,110,133,136,"ATGATCA","CTGA","TTGATAA","CTGG",2.49592484598219,13,9,23,54,2.30497654503905,4.7361188795634,7.88311680917003,101,"ENSG00000079974.19"
"34647","ENSG00000233723.11_119575",119567,119575,9,"ENSG00000233723.11",1,2,"VMVVVVVVV",0,8,0.884057971014493,114,120,133,136,144,150,165,168,"AAGGTGA","CTGG","GTTAGGA","ATGA",2.1873067700026,13,8,15,45,2.80537572273423,4.34685521402122,7.8830870980792,101,"ENSG00000079974.19"
"38015","ENSG00000249345.8_105373",105365,105373,9,"ENSG00000249345.8",1,7,"VVVVVVMVV",0,8,0.885300207039338,46,52,66,69,81,87,133,136,"ATGCAGA","CTGA","CTGATTA","CTGC",2.34477523855391,14,12,46,81,1.73570047497493,4.34188384966691,7.88308467782426,101,"ENSG00000079974.19"
"40461","ENSG00000256389.2_164356",164348,164356,9,"ENSG00000256389.2",0,NA,"VVVVUVVVV",1,8,0.889855072463768,114,120,133,136,141,147,171,174,"GTAAGGA","CAAA","AAGAGGA","CTGA",2.25798697440124,13,5,24,51,2.24137423735688,4.32365518334128,7.88307547319635,101,"ENSG00000079974.19"
"36652","ENSG00000242512.9_48971",48963,48971,9,"ENSG00000242512.9",0,NA,"VVVVVVUVV",1,8,0.886128364389234,115,121,133,136,186,192,223,226,"ATAAGGT","GTGA","GTGAGGA","CTGA",2.43687908086605,12,50,31,102,1.10824310879882,4.33852591197645,7.88303936953338,101,"ENSG00000079974.19"
"4606","ENSG00000101310.17_3694",3686,3694,9,"ENSG00000101310.17",1,5,"UVVVMUVVV",2,6,0.711387163561077,91,97,133,136,141,147,160,163,"ATGATGA","GTGA","TTGTAGA","CTGA",2.74398160284815,36,5,13,63,1.85664717428694,5.03746446498533,7.88301311922963,101,"ENSG00000079974.19"
"1899","ENSG00000067248.11_51350",51342,51350,9,"ENSG00000067248.11",1,8,"VVVVVVVMV",0,8,0.884057971014493,116,122,133,136,168,174,183,186,"GTGGTGG","CATA","TTAATGA","CTGA",2.30673133864318,11,32,9,61,2.00861964288673,4.34670714179365,7.88293902585162,101,"ENSG00000079974.19"
"45575","ENSG00000285713.1_484899",484891,484899,9,"ENSG00000285713.1",0,NA,"VVVVUVVVV",1,8,0.889855072463768,101,107,133,136,146,152,160,163,"ATGTTGA","CAGG","ATGATGG","ATGA",2.29227098679274,26,10,8,53,2.0121167995927,4.32348084455274,7.88290113440781,101,"ENSG00000079974.19"
"45660","ENSG00000285783.1_257678",257670,257678,9,"ENSG00000285783.1",0,NA,"VVVVUVVVV",1,8,0.889855072463768,101,107,133,136,146,152,160,163,"ATGTTGA","CAGG","ATGATGG","ATGA",2.29227098679274,26,10,8,53,2.0121167995927,4.32348084455274,7.88290113440781,101,"ENSG00000079974.19"
"33417","ENSG00000229670.2_778",770,778,9,"ENSG00000229670.2",0,NA,"VVVVUVVVV",1,8,0.889855072463768,41,47,64,67,100,106,133,136,"ATGATGG","CAGA","CTGAGGA","CGGA",2.44589554517846,17,33,27,86,0.987794649447623,4.32344123765934,7.88286152751441,101,"ENSG00000079974.19"
"36366","ENSG00000240286.1_940",932,940,9,"ENSG00000240286.1",0,NA,"VVVVUVVVV",1,8,0.889855072463768,41,47,64,67,100,106,133,136,"ATGATGG","CAGA","CTGAGGA","CGGA",2.44589554517846,17,33,27,86,0.987794649447623,4.32344123765934,7.88286152751441,101,"ENSG00000079974.19"
"27797","ENSG00000187391.22_283726",283718,283726,9,"ENSG00000187391.22",1,1,"MVVVVVUVV",1,7,0.792132505175983,105,111,133,136,142,148,174,177,"ATGATCA","TAGA","TTGATGA","CTGA",2.59501777887127,22,6,26,63,1.55715964040419,4.71431954155316,7.8828495622571,101,"ENSG00000079974.19"
"34539","ENSG00000233359.2_129442",129434,129442,9,"ENSG00000233359.2",1,2,"UMVVVVVVV",1,7,0.786749482401656,93,99,105,108,113,119,133,136,"GTGATGT","CTGA","ATGAAGT","CTTA",2.47293537961543,6,5,14,34,2.45696812835268,4.73580099811388,7.88279892772051,101,"ENSG00000079974.19"
"27180","ENSG00000185736.16_217775",217767,217775,9,"ENSG00000185736.16",1,2,"VMVVVVUVV",1,7,0.770186335403727,113,119,133,136,148,154,179,182,"ATGATGC","CTCA","TTGCTAA","CTGA",2.58079640322208,14,12,25,60,2.00277506147506,4.80202110407224,7.88276644568714,101,"ENSG00000079974.19"
"24599","ENSG00000177119.17_243572",243564,243572,9,"ENSG00000177119.17",1,8,"VVVVVVVMV",0,8,0.884057971014493,114,120,133,136,138,144,157,160,"ATGCTGA","AGGA","CTGAGTA","ATGA",2.23005204027048,13,2,13,37,2.51883054643972,4.34646103706073,7.8826929211187,101,"ENSG00000079974.19"
"28626","ENSG00000196277.16_244885",244877,244885,9,"ENSG00000196277.16",1,3,"VVMVVVVVV",0,8,0.882815734989648,114,120,133,136,150,156,169,172,"AAGAGGA","CCAA","GCTAGGA","CTGA",2.23004283195814,13,14,13,49,2.53874226753505,4.35142362014733,7.88268656010592,101,"ENSG00000079974.19"
"29367","ENSG00000197852.12_45331",45323,45331,9,"ENSG00000197852.12",1,5,"VVVVMVVVV",0,8,0.886542443064182,115,121,133,136,142,148,192,195,"ATAATCA","CCAA","GTAATAA","CTGA",2.30295006125872,12,6,44,71,1.9930142208925,4.33650365732099,7.88267342957772,101,"ENSG00000079974.19"
"16362","ENSG00000151413.17_134154",134146,134154,9,"ENSG00000151413.17",1,5,"UVVVMVVVV",1,7,0.789233954451346,94,100,107,110,116,122,133,136,"GGGATGT","GTGA","GTGAGAT","CTGA",2.41700249777272,7,6,11,33,2.78957949917831,4.72573237108244,7.88266818888783,101,"ENSG00000079974.19"
"47700","ENSG00000289084.1_3217",3209,3217,9,"ENSG00000289084.1",1,7,"UVVVVVMVV",1,7,0.787991718426501,116,122,133,136,185,191,203,206,"ATGCTGA","CTGT","GTGAGAC","CTGA",2.54833108780094,11,49,12,81,1.9339283015469,4.73070055505495,7.88266742876096,101,"ENSG00000079974.19"
"21541","ENSG00000168256.18_4888",4880,4888,9,"ENSG00000168256.18",1,2,"VMVVVVVVV",0,8,0.884057971014493,112,118,133,136,140,146,193,196,"CTCATTA","CAGA","CTGATTT","CTGA",2.34504604173435,15,4,47,75,1.75200803952034,4.34641207943733,7.8826439634953,101,"ENSG00000079974.19"
"7230","ENSG00000113361.13_48768",48760,48768,9,"ENSG00000113361.13",1,2,"VMVVVVVVV",0,8,0.884057971014493,111,117,133,136,142,148,157,160,"ATGAGGA","GAGA","ATGGGCA","CTGC",2.17980789706,16,6,9,40,2.85344667370478,4.34637483019287,7.88260671425084,101,"ENSG00000079974.19"
"30131","ENSG00000203739.6_17091",17083,17091,9,"ENSG00000203739.6",1,2,"VMVVVVVVV",0,8,0.884057971014493,96,102,133,136,143,149,161,164,"GTGATGC","CTGT","GGGAGGA","CTAA",2.30923658874371,31,7,12,59,1.99009765425228,4.34625206146925,7.88248394552722,101,"ENSG00000079974.19"
"7254","ENSG00000113396.13_226499",226491,226499,9,"ENSG00000113396.13",1,2,"UMVVVUVVV",2,6,0.708902691511387,107,113,133,136,142,148,159,162,"ATGATGA","TTTA","GTGAATA","CTGA",2.65845979349186,20,6,11,46,2.4640621002461,5.04678184754797,7.88239261359351,101,"ENSG00000079974.19"
"46846","ENSG00000287290.1_39606",39598,39606,9,"ENSG00000287290.1",1,8,"VVVVVVVMV",0,8,0.884057971014493,73,79,94,97,106,112,133,136,"ACGATGT","CTGT","GTGATTT","ATGA",2.25958123425751,15,9,21,54,2.32044583769513,4.34608018318629,7.88231206724427,101,"ENSG00000079974.19"
"15062","ENSG00000146938.16_97282",97274,97282,9,"ENSG00000146938.16",1,5,"VVVVMVUVV",1,7,0.772670807453416,77,83,97,100,107,113,133,136,"ATGTTGA","ATGA","ATTTTTA","CTGA",2.50280714202539,14,7,20,50,2.4810605553237,4.7916103755399,7.88229360535357,101,"ENSG00000079974.19"
"20648","ENSG00000165246.15_124406",124398,124406,9,"ENSG00000165246.15",1,5,"VVVVMVUVV",1,7,0.772670807453416,77,83,97,100,107,113,133,136,"ATGTTGA","ATGA","ATTTTTA","CTGA",2.50280714202539,14,7,20,50,2.4810605553237,4.7916103755399,7.88229360535357,101,"ENSG00000079974.19"
"47338","ENSG00000288016.3_200773",200765,200773,9,"ENSG00000288016.3",1,7,"VVVVVVMVV",0,8,0.885300207039338,116,122,133,136,151,157,192,195,"CTTACGA","CAAA","GTGATGA","CTGA",2.36738760430072,11,15,35,70,1.58166838537148,4.34106310351073,7.88226393166808,101,"ENSG00000079974.19"
"14662","ENSG00000145687.17_110405",110397,110405,9,"ENSG00000145687.17",1,2,"UMVVVVVVV",1,7,0.786749482401656,106,112,133,136,146,152,178,181,"AGGATGA","TTGT","ATGATGA","CTGA",2.60947990489361,21,10,26,66,1.54435297962267,4.73522141972835,7.88221934933498,101,"ENSG00000079974.19"
"4703","ENSG00000101745.17_49413",49405,49413,9,"ENSG00000101745.17",0,NA,"UVVVVUVVV",2,7,0.824844720496894,113,119,133,136,174,180,190,193,"ATGAGGA","TGGA","TGGAGGA","CTGA",2.45341969945779,14,38,10,71,1.97489844655056,4.58275744406728,7.88213632605486,101,"ENSG00000079974.19"
"42623","ENSG00000265257.5_82905",82897,82905,9,"ENSG00000265257.5",0,NA,"UVVVVUVVV",2,7,0.824844720496894,113,119,133,136,174,180,190,193,"ATGAGGA","TGGA","TGGAGGA","CTGA",2.45341969945779,14,38,10,71,1.97489844655056,4.58275744406728,7.88213632605486,101,"ENSG00000079974.19"
"27213","ENSG00000185737.13_89379",89371,89379,9,"ENSG00000185737.13",1,2,"UMVVVVVVV",1,7,0.786749482401656,73,79,96,99,106,112,133,136,"CAGATGA","CAGA","CTGAATA","CTGA",2.50874957413054,17,7,21,54,2.21537333202209,4.73509262322309,7.88209055282971,101,"ENSG00000079974.19"
"3496","ENSG00000085276.19_195996",195988,195996,9,"ENSG00000085276.19",0,NA,"VVVVVVUVV",1,8,0.886128364389234,21,27,37,40,85,91,133,136,"GTGATGA","ATGA","GTGTTCA","ATGA",2.46218898801847,10,45,42,106,0.935704902183411,4.33757453890997,7.88208799646691,101,"ENSG00000079974.19"
"30174","ENSG00000203963.12_22284",22276,22284,9,"ENSG00000203963.12",0,NA,"VVUVVVUVV",2,7,0.769772256728778,110,116,133,136,161,167,188,191,"ATGATGA","CTAC","ATGAGGA","CTGA",2.68089863173562,17,25,21,72,1.33921580078476,4.80296833642222,7.88205736333733,101,"ENSG00000079974.19"
"17851","ENSG00000155530.4_12396",12388,12396,9,"ENSG00000155530.4",1,8,"VVUVVVVMV",1,7,0.767701863354037,112,118,133,136,142,148,157,160,"CTGCTGA","CAGA","AATATGA","CTGA",2.44622692445193,15,6,9,39,2.93671406819146,4.81122339113441,7.88203084455056,101,"ENSG00000079974.19"
"24964","ENSG00000178882.15_262743",262735,262743,9,"ENSG00000178882.15",1,6,"VVVVVMUVV",1,7,0.788819875776397,116,122,133,136,144,150,162,165,"GTGAAAA","AGGA","ATGATGA","CTGA",2.39313104609605,11,8,12,40,2.95261791259771,4.72670622164284,7.88198572474843,101,"ENSG00000079974.19"
"12033","ENSG00000136928.7_125589",125581,125589,9,"ENSG00000136928.7",1,2,"VMVVVVVVV",0,8,0.884057971014493,91,97,109,112,114,120,133,136,"CTGCTGG","CTGA","GGGCTGA","CTAA",2.22534848574126,12,2,13,36,2.54708005331408,4.34568415623062,7.88191604028859,101,"ENSG00000079974.19"
"25383","ENSG00000181215.16_202833",202825,202833,9,"ENSG00000181215.16",1,8,"VVVVVVVMV",0,8,0.884057971014493,107,113,133,136,155,161,174,177,"AAAATGT","CAGA","ATGTTTA","CTGA",2.34757416309848,20,19,13,61,1.73220733663322,4.34567543932243,7.88190732338041,101,"ENSG00000079974.19"
"13570","ENSG00000142192.21_212273",212265,212273,9,"ENSG00000142192.21",1,8,"VVVVVVVMV",0,8,0.884057971014493,109,115,133,136,187,193,225,228,"TTGATGA","TTTA","TAGAGGA","CTGA",2.49377547040731,18,51,32,110,0.757487405551158,4.34566430206664,7.88189618612461,101,"ENSG00000079974.19"
"4087","ENSG00000094880.11_4980",4972,4980,9,"ENSG00000094880.11",1,8,"VVVVVUVMV",1,7,0.806211180124224,50,56,63,66,110,116,133,136,"GTGGTGA","ATGA","ATGTTGA","CTGA",2.59724318886969,7,44,17,77,1.31258702770782,4.65688540504311,7.88173012554,101,"ENSG00000079974.19"
"18195","ENSG00000156475.19_355983",355975,355983,9,"ENSG00000156475.19",1,8,"VVVVVVVMV",0,8,0.884057971014493,110,116,133,136,160,166,187,190,"ATCATGG","CTTC","ATGACGA","CTGA",2.40299827168376,17,24,21,71,1.36200110152543,4.34549739485428,7.88172927891226,101,"ENSG00000079974.19"
"43907","ENSG00000275212.3_22593",22585,22593,9,"ENSG00000275212.3",0,NA,"UVVVVUVVV",2,7,0.824844720496894,92,98,107,110,116,122,133,136,"GTGAGGA","CTCA","AGGATGA","CTCA",2.30874304551792,9,6,11,35,2.93749081376803,4.58227777930521,7.88165666129279,101,"ENSG00000079974.19"
"17357","ENSG00000153956.17_204379",204371,204379,9,"ENSG00000153956.17",0,NA,"VVVVVVUVV",1,8,0.886128364389234,58,64,73,76,84,90,133,136,"TTAATGA","TTGA","ATGATGG","TTGA",2.32715130464046,9,8,43,69,1.83403753189268,4.33709489070726,7.8816083482642,101,"ENSG00000079974.19"
"5914","ENSG00000107242.20_90780",90772,90780,9,"ENSG00000107242.20",0,NA,"UVVVVUVVV",2,7,0.824844720496894,41,47,63,66,86,92,133,136,"AAGATTA","CTGA","CTAATGA","CTGA",2.57942676047607,16,20,41,86,1.13273301656129,4.58222785493378,7.88160673692135,101,"ENSG00000079974.19"
"39811","ENSG00000254252.1_158",150,158,9,"ENSG00000254252.1",1,8,"VVVVVVVMV",0,8,0.884057971014493,103,109,133,136,146,152,170,173,"GTGAGGA","ATGC","AGGAATA","CTGA",2.34437212427709,24,10,18,61,1.75226221377298,4.34535242723839,7.88158431129636,101,"ENSG00000079974.19"
"32990","ENSG00000228422.5_18878",18870,18878,9,"ENSG00000228422.5",1,8,"VVVVVVVMV",0,8,0.884057971014493,112,118,133,136,177,183,195,198,"TTAATCA","CAGA","TTGTTTA","CTGA",2.32617587922886,15,41,12,77,1.8735695791074,4.34535219349162,7.88158407754959,101,"ENSG00000079974.19"
"5306","ENSG00000104313.20_56382",56374,56382,9,"ENSG00000104313.20",1,7,"VVVVVVMVV",0,8,0.885300207039338,83,89,105,108,114,120,133,136,"ATCATGG","CCGA","TGGAAGA","CTGT",2.19176279273082,16,6,13,44,2.74952189876665,4.34031846257636,7.88151929073371,101,"ENSG00000079974.19"
"16568","ENSG00000151789.13_922679",922671,922679,9,"ENSG00000151789.13",0,NA,"VVVVVVUVV",1,8,0.886128364389234,83,89,133,136,171,177,192,195,"ATTATGT","TTGT","TTGATGA","CTGA",2.47657844530064,44,35,15,103,0.837411612444449,4.33698364527884,7.88149710283577,101,"ENSG00000079974.19"
"23506","ENSG00000173077.16_309855",309847,309855,9,"ENSG00000173077.16",1,5,"UVVVMVVVV",1,7,0.789233954451346,116,122,133,136,148,154,167,170,"CAGATGG","CTGG","ATGATGC","CTGA",2.43482496978571,11,12,13,45,2.66580334278561,4.72449245200592,7.8814282698113,101,"ENSG00000079974.19"
"28992","ENSG00000196876.19_7051",7043,7051,9,"ENSG00000196876.19",0,NA,"VVVVVUUVV",2,7,0.808281573498965,75,81,99,102,115,121,133,136,"TTGATGG","CTGG","ATCTGGA","CTGA",2.44112217648429,18,13,12,52,2.31884957010788,4.64824935333412,7.88137564732998,101,"ENSG00000079974.19"
"43938","ENSG00000275688.4_16500",16492,16500,9,"ENSG00000275688.4",1,2,"VMVVVVVVV",0,8,0.884057971014493,66,72,92,95,114,120,133,136,"ATGCAGC","CTGA","GAGCTCA","CTGA",2.34724013666101,20,19,13,61,1.73220733663322,4.34511872859332,7.88135061265129,101,"ENSG00000079974.19"
"43982","ENSG00000276409.5_1883",1875,1883,9,"ENSG00000276409.5",1,2,"VMVVVVVVV",0,8,0.884057971014493,66,72,92,95,114,120,133,136,"ATGCAGC","CTGA","GAGCTCA","CTGA",2.34724013666101,20,19,13,61,1.73220733663322,4.34511872859332,7.88135061265129,101,"ENSG00000079974.19"
"18560","ENSG00000157654.19_589554",589546,589554,9,"ENSG00000157654.19",1,5,"UVVVMVVVV",1,7,0.789233954451346,55,61,78,81,87,93,133,136,"ATGAGGT","CTGA","TAGAGGA","CTGA",2.5706830904652,17,6,40,72,1.75926739302464,4.72428866569816,7.88122448350354,101,"ENSG00000079974.19"
"11514","ENSG00000135250.17_203714",203706,203714,9,"ENSG00000135250.17",0,NA,"VVVVUVVVV",1,8,0.889855072463768,67,73,94,97,109,115,133,136,"ATGATGT","CAGA","AGGCAGA","CTAA",2.32132793265213,21,12,18,60,1.81169125717822,4.32180270204811,7.88122299190318,101,"ENSG00000079974.19"
"8457","ENSG00000118965.16_77933",77925,77933,9,"ENSG00000118965.16",1,8,"VVVVVUVMV",1,7,0.806211180124224,112,118,133,136,171,177,189,192,"GTGAGGA","ATGA","GTGGAAA","CTGA",2.51069489260236,15,35,12,71,1.88741819608003,4.65634603669061,7.8811907571875,101,"ENSG00000079974.19"
"16669","ENSG00000152061.24_263941",263933,263941,9,"ENSG00000152061.24",0,NA,"VVVVUUVVV",2,7,0.812008281573499,115,121,133,136,142,148,190,193,"CTGATGT","CTCA","TTATTGA","CTGA",2.48021901523071,12,6,42,69,1.99764454234412,4.63310949430387,7.88114262059787,101,"ENSG00000079974.19"
"13047","ENSG00000139971.15_295273",295265,295273,9,"ENSG00000139971.15",0,NA,"VVVVVVUVV",1,8,0.886128364389234,87,93,104,107,113,119,133,136,"GAGATGT","GTGA","ATCAAGA","CTGT",2.17249925972017,11,6,14,40,2.86308628654337,4.33660367116946,7.88111712872639,101,"ENSG00000079974.19"
"17089","ENSG00000153094.24_28205",28197,28205,9,"ENSG00000153094.24",1,7,"VVVVVVMVV",0,8,0.885300207039338,94,100,133,136,173,179,191,194,"AAGATGA","CCTA","GTTTTGA","CTGA",2.45565287406921,33,37,12,91,0.98849371328875,4.33987821843753,7.88107904659488,101,"ENSG00000079974.19"
"16334","ENSG00000151332.20_6444",6436,6444,9,"ENSG00000151332.20",1,1,"MVUVVVVVV",1,7,0.789648033126294,81,87,98,101,107,113,133,136,"ATGAAGG","GTGA","TTGATCT","CTGA",2.4615901782549,11,6,20,46,2.47913190750884,4.7224332739687,7.88102540647388,101,"ENSG00000079974.19"
"18105","ENSG00000156113.24_736241",736233,736241,9,"ENSG00000156113.24",1,8,"VVVVVUVMV",1,7,0.806211180124224,97,103,133,136,138,144,159,162,"ATGATGC","TTGG","GTGATGC","CTGA",2.58582327380355,30,2,15,56,1.38589326890875,4.65617877356644,7.88102349406334,101,"ENSG00000079974.19"
"15018","ENSG00000146592.17_430610",430602,430610,9,"ENSG00000146592.17",1,2,"VMVVVVUVV",1,7,0.770186335403727,62,68,76,79,83,89,133,136,"ATGATGA","CTGA","AAGATGA","CTGT",2.64346042471042,8,4,44,65,1.57791390685612,4.8002458512314,7.88099119284631,101,"ENSG00000079974.19"
"31845","ENSG00000224976.2_49326",49318,49326,9,"ENSG00000224976.2",1,8,"VVVUVVVMV",1,7,0.764803312629399,86,92,106,109,116,122,133,136,"CTGAGAA","CTGA","AGGAGGA","CTGA",2.44698723511797,14,7,11,41,2.97383677531519,4.82177125235874,7.88098450287634,101,"ENSG00000079974.19"
"1909","ENSG00000067646.12_29245",29237,29245,9,"ENSG00000067646.12",1,2,"VMVUVVVVV",1,7,0.764803312629399,61,67,80,83,92,98,133,136,"GTTATGG","CTGA","ATGATTA","CTGA",2.59316140637815,13,9,35,66,1.99922361310955,4.8217415805743,7.8809548310919,101,"ENSG00000079974.19"
"26491","ENSG00000184305.16_385947",385939,385947,9,"ENSG00000184305.16",1,2,"VMVVUVVVV",1,7,0.773913043478261,69,75,91,94,106,112,133,136,"GTGATGT","CTGT","AGGAAGA","CTGA",2.56154419505074,16,12,21,58,2.06402870061076,4.78524750023726,7.8808996741503,101,"ENSG00000079974.19"
"40658","ENSG00000257261.7_63086",63078,63086,9,"ENSG00000257261.7",1,8,"UVVVVVVMV",1,7,0.786749482401656,47,53,67,70,80,86,133,136,"GTGGTGA","CTGA","GACAGGA","CTGA",2.56023324400618,14,10,47,80,1.86689578111524,4.73377935195578,7.8807772815624,101,"ENSG00000079974.19"
"31263","ENSG00000221866.10_10637",10629,10637,9,"ENSG00000221866.10",1,7,"VVVVVVMVV",0,8,0.885300207039338,90,96,133,136,147,153,170,173,"TGGATGA","GTCA","CTGTGGA","CTGA",2.37315831563174,37,11,17,74,1.53699771030149,4.33951328696161,7.88071411511896,101,"ENSG00000079974.19"
"40311","ENSG00000255502.6_42528",42520,42528,9,"ENSG00000255502.6",1,8,"VVVVVVVMV",0,8,0.884057971014493,66,72,93,96,115,121,133,136,"CTGAAGA","CTGA","TTGGAGA","CTGG",2.35308375374316,21,19,12,61,1.6905833892497,4.34445210355102,7.88068398760899,101,"ENSG00000079974.19"
"32338","ENSG00000226792.8_57142",57134,57142,9,"ENSG00000226792.8",1,7,"VVVVVVMVV",0,8,0.885300207039338,54,60,72,75,78,84,133,136,"AAGATGA","CTGT","GTGTTTA","CTGT",2.34806416218998,12,3,49,73,1.70406908160056,4.33945754071677,7.88065836887412,101,"ENSG00000079974.19"
"32742","ENSG00000227704.3_11066",11058,11066,9,"ENSG00000227704.3",1,1,"MVVVVUVVV",1,7,0.82815734989648,110,116,133,136,164,170,181,184,"CTGTTGA","CTGT","GAGCTGA","CTGA",2.46868438702465,17,28,11,65,1.81411288566132,4.56800219978975,7.88063159937567,101,"ENSG00000079974.19"
"9253","ENSG00000123453.19_62624",62616,62624,9,"ENSG00000123453.19",1,5,"VVVVMVVVV",0,8,0.886542443064182,116,122,133,136,143,149,202,205,"ATCGTGC","CTGT","CTGAGAA","CTGA",2.30421285171023,11,7,53,80,1.97597282703003,4.33434795960788,7.88051773186461,101,"ENSG00000079974.19"
"33006","ENSG00000228495.3_228579",228571,228579,9,"ENSG00000228495.3",1,7,"VVVVVVMVV",0,8,0.885300207039338,115,121,133,136,179,185,220,223,"ATGATCT","CAGT","GTGTTGA","CTGA",2.44498442225496,12,43,35,99,1.05725909005476,4.3392888096053,7.88048963776265,101,"ENSG00000079974.19"
"36736","ENSG00000242808.12_438513",438505,438513,9,"ENSG00000242808.12",1,2,"VMUVVVVVV",1,7,0.767701863354037,86,92,133,136,154,160,168,171,"ATGATGG","GTGA","GAGATGA","CTGA",2.68271481824421,41,18,8,76,1.35392035595715,4.80967145272964,7.88047890614579,101,"ENSG00000079974.19"
"37254","ENSG00000246339.6_10727",10719,10727,9,"ENSG00000246339.6",1,8,"VVVVVVUMV",1,7,0.770186335403727,91,97,133,136,144,150,161,164,"AGGATGA","CAGA","GTGAGTT","CTGA",2.58306227559347,36,8,11,64,1.9784766988863,4.79972296737736,7.88046830899227,101,"ENSG00000079974.19"
"18751","ENSG00000158321.19_780577",780569,780577,9,"ENSG00000158321.19",1,7,"VVVVVVMVV",0,8,0.885300207039338,110,116,133,136,141,147,157,160,"GTGATGG","ATAA","ATGATTC","CTAA",2.19695513822445,17,5,10,41,2.71060051602179,4.3392420260462,7.88044285420355,101,"ENSG00000079974.19"
"9670","ENSG00000126070.20_97187",97179,97187,9,"ENSG00000126070.20",1,7,"VVVVVVMVV",0,8,0.885300207039338,112,118,133,136,152,158,202,205,"ATAATGT","CAGG","GTGTTGC","CTGA",2.39243872213822,15,16,44,84,1.40722500985681,4.33920412269458,7.88040495085193,101,"ENSG00000079974.19"
"18303","ENSG00000156959.9_43792",43784,43792,9,"ENSG00000156959.9",1,7,"VVVVVVMVV",0,8,0.885300207039338,100,106,133,136,139,145,159,162,"ATGAAGA","TTGA","CTGAGAA","CTGC",2.35225504612895,27,3,14,53,1.67504951174792,4.33918745481856,7.88038828297591,101,"ENSG00000079974.19"
"30027","ENSG00000198952.8_14535",14527,14535,9,"ENSG00000198952.8",1,8,"VVVVVVVMV",0,8,0.884057971014493,89,95,133,136,146,152,166,169,"CTGAAGA","GTGA","GTGAGGA","CTGC",2.3406102407612,38,10,14,71,1.77254862565662,4.34415422434948,7.88038610840745,101,"ENSG00000079974.19"
"26220","ENSG00000183715.14_1021892",1021884,1021892,9,"ENSG00000183715.14",0,NA,"VVVVVUUVV",2,7,0.808281573498965,87,93,106,109,112,118,133,136,"ATGGTGG","ATGA","AAGAAGC","CTGA",2.40634514103357,13,3,15,40,2.54671263256553,4.64725339319733,7.88037968719319,101,"ENSG00000079974.19"
"42907","ENSG00000267320.5_51874",51866,51874,9,"ENSG00000267320.5",1,8,"VVVVVVVMV",0,8,0.884057971014493,113,119,133,136,146,152,163,166,"GTGCAGA","CAGT","GGCAGGA","CTGA",2.17795395009261,14,10,11,44,2.85658025701803,4.34406831440886,7.88030019846683,101,"ENSG00000079974.19"
"15016","ENSG00000146592.17_425208",425200,425208,9,"ENSG00000146592.17",1,5,"VVVVMVVVV",0,8,0.886542443064182,82,88,98,101,112,118,133,136,"TTGAGGA","CAGA","CAGATAA","CTGG",2.21383019506552,10,11,15,45,2.57752100538807,4.33409724312288,7.88026701537961,101,"ENSG00000079974.19"
"30161","ENSG00000203875.13_2385",2377,2385,9,"ENSG00000203875.13",1,7,"VVVVVUMVV",1,7,0.807453416149068,114,120,133,136,145,151,164,167,"AAGATGG","TTGC","ATGTTTA","CTGA",2.35916681199004,13,9,13,44,2.87402150436547,4.65045006274144,7.88026372733771,101,"ENSG00000079974.19"
"43387","ENSG00000271793.2_2186",2178,2186,9,"ENSG00000271793.2",1,7,"VVVVVUMVV",1,7,0.807453416149068,114,120,133,136,145,151,164,167,"AAGATGG","TTGC","ATGTTTA","CTGA",2.35916681199004,13,9,13,44,2.87402150436547,4.65045006274144,7.88026372733771,101,"ENSG00000079974.19"
"24822","ENSG00000178075.20_12803",12795,12803,9,"ENSG00000178075.20",1,1,"MVVUVVVVV",1,7,0.786749482401656,88,94,133,136,150,156,167,170,"ATGATGG","GTTA","GTGAAGA","CTGA",2.59833305303094,39,14,11,73,1.61064988661057,4.73321756003754,7.88021548964417,101,"ENSG00000079974.19"
"11433","ENSG00000134909.19_46316",46308,46316,9,"ENSG00000134909.19",0,NA,"UVVVVVUVV",2,7,0.788819875776397,93,99,109,112,114,120,133,136,"ATGATGA","CTTA","GTGTACA","TTGA",2.45540467301066,10,2,13,34,2.53037476663067,4.72493481334211,7.8802143164477,101,"ENSG00000079974.19"
"223","ENSG00000006715.16_150737",150729,150737,9,"ENSG00000006715.16",1,2,"VMVVVVVVV",0,8,0.884057971014493,111,117,133,136,151,157,175,178,"AGGAGGA","CAAA","AAGATTA","CTGA",2.30220898178265,16,15,18,58,2.02776239781024,4.3439555690903,7.88018745314827,101,"ENSG00000079974.19"
"32291","ENSG00000226674.11_244743",244735,244743,9,"ENSG00000226674.11",1,5,"VVVVMVVVV",0,8,0.886542443064182,108,114,133,136,141,147,187,190,"TTGAGCA","CTGG","GTGAAGT","CTGA",2.3710837077933,19,5,40,73,1.52876679124565,4.33399787746691,7.88016764972364,101,"ENSG00000079974.19"
"9891","ENSG00000128000.17_22156",22148,22156,9,"ENSG00000128000.17",1,1,"MVVVVVUVV",1,7,0.792132505175983,93,99,133,136,144,150,164,167,"CTGATGA","CTTT","ATTATGA","CTGA",2.54646150573058,34,8,14,65,1.87009887822687,4.71162722910769,7.88015724981162,101,"ENSG00000079974.19"
"34852","ENSG00000234279.2_132655",132647,132655,9,"ENSG00000234279.2",1,8,"VVVVVVVMV",0,8,0.884057971014493,72,78,95,98,100,106,133,136,"AGGAAGA","CTTA","GTCAAAA","CTGA",2.38372003674747,17,2,27,55,1.4838303012721,4.34382430323048,7.88005618728845,101,"ENSG00000079974.19"
"33726","ENSG00000230960.3_90945",90937,90945,9,"ENSG00000230960.3",1,2,"VMVVVVVVV",0,8,0.884057971014493,112,118,133,136,140,146,193,196,"CTGAACA","CGGA","GGGAGGA","CTGA",2.34348913705241,15,4,47,75,1.75200803952034,4.34381723830076,7.88004912235873,101,"ENSG00000079974.19"
"30020","ENSG00000198947.18_980516",980508,980516,9,"ENSG00000198947.18",1,8,"UVVVVVVMV",1,7,0.786749482401656,114,120,133,136,139,145,170,173,"ATGGTGA","CTTA","TTCAAGA","CTGA",2.54427764799316,13,3,25,50,1.9703123562739,4.73304083572374,7.88003876533036,101,"ENSG00000079974.19"
"18610","ENSG00000157837.16_133597",133589,133597,9,"ENSG00000157837.16",1,7,"VVVUVVMVV",1,7,0.766045548654244,99,105,133,136,145,151,169,172,"TTGATGA","TTGA","GAGATCA","CTGA",2.63981264102599,28,9,18,64,1.66460384754782,4.81583869693027,7.88002089154725,101,"ENSG00000079974.19"
"24520","ENSG00000176769.9_90366",90358,90366,9,"ENSG00000176769.9",1,2,"VMVVVUVVV",1,7,0.806211180124223,111,117,133,136,146,152,164,167,"TTGGAGA","TTGA","TTGATGG","CTGA",2.38856363045932,16,10,12,47,2.696939157786,4.65517417354537,7.88001889404226,101,"ENSG00000079974.19"
"15230","ENSG00000147459.18_151634",151626,151634,9,"ENSG00000147459.18",1,7,"VVVVVUMVV",1,7,0.807453416149068,86,92,104,107,116,122,133,136,"CAGATGA","CTGA","TTGCTGC","TTGA",2.34600085438675,12,9,11,41,2.96068183600898,4.65017188298016,7.87998554757643,101,"ENSG00000079974.19"
"23272","ENSG00000172456.18_481425",481417,481425,9,"ENSG00000172456.18",1,8,"VVVVVVVMV",0,8,0.884057971014493,65,71,92,95,109,115,133,136,"GTCCTGC","CTGA","CTGATTC","CTGA",2.35595549457361,21,14,18,62,1.6686423643938,4.34375308205447,7.87998496611244,101,"ENSG00000079974.19"
"28915","ENSG00000196689.13_15858",15850,15858,9,"ENSG00000196689.13",1,8,"VVVVVVVMV",0,8,0.884057971014493,67,73,87,90,94,100,133,136,"ATCCTGA","CTGA","GTGATAG","CTTA",2.3246074027324,14,4,33,60,1.87755546356525,4.34373453711198,7.87996642116995,101,"ENSG00000079974.19"
"42400","ENSG00000262304.2_42696",42688,42696,9,"ENSG00000262304.2",1,8,"VVVVVVVMV",0,8,0.884057971014493,67,73,87,90,94,100,133,136,"ATCCTGA","CTGA","GTGATAG","CTTA",2.3246074027324,14,4,33,60,1.87755546356525,4.34373453711198,7.87996642116995,101,"ENSG00000079974.19"
"28113","ENSG00000188158.17_123831",123823,123831,9,"ENSG00000188158.17",1,3,"VVMVVVVVV",0,8,0.882815734989648,114,120,133,136,144,150,198,201,"AGTATGC","ATGC","TTGATGA","CTGA",2.31129465283952,13,8,48,78,1.98608632854626,4.34867933686911,7.8799422768277,101,"ENSG00000079974.19"
"36931","ENSG00000243701.8_24793",24785,24793,9,"ENSG00000243701.8",1,8,"VVVVVUVMV",1,7,0.806211180124224,82,88,103,106,114,120,133,136,"CTAATAA","CAGA","TTCATGA","CTGA",2.36982836640199,15,8,13,45,2.82126418526281,4.65502999031902,7.87987471081592,101,"ENSG00000079974.19"
"5635","ENSG00000106034.18_55859",55851,55859,9,"ENSG00000106034.18",1,8,"VVVVVVVMV",0,8,0.884057971014493,113,119,133,136,179,185,204,207,"CTTATGA","GTGT","ATGTTTA","CTGA",2.37470626100138,14,43,19,85,1.54319439964837,4.34364236824772,7.87987425230569,101,"ENSG00000079974.19"
"13787","ENSG00000143473.14_428497",428489,428497,9,"ENSG00000143473.14",1,7,"VVVVVUMVV",1,7,0.807453416149068,70,76,93,96,107,113,133,136,"ATGCTGA","AAGA","ATCAGGA","CTGA",2.47406225936675,17,11,20,57,2.10648272536243,4.65005778028519,7.87987144488146,101,"ENSG00000079974.19"
"30101","ENSG00000203705.11_9856",9848,9856,9,"ENSG00000203705.11",1,8,"VVVVVVVMV",0,8,0.884057971014493,116,122,133,136,143,149,180,183,"GTGATAT","TTGC","CTGTTTA","CTGA",2.29385258942238,11,7,31,58,2.08193823768388,4.34357220845827,7.87980409251624,101,"ENSG00000079974.19"
"27512","ENSG00000186409.19_52265",52257,52265,9,"ENSG00000186409.19",0,NA,"VVUVVVVVV",1,8,0.883643892339545,80,86,102,105,111,117,133,136,"GAGATGA","ATGA","ATTAGCA","TTGA",2.21968366874997,16,6,16,47,2.58300164463542,4.3452231924088,7.87979876176698,101,"ENSG00000079974.19"
"4013","ENSG00000091844.8_33351",33343,33351,9,"ENSG00000091844.8",1,1,"MVVVVUVVV",1,7,0.82815734989648,80,86,100,103,113,119,133,136,"ATGAGGA","CTTA","TTGAACA","GTGA",2.32986376292274,14,10,14,47,2.73623958476761,4.5671661677298,7.87979556731572,101,"ENSG00000079974.19"
"43188","ENSG00000269821.1_67705",67697,67705,9,"ENSG00000269821.1",1,2,"VMVVVUVVV",1,7,0.806211180124223,79,85,99,102,111,117,133,136,"AGGAAGA","TTGT","ATGATCA","CTGA",2.39173364328267,14,9,16,48,2.67484456445411,4.65493387991798,7.87977860041487,101,"ENSG00000079974.19"
"43776","ENSG00000273540.5_441287",441279,441287,9,"ENSG00000273540.5",1,1,"MVVVUVVVV",1,7,0.795859213250517,69,75,87,90,96,102,133,136,"ATGGAGA","GTGA","CTGAAGA","CTGA",2.50413461930851,12,6,31,58,2.09110507583487,4.69633396780624,7.87977082080831,101,"ENSG00000079974.19"
"21815","ENSG00000169071.15_233345",233337,233345,9,"ENSG00000169071.15",1,6,"VVVUVMVVV",1,7,0.78343685300207,85,91,133,136,144,150,158,161,"GTGCTGA","CTGA","ATTTTTA","CTGA",2.55249301436228,42,8,8,67,1.96744503431708,4.7460162825164,7.87976369452469,101,"ENSG00000079974.19"
"12133","ENSG00000137449.17_12905",12897,12905,9,"ENSG00000137449.17",0,NA,"UVVUVVVVV",2,7,0.78343685300207,80,86,98,101,113,119,133,136,"TTGATGC","CTCA","GTAAAAA","CTGA",2.45158505311051,12,12,14,47,2.64013717591965,4.74600938249742,7.8797567945057,101,"ENSG00000079974.19"
"25295","ENSG00000180488.16_26333",26325,26333,9,"ENSG00000180488.16",1,5,"UVVVMVVVV",1,7,0.789233954451346,112,118,133,136,145,151,162,165,"ATGATAA","TTTA","GTACTGT","CTGA",2.40551265307339,15,9,11,44,2.85453102015611,4.72282051016135,7.87975632796673,101,"ENSG00000079974.19"
"34050","ENSG00000231824.4_44596",44588,44596,9,"ENSG00000231824.4",1,8,"VVUVVVVMV",1,7,0.767701863354037,95,101,109,112,116,122,133,136,"ATGAGGA","CTGC","ACTATCA","CTGA",2.46362618645167,8,4,11,32,2.8112293139677,4.80885097257803,7.87965842599418,101,"ENSG00000079974.19"
"29499","ENSG00000198104.4_7654",7646,7654,9,"ENSG00000198104.4",1,8,"VVVVVUVMV",1,7,0.806211180124224,95,101,133,136,149,155,163,166,"CTGATGT","CTGC","GTGCTCA","CTGA",2.53823124758196,32,13,8,62,1.69767158965785,4.65480331005105,7.87964803054795,101,"ENSG00000079974.19"
"29502","ENSG00000198104.4_7994",7986,7994,9,"ENSG00000198104.4",1,8,"VVVVVUVMV",1,7,0.806211180124224,95,101,133,136,149,155,163,166,"CTGATGT","CTGC","GTGCTCA","CTGA",2.53823124758196,32,13,8,62,1.69767158965785,4.65480331005105,7.87964803054795,101,"ENSG00000079974.19"
"34132","ENSG00000231918.1_902964",902956,902964,9,"ENSG00000231918.1",1,5,"VVVVMVVVV",0,8,0.886542443064182,84,90,133,136,150,156,177,180,"ATGAGGA","TTAA","CTTATGC","CTGA",2.43749502165107,43,14,21,87,1.08363183310969,4.33339966102921,7.87956943328593,101,"ENSG00000079974.19"
"26242","ENSG00000183715.14_692227",692219,692227,9,"ENSG00000183715.14",1,3,"UVMVVVVVV",1,7,0.785507246376811,111,117,133,136,150,156,167,170,"CTGAATA","CTGA","GTGACTA","CTGA",2.47542003232944,16,14,11,50,2.44723331944775,4.73750838374433,7.87953736925158,101,"ENSG00000079974.19"
"2380","ENSG00000073921.18_28803",28795,28803,9,"ENSG00000073921.18",0,NA,"UVVVVVUVV",2,7,0.788819875776397,113,119,133,136,146,152,164,167,"GTAATGA","CTGT","ATGATGA","ATGA",2.41061614575687,14,10,12,45,2.82619369388064,4.72424199973161,7.8795215028372,101,"ENSG00000079974.19"
"39164","ENSG00000253171.1_35313",35305,35313,9,"ENSG00000253171.1",1,3,"VVMVVVVVV",0,8,0.882815734989648,111,117,133,136,174,180,223,226,"TTGGTGA","GTGA","AAGAAGA","CTGA",2.47991615242949,16,38,43,106,0.860200742397669,4.34824377298191,7.8795067129405,101,"ENSG00000079974.19"
"2603","ENSG00000076554.16_103515",103507,103515,9,"ENSG00000076554.16",1,2,"VMVVVVVVV",0,8,0.884057971014493,111,117,133,136,163,169,179,182,"AGGATAA","CAAA","TTGAACA","CTGA",2.31711694064129,16,27,10,62,1.92544722297399,4.34322337347899,7.87945525753696,101,"ENSG00000079974.19"
"19695","ENSG00000163618.18_149589",149581,149589,9,"ENSG00000163618.18",1,3,"VVMVVUVVV",1,7,0.804968944099379,78,84,102,105,115,121,133,136,"GTGATAA","CTGA","GTGATCC","ATGA",2.41716433516892,18,10,12,49,2.5238215176267,4.65956260468821,7.87943838108573,101,"ENSG00000079974.19"
"30206","ENSG00000204131.10_154656",154648,154656,9,"ENSG00000204131.10",1,1,"MVVUVVVVV",1,7,0.786749482401656,114,120,133,136,143,149,158,161,"GGGATGT","CTTT","GTGATGG","CTGA",2.38133819611186,13,7,9,38,3.05406504890221,4.73241325574532,7.87941118535194,101,"ENSG00000079974.19"
"21186","ENSG00000166780.11_52474",52466,52474,9,"ENSG00000166780.11",1,3,"VVMVVVVVV",0,8,0.882815734989648,67,73,84,87,111,117,133,136,"ATAATAA","CTGA","GTGTTAA","CAGA",2.32688669694117,11,24,16,60,1.87999351338765,4.34814287324886,7.87940581320745,101,"ENSG00000079974.19"
"42215","ENSG00000261130.5_91195",91187,91195,9,"ENSG00000261130.5",1,3,"VVMVVVVVV",0,8,0.882815734989648,67,73,84,87,111,117,133,136,"ATAATAA","CTGA","GTGTTAA","CAGA",2.32688669694117,11,24,16,60,1.87999351338765,4.34814287324886,7.87940581320745,101,"ENSG00000079974.19"
"6194","ENSG00000108588.15_8179",8171,8179,9,"ENSG00000108588.15",0,NA,"VVVVVVUVV",1,8,0.886128364389234,114,120,133,136,182,188,199,202,"AGGATCA","GTGA","TTGATGA","CTTA",2.30340895255647,13,46,11,79,1.98349448098447,4.33488854117356,7.8794019987305,101,"ENSG00000079974.19"
"9659","ENSG00000126005.17_54115",54107,54115,9,"ENSG00000126005.17",1,8,"VVVUVVVMV",1,7,0.764803312629399,75,81,94,97,105,111,133,136,"ATGATGA","ATGA","GTGTTGT","ATGA",2.53357123829981,13,8,22,52,2.39013655326646,4.82015286881629,7.87936611933389,101,"ENSG00000079974.19"
"21998","ENSG00000169554.23_10873",10865,10873,9,"ENSG00000169554.23",1,8,"VVVVVVVMV",0,8,0.884057971014493,94,100,133,136,149,155,177,180,"ATGATAA","AAGA","ATGAGCC","CTGA",2.43803377322358,33,13,22,77,1.11869418301732,4.34306316779363,7.8792950518516,101,"ENSG00000079974.19"
"27349","ENSG00000186047.11_157104",157096,157104,9,"ENSG00000186047.11",1,7,"VVVVVVMVV",0,8,0.885300207039338,112,118,133,136,149,155,164,167,"ATAACGG","GGGA","CTGCAGA","CTGA",2.21186992737314,15,13,9,46,2.60637481336811,4.33804358229727,7.87924441045462,101,"ENSG00000079974.19"
"17410","ENSG00000154124.6_1101",1093,1101,9,"ENSG00000154124.6",1,8,"VVVVVVVMV",0,8,0.884057971014493,108,114,133,136,145,151,160,163,"AAGATGT","CTGC","TTGAAAA","CTAA",2.2262834612219,19,9,9,46,2.5301595398526,4.34301232033298,7.87924420439095,101,"ENSG00000079974.19"
"35676","ENSG00000236718.5_321",313,321,9,"ENSG00000236718.5",1,2,"VMVVVVVVV",0,8,0.884057971014493,106,112,133,136,149,155,203,206,"CTGGTGA","CCTA","ATGAAGA","CTGA",2.439605874794,21,13,48,91,1.10784097545212,4.34297003518636,7.87920191924433,101,"ENSG00000079974.19"
"48065","ENSG00000290344.1_1433",1425,1433,9,"ENSG00000290344.1",1,2,"VMVVVVVVV",0,8,0.884057971014493,106,112,133,136,149,155,203,206,"CTGGTGA","CCTA","ATGAAGA","CTGA",2.439605874794,21,13,48,91,1.10784097545212,4.34297003518636,7.87920191924433,101,"ENSG00000079974.19"
"17147","ENSG00000153253.20_112141",112133,112141,9,"ENSG00000153253.20",0,NA,"VVVVUVVVV",1,8,0.889855072463768,26,32,47,50,101,107,133,136,"ATTATCA","CTTA","GTAATGC","CTGA",2.41987041392423,15,51,26,101,1.14655722690983,4.31975666326784,7.87917695312291,101,"ENSG00000079974.19"
"36710","ENSG00000242759.10_197178",197170,197178,9,"ENSG00000242759.10",1,8,"VVVVVUVMV",1,7,0.806211180124224,113,119,133,136,143,149,162,165,"ATAATCA","ATGA","ATCGTGG","CTGA",2.35827417839839,14,7,13,43,2.89540137332488,4.65430730732853,7.87915202782543,101,"ENSG00000079974.19"
"42240","ENSG00000261261.3_23110",23102,23110,9,"ENSG00000261261.3",1,8,"VVVUVVVMV",1,7,0.764803312629399,37,43,57,60,73,79,133,136,"CTGATGA","CTGC","CTGAAGC","CTGA",2.6431052200018,14,13,54,90,1.65899940088349,4.81992521689054,7.87913846740813,101,"ENSG00000079974.19"
"18260","ENSG00000156687.11_52559",52551,52559,9,"ENSG00000156687.11",1,8,"VVUVVVVMV",1,7,0.767701863354037,110,116,133,136,144,150,160,163,"AGGATGA","TAGA","TTTAAGA","CTGA",2.47244099646077,17,8,10,44,2.7503009857581,4.80831024054081,7.87911769395696,101,"ENSG00000079974.19"
"16416","ENSG00000151474.23_381130",381122,381130,9,"ENSG00000151474.23",0,NA,"VVVUVVVVV",1,8,0.880745341614907,88,94,133,136,172,178,194,197,"ATTATTA","GTGA","GAGATGA","CTGA",2.49711143080596,39,36,16,100,0.777064532596958,4.35611851782585,7.87909988428547,101,"ENSG00000079974.19"
"661","ENSG00000023171.20_127718",127710,127718,9,"ENSG00000023171.20",0,NA,"VVVUVVVVV",1,8,0.880745341614907,109,115,133,136,142,148,171,174,"ATGAGAA","ATTA","ATGCTTA","CTGA",2.31231580481951,18,6,23,56,2.00885673171291,4.35607385762742,7.87905522408705,101,"ENSG00000079974.19"
"42446","ENSG00000263300.1_16244",16236,16244,9,"ENSG00000263300.1",1,1,"MVVVVVUVV",1,7,0.792132505175983,76,82,96,99,110,116,133,136,"TTGATGA","CAGT","ATTTGGA","CTGA",2.45174922560807,14,11,17,51,2.49708326756014,4.71051952623682,7.87904954694075,101,"ENSG00000079974.19"
"15678","ENSG00000149179.14_162209",162201,162209,9,"ENSG00000149179.14",0,NA,"VVVVVVUVV",1,8,0.886128364389234,111,117,133,136,181,187,199,202,"ATTATGT","ATGG","GTGTTTT","CTGA",2.33093186004204,16,45,12,82,1.7985763190138,4.33453051315684,7.87904397071378,101,"ENSG00000079974.19"
"33093","ENSG00000228659.1_23411",23403,23411,9,"ENSG00000228659.1",0,NA,"UVVVVVUVV",2,7,0.788819875776397,75,81,94,97,111,117,133,136,"ATGATCT","CTGT","CTGAAAA","CTGA",2.47766885888183,13,14,16,52,2.37723020157233,4.72375564852946,7.87903515163505,101,"ENSG00000079974.19"
"30688","ENSG00000206561.14_10776",10768,10776,9,"ENSG00000206561.14",0,NA,"VVUVVVVVV",1,8,0.883643892339545,112,118,133,136,165,171,187,190,"ATTATGT","TGGA","GTGAGTC","CTGA",2.34727883514605,15,29,16,69,1.72928173280805,4.3444518251121,7.87902739447028,101,"ENSG00000079974.19"
"21490","ENSG00000168014.18_65113",65105,65113,9,"ENSG00000168014.18",1,2,"VMVVVVVVV",0,8,0.884057971014493,54,60,103,106,112,118,133,136,"ATGGTGA","TTGA","AAGAGGA","CAGA",2.33545488117798,43,6,15,73,1.80137354614989,4.34276818850077,7.87900007255874,101,"ENSG00000079974.19"
"17326","ENSG00000153930.13_150508",150500,150508,9,"ENSG00000153930.13",1,2,"UMVVVUVVV",2,6,0.708902691511387,71,77,89,92,106,112,133,136,"TTGATGA","CTGG","GTGATGC","CTGA",2.71353760973688,12,14,21,56,2.08326217592912,5.04337822687708,7.87898899292263,101,"ENSG00000079974.19"
"40560","ENSG00000256995.8_98859",98851,98859,9,"ENSG00000256995.8",0,NA,"VVVVVVUVV",1,8,0.886128364389234,112,118,133,136,172,178,187,190,"GTGATGA","TTTA","GGGATAA","CAGA",2.31201118220667,15,36,9,69,1.9244599110256,4.33446694810085,7.87898040565779,101,"ENSG00000079974.19"
"4577","ENSG00000101134.12_140840",140832,140840,9,"ENSG00000101134.12",1,6,"VVVVVMUVV",1,7,0.788819875776397,116,122,133,136,139,145,155,158,"TTGAAAA","CTGG","GTGCTGA","CTGA",2.40162799149125,11,3,10,33,2.88390446837489,4.72368943624581,7.8789689393514,101,"ENSG00000079974.19"
"11546","ENSG00000135299.17_116892",116884,116892,9,"ENSG00000135299.17",1,5,"UVVVMVVVV",1,7,0.789233954451346,80,86,101,104,115,121,133,136,"AGGCTGA","CTGG","TTGAGGC","CTGA",2.4273878286043,15,11,12,47,2.70540742960106,4.72199823840743,7.87893405621281,101,"ENSG00000079974.19"
"11461","ENSG00000135046.14_8424",8416,8424,9,"ENSG00000135046.14",1,8,"VVVVVUVMV",1,7,0.806211180124224,110,116,133,136,146,152,194,197,"TGGATGA","CTTA","TTGAGGA","CTGA",2.54235629959819,17,10,42,78,1.66692550096493,4.65399187457154,7.87883659506844,101,"ENSG00000079974.19"
"2510","ENSG00000075391.18_293778",293770,293778,9,"ENSG00000075391.18",1,7,"VVVVVVMVV",0,8,0.885300207039338,86,92,133,136,148,154,165,168,"ATGTGGC","TTGA","TTAATGA","CTGA",2.3396650604885,41,12,11,73,1.75261784149348,4.33759622785421,7.87879705601156,101,"ENSG00000079974.19"
"16826","ENSG00000152377.14_92789",92781,92789,9,"ENSG00000152377.14",1,6,"UVVVVMUVV",2,6,0.691511387163561,116,122,133,136,139,145,155,158,"GTGATGA","GTGA","GTCAGGG","CTGA",2.63501489310736,11,3,10,33,2.88390446837489,5.11266760560599,7.87871315426024,101,"ENSG00000079974.19"
"10168","ENSG00000129636.13_258591",258583,258591,9,"ENSG00000129636.13",1,2,"VMVVVUVVV",1,7,0.806211180124223,110,116,133,136,146,152,170,173,"ATAATCA","TTGA","ATGATCC","CTGA",2.44881863007785,17,10,18,54,2.28934977564819,4.65370182737513,7.87854654787203,101,"ENSG00000079974.19"
"35341","ENSG00000235749.3_97815",97807,97815,9,"ENSG00000235749.3",1,8,"VVVVVVVMV",0,8,0.884057971014493,96,102,133,136,150,156,165,168,"ATGTTGC","CTGG","GCAATAA","CTGA",2.35734310144948,31,14,9,63,1.65347514108467,4.34227395435364,7.87850583841161,101,"ENSG00000079974.19"
"5841","ENSG00000107020.10_21683",21675,21683,9,"ENSG00000107020.10",1,8,"VVVVVVVMV",0,8,0.884057971014493,102,108,133,136,149,155,173,176,"AGGAGGA","CCCA","ATGTTGA","CTGA",2.38006495884857,25,13,18,65,1.50196143024175,4.34226528897473,7.8784971730327,101,"ENSG00000079974.19"
"30609","ENSG00000206052.11_255739",255731,255739,9,"ENSG00000206052.11",1,3,"VVMVVVVVV",0,8,0.882815734989648,115,121,133,136,144,150,199,202,"ATATTGA","AAGA","TTTAAGA","CTGA",2.30982020105932,12,8,49,78,1.98984840413315,4.34716243613216,7.87842537609075,101,"ENSG00000079974.19"
"22462","ENSG00000170613.4_2550",2542,2550,9,"ENSG00000170613.4",0,NA,"UVVVVUVVV",2,7,0.824844720496894,85,91,105,108,116,122,133,136,"ATTATAA","CTCC","GAGAGGA","CTGA",2.30433391022154,14,8,11,42,2.95372298478643,4.5789872632325,7.87836614522008,101,"ENSG00000079974.19"
"9333","ENSG00000124181.15_5858",5850,5858,9,"ENSG00000124181.15",1,6,"UVVVVMVVV",1,7,0.805383022774327,90,96,133,136,160,166,180,183,"TTGATGA","CTTA","GTGCTTA","CTGA",2.64071431710758,37,24,14,84,1.02237522307424,4.65678433428119,7.8783164253785,101,"ENSG00000079974.19"
"15086","ENSG00000147041.12_113928",113920,113928,9,"ENSG00000147041.12",1,2,"VMVVVVVVV",0,8,0.884057971014493,90,96,103,106,116,122,133,136,"CTGATGC","CAGA","AGGTAGA","ATGA",2.21906124903511,7,10,11,37,2.57458614788258,4.34208195202915,7.87831383608712,101,"ENSG00000079974.19"
"38530","ENSG00000250349.3_771151",771143,771151,9,"ENSG00000250349.3",1,2,"VMVVVVVVV",0,8,0.884057971014493,90,96,103,106,116,122,133,136,"CTGATGC","CAGA","AGGTAGA","ATGA",2.21906124903511,7,10,11,37,2.57458614788258,4.34208195202915,7.87831383608712,101,"ENSG00000079974.19"
"38431","ENSG00000250149.2_57907",57899,57907,9,"ENSG00000250149.2",1,8,"VVVVVVUMV",1,7,0.770186335403727,20,26,36,39,82,88,133,136,"ATTATGA","CTGA","GTGCAGA","CTGA",2.73890165747964,10,43,45,107,0.93072658109246,4.79751774107251,7.87826308268742,101,"ENSG00000079974.19"
"39838","ENSG00000254303.1_54695",54687,54695,9,"ENSG00000254303.1",1,6,"VVVVVMUVV",1,7,0.788819875776397,112,118,133,136,149,155,163,166,"ATGATGC","GTTA","TGGCTGA","CTGA",2.44530556585781,15,13,8,45,2.58980815956807,4.7229613163217,7.87824081942729,101,"ENSG00000079974.19"
"24579","ENSG00000177098.9_14731",14723,14731,9,"ENSG00000177098.9",1,8,"VVVVVUVMV",1,7,0.806211180124224,116,122,133,136,186,192,204,207,"TTCATGA","CAGA","CTGTGGA","CTGA",2.50197583011482,11,50,12,82,1.93370337732507,4.65338556118931,7.8782302816862,101,"ENSG00000079974.19"
"38462","ENSG00000250266.3_20462",20454,20462,9,"ENSG00000250266.3",1,8,"VVVVVVVMV",0,8,0.884057971014493,17,23,63,66,73,79,133,136,"ATAATGC","TTGA","GTGAGAC","CTGA",2.45481572853481,40,7,54,110,1.0024380339853,4.34196905605434,7.87820094011232,101,"ENSG00000079974.19"
"12249","ENSG00000137757.11_8777",8769,8777,9,"ENSG00000137757.11",1,2,"VMVVVVVVV",0,8,0.884057971014493,89,95,133,136,141,147,177,180,"ATGCTGA","ATGC","CTAAAGA","CTGA",2.44599825199266,38,5,30,82,1.06108374711821,4.34193469010066,7.87816657415863,101,"ENSG00000079974.19"
"41947","ENSG00000260126.2_18798",18790,18798,9,"ENSG00000260126.2",1,3,"VVMVVVVVV",0,8,0.882815734989648,113,119,133,136,151,157,211,214,"TTTATGA","GTGT","GGGAAGA","CTGA",2.38032367931949,14,15,54,92,1.51868161231518,4.34687653527794,7.87813947523653,101,"ENSG00000079974.19"
"14173","ENSG00000144468.17_9950",9942,9950,9,"ENSG00000144468.17",1,8,"VVVVVVVMV",0,8,0.884057971014493,114,120,133,136,179,185,198,201,"ATAATTT","CTGG","CTGACAA","CTGA",2.31730741032434,13,43,13,78,1.91873242896472,4.34186212444842,7.87809400850639,101,"ENSG00000079974.19"
"15118","ENSG00000147099.21_178969",178961,178969,9,"ENSG00000147099.21",1,2,"VMVVVVVVV",0,8,0.884057971014493,103,109,133,136,156,162,170,173,"ATTATTA","TTGT","CTGATGT","CTGA",2.38368734495541,24,20,8,61,1.47615505574088,4.34185100552757,7.87808288958554,101,"ENSG00000079974.19"
"45397","ENSG00000285547.1_178711",178703,178711,9,"ENSG00000285547.1",1,2,"VMVVVVVVV",0,8,0.884057971014493,103,109,133,136,156,162,170,173,"ATTATTA","TTGT","CTGATGT","CTGA",2.38368734495541,24,20,8,61,1.47615505574088,4.34185100552757,7.87808288958554,101,"ENSG00000079974.19"
"439","ENSG00000011454.18_128616",128608,128616,9,"ENSG00000011454.18",1,3,"VVMVVVVVV",0,8,0.882815734989648,112,118,133,136,147,153,185,188,"AAGATGG","GTGT","TTGGTGG","CTGA",2.33284220437241,15,11,32,67,1.8349362815133,4.34680441099902,7.87806735095761,101,"ENSG00000079974.19"
"20180","ENSG00000164411.12_36406",36398,36406,9,"ENSG00000164411.12",1,8,"VVVUVVVMV",1,7,0.764803312629399,53,59,65,68,77,83,133,136,"ATGAAGA","CAGA","GTGCTGA","CTGA",2.67524497743787,6,9,50,74,1.44043352697334,4.81885001080645,7.87806326132405,101,"ENSG00000079974.19"
"22169","ENSG00000169933.17_29448",29440,29448,9,"ENSG00000169933.17",1,2,"UMVVVUVVV",2,6,0.708902691511387,114,120,133,136,163,169,183,186,"ATGATGA","TTGA","GTGAATT","CTGA",2.73228412627271,13,27,14,63,1.95455779911213,5.04244632689921,7.87805709294476,101,"ENSG00000079974.19"
"5082","ENSG00000102984.15_31063",31055,31063,9,"ENSG00000102984.15",0,NA,"UVVUVVVVV",2,7,0.78343685300207,116,122,133,136,149,155,182,185,"GAGATGA","CTAA","TTGTTGA","CTGA",2.56569990193962,11,13,27,60,1.87249901272908,4.74429125641497,7.87803866842325,101,"ENSG00000079974.19"
"11548","ENSG00000135299.17_149761",149753,149761,9,"ENSG00000135299.17",1,1,"MVVVVUVVV",1,7,0.82815734989648,111,117,133,136,159,165,178,181,"GTAATTA","CTCA","ATGAAGA","CTGA",2.44967800977571,16,23,13,61,1.93009170549369,4.56531960933294,7.87794900891886,101,"ENSG00000079974.19"
"22840","ENSG00000171509.16_37941",37933,37941,9,"ENSG00000171509.16",1,8,"VVVVVVVMV",0,8,0.884057971014493,50,56,71,74,82,88,133,136,"GTGATCA","TTGA","GTGATTT","GTGA",2.31950167371101,15,8,45,77,1.90346586115695,4.34170258814092,7.87793447219889,101,"ENSG00000079974.19"
"20866","ENSG00000165914.15_125785",125777,125785,9,"ENSG00000165914.15",1,2,"VMVVVUVVV",1,7,0.806211180124223,110,116,133,136,143,149,159,162,"ATGCTAA","ATGC","ATGATGC","CTGA",2.37675043589852,17,7,10,43,2.76734840728039,4.65308782831763,7.87793254881452,101,"ENSG00000079974.19"
"12659","ENSG00000138760.11_64266",64258,64266,9,"ENSG00000138760.11",1,6,"VVVVUMVVV",1,7,0.792546583850932,116,122,133,136,161,167,182,185,"ATAATGT","CTTA","TTGAAGA","CTGA",2.53726608235201,11,25,15,60,1.91577256559593,4.70771994531899,7.87790628072272,101,"ENSG00000079974.19"
"4939","ENSG00000102466.16_164888",164880,164888,9,"ENSG00000102466.16",1,2,"VMVVVVVVV",0,8,0.884057971014493,116,122,133,136,150,156,171,174,"CTGAAGT","CCAA","CTGGTGC","CTGA",2.24256452796608,11,14,15,49,2.4158946589946,4.34158121135878,7.87781309541675,101,"ENSG00000079974.19"
"4819","ENSG00000101972.20_122927",122919,122927,9,"ENSG00000101972.20",1,8,"UVVVVVVMV",1,7,0.786749482401656,91,97,133,136,144,150,171,174,"ATTATGT","CTGA","ATGTAGA","CTGA",2.62051417154628,36,8,21,74,1.45304531106172,4.73078494700923,7.87778287661586,101,"ENSG00000079974.19"
"26292","ENSG00000183780.13_46264",46256,46264,9,"ENSG00000183780.13",1,5,"VVVVMVVVV",0,8,0.886542443064182,33,39,81,84,98,104,133,136,"TTGTTGG","CTGA","CTGAACA","CTGA",2.48308933271663,42,14,29,94,0.772523247093517,4.33161303296776,7.87778280522449,101,"ENSG00000079974.19"
"27149","ENSG00000185652.12_40654",40646,40654,9,"ENSG00000185652.12",1,8,"VVVVVUVMV",1,7,0.806211180124224,115,121,133,136,141,147,165,168,"ATGCTGA","GTGG","GGGACGT","CTGA",2.40528488139428,12,5,18,44,2.57637255898621,4.65290127540369,7.87774599590058,101,"ENSG00000079974.19"
"18037","ENSG00000156042.19_85157",85149,85157,9,"ENSG00000156042.19",0,NA,"VVVVVUUVV",2,7,0.808281573498965,113,119,133,136,177,183,196,199,"ATGATGT","CACA","ATAAGGA","CTGA",2.50339375243893,14,41,13,77,1.88905325649416,4.64458623485509,7.87771252885095,101,"ENSG00000079974.19"
"36843","ENSG00000243276.6_14734",14726,14734,9,"ENSG00000243276.6",1,8,"VVVVVVVMV",0,8,0.884057971014493,80,86,101,104,112,118,133,136,"ATGGTCA","CTCA","GTGGGGA","ATGA",2.19748622762406,15,8,15,47,2.71598342368375,4.34147290196105,7.87770478601902,101,"ENSG00000079974.19"
"12924","ENSG00000139547.8_2873",2865,2873,9,"ENSG00000139547.8",1,2,"VMVVVUUVV",2,6,0.692339544513457,114,120,133,136,145,151,164,167,"ATGATCT","CTGA","AAGATGA","CTGA",2.63387181950829,13,9,13,44,2.87402150436547,5.10829174193851,7.87764991999234,101,"ENSG00000079974.19"
"46867","ENSG00000287292.1_350603",350595,350603,9,"ENSG00000287292.1",1,2,"VMVVVVVVV",0,8,0.884057971014493,113,119,133,136,145,151,164,167,"ATAATAA","CTGT","ATGTTCA","CTGG",2.17885820542668,14,9,13,45,2.83962813440549,4.34133737597917,7.87756926003714,101,"ENSG00000079974.19"
"19709","ENSG00000163618.18_73558",73550,73558,9,"ENSG00000163618.18",1,1,"MVVVVUVVV",1,7,0.82815734989648,111,117,133,136,141,147,197,200,"ATGATTA","CATA","TTGAGGT","CTGA",2.47317548215155,16,5,50,80,1.77179206325548,4.56490715273311,7.87753655231903,101,"ENSG00000079974.19"
"37329","ENSG00000247199.6_80694",80686,80694,9,"ENSG00000247199.6",1,8,"VVVVVVVMV",0,8,0.884057971014493,102,108,133,136,139,145,154,157,"ATGAGGA","CAGG","GTGAAGA","CTGG",2.32345942394448,25,3,9,46,1.87537702181085,4.34127662869351,7.87750851275148,101,"ENSG00000079974.19"
"46434","ENSG00000286662.2_3866",3858,3866,9,"ENSG00000286662.2",1,8,"VVVVVVUMV",1,7,0.770186335403727,68,74,81,84,91,97,133,136,"TTGATGA","TTGA","CTGGTCA","CTGA",2.62967750589086,7,7,36,59,1.65581543468579,4.79674970182287,7.87749504343778,101,"ENSG00000079974.19"
"38326","ENSG00000249993.1_10144",10136,10144,9,"ENSG00000249993.1",1,8,"VVVVVVVMV",0,8,0.884057971014493,113,119,133,136,178,184,230,233,"ATAATGA","CACA","TTGATCT","CTGA",2.45852265295201,14,42,46,111,0.974842052829488,4.34124826812738,7.87748015218535,101,"ENSG00000079974.19"
"7219","ENSG00000113319.13_225523",225515,225523,9,"ENSG00000113319.13",1,8,"UVVVVVVMV",1,7,0.786749482401656,90,96,105,108,116,122,133,136,"ATTTTGA","ATGA","CTTATAA","CTGA",2.40513785355908,9,8,11,37,2.88752415993942,4.73044412924999,7.87744205885661,101,"ENSG00000079974.19"
"18406","ENSG00000157214.14_65587",65579,65587,9,"ENSG00000157214.14",1,6,"VVVVUMVVV",1,7,0.792546583850932,108,114,133,136,143,149,177,180,"AGGATGA","ATGT","ATGAAGA","CTGA",2.56158748024117,19,7,28,63,1.75133110588598,4.70714524354012,7.87733157894384,101,"ENSG00000079974.19"
"38137","ENSG00000249675.1_103973",103965,103973,9,"ENSG00000249675.1",1,8,"VVVVUVVMV",1,7,0.773913043478261,88,94,133,136,140,146,156,159,"GTGATCA","CTGA","GAGTAGA","CTGA",2.59303921732247,39,4,10,62,1.83977041954396,4.78167463375678,7.87732680766982,101,"ENSG00000079974.19"
"42964","ENSG00000267452.3_87097",87089,87097,9,"ENSG00000267452.3",1,7,"VVVVVVMVV",0,8,0.885300207039338,57,63,79,82,88,94,133,136,"AAGATGA","ATGA","TTGTTCA","CTGT",2.32463855416643,16,6,39,70,1.84660301797306,4.33604834477065,7.877249172928,101,"ENSG00000079974.19"
"27909","ENSG00000187672.15_280814",280806,280814,9,"ENSG00000187672.15",1,2,"VMVUVVVVV",1,7,0.764803312629399,116,122,133,136,144,150,162,165,"AAGATGT","AGGA","ATGATGT","CTGA",2.44789618084972,11,8,12,40,2.95261791259771,4.81798144623229,7.87719469674988,101,"ENSG00000079974.19"
"5663","ENSG00000106070.20_9319",9311,9319,9,"ENSG00000106070.20",1,7,"VVVVVVMVV",0,8,0.885300207039338,80,86,103,106,110,116,133,136,"ATGTTCA","CTGA","GTGCGCA","CTAA",2.25760162808615,17,4,17,47,2.29314669564479,4.33595605405478,7.87715688221212,101,"ENSG00000079974.19"
"21794","ENSG00000168959.15_426102",426094,426102,9,"ENSG00000168959.15",1,8,"VVVVVUVMV",1,7,0.806211180124224,81,87,95,98,112,118,133,136,"ATGATGA","CTGT","GTGAGAT","CTTA",2.46511702006852,8,14,15,46,2.17513472095807,4.65231204702039,7.87715676751728,101,"ENSG00000079974.19"
"44659","ENSG00000283286.2_725",717,725,9,"ENSG00000283286.2",1,8,"VVVVVVVMV",0,8,0.884057971014493,89,95,133,136,165,171,180,183,"ATGAGGA","AAGA","ATGTACA","CTGA",2.44508527382439,38,29,9,85,1.06293418122202,4.34087566834616,7.87710755240413,101,"ENSG00000079974.19"
"4190","ENSG00000099139.14_141741",141733,141741,9,"ENSG00000099139.14",1,2,"VMVVUVVVV",1,7,0.773913043478261,74,80,103,106,112,118,133,136,"ATGATGA","CTGA","GAGAAAA","CTAA",2.55770390926641,23,6,15,53,2.07407225997875,4.78135791377204,7.87701008768508,101,"ENSG00000079974.19"
"44269","ENSG00000280366.1_4154",4146,4154,9,"ENSG00000280366.1",1,2,"VMVVVVVVV",0,8,0.884057971014493,116,122,133,136,140,146,189,192,"ACGTTGG","CAGA","CTGAGAA","CTGA",2.3309090660148,11,4,43,67,1.82369815493282,4.34077298209121,7.87700486614918,101,"ENSG00000079974.19"
"25264","ENSG00000180287.17_209522",209514,209522,9,"ENSG00000180287.17",1,7,"VVVVVVMVV",0,8,0.885300207039338,105,111,133,136,153,159,170,173,"ATAGTGT","ATGA","CTGCAGA","CTGA",2.33883747590549,22,17,11,59,1.7509010244666,4.33578771595914,7.87698854411649,101,"ENSG00000079974.19"
"32144","ENSG00000226113.1_35693",35685,35693,9,"ENSG00000226113.1",1,7,"VVVVVVMVV",0,8,0.885300207039338,105,111,133,136,153,159,170,173,"ATAGTGT","ATGA","CTGCAGA","CTGA",2.33883747590549,22,17,11,59,1.7509010244666,4.33578771595914,7.87698854411649,101,"ENSG00000079974.19"
"44867","ENSG00000283930.1_189247",189239,189247,9,"ENSG00000283930.1",1,7,"VVVVVVMVV",0,8,0.885300207039338,105,111,133,136,153,159,170,173,"ATAGTGT","ATGA","CTGCAGA","CTGA",2.33883747590549,22,17,11,59,1.7509010244666,4.33578771595914,7.87698854411649,101,"ENSG00000079974.19"
"14023","ENSG00000144278.15_332737",332729,332737,9,"ENSG00000144278.15",1,7,"UVVVVVMVV",1,7,0.787991718426501,83,89,103,106,115,121,133,136,"GTGATGG","CTCC","AAGATAA","CTGA",2.40279116908591,14,9,12,44,2.88123422355851,4.72496050436614,7.87692737807214,101,"ENSG00000079974.19"
"9258","ENSG00000123500.10_30843",30835,30843,9,"ENSG00000123500.10",0,NA,"VVUVVVUVV",2,7,0.769772256728778,88,94,102,105,112,118,133,136,"GTGTTGA","CAGA","GAGAGGT","CTGA",2.48968659133476,8,7,15,39,2.59301425950687,4.79773121710132,7.87682024401643,101,"ENSG00000079974.19"
"27832","ENSG00000187398.12_195320",195312,195320,9,"ENSG00000187398.12",1,8,"UVVVVVVMV",1,7,0.786749482401656,54,60,75,78,115,121,133,136,"GTGAAGA","CAGA","ATGCAGA","CTGA",2.55572083526465,15,37,12,73,1.88099215105781,4.72978276320553,7.87678069281215,101,"ENSG00000079974.19"
"13348","ENSG00000141027.23_78501",78493,78501,9,"ENSG00000141027.23",1,8,"VVVVUVVMV",1,7,0.773913043478261,109,115,133,136,145,151,165,168,"ATGATGT","TTTA","GTGAGTT","CTGA",2.49530879404499,18,9,14,50,2.48905424386845,4.7811115510421,7.87676372495515,101,"ENSG00000079974.19"
"24608","ENSG00000177138.17_258743",258735,258743,9,"ENSG00000177138.17",1,1,"MVUVVVVVV",1,7,0.789648033126294,113,119,133,136,148,154,162,165,"GTGAAGA","TTTA","CTGTAGA","CTGA",2.42254074105905,14,12,8,43,2.72228636292583,4.71813949249654,7.87673162500172,101,"ENSG00000079974.19"
"38707","ENSG00000250910.8_189138",189130,189138,9,"ENSG00000250910.8",1,7,"VVVVVVMVV",0,8,0.885300207039338,116,122,133,136,148,154,168,171,"ATTATAT","ATGG","TTGAGAA","CTGA",2.20889688178573,11,12,14,46,2.61612816994928,4.33552684546353,7.87672767362088,101,"ENSG00000079974.19"
"42664","ENSG00000265554.3_22198",22190,22198,9,"ENSG00000265554.3",1,8,"VVVVVVVMV",0,8,0.884057971014493,109,115,133,136,145,151,193,196,"TTAATGA","CTAT","CTGTGGA","CTGA",2.35969715255121,18,9,42,78,1.63065274468338,4.3404917737562,7.87672365781417,101,"ENSG00000079974.19"
"2651","ENSG00000077092.20_786135",786127,786135,9,"ENSG00000077092.20",1,2,"VMVVVUVVV",1,7,0.806211180124223,80,86,101,104,113,119,133,136,"AAAATGT","GTGA","ATAATGA","CTGA",2.38099695933025,15,9,14,47,2.73419034790569,4.65187585252685,7.87672057302374,101,"ENSG00000079974.19"
"22816","ENSG00000171488.15_109095",109087,109095,9,"ENSG00000171488.15",1,8,"VVVVVVVMV",0,8,0.884057971014493,86,92,133,136,144,150,158,161,"ATTATAA","TTTA","GGGCTGA","CTGA",2.30911025649898,41,8,8,66,1.96774867363976,4.3404542625749,7.87668614663288,101,"ENSG00000079974.19"
"43462","ENSG00000271949.1_109027",109019,109027,9,"ENSG00000271949.1",1,8,"VVVVVVVMV",0,8,0.884057971014493,86,92,133,136,144,150,158,161,"ATTATAA","TTTA","GGGCTGA","CTGA",2.30911025649898,41,8,8,66,1.96774867363976,4.3404542625749,7.87668614663288,101,"ENSG00000079974.19"
"5936","ENSG00000107263.19_48499",48491,48499,9,"ENSG00000107263.19",1,8,"VVVVVVVMV",0,8,0.884057971014493,107,113,133,136,144,150,203,206,"AGGATTA","TTGA","ATCAGAA","CTGA",2.38252927924148,20,8,53,90,1.47821707036637,4.34043639966073,7.8766682837187,101,"ENSG00000079974.19"
"10114","ENSG00000129317.15_4399",4391,4399,9,"ENSG00000129317.15",1,8,"VVVVVVVMV",0,8,0.884057971014493,114,120,133,136,140,146,158,161,"AAGATTT","CACA","GTGGGAA","CTGA",2.176570512915,13,4,12,38,2.85126994004647,4.34043500653663,7.8766668905946,101,"ENSG00000079974.19"
"25329","ENSG00000180875.5_21906",21898,21906,9,"ENSG00000180875.5",0,NA,"VVVUVVVVV",1,8,0.880745341614907,33,39,55,58,71,77,133,136,"GTGCTCA","ATGA","TTGAGGT","CTGA",2.38230280520798,16,13,56,94,1.53261746891454,4.35365904257526,7.87664040903489,101,"ENSG00000079974.19"
"33914","ENSG00000231440.1_499",491,499,9,"ENSG00000231440.1",0,NA,"VVVUVVVVV",1,8,0.880745341614907,33,39,55,58,71,77,133,136,"GTGCTCA","ATGA","TTGAGGT","CTGA",2.38230280520798,16,13,56,94,1.53261746891454,4.35365904257526,7.87664040903489,101,"ENSG00000079974.19"
"28185","ENSG00000188396.4_595",587,595,9,"ENSG00000188396.4",1,2,"VMVVVVVVV",0,8,0.884057971014493,107,113,133,136,175,181,190,193,"AAGAAGG","TTGA","CTGGTGA","CTGA",2.37953385924492,20,39,9,77,1.49803564935794,4.34039867774768,7.87663056180565,101,"ENSG00000079974.19"
"28948","ENSG00000196793.14_16842",16834,16842,9,"ENSG00000196793.14",1,8,"VVVVVUVMV",1,7,0.806211180124224,94,100,133,136,144,150,193,196,"ATCAGGA","CTGA","GTGATAA","CTGA",2.6388374635221,33,8,43,93,1.01478221977009,4.65175799414602,7.87660271464291,101,"ENSG00000079974.19"
"6845","ENSG00000112137.19_153727",153719,153727,9,"ENSG00000112137.19",1,5,"VVVVMVVVV",0,8,0.886542443064182,82,88,133,136,159,165,182,185,"CTGATTA","CTCA","AAGAGGA","CTGA",2.46756440137196,45,23,17,94,0.871026280792375,4.33036390581803,7.87653367807476,101,"ENSG00000079974.19"
"38882","ENSG00000251209.10_273993",273985,273993,9,"ENSG00000251209.10",1,3,"VVMVVVVVV",0,8,0.882815734989648,101,107,133,136,141,147,163,166,"CTGATGA","CAGA","ATATGGA","CTCA",2.33360286637202,26,5,16,56,1.82358523732077,4.34523441995023,7.87649735990882,101,"ENSG00000079974.19"
"25557","ENSG00000182162.11_1568",1560,1568,9,"ENSG00000182162.11",1,2,"VMVVVVUVV",1,7,0.770186335403727,91,97,133,136,150,156,168,171,"TGGATGA","CTGA","GTGGGGA","CTGA",2.63940698373038,36,14,12,71,1.58695281321781,4.79574984285508,7.87649518446999,101,"ENSG00000079974.19"
"25558","ENSG00000182162.11_PAR_Y_1568",1560,1568,9,"ENSG00000182162.11_PAR_Y",1,2,"VMVVVVUVV",1,7,0.770186335403727,91,97,133,136,150,156,168,171,"TGGATGA","CTGA","GTGGGGA","CTGA",2.63940698373038,36,14,12,71,1.58695281321781,4.79574984285508,7.87649518446999,101,"ENSG00000079974.19"
"7903","ENSG00000116016.14_23345",23337,23345,9,"ENSG00000116016.14",0,NA,"VVVVUVVVV",1,8,0.889855072463768,92,98,133,136,142,148,158,161,"ATCTTGA","CTGA","CTGTTCA","ATGA",2.29134835069468,35,6,10,60,1.99237284003401,4.31700712783297,7.87642741768804,101,"ENSG00000079974.19"
"36213","ENSG00000238755.3_276928",276920,276928,9,"ENSG00000238755.3",1,2,"VMVVVVVVV",0,8,0.884057971014493,58,64,77,80,92,98,133,136,"CTGTTGT","ATGA","GTTAACA","CTGA",2.33193886063532,13,12,35,69,1.81450669694981,4.34019144196298,7.87642332602095,101,"ENSG00000079974.19"
"13496","ENSG00000141622.14_30614",30606,30614,9,"ENSG00000141622.14",0,NA,"UVVVVVUVV",2,7,0.788819875776397,112,118,133,136,146,152,186,189,"AATATGA","CTGA","ATAAAGA","CTGA",2.55198876099105,15,10,34,68,1.87125012169326,4.72112713207507,7.87640663518066,101,"ENSG00000079974.19"
"12153","ENSG00000137486.17_37819",37811,37819,9,"ENSG00000137486.17",0,NA,"VVVVUVVVV",1,8,0.889855072463768,58,64,83,86,101,107,133,136,"GTGATCA","CTGA","CTGTTAA","CTCA",2.38511812658888,19,15,26,69,1.36701416678278,4.31695041934383,7.87637070919891,101,"ENSG00000079974.19"
"42320","ENSG00000261645.7_270460",270452,270460,9,"ENSG00000261645.7",1,6,"VVVVVMUVV",1,7,0.788819875776397,116,122,133,136,142,148,156,159,"ATGAGGA","CTCT","ATTTTAA","CTGA",2.36680964212261,11,6,8,34,3.10547079730643,4.72105043619762,7.87632993930321,101,"ENSG00000079974.19"
"41873","ENSG00000259899.1_44638",44630,44638,9,"ENSG00000259899.1",1,5,"VVUVMVVVV",1,7,0.770186335403727,71,77,91,94,104,110,133,136,"AGGATGA","ATGA","GGGGGGA","CTGA",2.54422625167844,14,10,23,56,2.22080677515034,4.79557877991832,7.87632412153323,101,"ENSG00000079974.19"
"28056","ENSG00000188107.15_1145024",1145016,1145024,9,"ENSG00000188107.15",1,7,"UVVVVVMVV",1,7,0.787991718426501,114,120,133,136,145,151,163,166,"ATGATAA","AAGA","ATCCTAA","CTGA",2.39707093538574,13,9,12,43,2.91664667958975,4.72427989554034,7.87624676924635,101,"ENSG00000079974.19"
"31127","ENSG00000215869.4_58630",58622,58630,9,"ENSG00000215869.4",1,8,"VVVVVVVMV",0,8,0.884057971014493,87,93,133,136,143,149,173,176,"TTAATGA","TAGA","GTGCTCA","CTGA",2.40670745681668,40,7,24,80,1.31527664426738,4.33999825576131,7.87623013981928,101,"ENSG00000079974.19"
"11488","ENSG00000135097.7_3034",3026,3034,9,"ENSG00000135097.7",1,8,"VVVVVVVMV",0,8,0.884057971014493,86,92,101,104,114,120,133,136,"CTGGTGA","ATGA","ATGTGGG","CTGG",2.20229329234296,9,10,13,41,2.67776738158711,4.33993066596838,7.87616255002635,101,"ENSG00000079974.19"
"8968","ENSG00000121904.19_423335",423327,423335,9,"ENSG00000121904.19",0,NA,"VVVVUVVVV",1,8,0.889855072463768,112,118,133,136,152,158,192,195,"GTTATCA","ATAA","CTGATGA","CTGA",2.37073303053732,15,16,34,74,1.4617034857248,4.31664758899341,7.87606787884848,101,"ENSG00000079974.19"
"31855","ENSG00000225076.1_5389",5381,5389,9,"ENSG00000225076.1",1,7,"VVVVVVMVV",0,8,0.885300207039338,19,25,40,43,86,92,133,136,"ATGATGT","TTGA","CTGAAGA","CTGT",2.46132665964437,15,43,41,108,0.930339184212872,4.3347958954605,7.87599672361785,101,"ENSG00000079974.19"
"44579","ENSG00000283098.2_221553",221545,221553,9,"ENSG00000283098.2",0,NA,"VVVVUVVVV",1,8,0.889855072463768,115,121,133,136,148,154,164,167,"ATATTGT","TGGA","TTTCTGA","CTGA",2.17316241102963,12,12,10,43,2.77836774096739,4.31652928695789,7.87594957681297,101,"ENSG00000079974.19"
"22227","ENSG00000169967.17_74245",74237,74245,9,"ENSG00000169967.17",1,8,"VVVUVVVMV",1,7,0.764803312629399,108,114,133,136,145,151,169,172,"ATGAAGA","CCAA","TTGATGA","CTGA",2.56545983638317,19,9,18,55,2.1635125557618,4.81664453291241,7.87585778343001,101,"ENSG00000079974.19"
"8237","ENSG00000117569.19_35093",35085,35093,9,"ENSG00000117569.19",1,2,"VMVVVVVVV",0,8,0.884057971014493,111,117,133,136,181,187,198,201,"ATTATGG","GTGG","CAGAGGA","CTGA",2.32982151665339,16,45,11,81,1.82628773733867,4.33960779542366,7.87583967948163,101,"ENSG00000079974.19"
"135","ENSG00000005339.15_47653",47645,47653,9,"ENSG00000005339.15",1,8,"VVVVVVVMV",0,8,0.884057971014493,112,118,133,136,186,192,213,216,"ATGATCT","TTCA","AGGATGA","CTGA",2.39815540456393,15,50,21,95,1.37067761682003,4.33959507847823,7.8758269625362,101,"ENSG00000079974.19"
"3367","ENSG00000083067.25_430531",430523,430531,9,"ENSG00000083067.25",1,8,"UVVVVVVMV",1,7,0.786749482401656,81,87,103,106,115,121,133,136,"ATGATGA","ATGA","AGGGAGA","CTGG",2.42467886378243,16,9,12,46,2.75065253458755,4.72879457328427,7.8757925028909,101,"ENSG00000079974.19"
"2794","ENSG00000078304.20_50254",50246,50254,9,"ENSG00000078304.20",1,8,"VVVVVVVMV",0,8,0.884057971014493,115,121,133,136,183,189,204,207,"TTGTGGA","GTGA","TTGGAGA","CTGA",2.33087113440512,12,47,15,83,1.81894731260055,4.33952205215867,7.87575393621664,101,"ENSG00000079974.19"
"14733","ENSG00000145794.17_114879",114871,114879,9,"ENSG00000145794.17",1,2,"VMVVVVVVV",0,8,0.884057971014493,47,53,67,70,101,107,133,136,"ATAATGA","TTGA","ATGTTGA","CTGT",2.41730015475204,14,31,26,80,1.24274265705319,4.33951925551669,7.87575113957466,101,"ENSG00000079974.19"
"14485","ENSG00000145103.15_33288",33280,33288,9,"ENSG00000145103.15",1,8,"VVVVVVVMV",0,8,0.884057971014493,113,119,133,136,146,152,160,163,"CCGAGGA","CAAA","GAGTGGA","CTGA",2.17370334797311,14,10,8,41,2.86643073501561,4.33944659704242,7.8756784811004,101,"ENSG00000079974.19"
"29733","ENSG00000198648.12_231875",231867,231875,9,"ENSG00000198648.12",1,1,"MVVVVUVVV",1,7,0.82815734989648,93,99,133,136,144,150,165,168,"ATTATGT","CAGA","TTTAAGA","CTGA",2.4653635187032,34,8,15,66,1.81584109248876,4.56289947096086,7.87552887054678,101,"ENSG00000079974.19"
"38469","ENSG00000250303.6_26610",26602,26610,9,"ENSG00000250303.6",1,7,"UVVVVVMVV",1,7,0.787991718426501,48,54,63,66,85,91,133,136,"ATGTTGA","CAGA","ATGATAA","CTGA",2.65819721999447,9,19,42,79,1.17272885177498,4.72351091293453,7.87547778664053,101,"ENSG00000079974.19"
"15437","ENSG00000148219.18_889250",889242,889250,9,"ENSG00000148219.18",0,NA,"VVVUVVVVV",1,8,0.880745341614907,90,96,107,110,114,120,133,136,"ATGGTGA","ATTA","AGGGTGA","TTGA",2.18990849054007,11,4,13,37,2.81054232819474,4.35248306628213,7.87546443274176,101,"ENSG00000079974.19"
"27979","ENSG00000187772.8_61088",61080,61088,9,"ENSG00000187772.8",0,NA,"VVVVUVVVV",1,8,0.889855072463768,86,92,133,136,140,146,163,166,"ATGATGA","CATA","GTACTGA","CTGC",2.35916449314056,41,4,17,71,1.53636120847335,4.31603112401926,7.87545141387434,101,"ENSG00000079974.19"
"26282","ENSG00000183780.13_105542",105534,105542,9,"ENSG00000183780.13",1,7,"VVVVVVMVV",0,8,0.885300207039338,106,112,133,136,181,187,195,198,"ATGATGA","TTTA","ATGTTGT","TTGA",2.39165839387797,21,45,8,83,1.39258049727291,4.33424244744817,7.87544327560552,101,"ENSG00000079974.19"
"25191","ENSG00000179915.25_317555",317547,317555,9,"ENSG00000179915.25",1,7,"VVVVVVMVV",0,8,0.885300207039338,113,119,133,136,144,150,175,178,"CTCATCA","CTGT","GTTATTT","CTGA",2.26699108513066,14,8,25,56,2.22358893636574,4.3342157093092,7.87541653746655,101,"ENSG00000079974.19"
"25651","ENSG00000182348.7_354968",354960,354968,9,"ENSG00000182348.7",1,1,"MVVVVVUVV",1,7,0.792132505175983,109,115,133,136,181,187,197,200,"TTGATTA","CTGA","ATAATCA","CTGA",2.57378371225848,18,45,10,82,1.66894935140079,4.706876858281,7.87540687898494,101,"ENSG00000079974.19"
"44683","ENSG00000283380.1_155960",155952,155960,9,"ENSG00000283380.1",1,1,"MVVVVUVVV",1,7,0.82815734989648,114,120,133,136,173,179,188,191,"AAGATGA","TTAA","GTGCTAT","CTGA",2.43651154876393,13,37,9,68,2.00767780647373,4.56277203289164,7.87540143247757,101,"ENSG00000079974.19"
"36822","ENSG00000243176.8_161384",161376,161384,9,"ENSG00000243176.8",1,2,"VMVVVVVVV",0,8,0.884057971014493,106,112,133,136,156,162,176,179,"ATCATGG","AAGA","TTGAATA","CTGA",2.36959925940489,21,20,14,64,1.55916001221606,4.33912210206217,7.87535398612014,101,"ENSG00000079974.19"
"32904","ENSG00000228262.11_159013",159005,159013,9,"ENSG00000228262.11",1,3,"VVMVVVVVV",0,8,0.882815734989648,110,116,133,136,143,149,164,167,"GTGCTGT","ATGA","GTGAAGC","GTGA",2.22036137097583,17,7,15,48,2.57392178479345,4.34408273115808,7.87534567111667,101,"ENSG00000079974.19"
"19075","ENSG00000160799.12_51830",51822,51830,9,"ENSG00000160799.12",1,2,"VMVVVVVVV",0,8,0.884057971014493,81,87,104,107,114,120,133,136,"CTGATTA","CAGA","GAGAAGC","CTCA",2.20171617198533,17,7,13,46,2.67822954676562,4.33908434000028,7.87531622405825,101,"ENSG00000079974.19"
"27013","ENSG00000185420.19_499335",499327,499335,9,"ENSG00000185420.19",1,2,"VMVVVVVVV",0,8,0.884057971014493,95,101,133,136,147,153,166,169,"ACTATGA","CAGC","ATGGGGA","CTGA",2.33679538044907,32,11,13,65,1.77759746163541,4.33905833282397,7.87529021688194,101,"ENSG00000079974.19"
"13667","ENSG00000143153.14_126610",126602,126610,9,"ENSG00000143153.14",1,8,"VVVVVVVMV",0,8,0.884057971014493,112,118,133,136,182,188,198,201,"ATGAAGA","CTGC","CAGAAGA","GTGA",2.316612678558,15,46,10,80,1.91155729600369,4.33891045493092,7.87514233898889,101,"ENSG00000079974.19"
"8246","ENSG00000117598.14_301718",301710,301718,9,"ENSG00000117598.14",1,7,"VVVVVVMVV",0,8,0.885300207039338,102,108,133,136,147,153,166,169,"TTGAGGG","CTAG","GTGCTGA","CTGA",2.3114513151059,25,11,13,58,1.92595651141274,4.33390798636301,7.87510881452036,101,"ENSG00000079974.19"
"5854","ENSG00000107077.19_389897",389889,389897,9,"ENSG00000107077.19",1,2,"VMVVVUVVV",1,7,0.806211180124223,109,115,133,136,152,158,169,172,"GGGATGA","CAGA","AAGATTT","CTGA",2.46902799828511,18,16,11,54,2.14085000782938,4.65025916576586,7.87510388626276,101,"ENSG00000079974.19"
"34691","ENSG00000233797.4_63617",63609,63617,9,"ENSG00000233797.4",1,8,"VVVVVVVMV",0,8,0.884057971014493,115,121,133,136,137,143,154,157,"GAGAAGA","TTCA","ATGCAGT","CTGA",2.22531987937749,12,1,11,33,2.51988511000256,4.33883774312979,7.87506962718776,101,"ENSG00000079974.19"
"15576","ENSG00000148737.18_185507",185499,185507,9,"ENSG00000148737.18",1,2,"VMVVVVVVV",0,8,0.884057971014493,107,113,133,136,164,170,183,186,"ATAATCA","CTGC","GTGGCTA","CTGA",2.38087051926366,20,28,13,70,1.4828504681794,4.33883014915095,7.87506203320892,101,"ENSG00000079974.19"
"32800","ENSG00000227945.1_52243",52235,52243,9,"ENSG00000227945.1",1,2,"UMVVVVVVV",1,7,0.786749482401656,93,99,133,136,146,152,162,165,"ATGATGT","ATCA","AGGATGA","CTGA",2.55028407987525,34,10,10,63,1.91028546809079,4.72804483348146,7.87504276308808,101,"ENSG00000079974.19"
"4881","ENSG00000102221.14_73035",73027,73035,9,"ENSG00000102221.14",0,NA,"VVUVVVVVV",1,8,0.883643892339545,113,119,133,136,141,147,166,169,"ATCATCA","GTAA","ATTAGCA","CTGA",2.23326297925801,14,5,19,47,2.47341181075845,4.34045791811963,7.87503348747781,101,"ENSG00000079974.19"
"14537","ENSG00000145349.20_276593",276585,276593,9,"ENSG00000145349.20",1,7,"VVVVVVMVV",0,8,0.885300207039338,33,39,46,49,96,102,133,136,"ATGAAGA","CTGA","GTGAGGG","CTGG",2.49213549514582,7,47,31,94,0.720653638359955,4.33372256816635,7.8749233963237,101,"ENSG00000079974.19"
"27719","ENSG00000187239.19_120609",120601,120609,9,"ENSG00000187239.19",1,6,"VVVVVMUVV",1,7,0.788819875776397,77,83,98,101,108,114,133,136,"AGGATGA","CTGA","CTGAGCA","CTGT",2.45895375855238,15,7,19,50,2.48551652562052,4.7196353956591,7.87491489876469,101,"ENSG00000079974.19"
"47361","ENSG00000288036.1_14811",14803,14811,9,"ENSG00000288036.1",1,2,"VMVVVVVVV",0,8,0.884057971014493,110,116,133,136,143,149,185,188,"ATGATGT","ATTA","ATGATTA","ATGA",2.33333577093696,17,7,36,69,1.79909254148068,4.33866608693177,7.87489797098974,101,"ENSG00000079974.19"
"18793","ENSG00000158528.12_210343",210335,210343,9,"ENSG00000158528.12",1,7,"VVVVVVMVV",0,8,0.885300207039338,108,114,133,136,150,156,176,179,"CTGAGTA","ATGA","AGGAAGA","CTGA",2.34281100439164,19,14,20,62,1.71601925801669,4.33368982182357,7.87489064998092,101,"ENSG00000079974.19"
"20647","ENSG00000165246.15_103503",103495,103503,9,"ENSG00000165246.15",1,8,"VVVVVVVMV",0,8,0.884057971014493,112,118,133,136,163,169,183,186,"ATGATTT","CTTC","TTGGTGG","CTGA",2.32292331316843,15,27,14,65,1.86842404209924,4.33864486580553,7.8748767498635,101,"ENSG00000079974.19"
"40418","ENSG00000256041.1_297",289,297,9,"ENSG00000256041.1",1,8,"VVVVVVVMV",0,8,0.884057971014493,99,105,133,136,145,151,160,163,"AAGATGA","CTGT","CAGATAA","CAGA",2.29904751161083,28,9,9,55,2.02721611345761,4.33854988104911,7.87478176510708,101,"ENSG00000079974.19"
"46651","ENSG00000286980.1_52904",52896,52904,9,"ENSG00000286980.1",0,NA,"VVVVUVVVV",1,8,0.889855072463768,77,83,103,106,112,118,133,136,"ATTATTA","CTGA","ATGTCTA","CTCA",2.24537765614314,20,6,15,50,2.29202884224703,4.31530330413365,7.87472359398872,101,"ENSG00000079974.19"
"20865","ENSG00000165914.15_10064",10056,10064,9,"ENSG00000165914.15",1,5,"VVVVMUVVV",1,7,0.808695652173913,111,117,133,136,146,152,163,166,"GTGATAG","CTGC","GTGGGGT","CTGA",2.37502362393855,16,10,11,46,2.72599856804707,4.63987234857602,7.87465495727167,101,"ENSG00000079974.19"
"33328","ENSG00000229358.3_166669",166661,166669,9,"ENSG00000229358.3",1,8,"VVVVVVVMV",0,8,0.884057971014493,104,110,133,136,153,159,173,176,"CTGAAGA","CTGT","ATGATGA","GTGA",2.3671570962055,23,17,14,63,1.5724723107243,4.33837990469025,7.87461178874822,101,"ENSG00000079974.19"
"37301","ENSG00000246876.7_149309",149301,149309,9,"ENSG00000246876.7",1,2,"VMVVVVVVV",0,8,0.884057971014493,76,82,92,95,109,115,133,136,"AAGATGT","CTCA","CTGATGC","CTTA",2.27622851651544,10,14,18,51,2.17864146458955,4.33837456033978,7.87460644439775,101,"ENSG00000079974.19"
"282","ENSG00000007237.19_98436",98428,98436,9,"ENSG00000007237.19",0,NA,"VVVUVVVVV",1,8,0.880745341614907,92,98,133,136,142,148,181,184,"ATAATGA","GTGT","TTGTTCA","CTGA",2.45070248923385,35,6,33,83,1.06840580631964,4.35160560030299,7.87458696676261,101,"ENSG00000079974.19"
"17031","ENSG00000152977.10_47022",47014,47022,9,"ENSG00000152977.10",0,NA,"VVUVVUVVV",2,7,0.805797101449275,115,121,133,136,140,146,162,165,"TTGGTGA","CTGC","GTTTTCA","CTGA",2.39773678125607,12,4,16,41,2.62061531072136,4.65138179644045,7.87457020223755,101,"ENSG00000079974.19"
"1005","ENSG00000044115.21_146373",146365,146373,9,"ENSG00000044115.21",1,8,"UVVVVVVMV",1,7,0.786749482401656,115,121,133,136,146,152,165,168,"GGGAAGA","CTGG","GTGAATA","CTGA",2.41261040341977,12,10,13,44,2.82618681826955,4.72756404360033,7.87456197320695,101,"ENSG00000079974.19"
"1556","ENSG00000060709.16_81134",81126,81134,9,"ENSG00000060709.16",1,8,"VVVVVVVMV",0,8,0.884057971014493,113,119,133,136,163,169,179,182,"GCGCTGA","ATAA","ATAATGA","CTGA",2.29528069261365,14,27,10,60,2.05144686977321,4.33832953846606,7.87456142252403,101,"ENSG00000079974.19"
"19103","ENSG00000161270.20_38393",38385,38393,9,"ENSG00000161270.20",1,1,"MVVVVUVVV",1,7,0.82815734989648,115,121,133,136,152,158,169,172,"ATGATGA","CGTA","CTGGGGA","ATGA",2.36569722771225,12,16,11,48,2.47640955718845,4.56193110215086,7.87456050173678,101,"ENSG00000079974.19"
"7889","ENSG00000115970.19_181424",181416,181424,9,"ENSG00000115970.19",1,2,"VMVVVVVVV",0,8,0.884057971014493,114,120,133,136,146,152,165,168,"CTGAAGT","CAAA","ATAGTGG","CTGA",2.18014539340598,13,10,13,45,2.8189809746876,4.33832089934854,7.87455278340651,101,"ENSG00000079974.19"
"34894","ENSG00000234352.9_261273",261265,261273,9,"ENSG00000234352.9",0,NA,"VVVVVUUVV",2,7,0.808281573498965,114,120,133,136,147,153,173,176,"AAGGTGA","TTGG","CTGATGA","CTGA",2.43274244067685,13,11,20,53,2.34728147399957,4.64139110296131,7.87451739695717,101,"ENSG00000079974.19"
"43411","ENSG00000271860.9_18413",18405,18413,9,"ENSG00000271860.9",0,NA,"VVUVVVVVV",1,8,0.883643892339545,47,53,85,88,96,102,133,136,"ATTATAA","CAGA","TTGTTGT","CTGA",2.43637818854241,32,8,31,80,1.11723896121746,4.33994005454172,7.8745156238999,101,"ENSG00000079974.19"
"4902","ENSG00000102290.23_707241",707233,707241,9,"ENSG00000102290.23",1,2,"VMVVVVVVV",0,8,0.884057971014493,113,119,133,136,147,153,165,168,"ATCATTA","TTGA","AAGATGT","TTGA",2.18876832480106,14,11,12,46,2.76117004326452,4.33823971881789,7.87447160287586,101,"ENSG00000079974.19"
"41189","ENSG00000258655.2_942",934,942,9,"ENSG00000258655.2",1,2,"VMVVVUVVV",1,7,0.806211180124223,80,86,98,101,110,116,133,136,"CTCATGA","CTGA","GTGAGAA","CTGC",2.3920978677286,12,9,17,47,2.6511251156644,4.64961105846377,7.87445577896066,101,"ENSG00000079974.19"
"8630","ENSG00000119927.14_41703",41695,41703,9,"ENSG00000119927.14",1,8,"VVVVVUVMV",1,7,0.806211180124224,100,106,133,136,146,152,168,171,"ATGATCA","TTCA","ATGCTGA","CTGA",2.52583343103783,27,10,16,62,1.75937113544145,4.64956516892341,7.8744098894203,101,"ENSG00000079974.19"
"27337","ENSG00000186001.14_10095",10087,10095,9,"ENSG00000186001.14",1,8,"VVVVVVVMV",0,8,0.884057971014493,99,105,133,136,163,169,178,181,"ATAATGG","GTGA","GTCAGGG","CTGA",2.42824001660772,28,27,9,73,1.16422211544946,4.33812222320856,7.87435410726653,101,"ENSG00000079974.19"
"12077","ENSG00000137078.10_58",50,58,9,"ENSG00000137078.10",0,NA,"UVVVUVVVV",2,7,0.792546583850932,11,17,34,37,41,47,60,63,"ATGCTGA","CTGA","GGGATGG","CTGT",2.44385595962431,17,4,13,43,2.52426801399907,4.70416026954028,7.87434660494401,101,"ENSG00000079974.19"
"27596","ENSG00000186635.15_89618",89610,89618,9,"ENSG00000186635.15",0,NA,"UVVVVVUVV",2,7,0.788819875776397,85,91,133,136,144,150,158,161,"CTGATGT","CTGG","GGGAGGA","CTGA",2.53632324602596,42,8,8,67,1.96744503431708,4.71906666862253,7.87434617172812,101,"ENSG00000079974.19"
"14019","ENSG00000144278.15_260358",260350,260358,9,"ENSG00000144278.15",0,NA,"VVUVVVVVV",1,8,0.883643892339545,105,111,133,136,151,157,167,170,"ATAATGC","CTTT","CTGCTAA","CTGA",2.32020701155751,22,15,10,56,1.89083282208511,4.33971989145046,7.87429546080864,101,"ENSG00000079974.19"
"15338","ENSG00000147862.18_315968",315960,315968,9,"ENSG00000147862.18",0,NA,"VVVVVVUVV",1,8,0.886128364389234,112,118,133,136,173,179,188,191,"ATGTTGA","CTTC","TTGATGA","ATGA",2.3096269300326,15,37,9,70,1.92154490889812,4.32976444394553,7.87427790150246,101,"ENSG00000079974.19"
"8222","ENSG00000117501.15_128655",128647,128655,9,"ENSG00000117501.15",1,8,"VVVVVVVMV",0,8,0.884057971014493,82,88,98,101,110,116,133,136,"ATGATCA","CTGA","ATGATAT","CATA",2.21675616837601,10,9,17,45,2.57352739955105,4.33797546384778,7.87420734790575,101,"ENSG00000079974.19"
"25181","ENSG00000179915.25_1251547",1251539,1251547,9,"ENSG00000179915.25",1,8,"VVVVVVVMV",0,8,0.884057971014493,111,117,133,136,179,185,218,221,"ATTAAGA","CTAA","GTGAAAA","CTGA",2.46508287701067,16,43,33,101,0.917897005611429,4.3379457130873,7.87417759714527,101,"ENSG00000079974.19"
"24966","ENSG00000178882.15_67788",67780,67788,9,"ENSG00000178882.15",1,8,"VVVVVVVMV",0,8,0.884057971014493,102,108,133,136,147,153,165,168,"ATTATGT","CCGG","ATGCATA","CTGA",2.30803161311175,25,11,12,57,1.96490037245328,4.33794444829957,7.87417633235755,101,"ENSG00000079974.19"
"43882","ENSG00000274874.2_67814",67806,67814,9,"ENSG00000274874.2",1,8,"VVVVVVVMV",0,8,0.884057971014493,102,108,133,136,147,153,165,168,"ATTATGT","CCGG","ATGCATA","CTGA",2.30803161311175,25,11,12,57,1.96490037245328,4.33794444829957,7.87417633235755,101,"ENSG00000079974.19"
"1669","ENSG00000064989.13_10989",10981,10989,9,"ENSG00000064989.13",0,NA,"VVUVVVVVV",1,8,0.883643892339545,83,89,100,103,110,116,133,136,"GAGTGGA","CTGA","TTGATGA","CTTA",2.20159193180982,11,7,17,44,2.6811065779692,4.339596530842,7.87417210020018,101,"ENSG00000079974.19"
"10510","ENSG00000131374.15_713655",713647,713655,9,"ENSG00000131374.15",1,2,"UMVVVVVVV",1,7,0.786749482401656,73,79,97,100,107,113,133,136,"CTCATGA","CTTA","GTGATTT","CTGA",2.5088502723995,18,7,20,54,2.18283306324305,4.72712538647659,7.87412331608322,101,"ENSG00000079974.19"
"2628","ENSG00000077063.11_118597",118589,118597,9,"ENSG00000077063.11",1,3,"VVMVVVVVV",0,8,0.882815734989648,100,106,133,136,153,159,180,183,"ATGGGGA","CAAA","GTGATGA","CTGA",2.45701357466063,27,17,21,74,0.991108431421929,4.34279973228987,7.87406267224846,101,"ENSG00000079974.19"
"7716","ENSG00000115423.19_2068",2060,2068,9,"ENSG00000115423.19",0,NA,"VVVUVVVVV",1,8,0.880745341614907,110,116,133,136,147,153,204,207,"ATTATAA","GTGA","ATTAAAA","CTGA",2.37182801180121,17,11,51,88,1.59204919683391,4.35105898554384,7.87404035200346,101,"ENSG00000079974.19"
"30119","ENSG00000203727.4_16097",16089,16097,9,"ENSG00000203727.4",1,8,"VVVVVVVMV",0,8,0.884057971014493,84,90,103,106,111,117,133,136,"ATGCTGT","CAGA","TTAATAA","TTGA",2.19797829382084,13,5,16,43,2.69799301074586,4.33779540905453,7.87402729311251,101,"ENSG00000079974.19"
"12972","ENSG00000139734.19_286200",286192,286200,9,"ENSG00000139734.19",0,NA,"VVVUVVVVV",1,8,0.880745341614907,89,95,103,106,114,120,133,136,"CTAATGA","GTGA","GTCTAGA","TTGA",2.20611987641131,8,8,13,38,2.69671035235211,4.35104404877355,7.87402541523318,101,"ENSG00000079974.19"
"5934","ENSG00000107263.19_38230",38222,38230,9,"ENSG00000107263.19",1,2,"VMVVVVVVV",0,8,0.884057971014493,116,122,133,136,180,186,194,197,"GAGAAGA","CAAA","GTGAAGT","CTGA",2.30893474424235,11,44,8,72,1.9581567577994,4.33776376318711,7.87399564724508,101,"ENSG00000079974.19"
"27070","ENSG00000185532.20_310861",310853,310861,9,"ENSG00000185532.20",0,NA,"VVVVUVVVV",1,8,0.889855072463768,106,112,133,136,138,144,155,158,"GTGGGGA","CTGT","GTAATTG","CTGA",2.29875964356206,21,2,11,43,1.93319775461894,4.31456551125817,7.87398580111325,101,"ENSG00000079974.19"
"29806","ENSG00000198740.9_8708",8700,8708,9,"ENSG00000198740.9",0,NA,"VVVVUVVVV",1,8,0.889855072463768,113,119,133,136,141,147,179,182,"ATGATCC","GTGC","GTGCCCA","CTGA",2.29087724656584,14,5,32,60,1.98569817523472,4.31455328808507,7.87397357794015,101,"ENSG00000079974.19"
"37626","ENSG00000248550.4_314624",314616,314624,9,"ENSG00000248550.4",1,3,"VVMVVVVVV",0,8,0.882815734989648,43,49,62,65,97,103,133,136,"ATGATTT","CAGA","GGGAGTA","CTGA",2.43199070737741,13,32,30,84,1.15750133005787,4.34269317814348,7.87395611810207,101,"ENSG00000079974.19"
"22586","ENSG00000170921.16_284309",284301,284309,9,"ENSG00000170921.16",1,6,"VVUVVMVVV",1,7,0.786335403726708,115,121,133,136,184,190,211,214,"ATGATGA","TTGT","TTGTTGT","CTGA",2.61788859807868,12,48,21,90,1.46184207052357,4.72860818109536,7.87394979600219,101,"ENSG00000079974.19"
"15805","ENSG00000149573.9_4792",4784,4792,9,"ENSG00000149573.9",1,2,"VMVVVVVVV",0,8,0.884057971014493,108,114,133,136,171,177,190,193,"GTGAAGC","CTGG","CTTAGGA","CTGA",2.37522144644939,19,35,13,76,1.51586104408283,4.33766767176968,7.87389955582765,101,"ENSG00000079974.19"
"39151","ENSG00000253125.1_80896",80888,80896,9,"ENSG00000253125.1",1,3,"VVMVVVUVV",1,7,0.768944099378882,113,119,133,136,151,157,174,177,"GTGATGC","ATGA","TTGTTTA","CTGA",2.54651923361592,14,15,17,55,2.21537474872972,4.79804240987563,7.87381880739116,101,"ENSG00000079974.19"
"38897","ENSG00000251249.2_2994",2986,2994,9,"ENSG00000251249.2",1,7,"VVVVVVMVV",0,8,0.885300207039338,88,94,108,111,114,120,133,136,"ATAATAA","CTGA","GGTGTGA","CTAA",2.20526507531955,14,3,13,39,2.62870264911643,4.33261745447835,7.8738182826357,101,"ENSG00000079974.19"
"25407","ENSG00000181355.21_316541",316533,316541,9,"ENSG00000181355.21",1,1,"MVUVVUVVV",2,6,0.711801242236025,114,120,133,136,144,150,192,195,"ATGATGA","CAAA","GTGAGGA","CTGA",2.71656399046105,13,8,42,72,1.99595077984594,5.0265943457299,7.873799314674,101,"ENSG00000079974.19"
"42584","ENSG00000264569.2_1278",1270,1278,9,"ENSG00000264569.2",1,8,"VVVVVUVMV",1,7,0.806211180124224,79,85,100,103,109,115,133,136,"ATAGTGA","TTGA","CTTATAA","CTGA",2.4096781973021,15,6,18,48,2.53118672654907,4.6489270104741,7.87377173097099,101,"ENSG00000079974.19"
"24220","ENSG00000175497.17_429758",429750,429758,9,"ENSG00000175497.17",1,8,"VVVUVVVMV",1,7,0.764803312629399,51,57,70,73,78,84,133,136,"CTGATGA","CTGA","GTGATGC","TTGA",2.59921442655101,13,5,49,76,1.93012996571141,4.81455653567953,7.87376978619713,101,"ENSG00000079974.19"
"16590","ENSG00000151834.16_46399",46391,46399,9,"ENSG00000151834.16",1,1,"MVUVVVVVV",1,7,0.789648033126294,77,83,102,105,112,118,133,136,"ATGAAGT","CAGA","AAGATAA","CTGA",2.46986424826127,19,7,15,50,2.39468882324815,4.71511261958082,7.873704752086,101,"ENSG00000079974.19"
"15651","ENSG00000149021.7_1944",1936,1944,9,"ENSG00000149021.7",0,NA,"VVUVVVVVV",1,8,0.883643892339545,101,107,133,136,142,148,195,198,"CTGCTGA","TTAA","ATGATAA","CTGA",2.43510607660157,26,6,47,88,1.12222026324834,4.33906519348138,7.87364076283956,101,"ENSG00000079974.19"
"39909","ENSG00000254418.1_2108",2100,2108,9,"ENSG00000254418.1",1,8,"VVVVVVVMV",0,8,0.884057971014493,112,118,133,136,151,157,169,172,"ATGAAGA","AAGA","CTGGAGA","CTGT",2.23916129295775,15,15,12,51,2.42184094375225,4.33739572420098,7.87362760825895,101,"ENSG00000079974.19"
"13136","ENSG00000140386.13_297511",297503,297511,9,"ENSG00000140386.13",1,7,"VVVVVVMVV",0,8,0.885300207039338,94,100,133,136,172,178,195,198,"AGGAGGA","TTGA","GTGCAGA","CTGA",2.4898041175943,33,36,17,95,0.730985262692525,4.33241984499697,7.87362067315432,101,"ENSG00000079974.19"
"47170","ENSG00000287738.1_12159",12151,12159,9,"ENSG00000287738.1",1,1,"MVUVVVVVV",1,7,0.789648033126294,114,120,133,136,152,158,175,178,"ATGAAGA","CAGT","GTGGGGA","CTGA",2.50172782762222,13,16,17,55,2.18190973503158,4.71502381312827,7.87361594563344,101,"ENSG00000079974.19"
"29055","ENSG00000197085.11_375301",375293,375301,9,"ENSG00000197085.11",1,8,"VVVVVVVMV",0,8,0.884057971014493,110,116,133,136,169,175,186,189,"GTGATTG","AAGA","ATGAGGT","CTGA",2.33691815734306,17,33,11,70,1.76993510583524,4.33734737203057,7.87357925608854,101,"ENSG00000079974.19"
"8326","ENSG00000118257.17_60626",60618,60626,9,"ENSG00000118257.17",0,NA,"VVVUVVVVV",1,8,0.880745341614907,110,116,133,136,145,151,159,162,"AGGATCC","GTTA","GTAAAGA","CTGA",2.20562577270898,17,9,8,43,2.69811208993262,4.35057097699812,7.87355234345775,101,"ENSG00000079974.19"
"23773","ENSG00000173988.14_58668",58660,58668,9,"ENSG00000173988.14",1,3,"VVMVVVUVV",1,7,0.768944099378882,109,115,133,136,147,153,162,165,"ATGAAGA","TTAA","GTGACGT","CTGA",2.50322885931725,18,11,9,47,2.50284565971135,4.79775951378992,7.87353591130544,101,"ENSG00000079974.19"
"9684","ENSG00000126217.22_124355",124347,124355,9,"ENSG00000126217.22",1,2,"VMVVVVUVV",1,7,0.770186335403727,113,119,133,136,154,160,169,172,"ATGATCT","CAGA","GTGAAAA","CTGA",2.52517386936791,14,18,9,50,2.33605336437419,4.79263645670673,7.87338179832164,101,"ENSG00000079974.19"
"39459","ENSG00000253627.1_19825",19817,19825,9,"ENSG00000253627.1",0,NA,"VVVUUVVVV",2,7,0.770600414078675,108,114,133,136,141,147,156,159,"TTGATGA","TTGT","GTGGAAA","CTGA",2.49585630202115,19,5,9,42,2.52433574786271,4.79084444033427,7.87324609664897,101,"ENSG00000079974.19"
"47383","ENSG00000288067.1_89865",89857,89865,9,"ENSG00000288067.1",0,NA,"VVVUUVVVV",2,7,0.770600414078675,108,114,133,136,141,147,156,159,"TTGATGA","TTGT","GTGGAAA","CTGA",2.49585630202115,19,5,9,42,2.52433574786271,4.79084444033427,7.87324609664897,101,"ENSG00000079974.19"
"24647","ENSG00000177302.15_4232",4224,4232,9,"ENSG00000177302.15",1,3,"VVMVVVVVV",0,8,0.882815734989648,113,119,133,136,140,146,158,161,"AGGTTGA","CAGA","TTGACCA","TTGA",2.18450739746577,14,4,12,39,2.80452374081856,4.34197659764759,7.87323953760619,101,"ENSG00000079974.19"
"41696","ENSG00000259560.2_33634",33626,33634,9,"ENSG00000259560.2",1,2,"VMUVVVVVV",1,7,0.767701863354037,84,90,100,103,110,116,133,136,"GTGATGA","CTTA","ATGATCA","GTGA",2.48706296326987,10,7,17,43,2.62930063847044,4.80243009840073,7.87323755181688,101,"ENSG00000079974.19"
"18347","ENSG00000157131.12_43366",43358,43366,9,"ENSG00000157131.12",1,1,"MVUVVVVVV",1,7,0.789648033126294,116,122,133,136,167,173,186,189,"AGGATGA","ATGA","GTTTTGG","CTGA",2.53831408951628,11,31,13,64,1.93636087062896,4.71461370018437,7.87320583268955,101,"ENSG00000079974.19"
"46280","ENSG00000286425.1_25859",25851,25859,9,"ENSG00000286425.1",1,8,"VVVVVVVMV",0,8,0.884057971014493,107,113,133,136,180,186,201,204,"ATGAACA","AGGA","ATGAAGA","CTGA",2.40553055304831,20,44,15,88,1.31072730617885,4.33689941495856,7.87313129901653,101,"ENSG00000079974.19"
"19299","ENSG00000162687.19_137767",137759,137767,9,"ENSG00000162687.19",1,2,"UMVVVVVVV",1,7,0.786749482401656,113,119,133,136,142,148,156,159,"ATGATGC","ATGA","ATGATAT","CTGC",2.38467271941849,14,6,8,37,3.00670818158549,4.72613157776052,7.87312950736714,101,"ENSG00000079974.19"
"5422","ENSG00000104490.18_376294",376286,376294,9,"ENSG00000104490.18",1,6,"VVVVVMUVV",1,7,0.788819875776397,69,75,88,91,100,106,133,136,"ATGATGG","CAGA","ATGATGA","CTGG",2.50824472471514,13,9,27,58,2.14974892271985,4.7178451052052,7.87312460831079,101,"ENSG00000079974.19"
"3260","ENSG00000082805.21_201267",201259,201267,9,"ENSG00000082805.21",1,8,"VVVVVVVMV",0,8,0.884057971014493,82,88,99,102,111,117,133,136,"ATGATCT","CAGA","CTTATAA","CTGT",2.19861740218644,11,9,16,45,2.68993440327286,4.33684593779562,7.87307782185359,101,"ENSG00000079974.19"
"13862","ENSG00000143776.20_210303",210295,210303,9,"ENSG00000143776.20",1,2,"VMVVVVVVV",0,8,0.884057971014493,114,120,133,136,148,154,178,181,"GGGAAGA","CTAA","ATCTTAA","CTGA",2.2908159517403,13,12,24,58,2.07527002446548,4.3368440923502,7.87307597640818,101,"ENSG00000079974.19"
"28395","ENSG00000189056.15_10776",10768,10776,9,"ENSG00000189056.15",0,NA,"VVVVUUVVV",2,7,0.812008281573499,60,66,86,89,114,120,133,136,"CTGATGA","CTGA","GTGGGGA","ATGA",2.54500955203363,20,25,13,67,1.53338454482351,4.6250287229286,7.8730618492226,101,"ENSG00000079974.19"
"24069","ENSG00000175061.20_25897",25889,25897,9,"ENSG00000175061.20",1,7,"VVVVVVMVV",0,8,0.885300207039338,116,122,133,136,162,168,181,184,"AGAATGT","ATGA","GTCAGGG","CTGA",2.29932004518967,11,26,13,59,1.99823231567847,4.33175815423573,7.87295898239308,101,"ENSG00000079974.19"
"31789","ENSG00000224865.8_36524",36516,36524,9,"ENSG00000224865.8",1,3,"VVMVVVVVV",0,8,0.882815734989648,107,113,133,136,161,167,178,181,"ATGTTGG","GTGG","ATGTAGA","CTGA",2.36499408336266,20,25,11,65,1.60002720283054,4.34166360631207,7.87292654627066,101,"ENSG00000079974.19"
"7931","ENSG00000116117.19_384199",384191,384199,9,"ENSG00000116117.19",0,NA,"VVVVUVUVV",2,7,0.775983436853002,111,117,133,136,142,148,156,159,"GTGATCA","TTTA","GTGTTGG","CTGA",2.43435374054407,16,6,8,39,2.84665549196025,4.76892010723018,7.87285385464218,101,"ENSG00000079974.19"
"25405","ENSG00000181355.21_205238",205230,205238,9,"ENSG00000181355.21",1,1,"MVVVVUVVV",1,7,0.82815734989648,86,92,133,136,140,146,162,165,"AGGATGT","TTGA","CTGATTT","CTGA",2.49653524445158,41,4,16,70,1.59726805152302,4.56020908696672,7.87283848655264,101,"ENSG00000079974.19"
"27415","ENSG00000186094.18_956636",956628,956636,9,"ENSG00000186094.18",1,1,"MVVVVVUVV",1,7,0.792132505175983,30,36,62,65,77,83,133,136,"AAGATGA","CTGA","TTGTTTA","CTGA",2.68724250891682,26,12,50,97,0.901952890761346,4.70422573755171,7.87275575825564,101,"ENSG00000079974.19"
"33139","ENSG00000228824.8_114761",114753,114761,9,"ENSG00000228824.8",1,8,"VVVVVVUMV",1,7,0.770186335403727,106,112,133,136,152,158,171,174,"ATTATGA","CTGT","GTGATTG","CTGA",2.60254666982615,21,16,13,59,1.81754338453652,4.79196362917772,7.87270897079262,101,"ENSG00000079974.19"
"19980","ENSG00000164113.11_28171",28163,28171,9,"ENSG00000164113.11",1,2,"VMVVVVVVV",0,8,0.884057971014493,82,88,133,136,141,147,156,159,"AAAATGA","ATTA","GTTGTGA","CTGA",2.31233845449813,45,5,9,68,1.93029188862319,4.33647039631934,7.87270228037731,101,"ENSG00000079974.19"
"41708","ENSG00000259579.1_54295",54287,54295,9,"ENSG00000259579.1",1,7,"VVVVVVMVV",0,8,0.885300207039338,109,115,133,136,145,151,177,180,"TTCATAA","CTCA","ATGGTGG","CTGA",2.32089163916021,18,9,26,62,1.85325685931672,4.33146694676286,7.87266777492021,101,"ENSG00000079974.19"
"31399","ENSG00000223715.3_113379",113371,113379,9,"ENSG00000223715.3",0,NA,"VVUVVUVVV",2,7,0.805797101449275,114,120,133,136,147,153,168,171,"AGGAAGA","CTTT","GTGATAA","CTGA",2.39221302206696,13,11,15,48,2.64964956209931,4.64943409396976,7.87262249976686,101,"ENSG00000079974.19"
"45817","ENSG00000285939.2_425638",425630,425638,9,"ENSG00000285939.2",1,8,"UVVVVVVMV",1,7,0.786749482401656,40,46,57,60,71,77,133,136,"GGGATGA","CTGA","ATTTTCA","CTGA",2.56379013761468,11,11,56,87,1.81043782712236,4.72559301947172,7.87259094907835,101,"ENSG00000079974.19"
"23080","ENSG00000172199.1_899",891,899,9,"ENSG00000172199.1",1,8,"VVVVUVVMV",1,7,0.773913043478261,82,88,109,112,116,122,133,136,"ATGTTGA","CAGA","AGGAGGT","CTGA",2.53024113891339,21,4,11,45,2.23936645981481,4.77691017980935,7.8725623537224,101,"ENSG00000079974.19"
"868","ENSG00000038427.16_100304",100296,100304,9,"ENSG00000038427.16",0,NA,"VVVVVVUVV",1,8,0.886128364389234,110,116,133,136,170,176,188,191,"TAGATGA","ATTA","CAGATAA","CTGA",2.3362505546717,17,34,12,72,1.73716209560816,4.32804144835487,7.8725549059118,101,"ENSG00000079974.19"
"46720","ENSG00000287097.1_40177",40169,40177,9,"ENSG00000287097.1",1,7,"VVVVVVMVV",0,8,0.885300207039338,86,92,133,136,146,152,178,181,"GTGATTA","ATAA","GTGATTG","CTGA",2.42842861647259,41,10,26,86,1.13560127924188,4.33128134726478,7.87248217542213,101,"ENSG00000079974.19"
"19727","ENSG00000163630.11_229297",229289,229297,9,"ENSG00000163630.11",1,1,"MVVVVVUVV",1,7,0.792132505175983,73,79,93,96,107,113,133,136,"GTGCTGC","CTGA","TAGATAA","CTGA",2.47502306690953,14,11,20,54,2.31548075654835,4.70390863398631,7.87243865469025,101,"ENSG00000079974.19"
"35821","ENSG00000237311.3_43581",43573,43581,9,"ENSG00000237311.3",1,8,"VVVVVVVMV",0,8,0.884057971014493,89,95,133,136,150,156,164,167,"ATGGTGC","CTGC","AGGCTGC","CTGA",2.36079575148247,38,14,8,69,1.60592227367522,4.33614015422292,7.87237203828089,101,"ENSG00000079974.19"
"43064","ENSG00000267922.1_11294",11286,11294,9,"ENSG00000267922.1",1,8,"VVVVVVVMV",0,8,0.884057971014493,114,120,133,136,144,150,173,176,"ATGAGAA","GTGG","AGGAAGG","CTGA",2.25047224191994,13,8,23,53,2.34110970992738,4.33606449734842,7.87229638140639,101,"ENSG00000079974.19"
"13951","ENSG00000144036.16_474333",474325,474333,9,"ENSG00000144036.16",1,2,"VMVVVVVVV",0,8,0.884057971014493,89,95,133,136,150,156,169,172,"GTGATAA","GTTA","CAGATAA","CTGA",2.36989882531346,38,14,13,74,1.54491666615282,4.33606054206063,7.8722924261186,101,"ENSG00000079974.19"
"9817","ENSG00000127511.10_48251",48243,48251,9,"ENSG00000127511.10",0,NA,"VVUVUVVVV",2,7,0.773498964803312,86,92,100,103,115,121,133,136,"CTGAGGG","CTGA","CTGCAGA","CTGA",2.49508650985142,8,12,12,41,2.47920517986674,4.77827881138571,7.87227467059896,101,"ENSG00000079974.19"
"32092","ENSG00000225885.7_41320",41312,41320,9,"ENSG00000225885.7",1,8,"UVVVVVVMV",1,7,0.786749482401656,80,86,97,100,109,115,133,136,"AGGATGT","TTGA","ATGGATA","CTGA",2.45050483904617,11,9,18,47,2.5642180314518,4.72522923960657,7.87222716921319,101,"ENSG00000079974.19"
"4040","ENSG00000092421.17_104137",104129,104137,9,"ENSG00000092421.17",1,7,"VVVVVVMVV",0,8,0.885300207039338,103,109,133,136,168,174,183,186,"ACGATGC","CTGT","TTAGTGA","CTGA",2.41077869551804,24,32,9,74,1.25188064568639,4.33093465395167,7.87213548210902,101,"ENSG00000079974.19"
"1976","ENSG00000068654.17_39104",39096,39104,9,"ENSG00000068654.17",1,8,"VVUVVVVMV",1,7,0.767701863354037,51,57,69,72,77,83,133,136,"GTGATGA","ATGA","GCCATCA","CTGA",2.59062769458218,12,5,50,76,1.9340360714491,4.80122184216591,7.87202929558205,101,"ENSG00000079974.19"
"27179","ENSG00000185736.16_183327",183319,183327,9,"ENSG00000185736.16",0,NA,"VVVVUVVVV",1,8,0.889855072463768,59,65,103,106,111,117,133,136,"ATGAGGA","CTGG","CTGAGTA","CAGA",2.33361128335126,38,5,16,68,1.69295505902664,4.31259090367543,7.8720111935305,101,"ENSG00000079974.19"
"11993","ENSG00000136828.19_79502",79494,79502,9,"ENSG00000136828.19",1,7,"VVVVVVMVV",0,8,0.885300207039338,71,77,85,88,94,100,133,136,"ATGATCA","CCGA","AGGAGGA","TTGA",2.32980409024746,8,6,33,56,1.79085456091768,4.33072045730852,7.87192128546587,101,"ENSG00000079974.19"
"33271","ENSG00000229160.1_1581",1573,1581,9,"ENSG00000229160.1",1,7,"VVVVVVMVV",0,8,0.885300207039338,71,77,85,88,94,100,133,136,"ATGATCA","CCGA","AGGAGGA","TTGA",2.32980409024746,8,6,33,56,1.79085456091768,4.33072045730852,7.87192128546587,101,"ENSG00000079974.19"
"35846","ENSG00000237356.7_150263",150255,150263,9,"ENSG00000237356.7",1,7,"VVVVVVMVV",0,8,0.885300207039338,71,77,85,88,94,100,133,136,"ATGATCA","CCGA","AGGAGGA","TTGA",2.32980409024746,8,6,33,56,1.79085456091768,4.33072045730852,7.87192128546587,101,"ENSG00000079974.19"
"39249","ENSG00000253363.7_366175",366167,366175,9,"ENSG00000253363.7",1,7,"VVVVVVMVV",0,8,0.885300207039338,71,77,85,88,94,100,133,136,"ATGATCA","CCGA","AGGAGGA","TTGA",2.32980409024746,8,6,33,56,1.79085456091768,4.33072045730852,7.87192128546587,101,"ENSG00000079974.19"
"36039","ENSG00000237773.8_239079",239071,239079,9,"ENSG00000237773.8",1,3,"VVMVVVVVV",0,8,0.882815734989648,93,99,133,136,146,152,168,171,"ATGAGGA","TTGA","ATGCTGG","CTAA",2.35405861193767,34,10,16,69,1.66886048876964,4.34064614208853,7.87190908204713,101,"ENSG00000079974.19"
"18104","ENSG00000156113.24_724322",724314,724322,9,"ENSG00000156113.24",0,NA,"VVVVUVVVV",1,8,0.889855072463768,107,113,133,136,147,153,166,169,"ATGATAA","CTGT","ATCAGTA","CTGT",2.25077991826009,20,11,13,53,2.24474300493431,4.31248561500039,7.87190590485547,101,"ENSG00000079974.19"
"29177","ENSG00000197386.14_75705",75697,75705,9,"ENSG00000197386.14",1,3,"VVMVVVVVV",0,8,0.882815734989648,84,90,133,136,175,181,189,192,"ATAATGC","TAGA","GTGTTGA","CTGA",2.45591507569173,43,39,8,99,0.989740135861293,4.34062682678488,7.87188976674347,101,"ENSG00000079974.19"
"40349","ENSG00000255639.3_47262",47254,47262,9,"ENSG00000255639.3",1,2,"UMVVVVVVV",1,7,0.786749482401656,115,121,133,136,146,152,162,165,"ATAATGA","CTGA","GAGTTGG","CAGA",2.39655681033261,12,10,10,41,2.92251211305717,4.72488937881865,7.87188730842527,101,"ENSG00000079974.19"
"36216","ENSG00000238755.3_347875",347867,347875,9,"ENSG00000238755.3",1,3,"UVMVVVVVV",1,7,0.785507246376811,102,108,133,136,143,149,164,167,"ATGATAA","CAGA","ATGGTAT","CTGA",2.53953734187358,25,7,15,56,1.98885043786111,4.72977484592125,7.8718038314285,101,"ENSG00000079974.19"
"17669","ENSG00000154710.18_72724",72716,72724,9,"ENSG00000154710.18",1,8,"UVVVVVVMV",1,7,0.786749482401656,77,83,100,103,108,114,133,136,"TGGATGA","CTAA","ATGATAT","CTGA",2.49549662703451,17,5,19,50,2.26249922614084,4.72478585159272,7.87178378119935,101,"ENSG00000079974.19"
"44927","ENSG00000284461.2_125930",125922,125930,9,"ENSG00000284461.2",1,8,"UVVVVVVMV",1,7,0.786749482401656,77,83,100,103,108,114,133,136,"TGGATGA","CTAA","ATGATAT","CTGA",2.49549662703451,17,5,19,50,2.26249922614084,4.72478585159272,7.87178378119935,101,"ENSG00000079974.19"
"3402","ENSG00000083223.18_20707",20699,20707,9,"ENSG00000083223.18",1,8,"VVVVVVVMV",0,8,0.884057971014493,113,119,133,136,137,143,158,161,"ATGCTGA","CAGC","TTGAAGA","CAGA",2.27860237436329,14,1,15,39,2.15150064534778,4.33554578527576,7.87177766933373,101,"ENSG00000079974.19"
"13899","ENSG00000143889.16_27748",27740,27748,9,"ENSG00000143889.16",1,8,"VVVVVVVMV",0,8,0.884057971014493,108,114,133,136,140,146,159,162,"AAGATGA","AAGA","GGGATGT","TTGA",2.25035783375578,19,4,13,45,2.33974881011901,4.33553359212273,7.8717654761807,101,"ENSG00000079974.19"
"35050","ENSG00000234810.4_44873",44865,44873,9,"ENSG00000234810.4",0,NA,"VVVUVVVVV",1,8,0.880745341614907,69,75,94,97,116,122,133,136,"ATCATCA","CTGA","CTTATGA","CAGA",2.32645307480457,19,19,11,58,1.88533507286192,4.34875555955642,7.87173692601605,101,"ENSG00000079974.19"
"45632","ENSG00000285751.1_19677",19669,19677,9,"ENSG00000285751.1",0,NA,"UVVVVUVVV",2,7,0.824844720496894,111,117,133,136,142,148,161,164,"TTGAGGA","GTTA","ATGAGAT","CTGA",2.33094555040835,16,6,13,44,2.74952189876665,4.57228972537224,7.87166860735982,101,"ENSG00000079974.19"
"13351","ENSG00000141030.13_16368",16360,16368,9,"ENSG00000141030.13",1,1,"MVVUVVVVV",1,7,0.786749482401656,110,116,133,136,141,147,197,200,"ATGATGG","TGGA","ATGATGC","CTGA",2.58146071683367,17,5,50,81,1.68889615654442,4.72465856719222,7.87165649679884,101,"ENSG00000079974.19"
"22463","ENSG00000170615.15_26925",26917,26925,9,"ENSG00000170615.15",0,NA,"VVVVVVUVV",1,8,0.886128364389234,111,117,133,136,183,189,201,204,"ATTCTGA","ATCA","GTGCTAA","CTGA",2.32663429874268,16,47,12,84,1.79765555851339,4.32713772086614,7.87165117842307,101,"ENSG00000079974.19"
"15657","ENSG00000149084.13_46474",46466,46474,9,"ENSG00000149084.13",1,1,"MVVVVUVVV",1,7,0.82815734989648,59,65,78,81,88,94,133,136,"GTCATGG","CTCA","GTGAACA","CTGA",2.43230987858877,13,7,39,68,2.02050653749587,4.55897643202192,7.87160583160784,101,"ENSG00000079974.19"
"44667","ENSG00000283341.4_148265",148257,148265,9,"ENSG00000283341.4",1,1,"MVVVVUVVV",1,7,0.82815734989648,59,65,78,81,88,94,133,136,"GTCATGG","CTCA","GTGAACA","CTGA",2.43230987858877,13,7,39,68,2.02050653749587,4.55897643202192,7.87160583160784,101,"ENSG00000079974.19"
"15165","ENSG00000147234.11_36464",36456,36464,9,"ENSG00000147234.11",0,NA,"VVVUVVVVV",1,8,0.880745341614907,112,118,133,136,144,150,206,209,"ATGCTGG","AGGA","TGGAGGA","CTGA",2.32467328655457,15,8,56,88,1.89665952721748,4.34862035939533,7.87160172585495,101,"ENSG00000079974.19"
"20588","ENSG00000165119.22_3938",3930,3938,9,"ENSG00000165119.22",1,2,"VMVVVVVVV",0,8,0.884057971014493,89,95,133,136,155,161,175,178,"AAGATAA","TTGA","GTGAATC","CTGA",2.42164706233862,38,19,14,80,1.19711875792841,4.33535812671314,7.87159001077111,101,"ENSG00000079974.19"
"37075","ENSG00000245164.10_153387",153379,153387,9,"ENSG00000245164.10",0,NA,"VVVUVVVVV",1,8,0.880745341614907,112,118,133,136,169,175,185,188,"AAGAGGA","ATGT","GTTATAA","CTGA",2.31835317766054,15,33,10,67,1.9386072466905,4.34857377444019,7.87155514089982,101,"ENSG00000079974.19"
"8471","ENSG00000119042.18_67055",67047,67055,9,"ENSG00000119042.18",0,NA,"VVUVVVUVV",2,7,0.769772256728778,106,112,133,136,150,156,171,174,"ATGATGG","TTGC","GTGATGT","CTGA",2.5980222760462,21,14,15,59,1.84967297858982,4.79245537139111,7.87154439830623,101,"ENSG00000079974.19"
"46525","ENSG00000286778.1_37477",37469,37477,9,"ENSG00000286778.1",1,3,"VVMVVVVVV",0,8,0.882815734989648,113,119,133,136,146,152,173,176,"ATCATCT","TAGA","GTGATAG","CTGA",2.25578907195334,14,10,21,54,2.32249507455705,4.34027222189483,7.87153516185342,101,"ENSG00000079974.19"
"8049","ENSG00000116675.16_111449",111441,111449,9,"ENSG00000116675.16",1,5,"VVVVMUVVV",1,7,0.808695652173913,114,120,133,136,153,159,167,170,"GTGTTGG","CTGC","GTGGTGT","CTGA",2.4210483669243,13,17,8,47,2.40666933072637,4.6367479442221,7.87153055291775,101,"ENSG00000079974.19"
"17239","ENSG00000153707.19_2271198",2271190,2271198,9,"ENSG00000153707.19",1,7,"VVVVUVMVV",1,7,0.775155279503105,113,119,133,136,140,146,190,193,"ATGATGC","GTGA","GTGGAAA","CTGA",2.59092043917919,14,4,44,71,1.81071308802878,4.77087900397252,7.87150012198494,101,"ENSG00000079974.19"
"47600","ENSG00000288714.1_106563",106555,106563,9,"ENSG00000288714.1",1,8,"UVVVVVVMV",1,7,0.786749482401656,115,121,133,136,139,145,154,157,"ATTAAGA","GTCA","GTGATGG","CTGA",2.39848780885114,12,3,9,33,2.90790712619639,4.72445646296767,7.87145439257429,101,"ENSG00000079974.19"
"30295","ENSG00000204442.4_312793",312785,312793,9,"ENSG00000204442.4",1,7,"VVVVUVMVV",1,7,0.775155279503105,110,116,133,136,143,149,161,164,"ATGGTGA","ATTA","GAGATTA","CTGA",2.45459840366748,17,7,12,45,2.71907195134568,4.77076532728222,7.87138644529464,101,"ENSG00000079974.19"
"32600","ENSG00000227274.1_15814",15806,15814,9,"ENSG00000227274.1",1,8,"VVVVVVVMV",0,8,0.884057971014493,103,109,133,136,141,147,161,164,"ATGATGC","TTGC","TTGATAA","CTCA",2.29788450895029,24,5,14,52,2.0211148582266,4.3350862294738,7.87131811353177,101,"ENSG00000079974.19"
"16391","ENSG00000151461.20_15035",15027,15035,9,"ENSG00000151461.20",1,1,"MVVVVVUVV",1,7,0.792132505175983,93,99,105,108,113,119,133,136,"AGGAGGA","CTGT","GTGGTAA","CTGA",2.45309067934379,6,5,14,34,2.45696812835268,4.70272649766115,7.87125651836508,101,"ENSG00000079974.19"
"33782","ENSG00000231171.4_138049",138041,138049,9,"ENSG00000231171.4",1,1,"MVVUVVVVV",1,7,0.786749482401656,78,84,101,104,115,121,133,136,"ATGATGA","TTGA","GTAAAAA","CTAA",2.45215019770128,17,11,12,49,2.54934746839704,4.72425386326806,7.87125179287468,101,"ENSG00000079974.19"
"4630","ENSG00000101349.17_56705",56697,56705,9,"ENSG00000101349.17",1,5,"VVVVMVVVV",0,8,0.886542443064182,81,87,101,104,110,116,133,136,"TTGATGG","GTGA","ATTATTT","CTTA",2.19762750288167,14,6,17,46,2.64943788715123,4.32507197659059,7.87124174884732,101,"ENSG00000079974.19"
"28096","ENSG00000188107.15_893757",893749,893757,9,"ENSG00000188107.15",1,8,"VVVVVVVMV",0,8,0.884057971014493,109,115,133,136,142,148,156,159,"CTGGTGC","TTGA","GTGCTGA","CTTA",2.20281953402142,18,6,8,41,2.65448069157818,4.33498606293024,7.87121794698821,101,"ENSG00000079974.19"
"15876","ENSG00000149972.12_867496",867488,867496,9,"ENSG00000149972.12",1,8,"VVVUVVVMV",1,7,0.764803312629399,114,120,133,136,144,150,169,172,"TAGATGA","CAGA","ATGTTAA","CTGA",2.50338726271892,13,8,19,49,2.55873418354306,4.81199565041729,7.87120890093489,101,"ENSG00000079974.19"
"11333","ENSG00000134538.3_53614",53606,53614,9,"ENSG00000134538.3",1,2,"VMUVVVVVV",1,7,0.767701863354037,56,62,75,78,86,92,133,136,"ATGATGC","CTCA","ATAATAA","CTGA",2.58037410592479,13,8,41,71,1.99901769927377,4.80037793469309,7.87118538810924,101,"ENSG00000079974.19"
"41054","ENSG00000258489.4_24579",24571,24579,9,"ENSG00000258489.4",0,NA,"VVVVUVVVV",1,8,0.889855072463768,26,32,64,67,77,83,133,136,"TTGATGT","TTGA","ACTAAGA","CTGA",2.4483677226602,32,10,50,101,0.924124252051412,4.31164393411319,7.87106422396826,101,"ENSG00000079974.19"
"4163","ENSG00000096063.16_33268",33260,33268,9,"ENSG00000096063.16",1,7,"UVVVVVMVV",1,7,0.787991718426501,111,117,133,136,157,163,174,177,"GCAATGA","CTGA","TAGATGA","CTGA",2.52214184897671,16,21,11,57,2.06203448094708,4.71907836853129,7.87104524223729,101,"ENSG00000079974.19"
"7348","ENSG00000113638.14_183668",183660,183668,9,"ENSG00000113638.14",1,2,"VMVVVUVVV",1,7,0.806211180124223,110,116,133,136,150,156,169,172,"ATGATAA","CTTC","ATAAAGA","CTGA",2.44313886658353,17,14,13,53,2.29707918207127,4.64616790649036,7.87101262698725,101,"ENSG00000079974.19"
"35351","ENSG00000235817.2_253",245,253,9,"ENSG00000235817.2",1,2,"VMVVVVVVV",0,8,0.884057971014493,72,78,87,90,98,104,133,136,"GTGGTGG","CTGA","GTGATTT","ATGA",2.30507167175745,9,8,29,55,1.97188447494466,4.33475723833192,7.87098912238989,101,"ENSG00000079974.19"
"8629","ENSG00000119927.14_33721",33713,33721,9,"ENSG00000119927.14",1,7,"VVVVVVMVV",0,8,0.885300207039338,114,120,133,136,145,151,166,169,"AGGATAA","CTCA","ATGTTCA","ATGA",2.18274545915623,13,9,15,46,2.76741358991009,4.32976249607124,7.87096332422859,101,"ENSG00000079974.19"
"20716","ENSG00000165409.18_45983",45975,45983,9,"ENSG00000165409.18",1,3,"VVMVVVVVV",0,8,0.882815734989648,116,122,133,136,185,191,199,202,"GGGCTGA","CCAA","ATGGTGA","CTGA",2.31039852727943,11,49,8,77,1.95600292782889,4.33966494408961,7.8709278840482,101,"ENSG00000079974.19"
"10398","ENSG00000130856.18_107442",107434,107442,9,"ENSG00000130856.18",0,NA,"VVVVVVUVV",1,8,0.886128364389234,116,122,133,136,175,181,191,194,"ACGTTGA","AAGA","ATGAAAG","CTGA",2.29827363332009,11,39,10,69,1.98379259391548,4.32640420401236,7.8709176615693,101,"ENSG00000079974.19"
"2843","ENSG00000078328.23_644155",644147,644155,9,"ENSG00000078328.23",1,2,"VMUVVVVVV",1,7,0.767701863354037,109,115,133,136,138,144,153,156,"ATGAGGA","TTGA","GTAAGCA","CTGA",2.54255402699559,18,2,9,38,2.25003724238988,4.80009935559012,7.87090680900627,101,"ENSG00000079974.19"
"39248","ENSG00000253363.7_325139",325131,325139,9,"ENSG00000253363.7",0,NA,"VVVVVVUVV",1,8,0.886128364389234,115,121,133,136,140,146,200,203,"CTGAAGG","AGGA","CTGATGG","CTGA",2.31992907295141,12,4,54,79,1.83882074286717,4.32625364063582,7.87076709819275,101,"ENSG00000079974.19"
"12350","ENSG00000137936.18_28943",28935,28943,9,"ENSG00000137936.18",1,6,"VVVVVMUVV",1,7,0.788819875776397,39,45,58,61,71,77,133,136,"GTGATCC","CTGA","CTCATGA","CTGA",2.54513008068054,13,10,56,88,1.89437631664227,4.71547754696147,7.87075705006706,101,"ENSG00000079974.19"
"14869","ENSG00000145996.11_190550",190542,190550,9,"ENSG00000145996.11",1,3,"VVMUVVVVV",1,7,0.763561076604555,111,117,133,136,151,157,176,179,"GTGATAA","ATGA","ATGGTGA","CTGA",2.59485960821776,16,15,19,59,1.96697726712914,4.81651033047856,7.87075463689678,101,"ENSG00000079974.19"
"6275","ENSG00000109180.15_13261",13253,13261,9,"ENSG00000109180.15",1,8,"VVVVVVVMV",0,8,0.884057971014493,116,122,133,136,141,147,161,164,"AAGATGA","GTGC","ATGCAGG","CAGA",2.17733498243584,11,5,14,39,2.82242244801047,4.33449724939569,7.87072913345366,101,"ENSG00000079974.19"
"40838","ENSG00000257894.2_53181",53173,53181,9,"ENSG00000257894.2",1,5,"VVVVMVVVV",0,8,0.886542443064182,78,84,99,102,113,119,133,136,"TTGATGG","CTGT","GTAATTT","CAGA",2.20215457068119,15,11,14,49,2.61712918035591,4.32453991289096,7.87070968514768,101,"ENSG00000079974.19"
"19028","ENSG00000160218.13_39026",39018,39026,9,"ENSG00000160218.13",1,8,"VVVVVUVMV",1,7,0.806211180124224,33,39,52,55,104,110,133,136,"CTGATTG","CTGA","GTGAGGA","CTGA",2.58417991474184,13,49,23,94,1.35543324837948,4.64582483666461,7.8706695571615,101,"ENSG00000079974.19"
"11042","ENSG00000133706.19_24199",24191,24199,9,"ENSG00000133706.19",1,2,"VMVVVVVVV",0,8,0.884057971014493,53,59,70,73,79,85,133,136,"ATTATTA","CTGA","TTGAATA","ATGA",2.30627895923194,11,6,48,74,1.96242306172992,4.33440403081905,7.87063591487702,101,"ENSG00000079974.19"
"42490","ENSG00000263711.6_41443",41435,41443,9,"ENSG00000263711.6",1,5,"VVVVMVVVV",0,8,0.886542443064182,110,116,133,136,143,149,160,163,"TTAATGT","CTAA","TTGATGT","TTGA",2.18223149790069,17,7,11,44,2.74945851448307,4.32441712512191,7.87058689737864,101,"ENSG00000079974.19"
"44540","ENSG00000282943.1_90332",90324,90332,9,"ENSG00000282943.1",1,8,"VVVVVUVMV",1,7,0.806211180124224,33,39,54,57,73,79,133,136,"ATGATGA","CTGA","GTGTGGC","CTGT",2.57758204633205,15,16,54,94,1.39908375175488,4.6457410151588,7.87058573565569,101,"ENSG00000079974.19"
"21016","ENSG00000166250.12_86064",86056,86064,9,"ENSG00000166250.12",0,NA,"VVVVVVUVV",1,8,0.886128364389234,116,122,133,136,148,154,176,179,"CTGATAG","CAGT","ATGTGGA","CTGA",2.27338747686215,11,12,22,54,2.14833291073764,4.32606235578799,7.87057581334492,101,"ENSG00000079974.19"
"8637","ENSG00000119953.14_9614",9606,9614,9,"ENSG00000119953.14",1,8,"VVVVVVVMV",0,8,0.884057971014493,82,88,98,101,109,115,133,136,"ATGATTG","GTGA","AAGAAGA","CAGA",2.21832933042123,10,8,18,45,2.54802798582962,4.33422254715945,7.87045443121742,101,"ENSG00000079974.19"
"47622","ENSG00000288723.1_11159",11151,11159,9,"ENSG00000288723.1",1,7,"VVVVVVMVV",0,8,0.885300207039338,93,99,105,108,116,122,133,136,"AGGATTA","TTGA","TTGCAGA","TTGA",2.20356571746542,6,8,11,34,2.62656194355985,4.329250014999,7.87045084315635,101,"ENSG00000079974.19"
"34947","ENSG00000234426.3_54860",54852,54860,9,"ENSG00000234426.3",1,5,"VVVVMVUVV",1,7,0.772670807453416,110,116,133,136,143,149,162,165,"TTGACAA","CTGA","TTTATGA","CTGA",2.46611250452994,17,7,13,46,2.67822954676562,4.7797448942413,7.87042812405496,101,"ENSG00000079974.19"
"38460","ENSG00000250237.3_77508",77500,77508,9,"ENSG00000250237.3",1,5,"VVVVMVVVV",0,8,0.886542443064182,112,118,133,136,186,192,230,233,"TTGTTTA","TTGA","CTGATGA","CTGA",2.4534528735309,15,50,38,112,0.940656527833373,4.32425225450985,7.87042202676658,101,"ENSG00000079974.19"
"41937","ENSG00000260083.3_2660",2652,2660,9,"ENSG00000260083.3",1,2,"VMVVVVVVV",0,8,0.884057971014493,112,118,133,136,158,164,207,210,"CTGAGGA","CAGG","CTGATGC","CTGA",2.43187389875803,15,22,43,89,1.12422910114098,4.33418043988197,7.87041232393994,101,"ENSG00000079974.19"
"40477","ENSG00000256525.8_17511",17503,17511,9,"ENSG00000256525.8",0,NA,"UVVVVVUVV",2,7,0.788819875776397,101,107,133,136,145,151,163,166,"GTGTTGA","GTGA","GTTTTGA","CTGA",2.52268709026924,26,9,12,56,2.04223890616466,4.71503821032323,7.87031771342882,101,"ENSG00000079974.19"
"20723","ENSG00000165416.15_2888",2880,2888,9,"ENSG00000165416.15",1,3,"VVMVVVVVV",0,8,0.882815734989648,106,112,133,136,142,148,170,173,"GAGGTGA","CCGG","GTGACGA","CTGA",2.33321954583982,21,6,22,58,1.80118591678573,4.3389957222628,7.8702586622214,101,"ENSG00000079974.19"
"23696","ENSG00000173575.24_122974",122966,122974,9,"ENSG00000173575.24",1,8,"VVUVVVVMV",1,7,0.767701863354037,109,115,133,136,152,158,205,208,"AGGATGA","CTGA","CTGACAA","CTGA",2.70569603654466,18,16,47,90,1.15982008325731,4.79944841505543,7.87025586847158,101,"ENSG00000079974.19"
"25869","ENSG00000183023.19_332954",332946,332954,9,"ENSG00000183023.19",1,2,"VMVVVVVVV",0,8,0.884057971014493,114,120,133,136,138,144,191,194,"ATTAAAA","GTGA","GTGATAA","CTGA",2.37156485829838,13,2,47,71,1.52560281569123,4.33400880108678,7.87024068514475,101,"ENSG00000079974.19"
"44023","ENSG00000276975.4_122688",122680,122688,9,"ENSG00000276975.4",1,8,"VVVVVVVMV",0,8,0.884057971014493,108,114,133,136,138,144,153,156,"TTGAAGG","GAGA","ATGGGGA","CTGA",2.27857952665159,19,2,9,39,2.14549758127257,4.33400693973745,7.87023882379542,101,"ENSG00000079974.19"
"9895","ENSG00000128059.8_41030",41022,41030,9,"ENSG00000128059.8",1,2,"VMVVVVVVV",0,8,0.884057971014493,103,109,133,136,167,173,189,192,"GAGATGT","GTGA","GTGATCC","CTGA",2.44753545663137,24,31,16,80,1.019039486398,4.33398563265178,7.87021751670975,101,"ENSG00000079974.19"
"21656","ENSG00000168675.19_57065",57057,57065,9,"ENSG00000168675.19",1,8,"VVVVVUVMV",1,7,0.806211180124224,115,121,133,136,138,144,154,157,"AGCATGA","TGGA","ACGATGA","CTGA",2.3771600197004,12,2,10,33,2.73361353275093,4.64533674935507,7.87018146985196,101,"ENSG00000079974.19"
"4866","ENSG00000102174.10_265041",265033,265041,9,"ENSG00000102174.10",0,NA,"VVUVVVVVV",1,8,0.883643892339545,109,115,133,136,169,175,186,189,"CTGTAGA","TTGG","ATGATGA","CTGA",2.34915052351269,18,33,11,71,1.68129695497795,4.33557511126563,7.87015068062381,101,"ENSG00000079974.19"
"15181","ENSG00000147255.19_15396",15388,15396,9,"ENSG00000147255.19",1,8,"VVVVVUVMV",1,7,0.806211180124224,91,97,133,136,146,152,160,163,"ATGATGA","TTGA","CTGCAGA","CTCA",2.50451506256614,36,10,8,63,1.88442442723627,4.64529787775264,7.87014259824953,101,"ENSG00000079974.19"
"45429","ENSG00000285579.1_123187",123179,123187,9,"ENSG00000285579.1",1,2,"VMVVVVUVV",1,7,0.770186335403727,67,73,86,89,111,117,133,136,"ATGATGA","ATCA","ATGAACT","CTGA",2.57998913337618,13,22,16,60,1.95764777050334,4.78939383158613,7.87013917320104,101,"ENSG00000079974.19"
"41797","ENSG00000259754.2_177561",177553,177561,9,"ENSG00000259754.2",0,NA,"VVVUVUVVV",2,7,0.802898550724638,113,119,133,136,142,148,164,167,"AGGGTGC","CTGT","ATGAAGA","CTGA",2.38826700113135,14,6,16,45,2.71225618073006,4.65850904706809,7.87010324996664,101,"ENSG00000079974.19"
"19403","ENSG00000162894.12_14508",14500,14508,9,"ENSG00000162894.12",1,2,"VMVVVVVVV",0,8,0.884057971014493,115,121,133,136,154,160,169,172,"AGGGTGT","CTGT","ATAATTT","CTGA",2.24430892211019,12,18,9,48,2.37338542165261,4.33386122559681,7.87009310965478,101,"ENSG00000079974.19"
"48442","ENSG00000291112.1_12825",12817,12825,9,"ENSG00000291112.1",1,6,"VVVVVMUVV",1,7,0.788819875776397,89,95,108,111,114,120,133,136,"TTTATGA","ATGA","TGCATGA","CTGA",2.42752795493427,13,3,13,38,2.67544884834434,4.71474213697654,7.87002164008213,101,"ENSG00000079974.19"
"19266","ENSG00000162631.20_248577",248569,248577,9,"ENSG00000162631.20",1,8,"VVVVVVVMV",0,8,0.884057971014493,86,92,102,105,114,120,133,136,"TTGTTGT","ATGA","GTGAAAA","ATGA",2.17828986968701,10,9,13,41,2.81318230505451,4.33377869240865,7.87001057646662,101,"ENSG00000079974.19"
"23071","ENSG00000172167.8_1226",1218,1226,9,"ENSG00000172167.8",1,6,"VVUVVMVVV",1,7,0.786335403726708,112,118,133,136,143,149,166,169,"TTCTTGA","CTGA","GAGATAA","CTGA",2.44344732876843,15,7,17,48,2.60892697261066,4.72464395776672,7.86998557267355,101,"ENSG00000079974.19"
"41286","ENSG00000258773.2_29145",29137,29145,9,"ENSG00000258773.2",0,NA,"VVVVUVUVV",2,7,0.775983436853002,82,88,101,104,109,115,133,136,"GAGGTGA","CTGA","TTGATTG","CTGA",2.47424940157165,13,5,18,45,2.56916671540426,4.76604068147048,7.86997442888249,101,"ENSG00000079974.19"
"17002","ENSG00000152952.13_72780",72772,72780,9,"ENSG00000152952.13",1,6,"VVVVUMVVV",1,7,0.792546583850932,113,119,133,136,146,152,161,164,"AAGATTA","TTGA","GTTTTGT","CTGA",2.38814669755959,14,10,9,42,2.87814824916497,4.69978155822389,7.86996789362762,101,"ENSG00000079974.19"
"11073","ENSG00000133812.18_263314",263306,263314,9,"ENSG00000133812.18",0,NA,"UVVVVVUVV",2,7,0.788819875776397,45,51,77,80,84,90,133,136,"ATGATGC","CTGA","GTTAAAA","CTGA",2.6813982957905,26,4,43,82,0.982551492000219,4.71463503265088,7.86991453575647,101,"ENSG00000079974.19"
"6880","ENSG00000112182.16_64690",64682,64690,9,"ENSG00000112182.16",1,2,"UMVVVUVVV",2,6,0.708902691511387,78,84,102,105,114,120,133,136,"AAGATGA","TTGA","GTGAAAA","CTGA",2.63996582437872,18,9,13,49,2.53725595815155,5.03425703016908,7.86986779621463,101,"ENSG00000079974.19"
"33646","ENSG00000230561.6_73045",73037,73045,9,"ENSG00000230561.6",1,7,"VVVVVVMVV",0,8,0.885300207039338,115,121,133,136,142,148,182,185,"GTGCTGT","TTCA","ATAAGGA","CTGA",2.29002762699808,12,6,34,61,2.0474967140991,4.32858689018824,7.86978771834559,101,"ENSG00000079974.19"
"37690","ENSG00000248673.2_344236",344228,344236,9,"ENSG00000248673.2",1,8,"VVVVVVUMV",1,7,0.770186335403727,86,92,103,106,113,119,133,136,"GTGATGG","TTCA","TTGAGGC","CTGA",2.44286765827848,11,7,14,41,2.87032262606336,4.78902675364664,7.86977209526155,101,"ENSG00000079974.19"
"13243","ENSG00000140750.17_63678",63670,63678,9,"ENSG00000140750.17",1,8,"VVVVVUVMV",1,7,0.806211180124224,115,121,133,136,139,145,157,160,"TTTATGT","CTGT","CTGGGGA","CTGA",2.3726843202677,12,3,12,36,2.76165893118511,4.64488859990912,7.86973332040601,101,"ENSG00000079974.19"
"1658","ENSG00000064763.12_4903",4895,4903,9,"ENSG00000064763.12",1,1,"MVVVUVVVV",1,7,0.795859213250517,115,121,133,136,137,143,152,155,"GAGATGC","CTGA","AAAATAA","CTGA",2.41634639226382,12,1,9,31,2.63618269851883,4.68628966173608,7.86972651473815,101,"ENSG00000079974.19"
"34842","ENSG00000234265.2_12608",12600,12608,9,"ENSG00000234265.2",1,3,"VVMVVVVVV",0,8,0.882815734989648,112,118,133,136,185,191,236,239,"ATGAGAA","CTTA","GTGAAGG","CTGA",2.46533964373979,15,49,45,118,0.918011431257034,4.33840226404724,7.86966520400583,101,"ENSG00000079974.19"
"25146","ENSG00000179776.19_7389",7381,7389,9,"ENSG00000179776.19",1,8,"VVVVVVVMV",0,8,0.884057971014493,115,121,133,136,143,149,195,198,"GGCATGA","CTAA","GGAAAGA","CTGA",2.2991230193937,12,7,46,74,2.00606998125464,4.33338919430316,7.86962107836113,101,"ENSG00000079974.19"
"43542","ENSG00000272243.6_91866",91858,91866,9,"ENSG00000272243.6",1,7,"VVVVVVMVV",0,8,0.885300207039338,114,120,133,136,186,192,204,207,"GTCAAGA","CTGT","GAGATTC","CTGA",2.30384419838859,13,50,12,84,1.95452967647024,4.32837274976521,7.86957357792256,101,"ENSG00000079974.19"
"37602","ENSG00000248515.2_55443",55435,55443,9,"ENSG00000248515.2",1,3,"VVMVVVVVV",0,8,0.882815734989648,115,121,133,136,184,190,240,243,"ATAATGC","CTAA","AAGAAGA","CTGA",2.45235435367435,12,48,50,119,1.00404536517335,4.33826859741725,7.86953153737584,101,"ENSG00000079974.19"
"4429","ENSG00000100575.14_5586",5578,5586,9,"ENSG00000100575.14",0,NA,"UVVVVUVVV",2,7,0.824844720496894,111,117,133,136,137,143,152,155,"TTGATGT","CAGT","TTGCTGG","CTGA",2.3979732261612,16,1,9,35,2.29387178397808,4.57008998959652,7.8694688715841,101,"ENSG00000079974.19"
"13187","ENSG00000140527.15_47435",47427,47435,9,"ENSG00000140527.15",0,NA,"VVVUVVVVV",1,8,0.880745341614907,115,121,133,136,137,143,157,160,"CAGAAGA","CTGT","GTCTTCA","CTGA",2.2629239777092,12,1,14,36,2.29978357988248,4.34648585781928,7.86946722427891,101,"ENSG00000079974.19"
"22701","ENSG00000171132.14_406535",406527,406535,9,"ENSG00000171132.14",1,1,"MVVVVVUVV",1,7,0.792132505175983,98,104,133,136,167,173,186,189,"GTGAGGA","CTGA","GTGATTC","CTGA",2.66751940719831,29,31,13,82,1.020217679572,4.70092009855684,7.86945011926078,101,"ENSG00000079974.19"
"467","ENSG00000012660.14_35286",35278,35286,9,"ENSG00000012660.14",1,8,"VVVVVVVMV",0,8,0.884057971014493,78,84,95,98,107,113,133,136,"CTGAAGA","TTGA","TTGCTAA","CAGA",2.23344341090389,11,9,20,49,2.44298661979725,4.33315233978914,7.86938422384711,101,"ENSG00000079974.19"
"43504","ENSG00000272085.1_26",18,26,9,"ENSG00000272085.1",1,3,"VVMVVVVVV",0,8,0.882815734989648,3,9,28,31,36,42,57,60,"GTGAGCT","AAGA","ATGAAGA","CTGA",2.25377416737567,19,5,15,48,2.32723102602615,4.33809803546599,7.86936097542458,101,"ENSG00000079974.19"
"33019","ENSG00000228541.3_32891",32883,32891,9,"ENSG00000228541.3",1,8,"VVVVVUVMV",1,7,0.806211180124224,81,87,99,102,114,120,133,136,"AGGAAGA","CTAA","TTTATCA","CTGA",2.3833130668865,12,12,13,46,2.68924888045263,4.64450066492399,7.86934538542088,101,"ENSG00000079974.19"
"47148","ENSG00000287720.1_125774",125766,125774,9,"ENSG00000287720.1",1,1,"MVUVVVVVV",1,7,0.789648033126294,81,87,101,104,111,117,133,136,"ATGATGA","CAGA","ATTTTTA","ATGA",2.41742415410673,14,7,16,46,2.72653488024608,4.71067397690606,7.86926610941124,101,"ENSG00000079974.19"
"31584","ENSG00000224184.7_108311",108303,108311,9,"ENSG00000224184.7",1,8,"VVVVVUVMV",1,7,0.806211180124224,109,115,133,136,142,148,170,173,"AGGATGG","GTGA","GGGATGC","CTGA",2.4779378818159,18,6,22,55,2.05778949748675,4.64434384406486,7.86918856456175,101,"ENSG00000079974.19"
"16474","ENSG00000151623.15_8387",8379,8387,9,"ENSG00000151623.15",1,7,"VVVVVVMVV",0,8,0.885300207039338,108,114,133,136,142,148,174,177,"GTCATGC","CTAT","GTCATGA","CTGA",2.32723718287794,19,6,26,60,1.79696343862771,4.32796949778683,7.86917032594418,101,"ENSG00000079974.19"
"44640","ENSG00000283228.1_145013",145005,145013,9,"ENSG00000283228.1",1,8,"VVVUVVVMV",1,7,0.764803312629399,68,74,96,99,107,113,133,136,"TTGATCA","CTGA","GTTAAGA","CTGA",2.60995673911385,22,8,20,59,1.84004208535595,4.80993841986207,7.86915167037967,101,"ENSG00000079974.19"
"11467","ENSG00000135049.16_41937",41929,41937,9,"ENSG00000135049.16",1,6,"UVVVVMVVV",1,7,0.805383022774327,116,122,133,136,151,157,210,213,"CTCATGA","CTGT","ATGATGT","CTGA",2.55907299590523,11,15,53,88,1.52984025168703,4.64758172276381,7.86911381386112,101,"ENSG00000079974.19"
"27561","ENSG00000186487.21_325514",325506,325514,9,"ENSG00000186487.21",1,8,"VVVVUVVMV",1,7,0.773913043478261,85,91,100,103,115,121,133,136,"ATGATGT","CTGA","GTGCAAA","ATGA",2.4774136723678,9,12,12,42,2.57758639327252,4.7734193855978,7.86907155951084,101,"ENSG00000079974.19"
"29178","ENSG00000197403.5_20985",20977,20985,9,"ENSG00000197403.5",1,3,"VVMVVUVVV",1,7,0.804968944099379,113,119,133,136,146,152,187,190,"TTGATGA","TTTA","ATTATGG","CTGA",2.50222141635326,14,10,35,68,1.91513983734197,4.64915398659092,7.86902976298844,101,"ENSG00000079974.19"
"8215","ENSG00000117419.16_3871",3863,3871,9,"ENSG00000117419.16",0,NA,"VVVVUVVVV",1,8,0.889855072463768,93,99,133,136,141,147,156,159,"TTGCTGA","ATTA","GTTTTAA","CTGA",2.29442047256065,34,5,9,57,1.94219060813275,4.30958177296761,7.86900206282268,101,"ENSG00000079974.19"
"35303","ENSG00000235665.6_198532",198524,198532,9,"ENSG00000235665.6",1,2,"VMVVVVVVV",0,8,0.884057971014493,42,48,63,66,116,122,133,136,"CTCATGA","CTGA","ATGCAAA","CAGA",2.31520959552783,15,50,11,85,1.89610824792596,4.33270972119454,7.86894160525251,101,"ENSG00000079974.19"
"35703","ENSG00000236790.7_408630",408622,408630,9,"ENSG00000236790.7",1,2,"VMVVVVVVV",0,8,0.884057971014493,42,48,63,66,116,122,133,136,"CTCATGA","CTGA","ATGCAAA","CAGA",2.31520959552783,15,50,11,85,1.89610824792596,4.33270972119454,7.86894160525251,101,"ENSG00000079974.19"
"46026","ENSG00000286122.1_61066",61058,61066,9,"ENSG00000286122.1",0,NA,"VVVVUVVVV",1,8,0.889855072463768,107,113,133,136,148,154,165,168,"GGGATGG","ATCA","TTCCTGA","CTGA",2.24931991881935,20,12,11,52,2.24227368608454,4.30943495288672,7.86885524274179,101,"ENSG00000079974.19"
"2146","ENSG00000070729.14_804",796,804,9,"ENSG00000070729.14",1,3,"VVMVVUVVV",1,7,0.804968944099379,44,50,65,68,113,119,133,136,"ATAATGA","CTGA","ATGATCA","CTTA",2.52182828716659,15,45,14,83,1.78346212427137,4.64891267634549,7.86878845274301,101,"ENSG00000079974.19"
"8732","ENSG00000120549.19_167254",167246,167254,9,"ENSG00000120549.19",0,NA,"VVVVUUVVV",2,7,0.812008281573499,94,100,133,136,142,148,158,161,"GTTATGA","GTGA","GTCATAG","CTGA",2.47231182085727,33,6,10,58,2.00066744212664,4.62068656196045,7.86871968825444,101,"ENSG00000079974.19"
"11253","ENSG00000134352.21_53845",53837,53845,9,"ENSG00000134352.21",1,1,"MVVVVUVVV",1,7,0.82815734989648,112,118,133,136,144,150,160,163,"CTGAGGG","TTGA","GGCATGG","CTGA",2.29662739288088,15,8,10,42,2.91350402497271,4.55608832771131,7.86871772729723,101,"ENSG00000079974.19"
"4610","ENSG00000101333.19_192997",192989,192997,9,"ENSG00000101333.19",1,2,"VMVVVVVVV",0,8,0.884057971014493,76,82,92,95,99,105,133,136,"ATTATGA","CTTA","TTGTTCA","CTTA",2.30962365674513,10,4,28,51,1.93206412016227,4.33238879128245,7.86862067534042,101,"ENSG00000079974.19"
"7021","ENSG00000112531.17_127473",127465,127473,9,"ENSG00000112531.17",1,7,"VVVVVUMVV",1,7,0.807453416149068,114,120,133,136,148,154,195,198,"ATGAAGA","CTCA","ATGTCTA","CTGA",2.5165336025774,13,12,41,75,1.77825029887066,4.63878524568,7.86859891027628,101,"ENSG00000079974.19"
"6407","ENSG00000109689.20_13206",13198,13206,9,"ENSG00000109689.20",1,1,"MVUVVVVVV",1,7,0.789648033126294,101,107,133,136,138,144,156,159,"GTGATGA","CTAA","GCTATGT","CTGA",2.58327158221199,26,2,12,49,1.61808484166575,4.70997384743641,7.86856597994159,101,"ENSG00000079974.19"
"7684","ENSG00000115355.18_130811",130803,130811,9,"ENSG00000115355.18",1,6,"UVVVVMUVV",2,6,0.691511387163561,109,115,133,136,139,145,154,157,"ATGCTGA","CTGA","CTGAGTA","CTGA",2.69988877815713,18,3,9,39,2.41065720183996,5.10247893072187,7.86852447937611,101,"ENSG00000079974.19"
"16068","ENSG00000150672.19_1929256",1929248,1929256,9,"ENSG00000150672.19",1,5,"VVVVMVVVV",0,8,0.886542443064182,116,122,133,136,148,154,170,173,"GTTATTT","TTGG","ATGATCA","CTGA",2.21820736705347,11,12,16,48,2.50101977283424,4.32226722163101,7.86843699388774,101,"ENSG00000079974.19"
"23585","ENSG00000173320.12_98513",98505,98513,9,"ENSG00000173320.12",0,NA,"UVVVVUVVV",2,7,0.824844720496894,111,117,133,136,141,147,156,159,"GTGATCT","CCAA","ATGAAGT","CTGA",2.31951323478864,16,5,9,39,2.81278283517189,4.56905110010737,7.86842998209494,101,"ENSG00000079974.19"
"10038","ENSG00000128908.19_36063",36055,36063,9,"ENSG00000128908.19",1,5,"VVVVMVVVV",0,8,0.886542443064182,46,52,65,68,77,83,133,136,"GTGATGG","CATA","GTGAAGA","GTGA",2.30105093122826,13,9,50,81,1.94864243967573,4.32224549529936,7.86841526755609,101,"ENSG00000079974.19"
"30226","ENSG00000204188.7_45081",45073,45081,9,"ENSG00000204188.7",1,3,"VVMVVVVVV",0,8,0.882815734989648,101,107,133,136,142,148,165,168,"AGGATGA","CAGA","GTGTGGC","CTAA",2.32995537404907,26,6,17,58,1.81499537742279,4.33700780110415,7.86827074106274,101,"ENSG00000079974.19"
"43769","ENSG00000273540.5_247941",247933,247941,9,"ENSG00000273540.5",1,8,"VVVVVVVMV",0,8,0.884057971014493,115,121,133,136,170,176,219,222,"TTGCTGA","CAGC","ATGAGGA","CTGA",2.44388306093125,12,34,43,98,1.03550647531188,4.33201505371338,7.86824693777135,101,"ENSG00000079974.19"
"27092","ENSG00000185565.12_1018237",1018229,1018237,9,"ENSG00000185565.12",0,NA,"UVVVVUVVV",2,7,0.824844720496894,115,121,133,136,186,192,204,207,"ATTATTA","CTGC","GTGATTG","CTGA",2.44744895152443,12,50,12,83,1.95906037523486,4.56884667968277,7.86822556167034,101,"ENSG00000079974.19"
"7216","ENSG00000113319.13_195335",195327,195335,9,"ENSG00000113319.13",1,8,"VVVVUVVMV",1,7,0.773913043478261,68,74,91,94,106,112,133,136,"ATAAGGA","CTGA","GTTAGGA","CTGA",2.56635253151882,17,12,21,59,1.98112489054773,4.77253544183496,7.868187615748,101,"ENSG00000079974.19"
"19567","ENSG00000163320.12_35020",35012,35020,9,"ENSG00000163320.12",1,7,"VVVVVVMVV",0,8,0.885300207039338,110,116,133,136,180,186,205,208,"ATTATCA","TGGA","ATGATGG","CTGA",2.39613508598051,17,44,19,89,1.33354846090687,4.32694559186091,7.86814642001826,101,"ENSG00000079974.19"
"45571","ENSG00000285713.1_395307",395299,395307,9,"ENSG00000285713.1",0,NA,"VVVVVVUVV",1,8,0.886128364389234,105,111,133,136,154,160,180,183,"ATGTTTA","GTGA","ATTATAA","CTGA",2.41024007859631,22,18,20,69,1.22620236425332,4.32361738872384,7.86813084628078,101,"ENSG00000079974.19"
"45657","ENSG00000285783.1_168086",168078,168086,9,"ENSG00000285783.1",0,NA,"VVVVVVUVV",1,8,0.886128364389234,105,111,133,136,154,160,180,183,"ATGTTTA","GTGA","ATTATAA","CTGA",2.41024007859631,22,18,20,69,1.22620236425332,4.32361738872384,7.86813084628078,101,"ENSG00000079974.19"
"25975","ENSG00000183117.20_1764996",1764988,1764996,9,"ENSG00000183117.20",1,7,"VVVVVVMVV",0,8,0.885300207039338,115,121,133,136,179,185,197,200,"ATGTTGT","CTCC","TTCATGT","CTGA",2.30176883411862,12,43,12,76,1.96219407236737,4.32682990828954,7.86803073644689,101,"ENSG00000079974.19"
"8342","ENSG00000118322.14_103875",103867,103875,9,"ENSG00000118322.14",1,8,"VVVVVVVMV",0,8,0.884057971014493,108,114,133,136,149,155,194,197,"ATGAGGA","GTCA","GTAGGGA","CTGA",2.40466312451614,19,13,39,80,1.29593263540782,4.33175503304552,7.86798691710349,101,"ENSG00000079974.19"
"2981","ENSG00000079931.15_57333",57325,57333,9,"ENSG00000079931.15",1,3,"VVMVVVVVV",0,8,0.882815734989648,116,122,133,136,184,190,202,205,"GTGAAAA","CTAA","ATGTTTT","CTGA",2.3119025045069,11,48,12,80,1.93420428542241,4.33672191220043,7.86798485215903,101,"ENSG00000079974.19"
"40927","ENSG00000258101.2_21280",21272,21280,9,"ENSG00000258101.2",0,NA,"VVVVUVVVV",1,8,0.889855072463768,90,96,133,136,148,154,165,168,"ATCATGA","CTCA","CTGATTT","CTGG",2.3217156702308,37,12,11,69,1.75589345812896,4.30849948158358,7.86791977143865,101,"ENSG00000079974.19"
"28050","ENSG00000188092.15_58095",58087,58095,9,"ENSG00000188092.15",0,NA,"VVUVVVVVV",1,8,0.883643892339545,99,105,133,136,151,157,170,173,"TTGATGT","AAGA","ATAAAGC","CTGA",2.3673685640836,28,15,13,65,1.55091738006366,4.33334361848858,7.86791918784676,101,"ENSG00000079974.19"
"36904","ENSG00000243491.1_11417",11409,11417,9,"ENSG00000243491.1",1,8,"VVVVVVVMV",0,8,0.884057971014493,109,115,133,136,182,188,204,207,"GTTATGA","CTTG","CTGCTGG","CTGA",2.38492376399565,18,46,16,89,1.42701910427041,4.33162771606036,7.86785960011833,101,"ENSG00000079974.19"
"22891","ENSG00000171714.13_28763",28755,28763,9,"ENSG00000171714.13",1,8,"VVVVVUVMV",1,7,0.806211180124224,87,93,104,107,115,121,133,136,"AACATGG","ATGA","ATGAGCA","CTGA",2.34290458332696,11,8,12,40,2.95261791259771,4.64299545036102,7.86784017085792,101,"ENSG00000079974.19"
"20222","ENSG00000164483.17_176734",176726,176734,9,"ENSG00000164483.17",1,7,"VVUVVVMVV",1,7,0.768944099378882,66,72,87,90,96,102,133,136,"GTGAGGA","CTAA","GTTATGA","CTGA",2.57512932077271,15,6,31,61,2.00042597787294,4.79198869575608,7.86776509327161,101,"ENSG00000079974.19"
"23249","ENSG00000172380.6_101632",101624,101632,9,"ENSG00000172380.6",1,8,"VVUVVVVMV",1,7,0.767701863354037,115,121,133,136,184,190,202,205,"ATTATGA","GTGA","GAGATCA","CTGA",2.58423461167915,12,48,12,81,1.95956128332245,4.79694800696252,7.86775546037867,101,"ENSG00000079974.19"
"28498","ENSG00000189337.17_760529",760521,760529,9,"ENSG00000189337.17",1,5,"VVVVMVVVV",0,8,0.886542443064182,112,118,133,136,184,190,235,238,"ATGAGGC","CAGA","TTGATCC","CTGA",2.45518308421084,15,48,45,117,0.918287415119729,4.321543660798,7.86771343305473,101,"ENSG00000079974.19"
"31512","ENSG00000223935.3_2416",2408,2416,9,"ENSG00000223935.3",0,NA,"VVVVUVUVV",2,7,0.775983436853002,115,121,133,136,141,147,191,194,"GTGAAGA","CTGG","TTGATAA","CTGA",2.5671339614697,12,5,44,70,1.94066345977493,4.76372246739323,7.86765621480524,101,"ENSG00000079974.19"
"31596","ENSG00000224184.7_504962",504954,504962,9,"ENSG00000224184.7",1,1,"MVUVVVVVV",1,7,0.789648033126294,114,120,133,136,137,143,153,156,"TAGATGA","CAGA","GGGAGAA","CTGA",2.44595483028648,13,1,10,33,2.52955007314668,4.70897890209748,7.86757103460265,101,"ENSG00000079974.19"
"34955","ENSG00000234464.2_130131",130123,130131,9,"ENSG00000234464.2",1,1,"MVVVVUVVV",1,7,0.82815734989648,101,107,133,136,139,145,158,161,"TTGAAGA","CTGC","GTAATTA","CTGA",2.46982772806032,26,3,13,51,1.7540700742182,4.55489706532174,7.86752646490767,101,"ENSG00000079974.19"
"29691","ENSG00000198597.10_417123",417115,417123,9,"ENSG00000198597.10",1,8,"VVVVVVVMV",0,8,0.884057971014493,83,89,133,136,171,177,190,193,"TTAATGA","CAGC","GTGTTGA","CTGA",2.45784718384033,44,35,13,101,0.939432921835177,4.331270203526,7.86750208758397,101,"ENSG00000079974.19"
"19542","ENSG00000163235.16_77521",77513,77521,9,"ENSG00000163235.16",1,7,"UVVVVVMVV",1,7,0.787991718426501,61,67,94,97,107,113,133,136,"ATGAGGA","CTGC","ATGAAAA","CTGA",2.60171740266788,27,10,20,66,1.5172643016272,4.71551174651994,7.86747862022594,101,"ENSG00000079974.19"
"41508","ENSG00000259124.1_64930",64922,64930,9,"ENSG00000259124.1",1,5,"UVVVMVVVV",1,7,0.789233954451346,43,49,60,63,71,77,133,136,"ATAATCA","CTGA","CTAAGGA","CTGA",2.53199058488623,11,8,56,84,1.9619660749312,4.71047582687651,7.86741164468189,101,"ENSG00000079974.19"
"5919","ENSG00000107249.24_303825",303817,303825,9,"ENSG00000107249.24",1,8,"VVVVVVVMV",0,8,0.884057971014493,113,119,133,136,176,182,190,193,"GTGCTGG","CTTT","GTGAATA","CTGA",2.30596244986455,14,40,8,71,1.95141863160445,4.33112540767537,7.86735729173334,101,"ENSG00000079974.19"
"26622","ENSG00000184613.11_70018",70010,70018,9,"ENSG00000184613.11",1,1,"MVVVVVUVV",1,7,0.792132505175983,116,122,133,136,175,181,194,197,"GTGATGC","CTGG","TTGTTGC","CTGA",2.53384608643871,11,39,13,72,1.90295453649076,4.69881544485386,7.8673454655578,101,"ENSG00000079974.19"
"30721","ENSG00000211455.8_56742",56734,56742,9,"ENSG00000211455.8",1,5,"VVVVMVVVV",0,8,0.886542443064182,93,99,133,136,142,148,158,161,"ATAATGC","CCAA","GTGCCTA","CTGA",2.29332215971568,34,6,10,59,1.99587489898724,4.32117232427295,7.86734209652967,101,"ENSG00000079974.19"
"17054","ENSG00000153046.18_56657",56649,56657,9,"ENSG00000153046.18",0,NA,"VVVVVVUVV",1,8,0.886128364389234,97,103,133,136,187,193,204,207,"ATGATAA","GTAA","ATAATAA","CTGA",2.43918491654463,30,51,11,101,1.03006833734272,4.32282527857672,7.86733873613366,101,"ENSG00000079974.19"
"5625","ENSG00000106018.14_2036",2028,2036,9,"ENSG00000106018.14",0,NA,"VVVUVVVVV",1,8,0.880745341614907,111,117,133,136,146,152,163,166,"GAGATGA","CTGT","ATTAGTA","CTGT",2.19771231731405,16,10,11,46,2.72599856804707,4.34435350420185,7.86733487066147,101,"ENSG00000079974.19"
"30421","ENSG00000204949.11_5249",5241,5249,9,"ENSG00000204949.11",1,8,"VVVVVUVMV",1,7,0.806211180124224,58,64,78,81,115,121,133,136,"TTGGTGA","CTGT","ATGAAAA","CTGA",2.49358294030623,14,34,12,69,1.94605311907738,4.6424848469464,7.86732956744329,101,"ENSG00000079974.19"
"9027","ENSG00000122335.17_26133",26125,26133,9,"ENSG00000122335.17",0,NA,"VVUVVVVVV",1,8,0.883643892339545,115,121,133,136,137,143,151,154,"AAGAAAA","ATCA","GTGAATA","CTGA",2.19772067269602,12,1,8,30,2.67934450310494,4.33270391360294,7.86727948296112,101,"ENSG00000079974.19"
"47724","ENSG00000289127.1_51503",51495,51503,9,"ENSG00000289127.1",1,8,"VVVVVVVMV",0,8,0.884057971014493,108,114,133,136,146,152,195,198,"ATGGCGA","AAGA","TTGTTGA","CTGA",2.37568159217874,19,10,43,81,1.48623840003215,4.33102892030594,7.86726080436391,101,"ENSG00000079974.19"
"26837","ENSG00000185052.13_356025",356017,356025,9,"ENSG00000185052.13",1,8,"VVVVVVUMV",1,7,0.770186335403727,43,49,60,63,76,82,133,136,"ATGATGG","CTAA","ATGGGGA","CTGA",2.621258669511,11,13,51,84,1.67089876512128,4.78648914046532,7.86723448208023,101,"ENSG00000079974.19"
"5048","ENSG00000102805.16_12347",12339,12347,9,"ENSG00000102805.16",1,8,"VVVVVVVMV",0,8,0.884057971014493,116,122,133,136,143,149,191,194,"GTTATGT","TTCA","TTGAGTA","CTGA",2.30032429010438,11,7,42,69,1.98847770419313,4.33099324288891,7.86722512694688,101,"ENSG00000079974.19"
"44627","ENSG00000283208.2_10929",10921,10929,9,"ENSG00000283208.2",1,8,"VVVVVVVMV",0,8,0.884057971014493,116,122,133,136,143,149,191,194,"GTTATGT","TTCA","TTGAGTA","CTGA",2.30032429010438,11,7,42,69,1.98847770419313,4.33099324288891,7.86722512694688,101,"ENSG00000079974.19"
"28639","ENSG00000196277.16_66729",66721,66729,9,"ENSG00000196277.16",1,6,"UVVVVMVVV",1,7,0.805383022774327,62,68,92,95,113,119,133,136,"ATGAAGA","CTGA","TTGATGA","ATGA",2.568088680474,24,18,14,65,1.46212545073216,4.64567916347304,7.86721125457035,101,"ENSG00000079974.19"
"7419","ENSG00000114107.9_69031",69023,69031,9,"ENSG00000114107.9",1,8,"VVVVVVVMV",0,8,0.884057971014493,83,89,101,104,112,118,133,136,"AGCATGA","ATAA","GTGAAGA","CTTA",2.17663924928758,12,8,15,44,2.81258156631618,4.33087747372501,7.86710935778298,101,"ENSG00000079974.19"
"27181","ENSG00000185736.16_237766",237758,237766,9,"ENSG00000185736.16",1,5,"UVVVMVVVV",1,7,0.789233954451346,101,107,133,136,141,147,155,158,"ATGATGA","ATAA","GTGATGA","GTGA",2.51903467504023,26,5,8,48,2.04704411846572,4.71015215468348,7.86708797248886,101,"ENSG00000079974.19"
"37101","ENSG00000245322.8_103111",103103,103111,9,"ENSG00000245322.8",1,2,"VMVVVVUVV",1,7,0.770186335403727,87,93,106,109,115,121,133,136,"ATGGTGG","ATGA","ATGCAAA","CTGA",2.42619311400654,13,6,12,40,2.97060724261778,4.78630700066535,7.86705234228026,101,"ENSG00000079974.19"
"8734","ENSG00000120549.19_220698",220690,220698,9,"ENSG00000120549.19",1,3,"VVMVVVVVV",0,8,0.882815734989648,112,118,133,136,150,156,165,168,"ATTTGGA","ATTA","GAGATGA","CTGA",2.22139761069031,15,14,9,47,2.53367669746204,4.33574852551603,7.86701146547462,101,"ENSG00000079974.19"
"12112","ENSG00000137269.15_119757",119749,119757,9,"ENSG00000137269.15",1,8,"VVVUVVVMV",1,7,0.764803312629399,113,119,133,136,144,150,161,164,"GTGATGC","CTGA","ATGGGGA","GTGA",2.44160991616554,14,8,11,42,2.95372298478643,4.8077806064725,7.8669938569901,101,"ENSG00000079974.19"
"13376","ENSG00000141293.16_186853",186845,186853,9,"ENSG00000141293.16",1,8,"VVVVVVVMV",0,8,0.884057971014493,95,101,133,136,145,151,177,180,"AAGATGA","CAAA","GAGAACA","CTGA",2.41689771559409,32,9,26,76,1.21034908179685,4.33075012977269,7.86698201383066,101,"ENSG00000079974.19"
"15117","ENSG00000147099.21_173199",173191,173199,9,"ENSG00000147099.21",1,1,"MVVVVVUVV",1,7,0.792132505175983,38,44,55,58,107,113,133,136,"AAGATGA","TTGA","GTTTTGA","CTGA",2.5952023108652,11,49,20,89,1.49230696110962,4.69841392505274,7.86694394575667,101,"ENSG00000079974.19"
"45396","ENSG00000285547.1_172941",172933,172941,9,"ENSG00000285547.1",1,1,"MVVVVVUVV",1,7,0.792132505175983,38,44,55,58,107,113,133,136,"AAGATGA","TTGA","GTTTTGA","CTGA",2.5952023108652,11,49,20,89,1.49230696110962,4.69841392505274,7.86694394575667,101,"ENSG00000079974.19"
"27220","ENSG00000185745.10_1282",1274,1282,9,"ENSG00000185745.10",1,2,"UMVVVVVVV",1,7,0.786749482401656,115,121,133,136,156,162,193,196,"TTGAAGA","CAGA","ATGATGA","CTGA",2.62415862732629,12,20,31,72,1.38535110586023,4.71993548867554,7.86693341828217,101,"ENSG00000079974.19"
"42264","ENSG00000261400.1_4675",4667,4675,9,"ENSG00000261400.1",1,8,"VVVVVVVMV",0,8,0.884057971014493,96,102,133,136,154,160,169,172,"GGGGTGA","CAAA","ATGATGA","CTGA",2.38789867641729,31,18,9,67,1.40345757478393,4.33069552105814,7.86692740511611,101,"ENSG00000079974.19"
"12806","ENSG00000139154.16_132646",132638,132646,9,"ENSG00000139154.16",0,NA,"UVVVVUVVV",2,7,0.824844720496894,114,120,133,136,142,148,157,160,"ATGATGA","GTGG","ATTCTGC","CTTA",2.28195257041862,13,6,9,37,3.05690452077254,4.56748041422417,7.86685929621175,101,"ENSG00000079974.19"
"46788","ENSG00000287172.1_73172",73164,73172,9,"ENSG00000287172.1",0,NA,"VVVVUVUVV",2,7,0.775983436853002,116,122,133,136,152,158,169,172,"GTGATGA","AAGA","GCCATGC","CTGA",2.48995339309045,11,16,11,47,2.45199101991455,4.76292007679605,7.86685382420806,101,"ENSG00000079974.19"
"21096","ENSG00000166435.17_87189",87181,87189,9,"ENSG00000166435.17",1,7,"VVVVVVMVV",0,8,0.885300207039338,110,116,133,136,143,149,162,165,"TTGGTCA","CCGT","CTGCTGT","CTGA",2.19365126800543,17,7,13,46,2.67822954676562,4.32564283336712,7.86684366152447,101,"ENSG00000079974.19"
"44062","ENSG00000277268.2_69258",69250,69258,9,"ENSG00000277268.2",1,2,"UMVVVVVVV",1,7,0.786749482401656,77,83,100,103,112,118,133,136,"CTGATGA","CTGT","ATGATGC","CTAA",2.45332758561567,17,9,15,50,2.52343478820882,4.71973800641166,7.86673593601828,101,"ENSG00000079974.19"
"47137","ENSG00000287704.2_242751",242743,242751,9,"ENSG00000287704.2",1,8,"VVVVVVVMV",0,8,0.884057971014493,106,112,133,136,143,149,164,167,"AGGATAA","AGGA","AGGAAAA","CTGA",2.26422248642487,21,7,15,52,2.22717570314514,4.33049806982774,7.86672995388571,101,"ENSG00000079974.19"
"36953","ENSG00000243831.1_195",187,195,9,"ENSG00000243831.1",1,8,"VVVVVUVMV",1,7,0.806211180124224,112,118,133,136,149,155,170,173,"ATGATCA","GTGC","ATGAATG","CTGA",2.42197895077534,15,13,15,52,2.42101182640713,4.64188454122735,7.86672926172424,101,"ENSG00000079974.19"
"1229","ENSG00000049769.14_31567",31559,31567,9,"ENSG00000049769.14",0,NA,"VVVVVVUVV",1,8,0.886128364389234,105,111,133,136,141,147,157,160,"GTTATGT","ATCA","GTTAAAA","CTGA",2.25243186545194,22,5,10,46,2.27257857298657,4.32219775233321,7.86671120989014,101,"ENSG00000079974.19"
"43656","ENSG00000273079.7_506333",506325,506333,9,"ENSG00000273079.7",1,8,"VVVVVVVMV",0,8,0.884057971014493,116,122,133,136,146,152,168,171,"AGGAGGA","GTGA","CTGCAGA","CCGA",2.20293740498056,11,10,16,46,2.63565755816795,4.33047673117626,7.86670861523423,101,"ENSG00000079974.19"
"19566","ENSG00000163312.11_36256",36248,36256,9,"ENSG00000163312.11",1,2,"VMVVVVVVV",0,8,0.884057971014493,92,98,133,136,142,148,191,194,"ATGAGGA","CTAT","ATCAAGA","CTGA",2.44765658340055,35,6,43,93,1.00366333584963,4.33034347296333,7.8665753570213,101,"ENSG00000079974.19"
"7256","ENSG00000113396.13_299037",299029,299037,9,"ENSG00000113396.13",1,7,"VVVVVVMVV",0,8,0.885300207039338,44,50,61,64,72,78,133,136,"TTGTTTA","CTCA","TTGATCT","CTGA",2.30088780063573,11,8,55,83,1.96213836468618,4.32534759223109,7.86654842038844,101,"ENSG00000079974.19"
"14779","ENSG00000145864.14_39437",39429,39437,9,"ENSG00000145864.14",1,7,"VVVVVVMVV",0,8,0.885300207039338,83,89,133,136,184,190,207,210,"GTGATGT","GAGA","ATGAATA","CTGA",2.4902774300066,44,48,17,118,0.699419983999255,4.32531737934415,7.8665182075015,101,"ENSG00000079974.19"
"37535","ENSG00000248391.6_54082",54074,54082,9,"ENSG00000248391.6",1,2,"UMVVVVVVV",1,7,0.786749482401656,83,89,101,104,111,117,133,136,"ATTATGC","CTGC","CTAATCA","CTGA",2.41656164440433,12,7,16,44,2.76737040921505,4.71944534297764,7.86644327258426,101,"ENSG00000079974.19"
"12520","ENSG00000138443.17_54887",54879,54887,9,"ENSG00000138443.17",0,NA,"UVVVVUVVV",2,7,0.824844720496894,114,120,133,136,138,144,152,155,"ATCTTTA","ATGA","AAGATGA","CTGA",2.32659949692439,13,2,8,32,2.75757226228217,4.56705889377786,7.86643777576544,101,"ENSG00000079974.19"
"14584","ENSG00000145416.14_309527",309519,309527,9,"ENSG00000145416.14",1,8,"UVVVVVVMV",1,7,0.786749482401656,115,121,133,136,145,151,168,171,"ATAATGA","TTTA","TTTATGC","CTGA",2.43396809996347,12,9,17,47,2.6511251156644,4.71939477885522,7.86639270846185,101,"ENSG00000079974.19"
"11798","ENSG00000136111.14_170575",170567,170575,9,"ENSG00000136111.14",1,7,"VVVVVVMVV",0,8,0.885300207039338,83,89,133,136,142,148,178,181,"ATGCTTA","ATGA","TTGATAT","CTGA",2.42849175836367,44,6,30,89,1.11079705356633,4.32518552733104,7.86638635548839,101,"ENSG00000079974.19"
"46878","ENSG00000287299.1_36386",36378,36386,9,"ENSG00000287299.1",1,8,"VVVVVVVMV",0,8,0.884057971014493,112,118,133,136,187,193,207,210,"ATGGTGC","AAGA","AGGGTGA","CTGA",2.33085281182817,15,51,14,89,1.78151904364369,4.33013444729121,7.86636633134918,101,"ENSG00000079974.19"
"29745","ENSG00000198673.11_221811",221803,221811,9,"ENSG00000198673.11",1,8,"VVVVVVVMV",0,8,0.884057971014493,116,122,133,136,153,159,172,175,"AAGAAGA","ATCA","ATTAAAA","CTGA",2.24965429960098,11,17,13,50,2.32281586714079,4.3301277994535,7.86635968351147,101,"ENSG00000079974.19"
"23139","ENSG00000172264.19_1788803",1788795,1788803,9,"ENSG00000172264.19",1,8,"VVVVVVVMV",0,8,0.884057971014493,96,102,133,136,142,148,161,164,"GGGATTA","CTGT","GTTTTAA","CTGA",2.30779507719612,31,6,13,59,1.9349765501562,4.33006926619925,7.86630115025722,101,"ENSG00000079974.19"
"17555","ENSG00000154438.8_11887",11879,11887,9,"ENSG00000154438.8",1,5,"VVVVMUVVV",1,7,0.808695652173913,40,46,60,63,114,120,133,136,"ATGCTAA","CTGA","GTGCTTC","CTGA",2.49635042152244,14,51,13,87,1.88369737795526,4.63150838035955,7.8662909890552,101,"ENSG00000079974.19"
"37502","ENSG00000248330.5_3351",3343,3351,9,"ENSG00000248330.5",1,1,"MVVVUVVVV",1,7,0.795859213250517,110,116,133,136,158,164,178,181,"GAGATGA","TTGA","ATAAGGA","CTGA",2.5352220876109,17,22,14,62,1.82985593639831,4.68283413011774,7.86627098311981,101,"ENSG00000079974.19"
"28906","ENSG00000196663.16_83994",83986,83994,9,"ENSG00000196663.16",1,8,"VVVUVVVMV",1,7,0.764803312629399,93,99,106,109,116,122,133,136,"ATGATGT","ATGA","GTGCTGA","CAGA",2.46956961143981,7,7,11,34,2.76422608568165,4.80700587382009,7.86621912433769,101,"ENSG00000079974.19"
"29310","ENSG00000197651.4_11747",11739,11747,9,"ENSG00000197651.4",1,8,"UVVVVVVMV",1,7,0.786749482401656,19,25,64,67,113,119,133,136,"GTGATGA","TTGA","ATGCTGT","CTGA",2.70017552464002,39,46,14,108,0.875629560657596,4.7191999312311,7.86619786083773,101,"ENSG00000079974.19"
"23707","ENSG00000173588.16_86641",86633,86641,9,"ENSG00000173588.16",1,3,"VVMVVVVVV",0,8,0.882815734989648,110,116,133,136,144,150,178,181,"ATACTGA","CAGT","GTTTTGA","CTGA",2.31353671440244,17,8,28,62,1.91612873918375,4.3349267088,7.8661896487586,101,"ENSG00000079974.19"
"45443","ENSG00000285579.1_549389",549381,549389,9,"ENSG00000285579.1",1,2,"UMVVVUVVV",2,6,0.708902691511387,82,88,101,104,116,122,133,136,"ATGATGA","TCGA","ATCCTGA","CTGA",2.60534652690864,13,12,11,45,2.75327200458812,5.03056221266142,7.86617297870697,101,"ENSG00000079974.19"
"24222","ENSG00000175497.17_50028",50020,50028,9,"ENSG00000175497.17",1,7,"VVVVVVMVV",0,8,0.885300207039338,113,119,133,136,137,143,151,154,"TTCATGA","CCTA","GTGAAGA","ATGA",2.2160170604655,14,1,8,32,2.52632127629989,4.32494208651748,7.86614291467483,101,"ENSG00000079974.19"
"39002","ENSG00000251432.8_191360",191352,191360,9,"ENSG00000251432.8",1,8,"UVVVVVVMV",1,7,0.786749482401656,110,116,133,136,146,152,164,167,"CAGATGG","GTGA","TTGAGGA","CTGA",2.43952045062324,17,10,12,48,2.6131047904488,4.7191436153176,7.86614154492423,101,"ENSG00000079974.19"
"10617","ENSG00000131873.7_57392",57384,57392,9,"ENSG00000131873.7",0,NA,"VVVVUUVVV",2,7,0.812008281573499,116,122,133,136,147,153,202,205,"AGGAGGA","CTGG","TTGAAGA","CTGA",2.4989175998187,11,11,49,80,1.81296315833495,4.61810345594824,7.86613658224224,101,"ENSG00000079974.19"
"28267","ENSG00000188580.15_889680",889672,889680,9,"ENSG00000188580.15",1,8,"VVVVVVVMV",0,8,0.884057971014493,100,106,133,136,144,150,163,166,"GTGATGT","CAGA","GTGACTC","CTTA",2.29666986190748,27,8,13,57,2.00840301690395,4.32988385740512,7.86611574146309,101,"ENSG00000079974.19"
"11898","ENSG00000136381.13_4236",4228,4236,9,"ENSG00000136381.13",1,3,"VVMVVVVVV",0,8,0.882815734989648,110,116,133,136,140,146,155,158,"GTCAAAA","TTGA","GGAATGA","CTGA",2.20543144216658,17,4,9,39,2.63618549034849,4.33476544286476,7.86602838282335,101,"ENSG00000079974.19"
"31458","ENSG00000223786.1_254927",254919,254927,9,"ENSG00000223786.1",1,8,"VVVVVVVMV",0,8,0.884057971014493,112,118,133,136,153,159,167,170,"TAGATCA","TTAA","GTGAACA","CTGA",2.25001558517507,15,17,8,49,2.31895289154377,4.32976419817773,7.8659960822357,101,"ENSG00000079974.19"
"30679","ENSG00000206538.9_17379",17371,17379,9,"ENSG00000206538.9",1,8,"VVVVVVVMV",0,8,0.884057971014493,83,89,133,136,172,178,190,193,"TTGATGT","CTCA","AGGAAAA","CTGA",2.45163035246773,44,36,12,101,0.974852813331398,4.32976379077907,7.86599567483704,101,"ENSG00000079974.19"
"29927","ENSG00000198879.13_73500",73492,73500,9,"ENSG00000198879.13",0,NA,"VVVVVVUVV",1,8,0.886128364389234,55,61,77,80,94,100,133,136,"AGGAGGT","CTGG","GTGGAGA","CTGA",2.36237133010156,16,14,33,72,1.53663094851345,4.32144328729763,7.86595674485457,101,"ENSG00000079974.19"
"7924","ENSG00000116117.19_141297",141289,141297,9,"ENSG00000116117.19",0,NA,"VVUVVVVVV",1,8,0.883643892339545,42,48,67,70,97,103,133,136,"ATGAAGA","CTGA","GTGATAG","CTAA",2.48016035035817,19,27,30,85,0.791104233891994,4.33137664240328,7.86595221176146,101,"ENSG00000079974.19"
"26775","ENSG00000185008.19_768439",768431,768439,9,"ENSG00000185008.19",1,2,"VMVVVVVVV",0,8,0.884057971014493,33,39,57,60,96,102,133,136,"ATGGAGA","CTGA","ATAAGGG","CTGA",2.47932531375765,18,36,31,94,0.789975355768417,4.32970269520486,7.86593457926283,101,"ENSG00000079974.19"
"23119","ENSG00000172264.19_1264283",1264275,1264283,9,"ENSG00000172264.19",0,NA,"VVUVVUVVV",2,7,0.805797101449275,114,120,133,136,142,148,173,176,"GCAATGA","GTGA","GAGATGA","CTGA",2.4477112896627,13,6,25,53,2.25263884457577,4.64267852724845,7.86586693304555,101,"ENSG00000079974.19"
"14156","ENSG00000144455.14_678894",678886,678894,9,"ENSG00000144455.14",0,NA,"UVUVVVVVV",2,7,0.786335403726708,116,122,133,136,145,151,164,167,"TTGATAT","ATGA","TTTATGA","CTGA",2.40301802245416,11,9,13,42,2.8619218755468,4.7205105063103,7.86585212121713,101,"ENSG00000079974.19"
"44285","ENSG00000280560.3_357731",357723,357731,9,"ENSG00000280560.3",0,NA,"VVVVUVVVV",1,8,0.889855072463768,82,88,133,136,181,187,202,205,"GTGATGG","CACA","ATGAGAA","CTGA",2.4608382845681,45,45,15,114,0.820055160957918,4.30641093118631,7.86583122104138,101,"ENSG00000079974.19"
"38662","ENSG00000250754.6_49133",49125,49133,9,"ENSG00000250754.6",1,8,"VVVVUVVMV",1,7,0.773913043478261,113,119,133,136,170,176,195,198,"GTGATGA","CCCA","GTGCTGA","CTGA",2.62759852805645,14,34,19,76,1.56330233241273,4.77015646319727,7.86580863711032,101,"ENSG00000079974.19"
"8145","ENSG00000117020.19_122005",121997,122005,9,"ENSG00000117020.19",1,2,"VMVVVVVVV",0,8,0.884057971014493,111,117,133,136,144,150,176,179,"CTGAAGA","TTGA","GTGAACA","CTTA",2.28861353638652,16,8,26,59,2.0608509265638,4.32956862561848,7.86580050967645,101,"ENSG00000079974.19"
"34220","ENSG00000232184.1_11747",11739,11747,9,"ENSG00000232184.1",1,2,"VMVVVVVVV",0,8,0.884057971014493,111,117,133,136,144,150,176,179,"CTGAAGA","TTGA","GTGAACA","CTTA",2.28861353638652,16,8,26,59,2.0608509265638,4.32956862561848,7.86580050967645,101,"ENSG00000079974.19"
"23038","ENSG00000172014.14_11083",11075,11083,9,"ENSG00000172014.14",1,5,"UVVVMVVVV",1,7,0.789233954451346,86,92,133,136,137,143,152,155,"GTGATGA","ATGA","ATTAGGT","CTGA",2.62652296485245,41,1,9,60,1.32527342559108,4.70885663115185,7.86579244895724,101,"ENSG00000079974.19"
"26015","ENSG00000183148.9_11090",11082,11090,9,"ENSG00000183148.9",1,5,"UVVVMVVVV",1,7,0.789233954451346,86,92,133,136,137,143,152,155,"GTGATGA","ATGA","ATTAGGT","CTGA",2.62652296485245,41,1,9,60,1.32527342559108,4.70885663115185,7.86579244895724,101,"ENSG00000079974.19"
"35709","ENSG00000236816.5_11089",11081,11089,9,"ENSG00000236816.5",1,5,"UVVVMVVVV",1,7,0.789233954451346,86,92,133,136,137,143,152,155,"GTGATGA","ATGA","ATTAGGT","CTGA",2.62652296485245,41,1,9,60,1.32527342559108,4.70885663115185,7.86579244895724,101,"ENSG00000079974.19"
"36361","ENSG00000240240.10_11085",11077,11085,9,"ENSG00000240240.10",1,5,"UVVVMVVVV",1,7,0.789233954451346,86,92,133,136,137,143,152,155,"GTGATGA","ATGA","ATTAGGT","CTGA",2.62652296485245,41,1,9,60,1.32527342559108,4.70885663115185,7.86579244895724,101,"ENSG00000079974.19"
"42096","ENSG00000260691.8_37746",37738,37746,9,"ENSG00000260691.8",1,5,"UVVVMVVVV",1,7,0.789233954451346,86,92,133,136,137,143,152,155,"GTGATGA","ATGA","ATTAGGT","CTGA",2.62652296485245,41,1,9,60,1.32527342559108,4.70885663115185,7.86579244895724,101,"ENSG00000079974.19"
"43965","ENSG00000276203.7_11203",11195,11203,9,"ENSG00000276203.7",1,5,"UVVVMVVVV",1,7,0.789233954451346,86,92,133,136,137,143,152,155,"GTGATGA","ATGA","ATTAGGT","CTGA",2.62652296485245,41,1,9,60,1.32527342559108,4.70885663115185,7.86579244895724,101,"ENSG00000079974.19"
"48325","ENSG00000290971.1_37711",37703,37711,9,"ENSG00000290971.1",1,5,"UVVVMVVVV",1,7,0.789233954451346,86,92,133,136,137,143,152,155,"GTGATGA","ATGA","ATTAGGT","CTGA",2.62652296485245,41,1,9,60,1.32527342559108,4.70885663115185,7.86579244895724,101,"ENSG00000079974.19"
"48327","ENSG00000290972.1_11364",11356,11364,9,"ENSG00000290972.1",1,5,"UVVVMVVVV",1,7,0.789233954451346,86,92,133,136,137,143,152,155,"GTGATGA","ATGA","ATTAGGT","CTGA",2.62652296485245,41,1,9,60,1.32527342559108,4.70885663115185,7.86579244895724,101,"ENSG00000079974.19"
"48484","ENSG00000291166.1_33427",33419,33427,9,"ENSG00000291166.1",1,5,"UVVVMVVVV",1,7,0.789233954451346,86,92,133,136,137,143,152,155,"GTGATGA","ATGA","ATTAGGT","CTGA",2.62652296485245,41,1,9,60,1.32527342559108,4.70885663115185,7.86579244895724,101,"ENSG00000079974.19"
"48557","ENSG00000291287.1_11202",11194,11202,9,"ENSG00000291287.1",1,5,"UVVVMVVVV",1,7,0.789233954451346,86,92,133,136,137,143,152,155,"GTGATGA","ATGA","ATTAGGT","CTGA",2.62652296485245,41,1,9,60,1.32527342559108,4.70885663115185,7.86579244895724,101,"ENSG00000079974.19"
"2435","ENSG00000074660.17_4432",4424,4432,9,"ENSG00000074660.17",0,NA,"VVVUVVVVV",1,8,0.880745341614907,82,88,133,136,182,188,202,205,"GTGATGG","TGGA","ATGAGAA","CTGA",2.47460549357936,45,46,14,114,0.873806192317774,4.34279403737838,7.86577540383801,101,"ENSG00000079974.19"
"33225","ENSG00000229089.9_11209",11201,11209,9,"ENSG00000229089.9",1,5,"UVVVMVVVV",1,7,0.789233954451346,84,90,133,136,137,143,152,155,"GTGATGA","ATGA","ATTAGGT","CTGA",2.62652296485245,43,1,9,62,1.32475781833811,4.70872772933861,7.86566354714399,101,"ENSG00000079974.19"
"44039","ENSG00000277112.4_11075",11067,11075,9,"ENSG00000277112.4",1,5,"UVVVMVVVV",1,7,0.789233954451346,84,90,133,136,137,143,152,155,"GTGATGA","ATGA","ATTAGGT","CTGA",2.62652296485245,43,1,9,62,1.32475781833811,4.70872772933861,7.86566354714399,101,"ENSG00000079974.19"
"14876","ENSG00000145996.11_430538",430530,430538,9,"ENSG00000145996.11",1,1,"MVVVVVUVV",1,7,0.792132505175983,116,122,133,136,157,163,181,184,"ATGATGA","CTTA","CTGATGT","CTCA",2.5408897116207,11,21,18,59,1.84921573136412,4.69712011887554,7.86565013957947,101,"ENSG00000079974.19"
"14791","ENSG00000145908.13_4640",4632,4640,9,"ENSG00000145908.13",1,1,"MVVVVUVVV",1,7,0.82815734989648,95,101,133,136,137,143,152,155,"CTGAGGA","CAGA","GTGATTT","CTGA",2.52958101999066,32,1,9,51,1.34819309284677,4.55301663986279,7.86564603944871,101,"ENSG00000079974.19"
"40913","ENSG00000258081.4_404883",404875,404883,9,"ENSG00000258081.4",0,NA,"VVVVUVVVV",1,8,0.889855072463768,113,119,133,136,149,155,167,170,"CTCATGG","TTGG","TGTATGA","CTGA",2.19103550129216,14,13,12,48,2.61795024237316,4.30621339608022,7.86563368593529,101,"ENSG00000079974.19"
"18797","ENSG00000158528.12_258564",258556,258564,9,"ENSG00000158528.12",1,2,"VMUVVVVVV",1,7,0.767701863354037,108,114,133,136,146,152,164,167,"ATGAGGA","AAGA","GTGATTG","CTGA",2.51180824679737,19,10,12,50,2.43387182890351,4.79481503522149,7.86562248863764,101,"ENSG00000079974.19"
"36134","ENSG00000237978.6_257388",257380,257388,9,"ENSG00000237978.6",1,8,"VVVVVVUMV",1,7,0.770186335403727,101,107,133,136,145,151,159,162,"ATGCTGT","CTGA","TTTAGGA","CTGA",2.5612310219535,26,9,8,52,2.06460964533119,4.7848707812553,7.8656161228702,101,"ENSG00000079974.19"
"26634","ENSG00000184672.12_28799",28791,28799,9,"ENSG00000184672.12",0,NA,"VVVVUVVVV",1,8,0.889855072463768,91,97,133,136,146,152,205,208,"ATGATTA","CTCT","TTGAAAA","CTGA",2.44787939836438,36,10,53,108,0.905585369989127,4.30619533977125,7.86561562962632,101,"ENSG00000079974.19"
"20855","ENSG00000165891.16_33308",33300,33308,9,"ENSG00000165891.16",1,8,"VVVVVVVMV",0,8,0.884057971014493,114,120,133,136,143,149,193,196,"GTCAAGT","TTGA","GAGAAGA","CTGA",2.29691677232737,13,7,44,73,2.00467367390207,4.32936303902113,7.86559492307911,101,"ENSG00000079974.19"
"2681","ENSG00000077264.16_58736",58728,58736,9,"ENSG00000077264.16",1,5,"VVVVMVVVV",0,8,0.886542443064182,111,117,133,136,139,145,155,158,"ACAATGT","CTCT","ATGATTC","CTGA",2.20186216553522,16,3,10,38,2.59857356385691,4.31941366685626,7.86558343911299,101,"ENSG00000079974.19"
"29010","ENSG00000196935.10_52550",52542,52550,9,"ENSG00000196935.10",1,6,"UVVVVMVVV",1,7,0.805383022774327,86,92,105,108,116,122,133,136,"GTGATGT","GTGA","GTTAGGA","CAGA",2.33742253265663,13,8,11,41,2.99220180982414,4.64375467355042,7.86528676464773,101,"ENSG00000079974.19"
"21131","ENSG00000166501.14_334375",334367,334375,9,"ENSG00000166501.14",1,8,"VVVVVVVMV",0,8,0.884057971014493,88,94,133,136,186,192,208,211,"ATGATGT","CACA","TAGAGGA","CTGA",2.48312348216866,39,50,16,114,0.761554229977877,4.32892769444224,7.86515957850021,101,"ENSG00000079974.19"
"6481","ENSG00000110104.13_931",923,931,9,"ENSG00000110104.13",1,3,"VVMVVVVVV",0,8,0.882815734989648,115,121,133,136,144,150,180,183,"AGAATGT","CTGG","GAGAGGG","CTGA",2.28326851963407,12,8,30,59,2.11336356610669,4.33378842425013,7.86505136420872,101,"ENSG00000079974.19"
"40717","ENSG00000257467.6_22689",22681,22689,9,"ENSG00000257467.6",1,2,"UMVVVVVVV",1,7,0.786749482401656,113,119,133,136,138,144,156,159,"ATTAGGA","ATGA","ATGACTA","CTGA",2.45189096252549,14,2,12,37,2.52604326563276,4.71799575395068,7.8649936835573,101,"ENSG00000079974.19"
"2389","ENSG00000074047.22_7646",7638,7646,9,"ENSG00000074047.22",0,NA,"VVUUVVVVV",2,7,0.764389233954451,89,95,106,109,116,122,133,136,"TTGAAGA","CTGC","GAGAAGG","CTGA",2.43139867400626,11,7,11,38,3.0203974279366,4.80743048032792,7.86498741614573,101,"ENSG00000079974.19"
"28321","ENSG00000188672.19_1780",1772,1780,9,"ENSG00000188672.19",1,8,"VVVVVVVMV",0,8,0.884057971014493,110,116,133,136,144,150,159,162,"GTGTGGA","TTCA","AGGCAGA","CTGA",2.18434005428069,17,8,9,43,2.7526408765568,4.32872697627369,7.86495886033166,101,"ENSG00000079974.19"
"11811","ENSG00000136143.16_212162",212154,212162,9,"ENSG00000136143.16",1,1,"MVVVUUVVV",2,6,0.718012422360248,84,90,104,107,115,121,133,136,"CTGATGA","CTGA","CTGGTGA","CAGA",2.55758797867456,14,8,12,43,2.92097912702687,4.99289141288099,7.86494110232198,101,"ENSG00000079974.19"
"33060","ENSG00000228573.1_10150",10142,10150,9,"ENSG00000228573.1",1,1,"MVVVUUVVV",2,6,0.718012422360248,84,90,104,107,115,121,133,136,"CTGATGA","CTGA","CTGGTGA","CAGA",2.55758797867456,14,8,12,43,2.92097912702687,4.99289141288099,7.86494110232198,101,"ENSG00000079974.19"
"39330","ENSG00000253474.2_92905",92897,92905,9,"ENSG00000253474.2",1,8,"VVVVVVVMV",0,8,0.884057971014493,104,110,133,136,153,159,191,194,"ATGGTGA","CACA","GTGGTGG","CTGA",2.47848119211926,23,17,32,81,0.791553846365859,4.3286904484569,7.86492233251487,101,"ENSG00000079974.19"
"6290","ENSG00000109265.15_197125",197117,197125,9,"ENSG00000109265.15",0,NA,"UVVVVUVVV",2,7,0.824844720496894,35,41,57,60,74,80,133,136,"ATGATAT","GTGA","GTGAGGG","CTGA",2.52002873325308,16,14,53,92,1.46192090639392,4.56552811535362,7.8649069973412,101,"ENSG00000079974.19"
"16180","ENSG00000151067.23_504820",504812,504820,9,"ENSG00000151067.23",1,8,"VVUVVVVMV",1,7,0.767701863354037,100,106,133,136,147,153,164,167,"ATGAAGA","GTGA","AAGAAGA","CTGA",2.58789074664262,27,11,11,58,1.92350421504278,4.79402729816506,7.86483475158121,101,"ENSG00000079974.19"
"14010","ENSG00000144229.13_653885",653877,653885,9,"ENSG00000144229.13",1,1,"MVVVVVUVV",1,7,0.792132505175983,109,115,133,136,152,158,200,203,"CTGATAA","CAGA","GTGATGA","CTGA",2.64246195182228,18,16,42,85,1.16874079363446,4.69628845144574,7.86481847214967,101,"ENSG00000079974.19"
"44098","ENSG00000277930.1_2004",1996,2004,9,"ENSG00000277930.1",1,8,"VVVVVVVMV",0,8,0.884057971014493,93,99,133,136,157,163,174,177,"ATGAGCA","CTAG","CTGATGA","CTGA",2.41170564715495,34,21,11,75,1.23629937045638,4.32858425453902,7.86481613859699,101,"ENSG00000079974.19"
"12221","ENSG00000137674.4_46152",46144,46152,9,"ENSG00000137674.4",1,2,"VMVVVVVVV",0,8,0.884057971014493,78,84,95,98,109,115,133,136,"GTTATGT","CTGA","GTCATCT","CTTA",2.22999582087885,11,11,18,49,2.44715686390202,4.32844891744025,7.86468080149822,101,"ENSG00000079974.19"
"20995","ENSG00000166192.15_185",177,185,9,"ENSG00000166192.15",1,6,"VVUVVMVVV",1,7,0.786335403726708,108,114,133,136,145,151,193,196,"ATCATGA","GTGA","ATGTTGG","CTGA",2.60042078726899,19,9,42,79,1.54114105760098,4.71931990984856,7.86466152475539,101,"ENSG00000079974.19"
"45345","ENSG00000285471.1_229778",229770,229778,9,"ENSG00000285471.1",1,2,"VMVVVUVVV",1,7,0.806211180124223,96,102,133,136,143,149,169,172,"ATCATGA","CTGT","TTAAGGA","CTGA",2.55158757514573,31,7,20,67,1.54846476573344,4.63976215000957,7.86460687050647,101,"ENSG00000079974.19"
"17722","ENSG00000154975.14_209926",209918,209926,9,"ENSG00000154975.14",1,1,"MVVVUVVVV",1,7,0.795859213250517,116,122,133,136,151,157,166,169,"ATGATCA","CAGT","ATGAGAG","CTGA",2.42823677305319,11,15,9,44,2.5359501775769,4.6810488328162,7.86448568581827,101,"ENSG00000079974.19"
"35411","ENSG00000235978.8_71452",71444,71452,9,"ENSG00000235978.8",1,8,"VVVVVVVMV",0,8,0.884057971014493,84,90,133,136,143,149,158,161,"ATTATGC","AAGA","GTCTTTA","CTGA",2.297091677723,43,7,9,68,1.99906876819047,4.32825332158595,7.86448520564392,101,"ENSG00000079974.19"
"45078","ENSG00000284977.3_82141",82133,82141,9,"ENSG00000284977.3",1,2,"VMVVVVVVV",0,8,0.884057971014493,36,42,74,77,110,116,133,136,"ATAATGA","CTGA","GTGATCT","CTCA",2.48439464817045,32,33,17,91,0.750256644985126,4.32822190819703,7.864453792255,101,"ENSG00000079974.19"
"45132","ENSG00000285082.3_137374",137366,137374,9,"ENSG00000285082.3",1,2,"VMVVVVVVV",0,8,0.884057971014493,36,42,74,77,110,116,133,136,"ATAATGA","CTGA","GTGATCT","CTCA",2.48439464817045,32,33,17,91,0.750256644985126,4.32822190819703,7.864453792255,101,"ENSG00000079974.19"
"25506","ENSG00000182022.18_80578",80570,80578,9,"ENSG00000182022.18",1,1,"MVVVVUVVV",1,7,0.82815734989648,94,100,133,136,168,174,182,185,"GTGAAGA","CTTA","GTAATGA","CTGA",2.57623634451607,33,32,8,82,1.0323325164731,4.5518103699784,7.86443976956432,101,"ENSG00000079974.19"
"42364","ENSG00000261781.1_5662",5654,5662,9,"ENSG00000261781.1",1,3,"VVMVVVVVV",0,8,0.882815734989648,111,117,133,136,167,173,185,188,"GAGATGC","TAGA","GTGCTCA","CTGA",2.32413864947723,16,31,12,68,1.83840411822677,4.33316544535208,7.86442838531067,101,"ENSG00000079974.19"
"29948","ENSG00000198919.13_12986",12978,12986,9,"ENSG00000198919.13",1,2,"VMVVVVVVV",0,8,0.884057971014493,84,90,133,136,154,160,170,173,"ATGTTAA","TTGG","GTGGTGA","CTGA",2.39092368340511,43,18,10,80,1.37324176535134,4.32818324701302,7.86441513107099,101,"ENSG00000079974.19"
"43019","ENSG00000267586.7_492793",492785,492793,9,"ENSG00000267586.7",1,7,"VVVVVVMVV",0,8,0.885300207039338,98,104,133,136,149,155,211,214,"TTGATAA","CTCA","CTGAAGG","CTGA",2.48092204933397,29,13,56,107,0.753362046034443,4.32321059373189,7.86441142188924,101,"ENSG00000079974.19"
"13219","ENSG00000140598.16_122445",122437,122445,9,"ENSG00000140598.16",1,8,"VVVVVVVMV",0,8,0.884057971014493,110,116,133,136,147,153,183,186,"ATGAAAA","TTTA","ATGAAAA","CTGA",2.33937112119218,17,11,30,67,1.71668385569649,4.32812283257776,7.86435471663573,101,"ENSG00000079974.19"
"6300","ENSG00000109320.14_6436",6428,6436,9,"ENSG00000109320.14",1,7,"VVVVVVMVV",0,8,0.885300207039338,107,113,133,136,162,168,177,180,"TTAATGA","GTTA","ATCATGT","CTGA",2.3548832804814,20,26,9,64,1.59330251353466,4.32313109585266,7.86433192401001,101,"ENSG00000079974.19"
"31357","ENSG00000223546.9_48172",48164,48172,9,"ENSG00000223546.9",0,NA,"VVVVVVUVV",1,8,0.886128364389234,110,116,133,136,141,147,187,190,"ATCATGG","CTTC","ATGGTGG","CTGA",2.33585300141349,17,5,40,71,1.70691662740599,4.31981749254064,7.86433095009758,101,"ENSG00000079974.19"
"28141","ENSG00000188185.13_28379",28371,28379,9,"ENSG00000188185.13",1,2,"VMVVVVVVV",0,8,0.884057971014493,82,88,133,136,176,182,193,196,"ATGGAGA","CTGC","CAGATGA","CTGA",2.44771538327022,45,40,11,105,0.993491424586861,4.32789849493041,7.86413037898838,101,"ENSG00000079974.19"
"40557","ENSG00000256995.8_462575",462567,462575,9,"ENSG00000256995.8",1,1,"MVVUVVVVV",1,7,0.786749482401656,114,120,133,136,143,149,164,167,"AGCATGA","GTGA","TGGATAA","CTGA",2.4070458778677,13,7,15,44,2.82140405818526,4.71709414432582,7.86409207393245,101,"ENSG00000079974.19"
"14889","ENSG00000146021.15_61979",61971,61979,9,"ENSG00000146021.15",1,8,"VVVVVVVMV",0,8,0.884057971014493,111,117,133,136,146,152,166,169,"GGGATGA","TAGA","GTGTTCA","CTGT",2.20541444116013,16,10,14,49,2.60866090854085,4.3278559624021,7.86408784646007,101,"ENSG00000079974.19"
"42607","ENSG00000265125.5_56430",56422,56430,9,"ENSG00000265125.5",1,6,"UVVVVMVVV",1,7,0.805383022774327,116,122,133,136,139,145,154,157,"GTGATGT","CTAC","AAGCTTA","CTGA",2.34585862525065,11,3,9,32,2.93087201071515,4.64248237809655,7.86401446919385,101,"ENSG00000079974.19"
"19646","ENSG00000163539.18_80625",80617,80625,9,"ENSG00000163539.18",1,2,"VMVVVVVVV",0,8,0.884057971014493,54,60,83,86,116,122,133,136,"ATAAAGA","CTGA","GTGATGG","ATGA",2.40018482478345,23,30,11,73,1.30986262239313,4.32777369690403,7.864005580962,101,"ENSG00000079974.19"
"26983","ENSG00000185352.9_53944",53936,53944,9,"ENSG00000185352.9",0,NA,"VVVVVVUVV",1,8,0.886128364389234,115,121,133,136,148,154,168,171,"ATGATAC","TTGA","GTGGGGT","CTGC",2.19566530094975,12,12,14,47,2.64013717591965,4.3194764622295,7.86398991978644,101,"ENSG00000079974.19"
"37418","ENSG00000248138.5_73883",73875,73883,9,"ENSG00000248138.5",1,1,"MVVVUVVVV",1,7,0.795859213250517,113,119,133,136,153,159,183,186,"TTGAAGA","ATGA","GAGATGA","CTGA",2.55238341422207,14,17,24,64,1.70582654591004,4.6804289935143,7.86386584651637,101,"ENSG00000079974.19"
"25623","ENSG00000182247.10_179939",179931,179939,9,"ENSG00000182247.10",0,NA,"VVVUVVVVV",1,8,0.880745341614907,99,105,133,136,145,151,159,162,"AGGAGGA","TTGT","TTAAGGA","CTGA",2.30319575156244,28,9,8,54,2.00879077598598,4.34085727993389,7.86383864639352,101,"ENSG00000079974.19"
"7921","ENSG00000116106.12_134883",134875,134883,9,"ENSG00000116106.12",1,2,"VMVVVUVVV",1,7,0.806211180124223,116,122,133,136,143,149,162,165,"TTTTTGA","CTGG","ATGTAGA","CTGA",2.34433443735137,11,7,13,40,2.92704015889572,4.63898410197621,7.8638288224731,101,"ENSG00000079974.19"
"38311","ENSG00000249934.2_1259",1251,1259,9,"ENSG00000249934.2",1,8,"VVVVUUVMV",2,6,0.696066252587992,109,115,133,136,179,185,194,197,"ATGATGA","CTGT","CTGAGGA","CTGA",2.79734433667084,18,43,9,79,1.66896875649526,5.07948275024188,7.86374776059384,101,"ENSG00000079974.19"
"35688","ENSG00000236780.7_11512",11504,11512,9,"ENSG00000236780.7",1,2,"VMVVVUVVV",1,7,0.806211180124223,109,115,133,136,143,149,161,164,"ATGATGT","GTGA","TTGCAGA","ATGA",2.38904730224298,18,7,12,46,2.62852234995922,4.63887609122811,7.863720811725,101,"ENSG00000079974.19"
"4032","ENSG00000092203.15_6829",6821,6829,9,"ENSG00000092203.15",1,2,"VMVVVVVVV",0,8,0.884057971014493,112,118,133,136,153,159,172,175,"GTGAGAA","TTGT","ATGCTCA","CTGA",2.25796762161527,15,17,13,54,2.25681095909287,4.327482109132,7.86371399318997,101,"ENSG00000079974.19"
"1900","ENSG00000067369.14_101346",101338,101346,9,"ENSG00000067369.14",1,2,"VMVVVUVVV",1,7,0.806211180124223,113,119,133,136,142,148,157,160,"ATGTTTA","CTAT","TTGCTGA","CTGA",2.33236137464204,14,6,9,38,3.00615666399917,4.63880812373653,7.86365284423342,101,"ENSG00000079974.19"
"41516","ENSG00000259134.7_173207",173199,173207,9,"ENSG00000259134.7",0,NA,"VVVVUUVVV",2,7,0.812008281573499,105,111,133,136,145,151,168,171,"AAGATGG","CCGA","ATGCTGC","CTGA",2.47158880062449,22,9,17,57,1.98521013848261,4.61561720232813,7.86365032862212,101,"ENSG00000079974.19"
"39501","ENSG00000253675.1_25688",25680,25688,9,"ENSG00000253675.1",1,1,"MVVUVVVVV",1,7,0.786749482401656,106,112,133,136,147,153,173,176,"CTGATAA","CTGA","TAGATGG","CTGA",2.56577138844914,21,11,20,61,1.76127971519127,4.71660557621305,7.86360350581968,101,"ENSG00000079974.19"
"15185","ENSG00000147255.19_238602",238594,238602,9,"ENSG00000147255.19",1,2,"VMUVVVVVV",1,7,0.767701863354037,113,119,133,136,141,147,163,166,"ATAGTTA","CTGA","ATGAGGA","CTGA",2.47625061988594,14,5,16,44,2.66258055471462,4.79272950515522,7.86353695857137,101,"ENSG00000079974.19"
"16854","ENSG00000152465.18_35466",35458,35466,9,"ENSG00000152465.18",1,2,"VMVVVVVVV",0,8,0.884057971014493,76,82,97,100,112,118,133,136,"TTTATGT","TTGA","GTGGTGA","CTTA",2.22244071218617,15,12,15,51,2.49290068452352,4.3272930247745,7.86352490883247,101,"ENSG00000079974.19"
"14923","ENSG00000146147.15_77523",77515,77523,9,"ENSG00000146147.15",0,NA,"VVVVUVVVV",1,8,0.889855072463768,99,105,133,136,147,153,168,171,"CTGCTGA","TAGA","ACGTAGA","CTGA",2.32293672640031,28,11,15,63,1.73014811770189,4.30409824009265,7.86351852994773,101,"ENSG00000079974.19"
"14820","ENSG00000145934.17_422495",422487,422495,9,"ENSG00000145934.17",1,3,"UVMVVVVVV",1,7,0.785507246376811,31,37,53,56,72,78,133,136,"ATCATGA","CTCA","TTGAGGA","CTGA",2.6337933729335,16,16,55,96,1.32728873126043,4.72147780437095,7.86350678987819,101,"ENSG00000079974.19"
"31249","ENSG00000220913.1_4495",4487,4495,9,"ENSG00000220913.1",1,2,"VMVVVVVVV",0,8,0.884057971014493,89,95,133,136,158,164,175,178,"GTAATGT","ATGA","GTGTGGT","CTGA",2.41751202863394,38,22,11,80,1.19231919397489,4.32726651288363,7.8634983969416,101,"ENSG00000079974.19"
"3840","ENSG00000089250.20_20081",20073,20081,9,"ENSG00000089250.20",1,2,"VMVVVVVVV",0,8,0.884057971014493,107,113,133,136,138,144,152,155,"ATTCTGA","CCCA","GCGCTGA","CTGA",2.29022053829888,20,2,8,39,2.04054964598742,4.32717164199498,7.86340352605295,101,"ENSG00000079974.19"
"46685","ENSG00000287044.1_50989",50981,50989,9,"ENSG00000287044.1",1,8,"UVVVVVVMV",1,7,0.786749482401656,116,122,133,136,146,152,187,190,"AGGATGA","CTAG","GTGTTGA","CTGA",2.54093666672428,11,10,35,65,1.92603211803864,4.71640247405012,7.86340040365675,101,"ENSG00000079974.19"
"2617","ENSG00000076770.16_100354",100346,100354,9,"ENSG00000076770.16",1,8,"VVVVVVVMV",0,8,0.884057971014493,105,111,133,136,144,150,163,166,"CTCATGT","CTGA","CTGAAGC","CTGT",2.25977457098443,22,8,13,52,2.24307029528884,4.32705852546293,7.8632904095209,101,"ENSG00000079974.19"
"36301","ENSG00000239774.1_16154",16146,16154,9,"ENSG00000239774.1",1,8,"VVVVVVVMV",0,8,0.884057971014493,82,88,102,105,113,119,133,136,"CTGCTGA","CTGT","AAGAGGT","GTGA",2.17203875759519,14,8,14,45,2.8279150943933,4.32704336959031,7.86327525364828,101,"ENSG00000079974.19"
"708","ENSG00000027075.17_224233",224225,224233,9,"ENSG00000027075.17",1,6,"UVVVVMVVV",1,7,0.805383022774327,85,91,133,136,140,146,162,165,"GAGAAGA","CTGA","CTGATCA","CTGA",2.5454957537813,42,4,16,71,1.59696450890003,4.64173405019385,7.86326614129116,101,"ENSG00000079974.19"
"35132","ENSG00000235066.7_34543",34535,34543,9,"ENSG00000235066.7",1,2,"VMVVVVVVV",0,8,0.884057971014493,62,68,77,80,94,100,133,136,"GAGATGG","CTGA","ATGAAGA","CTTA",2.36594723851031,9,14,33,65,1.534968669765,4.32698756495844,7.86321944901641,101,"ENSG00000079974.19"
"28017","ENSG00000187957.8_242810",242802,242810,9,"ENSG00000187957.8",1,8,"VVVVVUVMV",1,7,0.806211180124224,114,120,133,136,142,148,163,166,"GTGAAGG","CTTA","GTGCTTT","CTGA",2.36167564099322,13,6,15,43,2.80890812931346,4.63835310065039,7.86319782114729,101,"ENSG00000079974.19"
"14674","ENSG00000145700.10_90380",90372,90380,9,"ENSG00000145700.10",1,7,"VVVVVVMVV",0,8,0.885300207039338,116,122,133,136,185,191,200,203,"AAAATGA","GTCA","ATAATGC","CTGA",2.29700890404655,11,49,9,78,1.9744810417719,4.32196843385389,7.86316926201124,101,"ENSG00000079974.19"
"37341","ENSG00000247381.3_89061",89053,89061,9,"ENSG00000247381.3",1,2,"VMVVVVUVV",1,7,0.770186335403727,76,82,92,95,102,108,133,136,"AGGAGGA","CTGA","AGGATAA","CTGA",2.54045918051079,10,7,25,51,2.19282464786701,4.7823047961514,7.8630501377663,101,"ENSG00000079974.19"
"29437","ENSG00000197977.4_57279",57271,57279,9,"ENSG00000197977.4",1,5,"VVUVMVVVV",1,7,0.770186335403727,52,58,103,106,111,117,133,136,"TGGATGA","CTGA","CTGAATA","CTGA",2.61575833508173,45,5,16,75,1.69022247638679,4.78215284423291,7.86289818584782,101,"ENSG00000079974.19"
"37103","ENSG00000245322.8_122512",122504,122512,9,"ENSG00000245322.8",1,2,"VMVVVVVVV",0,8,0.884057971014493,112,118,133,136,138,144,156,159,"TTGATGA","TTCA","TTTATTA","TTGA",2.22806813262746,15,2,12,38,2.45259901227958,4.32659664078233,7.8628285248403,101,"ENSG00000079974.19"
"37386","ENSG00000248049.8_362714",362706,362714,9,"ENSG00000248049.8",1,8,"VVVVVVVMV",0,8,0.884057971014493,105,111,133,136,145,151,162,165,"ATAATTA","ATCA","GCGATTT","CTGA",2.25486074546109,22,9,11,51,2.27385663755181,4.32656540182311,7.86279728588108,101,"ENSG00000079974.19"
"25683","ENSG00000182533.7_22402",22394,22402,9,"ENSG00000182533.7",1,8,"VVVVVVVMV",0,8,0.884057971014493,100,106,133,136,173,179,190,193,"AGGATTA","TGGA","GTGAGGA","CTGA",2.4306415733253,27,37,11,84,1.10192884511006,4.32655150015302,7.86278338421099,101,"ENSG00000079974.19"
"3470","ENSG00000084710.14_73257",73249,73257,9,"ENSG00000084710.14",0,NA,"VVVUVVVVV",1,8,0.880745341614907,115,121,133,136,151,157,167,170,"ATTAAAA","AAGA","GTGAGAA","CTGA",2.22016889882201,12,15,10,46,2.55807491051647,4.3398002256658,7.86278159212543,101,"ENSG00000079974.19"
"46993","ENSG00000287469.1_6242",6234,6242,9,"ENSG00000287469.1",1,5,"VVVVMUVVV",1,7,0.808695652173913,66,72,88,91,108,114,133,136,"CTCATGA","ATGA","CTGTTGT","CTGA",2.50059671220601,16,17,19,61,1.84127518321007,4.62797998281254,7.86276259150819,101,"ENSG00000079974.19"
"2785","ENSG00000078295.17_215839",215831,215839,9,"ENSG00000078295.17",1,2,"VMUVVVVVV",1,7,0.767701863354037,112,118,133,136,144,150,184,187,"CTGATGA","CAGA","GGGGTGC","CTGA",2.58121990305156,15,8,34,66,1.95966634489796,4.79194975797709,7.86275721139323,101,"ENSG00000079974.19"
"22203","ENSG00000169946.14_300323",300315,300323,9,"ENSG00000169946.14",1,3,"VVMVVVVVV",0,8,0.882815734989648,116,122,133,136,174,180,193,196,"ATGTTTA","ATTA","TTGAAGG","CTGA",2.31314341215515,11,38,13,71,1.90495234798196,4.33147710725407,7.86274004721267,101,"ENSG00000079974.19"
"8535","ENSG00000119487.17_266104",266096,266104,9,"ENSG00000119487.17",1,3,"VVMVVVVVV",0,8,0.882815734989648,63,69,84,87,90,96,133,136,"GTGATGG","TTGA","ATGAAAA","TTGA",2.35183707015191,15,3,37,64,1.64689898327376,4.33145319607163,7.86271613603022,101,"ENSG00000079974.19"
"23477","ENSG00000173040.13_147673",147665,147673,9,"ENSG00000173040.13",1,8,"VVVVVVVMV",0,8,0.884057971014493,96,102,133,136,137,143,156,159,"AGGATGA","ATGA","CTGATAA","CTGT",2.40432518990238,31,1,13,54,1.27698136010346,4.32645398986316,7.86268587392114,101,"ENSG00000079974.19"
"46807","ENSG00000287215.1_27138",27130,27138,9,"ENSG00000287215.1",1,8,"VVVVUVVMV",1,7,0.773913043478261,21,27,39,42,75,81,133,136,"ATGATGA","ATGT","ATGAAGA","CTGA",2.70555360585867,12,33,52,106,1.03093141175042,4.76698886270206,7.86264103661511,101,"ENSG00000079974.19"
"29524","ENSG00000198130.16_80398",80390,80398,9,"ENSG00000198130.16",1,1,"MVVVVUVVV",1,7,0.82815734989648,115,121,133,136,142,148,159,162,"ATTGTGG","AAGA","ATGCTGA","CTGA",2.2755691186431,12,6,11,38,3.02956426608759,4.5500062642604,7.86263566384632,101,"ENSG00000079974.19"
"17398","ENSG00000154080.14_171996",171988,171996,9,"ENSG00000154080.14",0,NA,"VVUUVVVVV",2,7,0.764389233954451,114,120,133,136,147,153,170,173,"ATGTTGT","CTGA","ATATTCA","CTGA",2.50365971122852,13,11,17,50,2.52909524765885,4.80503999729558,7.86259693311338,101,"ENSG00000079974.19"
"39292","ENSG00000253438.5_289760",289752,289760,9,"ENSG00000253438.5",1,8,"VVVVVVVMV",0,8,0.884057971014493,114,120,133,136,147,153,164,167,"TTGGTGG","CTGA","GAGCAGA","CTGT",2.17201332482296,13,11,11,44,2.82518629178893,4.32631878098549,7.86255066504346,101,"ENSG00000079974.19"
"18261","ENSG00000156687.11_53054",53046,53054,9,"ENSG00000156687.11",1,2,"VMVVVVVVV",0,8,0.884057971014493,110,116,133,136,144,150,162,165,"AAGATAT","CTTT","GTAATGC","CTGA",2.19018802159013,17,8,12,46,2.70380730046761,4.32626519443378,7.86249707849175,101,"ENSG00000079974.19"
"39354","ENSG00000253508.1_1750",1742,1750,9,"ENSG00000253508.1",1,2,"UMVVVVVVV",1,7,0.786749482401656,68,74,86,89,103,109,133,136,"TTGATGC","CTAA","GTGAGGC","CTGA",2.53876645384791,12,14,24,59,1.93674848997233,4.71546454557294,7.86246247517956,101,"ENSG00000079974.19"
"7808","ENSG00000115806.13_15642",15634,15642,9,"ENSG00000115806.13",1,8,"VVVVVUVMV",1,7,0.806211180124224,113,119,133,136,174,180,190,193,"AAGATGA","AAGA","GTATTGA","CTGA",2.48633153066698,14,38,10,71,1.97489844655056,4.63761049608261,7.8624552165795,101,"ENSG00000079974.19"
"19078","ENSG00000160862.13_6220",6212,6220,9,"ENSG00000160862.13",1,1,"MVVVVUVVV",1,7,0.82815734989648,99,105,133,136,156,162,181,184,"ATAAAGA","GTGA","GTGATGA","CTGA",2.59017270176288,28,20,19,76,0.931305172283719,4.54978079600906,7.86241019559498,101,"ENSG00000079974.19"
"39702","ENSG00000254101.8_319704",319696,319704,9,"ENSG00000254101.8",1,7,"VVUVVVMVV",1,7,0.768944099378882,103,109,133,136,145,151,159,162,"ATTATGA","CAGA","AGTATGA","CTGA",2.54954492355548,24,9,8,50,2.1495096157715,4.786618943202,7.86239534071753,101,"ENSG00000079974.19"
"8847","ENSG00000120992.18_36965",36957,36965,9,"ENSG00000120992.18",1,8,"VVVUVVVMV",1,7,0.764803312629399,108,114,133,136,146,152,174,177,"ATGTTGA","CAGA","ATGATAG","CTGA",2.59949789567015,19,10,22,60,1.8826188541332,4.80315120631688,7.86236445683448,101,"ENSG00000079974.19"
"39069","ENSG00000251574.8_680897",680889,680897,9,"ENSG00000251574.8",1,5,"VVVVMVVVV",0,8,0.886542443064182,101,107,133,136,145,151,159,162,"CTGAGGG","TAGA","TTGAGGG","CTGA",2.27999025355131,26,9,8,52,2.06460964533119,4.31613616725165,7.86230593950838,101,"ENSG00000079974.19"
"16521","ENSG00000151746.15_221025",221017,221025,9,"ENSG00000151746.15",1,5,"VVVVMVUVV",1,7,0.772670807453416,73,79,91,94,112,118,133,136,"CTGATGA","ATGA","ATGATGA","TTGA",2.53445072276587,12,18,15,54,2.19009893408361,4.77160927146402,7.86229250127769,101,"ENSG00000079974.19"
"7229","ENSG00000113361.13_46501",46493,46501,9,"ENSG00000113361.13",1,1,"MVVVVVUVV",1,7,0.792132505175983,84,90,105,108,111,117,133,136,"GTCATGA","TTGA","ATATTAA","CTGA",2.45906403338518,15,3,16,43,2.38126857839063,4.69375720023963,7.86228722094356,101,"ENSG00000079974.19"
"35718","ENSG00000236856.1_28182",28174,28182,9,"ENSG00000236856.1",1,8,"VVVVVUVMV",1,7,0.806211180124224,114,120,133,136,147,153,180,183,"CAGATGA","CCCA","CTGATGA","CTGA",2.47732357287898,13,11,27,60,2.03425866018871,4.63743728651214,7.86228200700903,101,"ENSG00000079974.19"
"22833","ENSG00000171502.15_272543",272535,272543,9,"ENSG00000171502.15",1,2,"VMVVVVVVV",0,8,0.884057971014493,85,91,133,136,140,146,156,159,"TTAAAGA","ATGA","TAGAGGA","CTGA",2.31986807204503,42,4,10,65,1.83838860571952,4.3260439381716,7.86227582222957,101,"ENSG00000079974.19"
"22142","ENSG00000169862.21_810625",810617,810625,9,"ENSG00000169862.21",1,8,"UVVVVVVMV",1,7,0.786749482401656,111,117,133,136,153,159,186,189,"AAGATGA","TTGA","GTTAGGA","CTGA",2.60871582437872,16,17,27,69,1.46959292302708,4.71525793805463,7.86225586766125,101,"ENSG00000079974.19"
"7257","ENSG00000113396.13_487624",487616,487624,9,"ENSG00000113396.13",1,8,"UVVVVVVMV",1,7,0.786749482401656,109,115,133,136,149,155,164,167,"ATCATGA","CTCA","GTGATGA","GTGA",2.47510008142771,18,13,9,49,2.36032871908099,4.71524898214977,7.86224691175639,101,"ENSG00000079974.19"
"2432","ENSG00000074603.19_28330",28322,28330,9,"ENSG00000074603.19",1,2,"VMVVVVVVV",0,8,0.884057971014493,110,116,133,136,145,151,161,164,"ATAATGA","TTGT","TTAATGC","CTCA",2.18885419219508,17,9,10,45,2.711575168361,4.32598411241538,7.86221599647335,101,"ENSG00000079974.19"
"37440","ENSG00000248199.2_25393",25385,25393,9,"ENSG00000248199.2",1,1,"MVVVVUVVV",1,7,0.82815734989648,112,118,133,136,187,193,211,214,"GTCATGT","CTGC","ATGAAGA","CTGA",2.49781289609709,15,51,18,93,1.54624017947733,4.54958153836448,7.8622109379504,101,"ENSG00000079974.19"
"16305","ENSG00000151320.11_48328",48320,48328,9,"ENSG00000151320.11",1,2,"VMVVVVVVV",0,8,0.884057971014493,49,55,70,73,88,94,133,136,"ATGCTGA","ATGA","GTGTGGA","CTGC",2.37233549908241,15,15,39,78,1.48824104397198,4.32595275946369,7.86218464352166,101,"ENSG00000079974.19"
"45902","ENSG00000286040.1_18927",18919,18927,9,"ENSG00000286040.1",1,8,"VVVVVVVMV",0,8,0.884057971014493,114,120,133,136,139,145,155,158,"GTGAGGA","ATCA","GTTAAGA","CTAA",2.17134420659765,13,3,10,35,2.82812012749484,4.3259370428698,7.86216892692777,101,"ENSG00000079974.19"
"8486","ENSG00000119125.17_86740",86732,86740,9,"ENSG00000119125.17",1,3,"VVMVVUVVV",1,7,0.804968944099379,114,120,133,136,185,191,201,204,"ATGATGT","GTGC","ATCATTA","CTGA",2.48587607831926,13,49,10,81,1.99666168092245,4.64229221742937,7.86216799382689,101,"ENSG00000079974.19"
"15358","ENSG00000148053.18_322397",322389,322397,9,"ENSG00000148053.18",1,8,"VVVVUVVMV",1,7,0.773913043478261,102,108,133,136,151,157,166,169,"ATGATGC","CTGC","AGGAAGA","CTGA",2.60122417611387,25,15,9,58,1.72418905900322,4.76642089160726,7.86207306552031,101,"ENSG00000079974.19"
"45924","ENSG00000286046.1_432132",432124,432132,9,"ENSG00000286046.1",1,8,"UVVVVVVMV",1,7,0.786749482401656,116,122,133,136,147,153,164,167,"GTGATTT","CAGA","ATTTTGA","CTGA",2.40706115979878,11,11,11,42,2.81308666297025,4.71504026540719,7.86203819501382,101,"ENSG00000079974.19"
"11990","ENSG00000136828.19_283553",283545,283553,9,"ENSG00000136828.19",1,8,"VVVUVVVMV",1,7,0.764803312629399,33,39,55,58,108,114,133,136,"GTGATGA","CAGA","TTGGTGC","CTGA",2.66958196174045,16,50,19,94,1.41406561901408,4.80281967432094,7.86203292483854,101,"ENSG00000079974.19"
"16223","ENSG00000151150.22_636591",636583,636591,9,"ENSG00000151150.22",0,NA,"VVVVUVVVV",1,8,0.889855072463768,103,109,133,136,150,156,168,171,"ATTATGA","CTTA","TTGTTTA","CTTA",2.31173514323162,24,14,12,59,1.79884772119209,4.30260383568405,7.86202412553912,101,"ENSG00000079974.19"
"37084","ENSG00000245248.9_132760",132752,132760,9,"ENSG00000245248.9",1,1,"MVVVUVVVV",1,7,0.795859213250517,115,121,133,136,154,160,176,179,"GAGATGT","CTGT","CTGAAGA","CTGA",2.48738467694054,12,18,16,55,2.13148180977598,4.67851158067822,7.86194843368029,101,"ENSG00000079974.19"
"20912","ENSG00000165973.19_749688",749680,749688,9,"ENSG00000165973.19",1,2,"UMVVVVVVV",1,7,0.786749482401656,114,120,133,136,152,158,170,173,"CTGGTAA","GTGA","ATGATGA","CTGA",2.46248335044967,13,16,12,50,2.44308430673262,4.71490999409928,7.8619079237059,101,"ENSG00000079974.19"
"40763","ENSG00000257551.1_40990",40982,40990,9,"ENSG00000257551.1",1,2,"VMVVVUVVV",1,7,0.806211180124223,107,113,133,136,145,151,163,166,"ATGATTA","AAGA","GTCACAA","CTGA",2.42226989493103,20,9,12,50,2.39976739252331,4.63705833968255,7.86190306017944,101,"ENSG00000079974.19"
"32562","ENSG00000227197.1_7643",7635,7643,9,"ENSG00000227197.1",1,8,"VVVVVVVMV",0,8,0.884057971014493,114,120,133,136,168,174,227,230,"ATGATCT","CTAA","ATAATTA","CTGA",2.44055267902863,13,32,53,107,1.03212607712654,4.32561931766269,7.86185120172066,101,"ENSG00000079974.19"
"10059","ENSG00000129003.19_95998",95990,95998,9,"ENSG00000129003.19",0,NA,"VVVVUUVVV",2,7,0.812008281573499,115,121,133,136,152,158,171,174,"GTGGTGG","CTTA","GAGAAGA","CTGA",2.40698334283761,12,16,13,50,2.40868406116155,4.61380992001974,7.86184304631374,101,"ENSG00000079974.19"
"8051","ENSG00000116675.16_68965",68957,68965,9,"ENSG00000116675.16",1,8,"VVVVVVVMV",0,8,0.884057971014493,106,112,133,136,146,152,200,203,"ATCTTGA","ATGT","ATGAAGA","CTGA",2.39856701446841,21,10,48,88,1.31188651413236,4.32558331931378,7.86181520337175,101,"ENSG00000079974.19"
"48022","ENSG00000290094.1_6882",6874,6882,9,"ENSG00000290094.1",1,8,"VVVVVVVMV",0,8,0.884057971014493,106,112,133,136,146,152,200,203,"ATCTTGA","ATGT","ATGAAGA","CTGA",2.39856701446841,21,10,48,88,1.31188651413236,4.32558331931378,7.86181520337175,101,"ENSG00000079974.19"
"17006","ENSG00000152953.13_165179",165171,165179,9,"ENSG00000152953.13",1,6,"VVUVVMVVV",1,7,0.786335403726708,85,91,133,136,149,155,180,183,"ATGAGGA","CAGA","GTGATGG","CTGA",2.68468005869061,42,13,25,89,0.967953432786716,4.71645512268103,7.86179673758786,101,"ENSG00000079974.19"
"19915","ENSG00000163982.6_19389",19381,19389,9,"ENSG00000163982.6",1,8,"VVVVVVVMV",0,8,0.884057971014493,102,108,133,136,147,153,161,164,"ATGGTAA","TTTA","ATAATGT","CTGA",2.29726328249604,25,11,8,53,1.9871645314333,4.32556327035173,7.8617951544097,101,"ENSG00000079974.19"
"18257","ENSG00000156687.11_405179",405171,405179,9,"ENSG00000156687.11",1,2,"UMVVVVVVV",1,7,0.786749482401656,99,105,133,136,149,155,175,178,"AGGATGA","CTGA","ATTATAT","CTGA",2.63559468519331,28,13,20,70,1.28854436712236,4.71479390043611,7.86179183004273,101,"ENSG00000079974.19"
"9925","ENSG00000128512.24_322580",322572,322580,9,"ENSG00000128512.24",0,NA,"VVVVUVVVV",1,8,0.889855072463768,107,113,133,136,141,147,166,169,"GTGATAG","ATCA","GTCATAA","CTGA",2.28180849861298,20,5,19,53,1.99726370870494,4.30233009153119,7.86175038138627,101,"ENSG00000079974.19"
"35154","ENSG00000235127.1_944",936,944,9,"ENSG00000235127.1",1,8,"VVVVVUVMV",1,7,0.806211180124224,75,81,103,106,114,120,133,136,"TTGAGGA","CAGA","GAGAATA","CTGA",2.44567141128174,22,8,13,52,2.24307029528884,4.6368865926251,7.861731313122,101,"ENSG00000079974.19"
"46853","ENSG00000287291.1_85346",85338,85346,9,"ENSG00000287291.1",1,8,"VVVVVUVMV",1,7,0.806211180124224,75,81,103,106,114,120,133,136,"TTGAGGA","CAGA","GAGAATA","CTGA",2.44567141128174,22,8,13,52,2.24307029528884,4.6368865926251,7.861731313122,101,"ENSG00000079974.19"
"24596","ENSG00000177119.17_111305",111297,111305,9,"ENSG00000177119.17",1,2,"VMVVVUVVV",1,7,0.806211180124223,79,85,102,105,116,122,133,136,"ATGAAAA","TTGA","GGGAAAA","CTGA",2.39545896748654,17,11,11,48,2.57770401839711,4.63685761707684,7.86170233757373,101,"ENSG00000079974.19"
"30524","ENSG00000205549.10_153217",153209,153217,9,"ENSG00000205549.10",1,6,"VVVVVMUVV",1,7,0.788819875776397,92,98,133,136,145,151,176,179,"TTGATGA","CTGC","GTGGTCA","CTGA",2.63900980048207,35,9,25,78,1.23228991298126,4.70642214571543,7.86170164882102,101,"ENSG00000079974.19"
"34159","ENSG00000232006.9_146308",146300,146308,9,"ENSG00000232006.9",1,8,"VVVVVVVMV",0,8,0.884057971014493,35,41,55,58,107,113,133,136,"GTGATGA","GTGA","GAGTCGA","CTCA",2.37303974831972,14,49,20,92,1.48141503511813,4.32542000597906,7.86165189003703,101,"ENSG00000079974.19"
"36081","ENSG00000237844.2_605047",605039,605047,9,"ENSG00000237844.2",1,3,"VVMVUVVVV",1,7,0.772670807453416,112,118,133,136,146,152,161,164,"ACAATGA","TTCA","CTGATGA","CTGA",2.43973335998936,15,10,9,43,2.81870118800301,4.77089756364969,7.86158079346336,101,"ENSG00000079974.19"
"27920","ENSG00000187672.15_457819",457811,457819,9,"ENSG00000187672.15",1,5,"VVVVMUVVV",1,7,0.808695652173913,90,96,133,136,139,145,154,157,"CTGATGA","CTCA","AAAATAA","CTGA",2.52048150116406,37,3,9,58,1.70374238826806,4.62673809900712,7.86152070770277,101,"ENSG00000079974.19"
"45688","ENSG00000285784.1_366699",366691,366699,9,"ENSG00000285784.1",1,1,"MVUVVVVVV",1,7,0.789648033126294,56,62,81,84,115,121,133,136,"ATGATGA","CTGA","GTGAGTT","CTCA",2.58515323359073,19,31,12,71,1.5773583229272,4.70292830338302,7.8615204358882,101,"ENSG00000079974.19"
"38370","ENSG00000250049.7_63640",63632,63640,9,"ENSG00000250049.7",1,8,"VVVVVVVMV",0,8,0.884057971014493,85,91,133,136,169,175,187,190,"TTGATGA","CACA","GTACTGC","CTGA",2.4469617801526,42,33,12,96,0.987994129581876,4.32526816598314,7.86150005004111,101,"ENSG00000079974.19"
"18007","ENSG00000155975.10_53214",53206,53214,9,"ENSG00000155975.10",1,2,"VMVVVUVVV",1,7,0.806211180124223,67,73,84,87,99,105,133,136,"ATGATTT","CTGT","GTGTTGG","CTGA",2.49470529148592,11,12,28,60,1.91514882848303,4.6366293595973,7.86147408009419,101,"ENSG00000079974.19"
"26383","ENSG00000184060.11_47689",47681,47689,9,"ENSG00000184060.11",1,8,"VVVVVVVMV",0,8,0.884057971014493,97,103,133,136,181,187,199,202,"ATCATGA","GTCA","TTGCTGG","CTGA",2.44449794875463,30,45,12,96,1.00429999964903,4.32523824783664,7.86147013189461,101,"ENSG00000079974.19"
"30583","ENSG00000205885.8_4683",4675,4683,9,"ENSG00000205885.8",1,8,"VVVVVVVMV",0,8,0.884057971014493,107,113,133,136,155,161,177,180,"AGGGTGA","AAGA","ATGTAGA","CTGA",2.35937352555531,20,19,16,64,1.57161840787494,4.32519381122758,7.86142569528555,101,"ENSG00000079974.19"
"48166","ENSG00000290551.1_521338",521330,521338,9,"ENSG00000290551.1",0,NA,"UVVVVUVVV",2,7,0.824844720496894,105,111,133,136,147,153,168,171,"TTGGTAA","CCGA","CTGATGA","CTGA",2.43882008006907,22,11,15,57,1.98920374431963,4.56200106952835,7.86137995151593,101,"ENSG00000079974.19"
"38776","ENSG00000251026.2_122328",122320,122328,9,"ENSG00000251026.2",0,NA,"VVVUVVVVV",1,8,0.880745341614907,104,110,133,136,160,166,180,183,"ATGATGT","ATGT","AACATGG","CTGA",2.40937895776315,23,24,14,70,1.29106530345084,4.33839792213463,7.86137928859426,101,"ENSG00000079974.19"
"19250","ENSG00000162620.16_118987",118979,118987,9,"ENSG00000162620.16",1,1,"MVVVVUVVV",1,7,0.82815734989648,106,112,133,136,142,148,158,161,"ATGATGT","CTTA","TTGAACA","CTTA",2.36956424306186,21,6,10,46,2.39770287043562,4.54869945604534,7.86132885563127,101,"ENSG00000079974.19"
"19321","ENSG00000162736.18_1862",1854,1862,9,"ENSG00000162736.18",1,5,"UVVVMVVVV",1,7,0.789233954451346,111,117,133,136,146,152,166,169,"AAGATCA","ATGA","CTGGTGG","CTGA",2.43132594841117,16,10,14,49,2.60866090854085,4.70437514115382,7.86131095895921,101,"ENSG00000079974.19"
"4800","ENSG00000101935.13_31009",31001,31009,9,"ENSG00000101935.13",0,NA,"VVVVUUVVV",2,7,0.812008281573499,114,120,133,136,145,151,174,177,"AAGAGGA","CTGG","ATTAGGA","CTGA",2.42218704516384,13,9,23,54,2.30497654503905,4.61322254486616,7.86125567116015,101,"ENSG00000079974.19"
"10940","ENSG00000133136.6_31063",31055,31063,9,"ENSG00000133136.6",0,NA,"VVVVUUVVV",2,7,0.812008281573499,114,120,133,136,145,151,174,177,"AAGAGGA","CTGG","ATTAGGA","CTGA",2.42218704516384,13,9,23,54,2.30497654503905,4.61322254486616,7.86125567116015,101,"ENSG00000079974.19"
"26492","ENSG00000184305.16_409228",409220,409228,9,"ENSG00000184305.16",1,8,"VVVVVUVMV",1,7,0.806211180124224,106,112,133,136,141,147,158,161,"TTGATTA","ATGA","ATGGCAA","CTGA",2.43216190036524,21,5,11,46,2.33115643769412,4.63639227669893,7.86123699719582,101,"ENSG00000079974.19"
"26933","ENSG00000185345.24_1005497",1005489,1005497,9,"ENSG00000185345.24",1,2,"VMVVVVVVV",0,8,0.884057971014493,106,112,133,136,147,153,164,167,"ATTATGA","ATGC","ATTATGA","CTGG",2.26034896915301,21,11,11,52,2.23095793674881,4.32498776610889,7.86121965016686,101,"ENSG00000079974.19"
"24765","ENSG00000177822.10_75624",75616,75624,9,"ENSG00000177822.10",1,8,"VVVVVUVMV",1,7,0.806211180124224,116,122,133,136,185,191,203,206,"GTAATAA","CTGA","TTGAACA","CTGA",2.49171945631235,11,49,12,81,1.9339283015469,4.6363478359073,7.86119255640419,101,"ENSG00000079974.19"
"18541","ENSG00000157625.16_26929",26921,26929,9,"ENSG00000157625.16",1,2,"VMVVVVVVV",0,8,0.884057971014493,110,116,133,136,148,154,166,169,"CTCATTA","TAGA","ATTATGG","CTGA",2.22302273557462,17,12,12,50,2.47967032432243,4.32495547370497,7.86118735776295,101,"ENSG00000079974.19"
"16736","ENSG00000152208.13_483795",483787,483795,9,"ENSG00000152208.13",1,7,"UVVVVVMVV",1,7,0.787991718426501,109,115,133,136,145,151,164,167,"ATGAAGA","AAGA","GAGAGGT","CTGA",2.44494073311219,18,9,13,49,2.53725595815155,4.70921521139154,7.86118208509755,101,"ENSG00000079974.19"
"17781","ENSG00000155052.15_826751",826743,826751,9,"ENSG00000155052.15",1,7,"VVVUVVMVV",1,7,0.766045548654244,69,75,91,94,102,108,133,136,"GTGATGG","CTGG","GAGAGGA","CTGA",2.56356276280102,16,8,25,58,2.09756005506019,4.79699461843342,7.8611768130504,101,"ENSG00000079974.19"
"47227","ENSG00000287876.1_140296",140288,140296,9,"ENSG00000287876.1",0,NA,"UVVVVUVVV",2,7,0.824844720496894,106,112,133,136,143,149,164,167,"ATGGTGG","TTGG","TTGATGT","CTGA",2.40298314715609,21,7,15,52,2.22717570314514,4.5617658377131,7.86114471970068,101,"ENSG00000079974.19"
"36463","ENSG00000241170.3_34286",34278,34286,9,"ENSG00000241170.3",1,8,"UVVVVVVMV",1,7,0.786749482401656,114,120,133,136,143,149,159,162,"ATGATGA","AAGA","AGGATGG","CAGA",2.37241793101657,13,7,10,39,3.04039141490683,4.71412773875432,7.86112566836095,101,"ENSG00000079974.19"
"1426","ENSG00000055609.21_270554",270546,270554,9,"ENSG00000055609.21",0,NA,"VVVVUUVVV",2,7,0.812008281573499,111,117,133,136,142,148,164,167,"ATAATGA","CTTC","ACGTTGT","CTGA",2.38037809725739,16,6,16,47,2.58300164463542,4.61304723992117,7.86108036621517,101,"ENSG00000079974.19"
"21823","ENSG00000169083.18_25242",25234,25242,9,"ENSG00000169083.18",1,8,"VVVVVVVMV",0,8,0.884057971014493,112,118,133,136,144,150,171,174,"ATTATTA","CTTA","ATGATAA","CTGG",2.24138319787967,15,8,21,53,2.35657900258347,4.32478341377865,7.86101529783662,101,"ENSG00000079974.19"
"17471","ENSG00000154217.16_87298",87290,87298,9,"ENSG00000154217.16",1,2,"VMVVVVVVV",0,8,0.884057971014493,87,93,133,136,142,148,158,161,"ATGGTAA","TTCA","GTCCTGA","CTGA",2.2970904524382,40,6,10,65,1.98518518883741,4.32478038460635,7.86101226866432,101,"ENSG00000079974.19"
"19882","ENSG00000163873.10_154445",154437,154445,9,"ENSG00000163873.10",1,5,"VVVVMVUVV",1,7,0.772670807453416,114,120,133,136,150,156,166,169,"AAGATGA","CTGA","CTGAAGG","CTCA",2.4687639857508,13,14,10,46,2.62251187635804,4.7702346120075,7.86091784182117,101,"ENSG00000079974.19"
"21760","ENSG00000168887.11_2899",2891,2899,9,"ENSG00000168887.11",1,8,"VVVVVVVMV",0,8,0.884057971014493,107,113,133,136,187,193,203,206,"GAAATGA","TTGA","TGGAAGA","CTGA",2.37111890759602,20,51,10,90,1.49102476250019,4.32462103661841,7.86085292067638,101,"ENSG00000079974.19"
"44656","ENSG00000283258.2_24095",24087,24095,9,"ENSG00000283258.2",1,8,"VVVVVUVMV",1,7,0.806211180124224,62,68,78,81,115,121,133,136,"ATGAGGA","TTGA","GTGATGA","CTCA",2.49637280112686,10,34,12,65,1.90144526216629,4.63598265075301,7.8608273712499,101,"ENSG00000079974.19"
"17339","ENSG00000153930.13_618826",618818,618826,9,"ENSG00000153930.13",1,8,"VVUVVVVMV",1,7,0.767701863354037,15,21,37,40,82,88,133,136,"ATGATGA","CTGG","ATGCAGA","CTGA",2.74646517606468,16,42,45,112,0.850259586443143,4.79000685671858,7.86081431013473,101,"ENSG00000079974.19"
"39853","ENSG00000254349.6_213943",213935,213943,9,"ENSG00000254349.6",1,3,"VVMVVVVVV",0,8,0.882815734989648,116,122,133,136,168,174,185,188,"ACCATGA","ATCA","GTGAAAG","CTGA",2.29836302950237,11,32,11,63,1.99577562745395,4.3295489560341,7.8608118959927,101,"ENSG00000079974.19"
"15708","ENSG00000149256.16_496277",496269,496277,9,"ENSG00000149256.16",0,NA,"VVVVVVUVV",1,8,0.886128364389234,103,109,133,136,179,185,195,198,"GTGAAGA","CTTA","ACAATTA","CTGA",2.40647283100256,24,43,10,86,1.2220091854258,4.31629034802739,7.86080380558432,101,"ENSG00000079974.19"
"10844","ENSG00000132964.13_131070",131062,131070,9,"ENSG00000132964.13",1,2,"VMVVVVVVV",0,8,0.884057971014493,91,97,133,136,143,149,169,172,"AAGATGG","TTTA","ATGATTT","CTGA",2.36636119348042,36,7,20,72,1.52249637829045,4.32455941703998,7.86079130109795,101,"ENSG00000079974.19"
"38333","ENSG00000249998.1_84361",84353,84361,9,"ENSG00000249998.1",1,8,"VVVVVVVMV",0,8,0.884057971014493,75,81,94,97,106,112,133,136,"ATTGTGA","CTGA","ATGCTTC","CTGG",2.23369282744283,13,9,21,52,2.40678863774675,4.32451853850807,7.86075042256604,101,"ENSG00000079974.19"
"6477","ENSG00000110079.19_77844",77836,77844,9,"ENSG00000110079.19",1,8,"VVVVVVUMV",1,7,0.770186335403727,60,66,79,82,86,92,133,136,"ATAATGA","GTGA","GTTTTGA","CTGA",2.59043585526571,13,4,41,67,1.85012864096585,4.77992525235098,7.86067059396589,101,"ENSG00000079974.19"
"16964","ENSG00000152894.15_264717",264709,264717,9,"ENSG00000152894.15",1,8,"UVVVVVVMV",1,7,0.786749482401656,76,82,101,104,116,122,133,136,"CTGATAA","CTTA","TTGAAAA","CTGA",2.47885583945208,19,12,11,51,2.32893815951228,4.71366093896488,7.8606588685715,101,"ENSG00000079974.19"
"17392","ENSG00000154027.19_53095",53087,53095,9,"ENSG00000154027.19",1,7,"UVVVVVMVV",1,7,0.787991718426501,76,82,95,98,108,114,133,136,"ATTATGG","CTAA","ATAAAGA","CTGA",2.45475492158523,13,10,19,51,2.46958636945555,4.70865479500594,7.86062166871195,101,"ENSG00000079974.19"
"30065","ENSG00000203356.2_35736",35728,35736,9,"ENSG00000203356.2",1,7,"VVVVVVMVV",0,8,0.885300207039338,110,116,133,136,141,147,159,162,"GTGAGGA","GAGA","CTGAAAA","GTGA",2.19309625488678,17,5,12,43,2.65690039645844,4.31938552392591,7.86058635208326,101,"ENSG00000079974.19"
"5574","ENSG00000105887.11_14311",14303,14311,9,"ENSG00000105887.11",1,6,"UVVVVMVVV",1,7,0.805383022774327,115,121,133,136,142,148,184,187,"ATGCTGT","GTGA","ATGCTAA","CTGA",2.47919911128814,12,6,36,63,2.02804359386469,4.63900941727974,7.86054150837705,101,"ENSG00000079974.19"
"22742","ENSG00000171310.11_227527",227519,227527,9,"ENSG00000171310.11",1,8,"VVVVVUVMV",1,7,0.806211180124224,30,36,46,49,91,97,133,136,"ATGATGT","GTGA","ATGTTCA","CTGA",2.63615154934723,10,42,36,97,0.968396246067453,4.63568497709558,7.86052969759247,101,"ENSG00000079974.19"
"25310","ENSG00000180745.5_10418",10410,10418,9,"ENSG00000180745.5",1,8,"VVVVVVVMV",0,8,0.884057971014493,57,63,76,79,85,91,133,136,"GTCATGG","CTGA","ATGAACA","CTGG",2.2955806900761,13,6,42,70,1.99311382564857,4.32424627320565,7.86047815726362,101,"ENSG00000079974.19"
"9754","ENSG00000127083.8_9756",9748,9756,9,"ENSG00000127083.8",1,5,"VVVVMVVVV",0,8,0.886542443064182,85,91,133,136,141,147,159,162,"CTGAGGA","TTCA","AGGAATA","CTGA",2.305011879511,42,5,12,68,1.89018260891363,4.31423211808008,7.86040189033681,101,"ENSG00000079974.19"
"11416","ENSG00000134871.19_85753",85745,85753,9,"ENSG00000134871.19",0,NA,"VVVVVVUVV",1,8,0.886128364389234,91,97,104,107,116,122,133,136,"ATTAAGA","ATGA","TTGAGTA","CAGA",2.19188276351213,7,9,11,36,2.65067034085286,4.3158055244001,7.86031898195704,101,"ENSG00000079974.19"
"11874","ENSG00000136267.14_162859",162851,162859,9,"ENSG00000136267.14",1,1,"MVVUVVVVV",1,7,0.786749482401656,116,122,133,136,158,164,174,177,"TTGATGA","TTCA","CTAAAGA","CTGA",2.50120399170082,11,22,10,52,2.17858775081675,4.71332025720556,7.86031818681218,101,"ENSG00000079974.19"
"15591","ENSG00000148848.15_171988",171980,171988,9,"ENSG00000148848.15",0,NA,"VVUVVUVVV",2,7,0.805797101449275,85,91,104,107,114,120,133,136,"AGGCTGA","ATCA","GTGATTT","CTGA",2.34241516429418,13,7,13,42,2.93215203790703,4.6370632833004,7.8602516890975,101,"ENSG00000079974.19"
"46591","ENSG00000286863.2_400514",400506,400514,9,"ENSG00000286863.2",0,NA,"UVVVUVVVV",2,7,0.792546583850932,113,119,133,136,187,193,214,217,"ATGATGC","CGGA","AGGATGT","CTGA",2.60028761690135,14,51,21,95,1.42490910950262,4.69003997221123,7.86022630761496,101,"ENSG00000079974.19"
"37710","ENSG00000248690.8_349126",349118,349126,9,"ENSG00000248690.8",1,2,"VMUVVVVVV",1,7,0.767701863354037,109,115,133,136,152,158,176,179,"ATGATAA","CAGA","CTGAAGG","CTGA",2.60499342295466,18,16,18,61,1.79102955879543,4.7894130946233,7.86022054803944,101,"ENSG00000079974.19"
"18623","ENSG00000157890.19_129896",129888,129896,9,"ENSG00000157890.19",1,8,"VVUVVVVMV",1,7,0.767701863354037,111,117,133,136,186,192,207,210,"ATGATGG","CTGG","ATGTTGT","CTGA",2.62523217524452,16,50,15,90,1.65586411369649,4.78935298716499,7.86016044058114,101,"ENSG00000079974.19"
"25668","ENSG00000182463.16_251974",251966,251974,9,"ENSG00000182463.16",0,NA,"VVUVVVUVV",2,7,0.769772256728778,77,83,97,100,109,115,133,136,"ATAATGT","ATGA","TTGAGCA","CTGA",2.4859381978342,14,9,18,50,2.55130451144728,4.78105645758548,7.86014548450059,101,"ENSG00000079974.19"
"22670","ENSG00000171094.18_364797",364789,364797,9,"ENSG00000171094.18",1,5,"VVVVMVVVV",0,8,0.886542443064182,51,57,64,67,113,119,133,136,"CTTATGA","CTGA","TTGAGGG","TTGA",2.36556540835497,7,46,14,76,1.48519044333195,4.31390662475794,7.86007639701467,101,"ENSG00000079974.19"
"35999","ENSG00000237666.2_2935",2927,2935,9,"ENSG00000237666.2",1,8,"VVVVVVVMV",0,8,0.884057971014493,111,117,133,136,157,163,172,175,"TTGAGGT","CTCT","GTGAAGC","CTGA",2.28306215742902,16,21,9,55,2.0749300667701,4.32383611240756,7.86006799646553,101,"ENSG00000079974.19"
"3978","ENSG00000091513.16_3889",3881,3889,9,"ENSG00000091513.16",1,1,"MVVVVUVVV",1,7,0.82815734989648,110,116,133,136,148,154,167,170,"GAGAAGT","CTGG","GTGAGGA","CTGA",2.36234033580451,17,12,13,51,2.44044562503068,4.54734529926519,7.85997469885111,101,"ENSG00000079974.19"
"48373","ENSG00000291042.1_88003",87995,88003,9,"ENSG00000291042.1",1,1,"MVVVVUVVV",1,7,0.82815734989648,110,116,133,136,148,154,167,170,"GAGAAGT","CTGG","GTGAGGA","CTGA",2.36234033580451,17,12,13,51,2.44044562503068,4.54734529926519,7.85997469885111,101,"ENSG00000079974.19"
"15688","ENSG00000149256.16_168917",168909,168917,9,"ENSG00000149256.16",1,8,"VVVVVVVMV",0,8,0.884057971014493,109,115,133,136,148,154,165,168,"GGGATGT","CTTT","GTCACAA","CTGA",2.23142265557132,18,12,11,50,2.41874360150039,4.32372365966063,7.8599555437186,101,"ENSG00000079974.19"
"1260","ENSG00000050628.21_81970",81962,81970,9,"ENSG00000050628.21",1,5,"VVVVMVVVV",0,8,0.886542443064182,51,57,66,69,111,117,133,136,"TTGTGGA","TTGA","CTGAGAA","CTGA",2.34831217134318,9,42,16,76,1.59969060885869,4.31377627111998,7.8599460433767,101,"ENSG00000079974.19"
"181","ENSG00000006116.4_93737",93729,93737,9,"ENSG00000006116.4",1,2,"VMVVVVVVV",0,8,0.884057971014493,114,120,133,136,140,146,192,195,"AGGAAGA","CTTT","CTGAAGC","CTGA",2.31831099503993,13,4,46,72,1.83929691800515,4.32367588790118,7.85990777195915,101,"ENSG00000079974.19"
"45583","ENSG00000285713.1_757078",757070,757078,9,"ENSG00000285713.1",1,3,"VVMVVVVVV",0,8,0.882815734989648,112,118,133,136,144,150,169,172,"GTAAAGA","GAGA","GTTTGGA","CTGA",2.22639317701684,15,8,19,51,2.47186958003076,4.32862269003576,7.85988562999435,101,"ENSG00000079974.19"
"45669","ENSG00000285783.1_529857",529849,529857,9,"ENSG00000285783.1",1,3,"VVMVVVVVV",0,8,0.882815734989648,112,118,133,136,144,150,169,172,"GTAAAGA","GAGA","GTTTGGA","CTGA",2.22639317701684,15,8,19,51,2.47186958003076,4.32862269003576,7.85988562999435,101,"ENSG00000079974.19"
"28555","ENSG00000196104.11_262558",262550,262558,9,"ENSG00000196104.11",1,5,"VVVVMUVVV",1,7,0.808695652173913,112,118,133,136,142,148,164,167,"ATCATGC","CTTC","CTGCTGA","CTGA",2.37665997369982,15,6,16,46,2.65593009876324,4.62508248085717,7.85986508955282,101,"ENSG00000079974.19"
"46273","ENSG00000286417.1_77084",77076,77084,9,"ENSG00000286417.1",1,1,"MVVVUVVVV",1,7,0.795859213250517,116,122,133,136,149,155,172,175,"TTGAGGA","ATGA","TTCATTA","CTGA",2.45075430628563,11,13,17,50,2.36733560019922,4.67642441052585,7.85986126352792,101,"ENSG00000079974.19"
"27014","ENSG00000185420.19_504307",504299,504307,9,"ENSG00000185420.19",1,3,"VVMVVUVVV",1,7,0.804968944099379,114,120,133,136,138,144,154,157,"TTGGTGA","CTTA","ATCGTGC","CTGA",2.3808602168005,13,2,10,34,2.68753926072926,4.63998517651648,7.85986095291399,101,"ENSG00000079974.19"
"26979","ENSG00000185352.9_333320",333312,333320,9,"ENSG00000185352.9",1,5,"VVVVMVVVV",0,8,0.886542443064182,110,116,133,136,142,148,204,207,"ATGCTGT","CGGT","ATAATAA","CTGA",2.32729576081627,17,6,56,88,1.73934618920428,4.31366281532818,7.85983258758491,101,"ENSG00000079974.19"
"24218","ENSG00000175497.17_399785",399777,399785,9,"ENSG00000175497.17",1,7,"VVVVVVMVV",0,8,0.885300207039338,106,112,133,136,182,188,198,201,"ATTATGT","TGGA","TTGAAGG","CTGA",2.37937342974065,21,46,10,86,1.41190638596724,4.31859897939289,7.85979980755024,101,"ENSG00000079974.19"
"10207","ENSG00000129816.5_4369",4361,4369,9,"ENSG00000129816.5",1,7,"VVVVVVMVV",0,8,0.885300207039338,112,118,133,136,157,163,182,185,"GTGGGGC","CTCA","GTGAGGA","CTGA",2.33263400741061,15,21,19,64,1.72312103572933,4.31850360461668,7.85970443277403,101,"ENSG00000079974.19"
"10212","ENSG00000129845.5_4369",4361,4369,9,"ENSG00000129845.5",1,7,"VVVVVVMVV",0,8,0.885300207039338,112,118,133,136,157,163,182,185,"GTGGGGC","CTCA","GTGAGGA","CTGA",2.33263400741061,15,21,19,64,1.72312103572933,4.31850360461668,7.85970443277403,101,"ENSG00000079974.19"
"35794","ENSG00000237187.9_151958",151950,151958,9,"ENSG00000237187.9",1,7,"VVVVVVMVV",0,8,0.885300207039338,115,121,133,136,142,148,181,184,"AGGAAGC","TTGA","GTCAAAA","CTGA",2.28212206186179,12,6,33,60,2.05985659642896,4.31850091887689,7.85970174703424,101,"ENSG00000079974.19"
"20347","ENSG00000164707.16_11649",11641,11649,9,"ENSG00000164707.16",1,6,"VVVVVMUVV",1,7,0.788819875776397,111,117,133,136,142,148,177,180,"ATTAGGA","CAGA","GTGCTGA","CTGA",2.52704455400809,16,6,29,60,1.97063033689916,4.7043985075716,7.85967801067719,101,"ENSG00000079974.19"
"6131","ENSG00000108094.17_101884",101876,101884,9,"ENSG00000108094.17",1,3,"VVMVVVVVV",0,8,0.882815734989648,100,106,133,136,149,155,163,166,"ATGGTTA","TTTA","TTAATGA","CTGA",2.33048589068998,27,13,8,57,1.77694699120921,4.32837989895227,7.85964283891086,101,"ENSG00000079974.19"
"27038","ENSG00000185453.13_13892",13884,13892,9,"ENSG00000185453.13",0,NA,"VVVVUVVVV",1,8,0.889855072463768,78,84,103,106,113,119,133,136,"GAGATTC","CTGT","CTCATGC","CTGA",2.21271619671013,19,7,14,49,2.44938442174101,4.30020643328547,7.85962672314054,101,"ENSG00000079974.19"
"26497","ENSG00000184305.16_502963",502955,502963,9,"ENSG00000184305.16",1,1,"MVVVVUVVV",1,7,0.82815734989648,116,122,133,136,143,149,158,161,"AAGATAA","CTGA","GTGTCAA","CTTA",2.26676399784198,11,7,9,36,3.07598718949591,4.54693679377728,7.8595661933632,101,"ENSG00000079974.19"
"27690","ENSG00000187144.11_38225",38217,38225,9,"ENSG00000187144.11",0,NA,"VVUVVVVVV",1,8,0.883643892339545,110,116,133,136,147,153,182,185,"GGGAGGA","AAGA","TTGTTGA","CTGA",2.33404433035799,17,11,29,66,1.7390364937826,4.32483300737564,7.85940857673382,101,"ENSG00000079974.19"
"38751","ENSG00000250979.1_26981",26973,26981,9,"ENSG00000250979.1",1,8,"VVVVVVVMV",0,8,0.884057971014493,78,84,96,99,110,116,133,136,"AAGATGA","AGGA","CTCAAGA","CTTA",2.21378607991049,12,11,17,49,2.53406394811461,4.32315945354613,7.8593913376041,101,"ENSG00000079974.19"
"6553","ENSG00000110693.19_552827",552819,552827,9,"ENSG00000110693.19",1,8,"VVUVVVVMV",1,7,0.767701863354037,31,37,64,67,114,120,133,136,"ATGATGA","TTGA","GTGAGCC","CTGA",2.71961520735379,27,47,13,96,1.02353035512255,4.78857460103695,7.8593820544531,101,"ENSG00000079974.19"
"2397","ENSG00000074201.9_9346",9338,9346,9,"ENSG00000074201.9",0,NA,"VVUVVVVVV",1,8,0.883643892339545,113,119,133,136,145,151,168,171,"ATGAGGA","GTTA","GTGTAGT","CTAA",2.20282702600255,14,9,17,49,2.61329259943963,4.32470152653083,7.85927709588901,101,"ENSG00000079974.19"
"38969","ENSG00000251372.7_148309",148301,148309,9,"ENSG00000251372.7",1,2,"VMVVVVVVV",0,8,0.884057971014493,114,120,133,136,182,188,204,207,"AGGTTGA","TTTA","ATGATAG","CTGA",2.3303753244957,13,46,16,84,1.75626646115805,4.32302548944901,7.85925737350698,101,"ENSG00000079974.19"
"42105","ENSG00000260715.1_1120",1112,1120,9,"ENSG00000260715.1",1,7,"VVVVVVMVV",0,8,0.885300207039338,107,113,133,136,146,152,161,164,"GTGATTA","CTGG","TAGATAA","TTGA",2.23247591286383,20,10,9,48,2.38903788117283,4.31805265839959,7.85925348655694,101,"ENSG00000079974.19"
"33448","ENSG00000229855.9_126758",126750,126758,9,"ENSG00000229855.9",1,8,"VVVVVUVMV",1,7,0.806211180124224,113,119,133,136,143,149,159,162,"AGGAAGG","ATGA","GAGATGC","CTGA",2.33109158384194,14,7,10,40,2.99698625746431,4.63439920410264,7.85924392459954,101,"ENSG00000079974.19"
"14887","ENSG00000146005.4_29734",29726,29734,9,"ENSG00000146005.4",1,1,"MVUVVUVVV",2,6,0.711801242236025,108,114,133,136,139,145,156,159,"ATGATGG","CTGA","AGGGAGA","CTGA",2.66508456674741,19,3,11,42,2.28090284055374,5.01203332138412,7.85923829032822,101,"ENSG00000079974.19"
"25189","ENSG00000179915.25_265297",265289,265297,9,"ENSG00000179915.25",1,8,"UVVVVVVMV",1,7,0.786749482401656,102,108,133,136,143,149,164,167,"ATGAGGA","GTTA","TTGAAGA","CTGA",2.52899135997939,25,7,15,56,1.98885043786111,4.71219820943092,7.85919613903755,101,"ENSG00000079974.19"
"31310","ENSG00000222042.2_169157",169149,169157,9,"ENSG00000222042.2",0,NA,"VVVUVVVVV",1,8,0.880745341614907,112,118,133,136,144,150,162,165,"ATGAAGA","GTGT","ATGGAGG","CTGC",2.17227658910496,15,8,12,44,2.86287027441583,4.33617855044556,7.85915991690519,101,"ENSG00000079974.19"
"11062","ENSG00000133805.16_135802",135794,135802,9,"ENSG00000133805.16",1,3,"VVMVVUVVV",1,7,0.804968944099379,111,117,133,136,153,159,175,178,"CAGATGT","CAGA","GTGTTGA","CTGA",2.47988911522421,16,17,16,58,2.02452488249574,4.63927974599762,7.85915552239513,101,"ENSG00000079974.19"
"41970","ENSG00000260192.3_528744",528736,528744,9,"ENSG00000260192.3",1,1,"MVVVVUVVV",1,7,0.82815734989648,112,118,133,136,141,147,198,201,"ATGAAGA","CAGT","GTGAGTT","CTGA",2.45147444924384,15,5,51,80,1.84286607358615,4.54650726713628,7.8591366667222,101,"ENSG00000079974.19"
"16776","ENSG00000152217.20_330821",330813,330821,9,"ENSG00000152217.20",1,1,"MVVVUVVVV",1,7,0.795859213250517,113,119,133,136,142,148,168,171,"ATGATAT","ATAA","GTGATCA","CTGA",2.43561631316717,14,6,20,49,2.46530839725445,4.67568762125889,7.85912447426096,101,"ENSG00000079974.19"
"23351","ENSG00000172748.14_17657",17649,17657,9,"ENSG00000172748.14",1,2,"VMVVVVVVV",0,8,0.884057971014493,81,87,105,108,116,122,133,136,"CTGCTGA","CTGC","TGGAGGA","CTGG",2.19730143059136,18,8,11,46,2.64288057764558,4.32288919539699,7.85912107945496,101,"ENSG00000079974.19"
"25612","ENSG00000182240.16_12662",12654,12662,9,"ENSG00000182240.16",1,2,"VMVVVVVVV",0,8,0.884057971014493,81,87,105,108,116,122,133,136,"CTGCTGA","CTGC","TGGAGGA","CTGG",2.19730143059136,18,8,11,46,2.64288057764558,4.32288919539699,7.85912107945496,101,"ENSG00000079974.19"
"31678","ENSG00000224388.1_366",358,366,9,"ENSG00000224388.1",1,2,"VMVVVVVVV",0,8,0.884057971014493,81,87,105,108,116,122,133,136,"CTGCTGA","CTGC","TGGAGGA","CTGG",2.19730143059136,18,8,11,46,2.64288057764558,4.32288919539699,7.85912107945496,101,"ENSG00000079974.19"
"452","ENSG00000011677.13_4615",4607,4615,9,"ENSG00000011677.13",0,NA,"UVUVVVVVV",2,7,0.786335403726708,66,72,87,90,110,116,133,136,"AGGGTGA","CTGA","TTGTTGT","CTGA",2.54550409839974,15,20,17,61,1.88508541599542,4.71377818466509,7.85911979957192,101,"ENSG00000079974.19"
"18399","ENSG00000157193.18_83647",83639,83647,9,"ENSG00000157193.18",1,2,"VMVVVVUVV",1,7,0.770186335403727,114,120,133,136,153,159,182,185,"ATGATGA","TGGA","GTGACTT","CTGA",2.59965317711328,13,17,23,62,1.78241619050185,4.77835934281427,7.85910468442918,101,"ENSG00000079974.19"
"2300","ENSG00000072786.13_56504",56496,56504,9,"ENSG00000072786.13",1,8,"VVVVVVVMV",0,8,0.884057971014493,64,70,83,86,96,102,133,136,"ATTATTT","TTGA","TTTATTA","CTGA",2.29354673856743,13,10,31,63,2.00097704281049,4.322822158315,7.85905404237297,101,"ENSG00000079974.19"
"32051","ENSG00000225718.2_193505",193497,193505,9,"ENSG00000225718.2",1,7,"VVVVVVMVV",0,8,0.885300207039338,113,119,133,136,150,156,164,167,"TTGATAG","CAAA","CTTGTGA","CTGA",2.2047265531649,14,14,8,45,2.57287265732546,4.31776241960619,7.85896324776354,101,"ENSG00000079974.19"
"16202","ENSG00000151131.11_40372",40364,40372,9,"ENSG00000151131.11",1,2,"VMVVVVVVV",0,8,0.884057971014493,57,63,76,79,111,117,133,136,"GTGTTAA","CTGC","TTTATGT","CTGA",2.32522949759626,13,32,16,70,1.78937259125737,4.32272564380811,7.85895752786608,101,"ENSG00000079974.19"
"5477","ENSG00000105053.11_37243",37235,37243,9,"ENSG00000105053.11",1,1,"MVUVVVVVV",1,7,0.789648033126294,64,70,82,85,109,115,133,136,"GTGCTGA","ATGA","ATGAGGG","CTGA",2.55276309436093,12,24,18,63,1.78288803301607,4.70032716552223,7.85891929802741,101,"ENSG00000079974.19"
"21059","ENSG00000166349.11_5929",5921,5929,9,"ENSG00000166349.11",1,2,"VMVVVVVVV",0,8,0.884057971014493,115,121,133,136,149,155,169,172,"ATGGTGT","CTGT","TTGTTGG","TTGA",2.20846689135704,12,13,14,48,2.56750450935278,4.32265427959993,7.8588861636579,101,"ENSG00000079974.19"
"19152","ENSG00000162236.13_20989",20981,20989,9,"ENSG00000162236.13",1,8,"VVVVVUVMV",1,7,0.806211180124224,114,120,133,136,180,186,200,203,"AAGATGA","GAGA","GTGGTTA","CTGA",2.49989102648946,13,44,14,80,1.87021376816018,4.63403848618915,7.85888320668604,101,"ENSG00000079974.19"
"12795","ENSG00000139144.11_238389",238381,238389,9,"ENSG00000139144.11",0,NA,"VVVUUVVVV",2,7,0.770600414078675,114,120,133,136,150,156,212,215,"GAGATGA","CTGA","GTGCAGG","CTGA",2.62303931268954,13,14,56,92,1.61898065399844,4.77647735131551,7.85887900763021,101,"ENSG00000079974.19"
"39075","ENSG00000251574.8_980127",980119,980127,9,"ENSG00000251574.8",1,3,"VVMVVVUVV",1,7,0.768944099378882,94,100,133,136,144,150,160,163,"CTAATGA","CTGA","ATGGAGG","CTGA",2.56931129479868,33,8,10,60,2.00349172395447,4.78305842231975,7.85883481983528,101,"ENSG00000079974.19"
"3375","ENSG00000083067.25_684062",684054,684062,9,"ENSG00000083067.25",1,8,"VVVUVVVMV",1,7,0.764803312629399,113,119,133,136,146,152,161,164,"ATGGTGT","CTGG","CAGAAGA","CTGA",2.44803777901343,14,10,9,42,2.87814824916497,4.79960002731362,7.85881327783121,101,"ENSG00000079974.19"
"38210","ENSG00000249787.2_54992",54984,54992,9,"ENSG00000249787.2",0,NA,"VVVVVVUVV",1,8,0.886128364389234,113,119,133,136,149,155,173,176,"ATGATGC","GTAA","TTGTAGA","CTTA",2.24442803615128,14,13,18,54,2.29419522757255,4.3142622004786,7.85877565803553,101,"ENSG00000079974.19"
"14180","ENSG00000144535.20_181040",181032,181040,9,"ENSG00000144535.20",1,8,"VVVVVVVMV",0,8,0.884057971014493,111,117,133,136,145,151,201,204,"AGGATCA","GTGT","CTGAGAA","CTGA",2.32487249772151,16,9,50,84,1.79092913061742,4.32251977885688,7.85875166291485,101,"ENSG00000079974.19"
"32043","ENSG00000225689.2_858316",858308,858316,9,"ENSG00000225689.2",0,NA,"VVVVVVUVV",1,8,0.886128364389234,85,91,101,104,106,112,133,136,"GTGAAGT","CTGA","TTGAAGG","ATGA",2.30019394425931,10,2,21,42,1.92225685029,4.31422078633802,7.85873424389495,101,"ENSG00000079974.19"
"30852","ENSG00000214113.11_129173",129165,129173,9,"ENSG00000214113.11",1,8,"VVVVVVVMV",0,8,0.884057971014493,107,113,133,136,165,171,185,188,"GTGAGGA","ATGG","CTAATAA","CTGA",2.38004858218055,20,29,14,72,1.42300762618296,4.32249954351332,7.85873142757129,101,"ENSG00000079974.19"
"1708","ENSG00000065534.20_128574",128566,128574,9,"ENSG00000065534.20",1,2,"VMVVVVVVV",0,8,0.884057971014493,105,111,133,136,160,166,183,186,"TTGATGA","CAGC","GTGATGA","CTGG",2.41629158007142,22,24,17,72,1.18134880656226,4.32248983509293,7.8587217191509,101,"ENSG00000079974.19"
"24325","ENSG00000175792.12_8554",8546,8554,9,"ENSG00000175792.12",0,NA,"VVVVVVUVV",1,8,0.886128364389234,115,121,133,136,145,151,168,171,"ATGGTGT","CAGA","GTGTCCA","CTGG",2.19084762578134,12,9,17,47,2.6511251156644,4.31419398855167,7.85870744610861,101,"ENSG00000079974.19"
"16580","ENSG00000151812.15_325691",325683,325691,9,"ENSG00000151812.15",1,5,"VVVVMVVVV",0,8,0.886542443064182,87,93,133,136,147,153,190,193,"CTGAGGA","ATGA","ATGCAAA","CTGA",2.45653891499455,40,11,37,97,0.873187770711126,4.31252846766869,7.85869823992542,101,"ENSG00000079974.19"
"27196","ENSG00000185737.13_423731",423723,423731,9,"ENSG00000185737.13",1,1,"MVVVVUVVV",1,7,0.82815734989648,65,71,81,84,92,98,133,136,"ATGTAGA","CTCA","GTGTTCA","CTGA",2.43376661055009,10,8,35,62,1.95894991099673,4.54601516199933,7.85864456158525,101,"ENSG00000079974.19"
"9970","ENSG00000128595.17_9085",9077,9085,9,"ENSG00000128595.17",1,2,"UMVVVVVVV",1,7,0.786749482401656,110,116,133,136,139,145,155,158,"ATGAAGG","CTCA","GTAATAA","CTGA",2.45188843959508,17,3,10,39,2.50064968307193,4.71164315342646,7.85864108303308,101,"ENSG00000079974.19"
"27752","ENSG00000187323.12_1180396",1180388,1180396,9,"ENSG00000187323.12",1,8,"VVVVVVVMV",0,8,0.884057971014493,101,107,133,136,140,146,194,197,"TTGGTGA","CTGC","GTGAGCT","CTGA",2.44714556503985,26,4,48,87,0.975224319063795,4.32238202149903,7.858613905557,101,"ENSG00000079974.19"
"47259","ENSG00000287915.1_1985",1977,1985,9,"ENSG00000287915.1",1,1,"MVVVVUVVV",1,7,0.82815734989648,112,118,133,136,140,146,180,183,"AGGATCT","ATGA","CTGATGA","CTGA",2.45596969280835,15,4,34,62,1.81077926165633,4.54597763676133,7.85860703634726,101,"ENSG00000079974.19"
"10835","ENSG00000132938.22_445641",445633,445641,9,"ENSG00000132938.22",1,8,"VVVVVVVMV",0,8,0.884057971014493,104,110,133,136,146,152,171,174,"GTGCTGA","CCGC","GGGTTGC","CTGA",2.33144548451078,23,10,19,61,1.74647667505425,4.32236164294819,7.85859352700616,101,"ENSG00000079974.19"
"37267","ENSG00000246379.8_205148",205140,205148,9,"ENSG00000246379.8",1,2,"VMVVVVVVV",0,8,0.884057971014493,39,45,69,72,111,117,133,136,"ATGATCA","CTGA","GTTATAA","CTCA",2.44552064714049,24,39,16,88,0.985633904719248,4.32227622141396,7.85850810547193,101,"ENSG00000079974.19"
"25865","ENSG00000183023.19_142963",142955,142963,9,"ENSG00000183023.19",0,NA,"VVVVUUVVV",2,7,0.812008281573499,116,122,133,136,143,149,200,203,"ATTATGT","TTGA","AAGATTA","CTGA",2.46977464917034,11,7,51,78,1.97671355197241,4.61046946994367,7.85850259623766,101,"ENSG00000079974.19"
"44721","ENSG00000283434.2_75927",75919,75927,9,"ENSG00000283434.2",0,NA,"VVVVVVUVV",1,8,0.886128364389234,115,121,133,136,140,146,195,198,"AGGCTGG","TTGA","CTGCTCA","CTGA",2.31224404826244,12,4,49,74,1.84095922750712,4.31397988731419,7.85849334487112,101,"ENSG00000079974.19"
"38361","ENSG00000250048.2_84797",84789,84797,9,"ENSG00000250048.2",1,8,"VVVVVUVMV",1,7,0.806211180124224,115,121,133,136,142,148,166,169,"AGGTTGC","TTGA","ATGGTGA","CTGA",2.38627362874271,12,6,18,45,2.62604818500165,4.6336347608216,7.8584794813185,101,"ENSG00000079974.19"
"13323","ENSG00000140945.17_810208",810200,810208,9,"ENSG00000140945.17",1,7,"VVVVVVMVV",0,8,0.885300207039338,110,116,133,136,143,149,164,167,"ATGGTGT","CAGA","AAGGTGA","CTGT",2.2042404829242,17,7,15,48,2.57392178479345,4.31721458440536,7.85841541256272,101,"ENSG00000079974.19"
"9454","ENSG00000124749.17_79532",79524,79532,9,"ENSG00000124749.17",1,8,"VVVVVVVMV",0,8,0.884057971014493,115,121,133,136,158,164,183,186,"AAGTTGA","CCAA","GTGTTGC","CTGA",2.32644850677551,12,22,19,62,1.77893975942454,4.32214911781533,7.8583810018733,101,"ENSG00000079974.19"
"22726","ENSG00000171234.14_30982",30974,30982,9,"ENSG00000171234.14",1,7,"VVVVVVMVV",0,8,0.885300207039338,110,116,133,136,147,153,177,180,"ATGAGGA","CAGA","GTTAAGC","GTGA",2.30470298340104,17,11,24,61,1.90388439876511,4.31714273869301,7.85834356685036,101,"ENSG00000079974.19"
"17457","ENSG00000154175.18_4026",4018,4026,9,"ENSG00000154175.18",1,2,"VMVVVUVVV",1,7,0.806211180124223,41,47,56,59,78,84,133,136,"ATGAGGA","GTGA","GGGAAGA","CTGA",2.60577177384131,9,19,49,86,1.16209578294639,4.63347690213878,7.85832162263567,101,"ENSG00000079974.19"
"42082","ENSG00000260658.7_85025",85017,85025,9,"ENSG00000260658.7",1,3,"VVMVVVVVV",0,8,0.882815734989648,106,112,133,136,168,174,186,189,"AAGATGT","ATCA","GTGACAA","CTGA",2.38575294014343,21,32,12,74,1.40310541667458,4.32703125440769,7.85829419436628,101,"ENSG00000079974.19"
"35028","ENSG00000234730.1_36753",36745,36753,9,"ENSG00000234730.1",1,8,"VVVVVVVMV",0,8,0.884057971014493,112,118,133,136,168,174,185,188,"TTGGGGA","CTGG","GTGAATT","CTGA",2.30364935609863,15,32,11,67,1.93046787423654,4.32203256205684,7.85826444611482,101,"ENSG00000079974.19"
"40797","ENSG00000257703.6_35901",35893,35901,9,"ENSG00000257703.6",1,3,"VVMVVVVVV",0,8,0.882815734989648,109,115,133,136,142,148,157,160,"AAGTTGA","TTGA","GAGATAA","TTGA",2.19622513544021,18,6,9,42,2.66619820572753,4.32692477716556,7.85818771712415,101,"ENSG00000079974.19"
"24862","ENSG00000178385.15_148714",148706,148714,9,"ENSG00000178385.15",1,8,"VVVVVVVMV",0,8,0.884057971014493,3,9,25,28,74,80,133,136,"ATGAGGA","CTGA","CTGAAGG","CTGG",2.46694219802018,16,46,53,124,0.841306658711284,4.32189699471145,7.85812887876942,101,"ENSG00000079974.19"
"43861","ENSG00000274588.2_87531",87523,87531,9,"ENSG00000274588.2",1,8,"VVVVVUVMV",1,7,0.806211180124224,75,81,90,93,98,104,133,136,"TTGATCA","CTGG","GTGTTTA","CTGA",2.49240164490825,9,5,29,52,1.91695946474451,4.63324260769988,7.85808732819678,101,"ENSG00000079974.19"
"37143","ENSG00000245662.4_30962",30954,30962,9,"ENSG00000245662.4",1,2,"VMVVVVUVV",1,7,0.770186335403727,105,111,133,136,143,149,165,168,"GTGATGA","CTGA","CTGGAGA","CTTA",2.55204921690013,22,7,16,54,2.0956278756075,4.7773223304021,7.85806767201701,101,"ENSG00000079974.19"
"35504","ENSG00000236204.7_283900",283892,283900,9,"ENSG00000236204.7",1,8,"VVVVVVVMV",0,8,0.884057971014493,61,67,83,86,109,115,133,136,"ATAATGA","CTCA","ATGGGGA","GTGA",2.34602731158659,16,23,18,66,1.64704533603139,4.32180685331884,7.85803873737681,101,"ENSG00000079974.19"
"5546","ENSG00000105784.16_92662",92654,92662,9,"ENSG00000105784.16",1,7,"VVVVVVMVV",0,8,0.885300207039338,115,121,133,136,142,148,191,194,"AAGAATA","CTTA","ATGAACA","CTGA",2.29081224716537,12,6,43,70,1.99510725174064,4.31679722487745,7.8579980530348,101,"ENSG00000079974.19"
"38308","ENSG00000249917.3_292050",292042,292050,9,"ENSG00000249917.3",1,3,"VVMVVVVVV",0,8,0.882815734989648,89,95,133,136,162,168,179,182,"CTGATGC","CTGA","TTGGTGA","ATGA",2.43206663160792,38,26,11,84,1.09313959721498,4.32672928531694,7.85799222527553,101,"ENSG00000079974.19"
"17099","ENSG00000153107.13_30031",30023,30031,9,"ENSG00000153107.13",1,8,"VVVVVVVMV",0,8,0.884057971014493,111,117,133,136,157,163,172,175,"TTGAGGT","CTCC","GTGAAGC","CTGA",2.28181059297345,16,21,9,55,2.0749300667701,4.32175017164827,7.85798205570624,101,"ENSG00000079974.19"
"34639","ENSG00000233673.8_25744",25736,25744,9,"ENSG00000233673.8",1,8,"VVVVVVVMV",0,8,0.884057971014493,111,117,133,136,157,163,172,175,"TTGAGGT","CTCC","GTGAAGC","CTGA",2.28181059297345,16,21,9,55,2.0749300667701,4.32175017164827,7.85798205570624,101,"ENSG00000079974.19"
"22226","ENSG00000169967.17_70306",70298,70306,9,"ENSG00000169967.17",1,2,"VMVVVVVVV",0,8,0.884057971014493,49,55,94,97,106,112,133,136,"ATGATGT","TTGA","GTCCTGA","CTGC",2.38109017315788,39,9,21,78,1.41298030008374,4.32172869695074,7.85796058100871,101,"ENSG00000079974.19"
"10757","ENSG00000132693.12_1451",1443,1451,9,"ENSG00000132693.12",1,8,"VVVVUUVMV",2,6,0.696066252587992,88,94,104,107,116,122,133,136,"ATGATGT","CTCA","GAGCTGA","CTGA",2.60913562149823,10,9,11,39,2.90046542025052,5.07367572422635,7.85794073457831,101,"ENSG00000079974.19"
"42454","ENSG00000263400.8_60376",60368,60376,9,"ENSG00000263400.8",1,8,"VVVVVVVMV",0,8,0.884057971014493,68,74,88,91,100,106,133,136,"GGGGTGA","CTGA","GTGTTGG","TTGA",2.27531031336937,14,9,27,59,2.11802279421389,4.32168955416909,7.85792143822707,101,"ENSG00000079974.19"
"45235","ENSG00000285220.1_60376",60368,60376,9,"ENSG00000285220.1",1,8,"VVVVVVVMV",0,8,0.884057971014493,68,74,88,91,100,106,133,136,"GGGGTGA","CTGA","GTGTTGG","TTGA",2.27531031336937,14,9,27,59,2.11802279421389,4.32168955416909,7.85792143822707,101,"ENSG00000079974.19"
"27790","ENSG00000187391.22_1421479",1421471,1421479,9,"ENSG00000187391.22",1,1,"MVVVVUVVV",1,7,0.82815734989648,88,94,133,136,150,156,166,169,"TTGTTGA","ATGA","GTTTTGA","CTGA",2.48339308921111,39,14,10,72,1.62484555129138,4.54519986984135,7.85782926942728,101,"ENSG00000079974.19"
"4351","ENSG00000100297.16_11427",11419,11427,9,"ENSG00000100297.16",0,NA,"VVUVUVVVV",2,7,0.773498964803312,103,109,133,136,145,151,166,169,"GGGATGA","TTGA","ATGGGGA","CTGA",2.56043237199549,24,9,15,57,1.9856773350411,4.76380662041943,7.85780247963268,101,"ENSG00000079974.19"
"28448","ENSG00000189132.6_1717",1709,1717,9,"ENSG00000189132.6",1,8,"VVVVVVVMV",0,8,0.884057971014493,116,122,133,136,138,144,180,183,"AAGTTGG","AAGA","GTGATGA","CTGA",2.36130113241411,11,2,36,58,1.54411455204122,4.32153052536715,7.85776240942512,101,"ENSG00000079974.19"
"29538","ENSG00000198173.5_2896",2888,2896,9,"ENSG00000198173.5",1,8,"VVVVVVVMV",0,8,0.884057971014493,116,122,133,136,138,144,180,183,"AAGTTGG","AAGA","GTGATGA","CTGA",2.36130113241411,11,2,36,58,1.54411455204122,4.32153052536715,7.85776240942512,101,"ENSG00000079974.19"
"14932","ENSG00000146192.15_22908",22900,22908,9,"ENSG00000146192.15",1,2,"VMVVVVVVV",0,8,0.884057971014493,87,93,133,136,142,148,170,173,"CTGGTGA","ATGC","CTGAAGT","CTGA",2.38394349699066,40,6,22,77,1.39285571282027,4.32145308985617,7.85768497391414,101,"ENSG00000079974.19"
"16381","ENSG00000151422.14_324015",324007,324015,9,"ENSG00000151422.14",1,8,"VVVVVVVMV",0,8,0.884057971014493,104,110,133,136,179,185,200,203,"TTAATGA","ATTA","GTCATGA","CTGA",2.42873932519946,23,43,15,90,1.09414154007231,4.32143426035051,7.85766614440848,101,"ENSG00000079974.19"
"40857","ENSG00000257986.3_205158",205150,205158,9,"ENSG00000257986.3",1,2,"VMVVVVVVV",0,8,0.884057971014493,110,116,133,136,160,166,197,200,"TTTATGC","CTGC","GTGATGG","CTGA",2.44148880780626,17,24,31,81,1.00890303687488,4.32137377222915,7.85760565628712,101,"ENSG00000079974.19"
"13753","ENSG00000143344.16_188943",188935,188943,9,"ENSG00000143344.16",1,8,"VVVVVUVMV",1,7,0.806211180124224,109,115,133,136,143,149,161,164,"TAGATAA","TTGA","TTGGTGA","CTGA",2.38534111763245,18,7,12,46,2.62852234995922,4.63269911687722,7.85754383737411,101,"ENSG00000079974.19"
"17989","ENSG00000155974.14_313725",313717,313725,9,"ENSG00000155974.14",0,NA,"VVUVVVVVV",1,8,0.883643892339545,22,28,47,50,72,78,133,136,"ATGAAGA","CTGA","GTGCTAA","TTGA",2.47660098742381,19,22,55,105,0.781154066545013,4.32295682900927,7.85753239836745,101,"ENSG00000079974.19"
"39961","ENSG00000254532.2_218067",218059,218067,9,"ENSG00000254532.2",1,8,"VVVVVVVMV",0,8,0.884057971014493,79,85,100,103,109,115,133,136,"GTGATCA","CTGG","GTCAACA","CAGA",2.21308668103194,15,6,18,48,2.53118672654907,4.32127448335716,7.85750636741513,101,"ENSG00000079974.19"
"11672","ENSG00000135749.19_255420",255412,255420,9,"ENSG00000135749.19",0,NA,"VVVVVUUVV",2,7,0.808281573498965,85,91,104,107,114,120,133,136,"ATGAAGA","CTAA","GTCATGT","TTGA",2.33480211721443,13,7,13,42,2.93215203790703,4.6243748715008,7.85750116549666,101,"ENSG00000079974.19"
"6848","ENSG00000112137.19_275561",275553,275561,9,"ENSG00000112137.19",1,5,"VVVVMVVVV",0,8,0.886542443064182,98,104,133,136,146,152,178,181,"ATAATGA","TTGC","ATCAGAA","CTGA",2.40777034009472,29,10,26,74,1.19316776892102,4.31124250905479,7.85741228131151,101,"ENSG00000079974.19"
"26620","ENSG00000184613.11_306469",306461,306469,9,"ENSG00000184613.11",1,5,"VVVVMUVVV",1,7,0.808695652173913,82,88,102,105,116,122,133,136,"AGGATTA","ATGT","GTGATAT","CTGA",2.35495416423286,14,11,11,45,2.79079292182895,4.622621837512,7.85740444620765,101,"ENSG00000079974.19"
"27906","ENSG00000187672.15_173540",173532,173540,9,"ENSG00000187672.15",1,3,"VVMVVVVVV",0,8,0.882815734989648,49,55,74,77,82,88,133,136,"ACAATGA","CTGA","GGGATGA","CAGA",2.36828881933526,19,5,45,78,1.51565192403543,4.3260610132343,7.85732395319289,101,"ENSG00000079974.19"
"10078","ENSG00000129116.20_215278",215270,215278,9,"ENSG00000129116.20",1,1,"MVVVUVVVV",1,7,0.795859213250517,112,118,133,136,146,152,164,167,"ATTAAGT","CTGA","GCGGGGA","CTGA",2.38883209912453,15,10,12,46,2.76986761191382,4.67385373485267,7.85729058785474,101,"ENSG00000079974.19"
"33212","ENSG00000229011.1_560",552,560,9,"ENSG00000229011.1",1,2,"UMVVVVVVV",1,7,0.786749482401656,65,71,107,110,114,120,133,136,"TGGATGA","CTGA","TTTATCA","CTGA",2.56170428102768,36,4,13,62,1.76294673192059,4.71024381802627,7.8572417476329,101,"ENSG00000079974.19"
"35858","ENSG00000237356.7_395260",395252,395260,9,"ENSG00000237356.7",1,6,"VVVUVMVVV",1,7,0.78343685300207,29,35,65,68,116,122,133,136,"ATGTTGA","CTGA","TTGGTGG","CTGA",2.67947962959431,30,48,11,98,1.03075237445934,4.72348747627202,7.8572348882803,101,"ENSG00000079974.19"
"18998","ENSG00000160145.16_28956",28948,28956,9,"ENSG00000160145.16",1,2,"VMVVVVVVV",0,8,0.884057971014493,70,76,85,88,97,103,133,136,"ATGAAGA","CAGA","GTGGTCT","CTAA",2.30558402183941,9,9,30,57,1.9134270066895,4.3209967880714,7.85722867212937,101,"ENSG00000079974.19"
"48281","ENSG00000290853.1_19282",19274,19282,9,"ENSG00000290853.1",1,7,"VVVVVVMVV",0,8,0.885300207039338,100,106,133,136,182,188,204,207,"ATATTGA","TTGA","GTGCTTA","CTGA",2.46007611639268,27,46,16,98,0.86335889305395,4.31596658391795,7.8571674120753,101,"ENSG00000079974.19"
"30812","ENSG00000213904.11_35740",35732,35740,9,"ENSG00000213904.11",1,1,"MVVVVUVVV",1,7,0.82815734989648,110,116,133,136,142,148,156,159,"AAGGTGA","CTGA","GTGCTTA","CTTA",2.31391109200742,17,6,8,40,2.75207265296066,4.5445366499192,7.85716604950512,101,"ENSG00000079974.19"
"39912","ENSG00000254434.1_3461",3453,3461,9,"ENSG00000254434.1",1,8,"VVVVVVVMV",0,8,0.884057971014493,82,88,133,136,145,151,164,167,"CTGATGC","CAGA","GTGAACA","CTGG",2.31202698262584,45,9,13,76,1.86994520050171,4.32086460450183,7.8570964885598,101,"ENSG00000079974.19"
"17413","ENSG00000154127.10_129147",129139,129147,9,"ENSG00000154127.10",1,3,"VVMVUVVVV",1,7,0.772670807453416,108,114,133,136,148,154,167,170,"TTGATGC","TTGA","CTGATCT","CTGA",2.52053526114081,19,12,13,53,2.26197368379158,4.76638552284925,7.85706875266291,101,"ENSG00000079974.19"
"29041","ENSG00000197057.10_14365",14357,14365,9,"ENSG00000197057.10",1,7,"UVVVVVMVV",1,7,0.787991718426501,104,110,133,136,154,160,194,197,"ATGTTGA","CTGA","TTTATGA","CTGA",2.71664179175647,23,18,34,84,0.709401294271853,4.70508664316208,7.85705351686808,101,"ENSG00000079974.19"
"24860","ENSG00000178385.15_117877",117869,117877,9,"ENSG00000178385.15",0,NA,"VVUVVVVVV",1,8,0.883643892339545,113,119,133,136,139,145,160,163,"ATGAAAA","TTGA","GTGTTAA","CTCA",2.21752098486106,14,3,15,41,2.50604058718248,4.32237845489738,7.85695402425556,101,"ENSG00000079974.19"
"11935","ENSG00000136546.17_46023",46015,46023,9,"ENSG00000136546.17",1,2,"VMVVVUVVV",1,7,0.806211180124223,79,85,92,95,106,112,133,136,"ATGTTGA","CTGA","GTGAAAA","GTGA",2.4929147164669,7,11,21,48,1.90898464027118,4.63210402084596,7.85694874134285,101,"ENSG00000079974.19"
"47325","ENSG00000287999.1_56724",56716,56724,9,"ENSG00000287999.1",1,8,"VVVVUUVMV",2,6,0.696066252587992,115,121,133,136,142,148,160,163,"ATGATGC","CTCA","GTTTTGA","CTGA",2.59557680862749,12,6,12,39,2.98682487368228,5.07266756613305,7.85693257648502,101,"ENSG00000079974.19"
"44515","ENSG00000282890.1_502099",502091,502099,9,"ENSG00000282890.1",1,8,"VVVVVVVMV",0,8,0.884057971014493,113,119,133,136,157,163,171,174,"CTGTTGG","GTGT","GTGGTGC","CTGA",2.26499717824184,14,21,8,52,2.18270976639425,4.32067273866829,7.85690462272626,101,"ENSG00000079974.19"
"28366","ENSG00000188869.13_3934",3926,3934,9,"ENSG00000188869.13",1,8,"VVVVVVVMV",0,8,0.884057971014493,88,94,133,136,148,154,201,204,"TTGCTGA","CGGA","TTGAGAA","CTGA",2.47647553294018,39,12,47,107,0.772803828446441,4.32066017867858,7.85689206273655,101,"ENSG00000079974.19"
"13917","ENSG00000143951.16_222653",222645,222653,9,"ENSG00000143951.16",0,NA,"VVVVVVUVV",1,8,0.886128364389234,11,17,31,34,80,86,133,136,"TTGATGA","CTGC","GTCATGA","ATGA",2.4417366344589,14,46,47,116,0.970885870763854,4.31228252512247,7.8567959826794,101,"ENSG00000079974.19"
"15122","ENSG00000147099.21_50376",50368,50376,9,"ENSG00000147099.21",1,5,"UVVVMVVVV",1,7,0.789233954451346,111,117,133,136,138,144,154,157,"TTGATAA","CTGT","TTGGTAA","CTGA",2.45361490019484,16,2,10,37,2.44195526195229,4.69984698247948,7.85678280028486,101,"ENSG00000079974.19"
"45402","ENSG00000285547.1_50118",50110,50118,9,"ENSG00000285547.1",1,5,"UVVVMVVVV",1,7,0.789233954451346,111,117,133,136,138,144,154,157,"TTGATAA","CTGT","TTGGTAA","CTGA",2.45361490019484,16,2,10,37,2.44195526195229,4.69984698247948,7.85678280028486,101,"ENSG00000079974.19"
"31589","ENSG00000224184.7_354301",354293,354301,9,"ENSG00000224184.7",0,NA,"VVUVVVVVV",1,8,0.883643892339545,114,120,133,136,166,172,184,187,"GTAATGC","TGGA","GTTCTGA","CTGA",2.29260996152649,13,30,12,64,2.00472153873148,4.32219698722702,7.8567725565852,101,"ENSG00000079974.19"
"20997","ENSG00000166200.15_21571",21563,21571,9,"ENSG00000166200.15",1,3,"VVMVVVVVV",0,8,0.882815734989648,112,118,133,136,144,150,165,168,"AGAATGT","CTTG","GTGAATT","CTGA",2.18790702469107,15,8,15,47,2.71598342368375,4.32550756373939,7.85677050369798,101,"ENSG00000079974.19"
"35247","ENSG00000235470.5_20256",20248,20256,9,"ENSG00000235470.5",1,1,"MVVVVUVVV",1,7,0.82815734989648,106,112,133,136,141,147,157,160,"GTGATGG","GGGA","GTCCTTA","CTGA",2.37439418637103,21,5,10,45,2.34726355984722,4.54413953391352,7.85676893349944,101,"ENSG00000079974.19"
"10845","ENSG00000132964.13_155485",155477,155485,9,"ENSG00000132964.13",1,2,"VMVVVVUVV",1,7,0.770186335403727,116,122,133,136,144,150,188,191,"ATGATGA","CTAT","CTTATAA","CTGA",2.56686303402902,11,8,38,66,1.99164266666938,4.77601572338238,7.85676106499729,101,"ENSG00000079974.19"
"654","ENSG00000022267.19_64016",64008,64016,9,"ENSG00000022267.19",1,1,"MVVVVUVVV",1,7,0.82815734989648,93,99,109,112,116,122,133,136,"AGCATGG","GTGA","GGGAAGT","CTGA",2.29003585002052,10,4,11,34,2.9095552101882,4.54411521924792,7.85674461883384,101,"ENSG00000079974.19"
"11633","ENSG00000135577.5_48383",48375,48383,9,"ENSG00000135577.5",1,1,"MVVVVVUVV",1,7,0.792132505175983,87,93,105,108,114,120,133,136,"ATTATGA","TTGA","TAGATGA","CTTA",2.37248887255543,12,6,13,40,2.93620699704671,4.6881998701874,7.85672989089133,101,"ENSG00000079974.19"
"18898","ENSG00000159216.19_332988",332980,332988,9,"ENSG00000159216.19",1,8,"VVVVVVVMV",0,8,0.884057971014493,92,98,133,136,144,150,159,162,"TTGCTGA","GTAA","GTCATAG","CTGA",2.29321489041405,35,8,9,61,1.99385260403745,4.32048796836611,7.85671985242408,101,"ENSG00000079974.19"
"46855","ENSG00000287292.1_11968",11960,11968,9,"ENSG00000287292.1",1,7,"VVVVVVMVV",0,8,0.885300207039338,114,120,133,136,160,166,181,184,"AGTATGA","TAGA","GTTTGGA","CTGA",2.29537981610257,13,24,15,61,1.95938129523589,4.31547835064659,7.85667917880394,101,"ENSG00000079974.19"
"16367","ENSG00000151413.17_44801",44793,44801,9,"ENSG00000151413.17",1,2,"VMVVVVVVV",0,8,0.884057971014493,60,66,87,90,101,107,133,136,"ATGTTGA","CTGT","TTGATCA","GTGA",2.37007324232692,21,11,26,67,1.48124068283603,4.32043224125388,7.85666412531185,101,"ENSG00000079974.19"
"16218","ENSG00000151150.22_387973",387965,387973,9,"ENSG00000151150.22",1,7,"VVVVVVMVV",0,8,0.885300207039338,107,113,133,136,140,146,155,158,"GTGTTGG","ATAA","TTTCTGA","CTGA",2.23764977747127,20,4,9,42,2.34416448849829,4.31545741791003,7.85665824606738,101,"ENSG00000079974.19"
"37713","ENSG00000248692.5_41103",41095,41103,9,"ENSG00000248692.5",1,8,"VVVVUVVMV",1,7,0.773913043478261,111,117,133,136,150,156,166,169,"GTGATGA","CTGC","TTGAGGA","ATGA",2.48731911266753,16,14,10,49,2.46186698304762,4.76099860020778,7.85665077412083,101,"ENSG00000079974.19"
"45883","ENSG00000286021.3_52725",52717,52725,9,"ENSG00000286021.3",1,5,"VVVVMVVVV",0,8,0.886542443064182,94,100,133,136,144,150,167,170,"CTGAAGA","CTCC","CTAAGGA","CTGA",2.33109152528191,33,8,17,67,1.70115444478065,4.31044115333167,7.8566109255884,101,"ENSG00000079974.19"
"357","ENSG00000009694.14_654305",654297,654305,9,"ENSG00000009694.14",1,2,"VMVVVVVVV",0,8,0.884057971014493,101,107,133,136,146,152,165,168,"TTGAAGA","GTTA","ATGCCCA","CTGA",2.29955100969614,26,10,13,58,1.95090877957214,4.32031221105328,7.85654409511125,101,"ENSG00000079974.19"
"17071","ENSG00000153086.14_6057",6049,6057,9,"ENSG00000153086.14",1,8,"VVVVVUVMV",1,7,0.806211180124224,104,110,133,136,141,147,159,162,"TTGATCA","CTCA","GTGAAAT","CTGA",2.45445619789679,23,5,12,49,2.1637276125875,4.63169223297485,7.85653695347175,101,"ENSG00000079974.19"
"33973","ENSG00000231672.8_69974",69966,69974,9,"ENSG00000231672.8",1,7,"VVVVVVMVV",0,8,0.885300207039338,102,108,133,136,184,190,207,210,"CTGATGG","AAGA","GTGGAGA","CTGA",2.45856779304086,25,48,17,99,0.870794240675836,4.31531154857039,7.85651237672774,101,"ENSG00000079974.19"
"6884","ENSG00000112186.13_75398",75390,75398,9,"ENSG00000112186.13",0,NA,"UVVVVUVVV",2,7,0.824844720496894,112,118,133,136,143,149,163,166,"AAAATAA","TTGA","ATGAACA","CTGA",2.31624320664807,15,7,14,45,2.78685366330455,4.55711876023959,7.85649764222716,101,"ENSG00000079974.19"
"19158","ENSG00000162373.13_38281",38273,38281,9,"ENSG00000162373.13",1,8,"VVVVVVVMV",0,8,0.884057971014493,114,120,133,136,140,146,178,181,"GTGGTGG","GAGA","TTGAAAA","CTGA",2.30359132832623,13,4,32,58,1.92372764955254,4.32025079293186,7.85648267698983,101,"ENSG00000079974.19"
"27385","ENSG00000186094.18_1285266",1285258,1285266,9,"ENSG00000186094.18",1,8,"VVVVVVVMV",0,8,0.884057971014493,114,120,133,136,140,146,178,181,"GTGGTGG","GAGA","TTGAAAA","CTGA",2.30359132832623,13,4,32,58,1.92372764955254,4.32025079293186,7.85648267698983,101,"ENSG00000079974.19"
"2501","ENSG00000075303.13_7845",7837,7845,9,"ENSG00000075303.13",0,NA,"UVVVUVVVV",2,7,0.792546583850932,116,122,133,136,138,144,153,156,"CTGATTA","CTGG","GGCATGG","CTGA",2.39022268622127,11,2,9,31,2.81035846144707,4.68629409239722,7.85648042780094,101,"ENSG00000079974.19"
"25607","ENSG00000182197.13_59762",59754,59762,9,"ENSG00000182197.13",1,1,"MVUVVVVVV",1,7,0.789648033126294,109,115,133,136,142,148,159,162,"ATGATGA","ATGA","GCAAAGA","CTAA",2.42199425953533,18,6,11,44,2.64463021358059,4.69781465262069,7.85640678512587,101,"ENSG00000079974.19"
"7160","ENSG00000113013.16_12081",12073,12081,9,"ENSG00000113013.16",0,NA,"VVVVVVUVV",1,8,0.886128364389234,113,119,133,136,159,165,178,181,"GTGTCGA","CTTT","GTGAAGG","CTGA",2.27870594583053,14,23,13,59,2.05609443837184,4.31186685264384,7.85638031020077,101,"ENSG00000079974.19"
"39102","ENSG00000251629.7_173361",173353,173361,9,"ENSG00000251629.7",1,7,"UVVVVVMVV",1,7,0.787991718426501,105,111,133,136,141,147,183,186,"ATGATGA","ATGT","CTGAACA","CTGA",2.62573941666949,22,5,36,72,1.3126035102769,4.70438323868504,7.85635011239104,101,"ENSG00000079974.19"
"11268","ENSG00000134376.17_162291",162283,162291,9,"ENSG00000134376.17",1,2,"VMVVVVVVV",0,8,0.884057971014493,109,115,133,136,140,146,160,163,"TTAAAGA","CTTT","GTGTTGT","CTGA",2.23484096890936,18,4,14,45,2.3814967845591,4.32010914432204,7.85634102838001,101,"ENSG00000079974.19"
"35919","ENSG00000237480.3_54751",54743,54751,9,"ENSG00000237480.3",1,5,"VVVVMVVVV",0,8,0.886542443064182,106,112,133,136,147,153,168,171,"CTGATCA","ATGA","GTGAACA","CTGC",2.27678604172103,21,11,15,56,2.06199815162735,4.31014294077522,7.85631271303195,101,"ENSG00000079974.19"
"2212","ENSG00000071282.12_59786",59778,59786,9,"ENSG00000071282.12",1,1,"MVVVVUVVV",1,7,0.82815734989648,115,121,133,136,146,152,201,204,"ATGATGG","CTTT","GTCAGGT","CTGA",2.44096943550227,12,10,49,80,1.90143234661808,4.54364047915831,7.85626987874423,101,"ENSG00000079974.19"
"15555","ENSG00000148655.15_999796",999788,999796,9,"ENSG00000148655.15",1,7,"VVVVVVMVV",0,8,0.885300207039338,41,47,61,64,112,118,133,136,"TTGCTGA","GTGA","GTGACGA","CAGA",2.32168726448444,14,48,15,86,1.78236010568132,4.31506880056106,7.85626962871841,101,"ENSG00000079974.19"
"24448","ENSG00000176406.25_388001",387993,388001,9,"ENSG00000176406.25",1,2,"VMVVVVVVV",0,8,0.884057971014493,115,121,133,136,173,179,195,198,"ATAAAAA","CAGA","GTGATAT","CTGA",2.32618452186939,12,37,16,74,1.77213909376344,4.32000897655651,7.85624086061448,101,"ENSG00000079974.19"
"21439","ENSG00000167632.18_305392",305384,305392,9,"ENSG00000167632.18",1,8,"VVVVVVVMV",0,8,0.884057971014493,82,88,133,136,184,190,207,210,"ATGAGGA","GTGA","AGAATGG","CTGA",2.48710623330077,45,48,17,119,0.699324936383297,4.3200082895971,7.85624017365507,101,"ENSG00000079974.19"
"16811","ENSG00000152348.16_67506",67498,67506,9,"ENSG00000152348.16",1,2,"VMVVVVVVV",0,8,0.884057971014493,88,94,102,105,115,121,133,136,"TTGAAGA","CTTA","ATGAAAT","CTTA",2.19715965781324,8,10,12,39,2.63219726516222,4.31998207931262,7.8562139633706,101,"ENSG00000079974.19"
"20015","ENSG00000164162.14_109808",109800,109808,9,"ENSG00000164162.14",1,1,"MVVVUVVVV",1,7,0.795859213250517,113,119,133,136,147,153,171,174,"GTGGGGA","ATGA","GGGATGA","CTGA",2.43834079229528,14,11,18,52,2.43533852907193,4.67273595276011,7.85617280576218,101,"ENSG00000079974.19"
"45560","ENSG00000285713.1_109441",109433,109441,9,"ENSG00000285713.1",1,1,"MVVVUVVVV",1,7,0.795859213250517,113,119,133,136,147,153,171,174,"GTGGGGA","ATGA","GGGATGA","CTGA",2.43834079229528,14,11,18,52,2.43533852907193,4.67273595276011,7.85617280576218,101,"ENSG00000079974.19"
"2676","ENSG00000077264.16_164596",164588,164596,9,"ENSG00000077264.16",0,NA,"VVVVUVUVV",2,7,0.775983436853002,82,88,104,107,110,116,133,136,"AGGAAGA","CTGA","GTGCTTG","CTGA",2.51497680196075,16,3,17,45,2.24241190716345,4.75223098005877,7.85616472747078,101,"ENSG00000079974.19"
"12437","ENSG00000138185.20_57635",57627,57635,9,"ENSG00000138185.20",1,6,"UVVVVMVVV",1,7,0.805383022774327,91,97,133,136,148,154,209,212,"GTGAAGA","CTGA","GTGTTTA","CTGA",2.66484108270232,36,12,55,112,0.772752765547395,4.63458999589072,7.85612208698803,101,"ENSG00000079974.19"
"15366","ENSG00000148057.16_2143",2135,2143,9,"ENSG00000148057.16",1,1,"MVVVUVVVV",1,7,0.795859213250517,114,120,133,136,146,152,168,171,"ATGTTGG","AAGA","AGGATGA","CTGA",2.4054775424162,13,10,16,48,2.65419740473622,4.6726785885444,7.85611544154647,101,"ENSG00000079974.19"
"24389","ENSG00000176124.15_655720",655712,655720,9,"ENSG00000176124.15",1,2,"VMVVVVVVV",0,8,0.884057971014493,97,103,133,136,182,188,200,203,"ATGATTA","AAGA","ATGCAAA","CTGA",2.44127327330941,30,46,12,97,1.00379343420864,4.31973714740118,7.85596903145915,101,"ENSG00000079974.19"
"21343","ENSG00000167210.17_162906",162898,162906,9,"ENSG00000167210.17",1,2,"VMVVVVVVV",0,8,0.884057971014493,42,48,64,67,80,86,133,136,"GTGAAGA","CTGA","GTGGTTT","TTGA",2.36129981822356,16,13,47,85,1.5368551585044,4.31971348666536,7.85594537072333,101,"ENSG00000079974.19"
"10716","ENSG00000132549.20_347877",347869,347877,9,"ENSG00000132549.20",1,5,"VVVVMVVVV",0,8,0.886542443064182,73,79,93,96,100,106,133,136,"ATGATCC","CTGT","ATGAAGA","CTGG",2.28505599195704,14,4,27,54,2.00531214935564,4.30975469060064,7.85592446285736,101,"ENSG00000079974.19"
"23287","ENSG00000172487.4_3435",3427,3435,9,"ENSG00000172487.4",0,NA,"VVVVVUUVV",2,7,0.808281573498965,109,115,133,136,169,175,216,219,"GTGATGA","TTGA","GTGCAGG","CTGA",2.66681403815354,18,33,41,101,0.71239418352194,4.62278860946971,7.85591490346557,101,"ENSG00000079974.19"
"36615","ENSG00000242208.1_398",390,398,9,"ENSG00000242208.1",0,NA,"VVVVVUUVV",2,7,0.808281573498965,109,115,133,136,169,175,216,219,"GTGATGA","TTGA","GTGCAGG","CTGA",2.66681403815354,18,33,41,101,0.71239418352194,4.62278860946971,7.85591490346557,101,"ENSG00000079974.19"
"42338","ENSG00000261715.1_14972",14964,14972,9,"ENSG00000261715.1",0,NA,"VVUVVVVVV",1,8,0.883643892339545,107,113,133,136,149,155,172,175,"ATTATGA","TTGC","GTGATAA","CTTA",2.31047353666259,20,13,17,59,1.88210681320479,4.32131593107219,7.85589150043037,101,"ENSG00000079974.19"
"40368","ENSG00000255760.4_56108",56100,56108,9,"ENSG00000255760.4",1,2,"UMVVVVVVV",1,7,0.786749482401656,81,87,100,103,116,122,133,136,"ATTATGT","CTTA","TTTATCA","CTGA",2.42337902795463,13,13,11,46,2.67966633841436,4.70888163119464,7.85587956080127,101,"ENSG00000079974.19"
"25363","ENSG00000181090.21_250473",250465,250473,9,"ENSG00000181090.21",1,8,"UVVVVVVMV",1,7,0.786749482401656,96,102,133,136,144,150,158,161,"CTGATGA","TAGA","TTGGTAA","CTGA",2.52549727256751,31,8,8,56,1.99886079047268,4.70887731856401,7.85587524817064,101,"ENSG00000079974.19"
"35180","ENSG00000235257.11_63382",63374,63382,9,"ENSG00000235257.11",1,1,"MVVVVUVVV",1,7,0.82815734989648,85,91,133,136,141,147,157,160,"ATGATGC","GCGA","ATGCTCC","CTGA",2.4361112181935,42,5,10,66,1.93208985490681,4.54320782738254,7.85583722696846,101,"ENSG00000079974.19"
"22758","ENSG00000171365.17_35104",35096,35104,9,"ENSG00000171365.17",1,6,"VVVUVMVVV",1,7,0.78343685300207,70,76,85,88,99,105,133,136,"ATGATCA","CTGT","TTGGTGG","CTGA",2.55636039886924,9,11,28,57,1.84586386587601,4.72206663125107,7.85581404325935,101,"ENSG00000079974.19"
"15831","ENSG00000149970.16_11108",11100,11108,9,"ENSG00000149970.16",1,2,"VMVVVVVVV",0,8,0.884057971014493,116,122,133,136,139,145,161,164,"TTTATTA","TTAA","ATGCTGG","CTGA",2.21989359877442,11,3,16,39,2.4790089179838,4.31957489411998,7.85580677817795,101,"ENSG00000079974.19"
"21489","ENSG00000168014.18_60008",60000,60008,9,"ENSG00000168014.18",1,1,"MVVUVVVVV",1,7,0.786749482401656,115,121,133,136,149,155,165,168,"ATCAGGA","AAGA","ATGAGGA","CTGA",2.41976770148847,12,13,10,44,2.70297930414941,4.70869099518481,7.85568892479143,101,"ENSG00000079974.19"
"19314","ENSG00000162722.9_14788",14780,14788,9,"ENSG00000162722.9",1,8,"VVVVVUVMV",1,7,0.806211180124224,115,121,133,136,144,150,161,164,"ATGATCT","TTCA","GAAATGA","CTGA",2.32763175591528,12,8,11,40,3.00568632882915,4.63080784206609,7.85565256256299,101,"ENSG00000079974.19"
"9783","ENSG00000127249.15_85308",85300,85308,9,"ENSG00000127249.15",1,6,"UVVVVMUVV",2,6,0.691511387163561,78,84,101,104,116,122,133,136,"CTGATGA","GTGA","GTGATAT","CTGA",2.67756499658063,17,12,11,49,2.50781974433362,5.08956326371779,7.85560881237203,101,"ENSG00000079974.19"
"22503","ENSG00000170624.14_887568",887560,887568,9,"ENSG00000170624.14",1,3,"VVMVVVVVV",0,8,0.882815734989648,106,112,133,136,141,147,158,161,"GTGATGA","GAGA","GGCATGT","CAGA",2.24491612250366,21,5,11,46,2.33115643769412,4.32431598026297,7.85557892022156,101,"ENSG00000079974.19"
"35071","ENSG00000234828.9_496990",496982,496990,9,"ENSG00000234828.9",1,1,"MVVVVVUVV",1,7,0.792132505175983,115,121,133,136,145,151,164,167,"AGGGTGG","CTCA","ATGATGT","CTGA",2.37983474555171,12,9,13,43,2.88224643401867,4.68695285109085,7.85548287179479,101,"ENSG00000079974.19"
"22242","ENSG00000170017.12_145538",145530,145538,9,"ENSG00000170017.12",1,3,"VVMVVVVVV",0,8,0.882815734989648,115,121,133,136,142,148,167,170,"CTTATGT","CAGG","GTAATTT","CTGA",2.21002357498684,12,6,19,46,2.5633594974395,4.32421249933794,7.85547543929653,101,"ENSG00000079974.19"
"2249","ENSG00000072201.14_126862",126854,126862,9,"ENSG00000072201.14",1,7,"VVVVVUMVV",1,7,0.807453416149068,72,78,91,94,112,118,133,136,"ATAGTGA","CTCA","CAGATGA","CTGA",2.44756920548801,13,18,15,55,2.1855154587462,4.62566087383323,7.8554745384295,101,"ENSG00000079974.19"
"31103","ENSG00000215568.9_15886",15878,15886,9,"ENSG00000215568.9",1,3,"VVMVVVVVV",0,8,0.882815734989648,88,94,102,105,115,121,133,136,"GTGATGA","TTGA","ATGCTGC","TTCA",2.1996928991574,8,10,12,39,2.63219726516222,4.32420414821955,7.85546708817814,101,"ENSG00000079974.19"
"4244","ENSG00000099725.14_82869",82861,82869,9,"ENSG00000099725.14",1,5,"VVVVMVVVV",0,8,0.886542443064182,65,71,87,90,97,103,133,136,"ATGCTTT","CTTA","CTGGTCA","CTGA",2.29090850829948,16,7,30,62,1.96446340209836,4.30929669769039,7.85546646994711,101,"ENSG00000079974.19"
"26354","ENSG00000183943.6_88139",88131,88139,9,"ENSG00000183943.6",1,5,"VVVVMVVVV",0,8,0.886542443064182,65,71,87,90,97,103,133,136,"ATGCTTT","CTTA","CTGGTCA","CTGA",2.29090850829948,16,7,30,62,1.96446340209836,4.30929669769039,7.85546646994711,101,"ENSG00000079974.19"
"20365","ENSG00000164741.15_61732",61724,61732,9,"ENSG00000164741.15",1,2,"VMVVVVVVV",0,8,0.884057971014493,111,117,133,136,153,159,170,173,"GTAATTA","CATA","GTTATTA","CTGA",2.25373734915263,16,17,11,53,2.25195535187037,4.31921775322198,7.85544963727995,101,"ENSG00000079974.19"
"1390","ENSG00000054965.11_177956",177948,177956,9,"ENSG00000054965.11",0,NA,"UVVVVUVVV",2,7,0.824844720496894,23,29,38,41,82,88,133,136,"TTAATGA","CTGA","GAGATGG","CTGA",2.60617871311679,9,41,45,104,0.849716095051866,4.55606021229094,7.85543909427852,101,"ENSG00000079974.19"
"26772","ENSG00000185008.19_566202",566194,566202,9,"ENSG00000185008.19",1,8,"UVVVVVVMV",1,7,0.786749482401656,81,87,100,103,107,113,133,136,"ATGTTGA","CTGG","AGCATGT","CTGA",2.47197521106439,13,4,20,46,2.35390599769916,4.70843518453211,7.85543311413873,101,"ENSG00000079974.19"
"29675","ENSG00000198589.15_497829",497821,497829,9,"ENSG00000198589.15",1,8,"VVVVVVVMV",0,8,0.884057971014493,101,107,133,136,154,160,175,178,"ATAATAA","TTGC","CTGAAGA","CTGA",2.39299887535192,26,18,15,68,1.32345593593242,4.31919544290298,7.85542732696095,101,"ENSG00000079974.19"
"48038","ENSG00000290203.13_79931",79923,79931,9,"ENSG00000290203.13",0,NA,"VVVUUVVVV",2,7,0.770600414078675,58,64,77,80,93,99,133,136,"ATGTTGT","CTGA","CTGAAAA","CTGA",2.6007880896069,13,13,34,69,1.75333739709416,4.77298116528504,7.85538282159973,101,"ENSG00000079974.19"
"11339","ENSG00000134602.16_20867",20859,20867,9,"ENSG00000134602.16",0,NA,"VVUUVVVVV",2,7,0.764389233954451,116,122,133,136,145,151,161,164,"ATGGTGT","CTAC","GTGAGGA","CTGA",2.43314691036004,11,9,10,39,2.9701612525466,4.79778516373672,7.85534209955452,101,"ENSG00000079974.19"
"31159","ENSG00000217128.13_64354",64346,64354,9,"ENSG00000217128.13",0,NA,"VVVUVVVVV",1,8,0.880745341614907,83,89,133,136,164,170,180,183,"ATGGTGC","CTCA","CTGATCT","CTGA",2.43834095156365,44,28,10,91,1.07373017140616,4.33233412879096,7.85531549525059,101,"ENSG00000079974.19"
"43698","ENSG00000273217.1_64320",64312,64320,9,"ENSG00000273217.1",0,NA,"VVVUVVVVV",1,8,0.880745341614907,83,89,133,136,164,170,180,183,"ATGGTGC","CTCA","CTGATCT","CTGA",2.43834095156365,44,28,10,91,1.07373017140616,4.33233412879096,7.85531549525059,101,"ENSG00000079974.19"
"35925","ENSG00000237484.7_224847",224839,224847,9,"ENSG00000237484.7",1,8,"VVVVUVVMV",1,7,0.773913043478261,83,89,133,136,165,171,181,184,"GTGATCA","CTGA","CTGATGC","CTGA",2.69650205516031,44,29,10,92,1.06165105693248,4.75958285616697,7.85523503008002,101,"ENSG00000079974.19"
"10072","ENSG00000129084.18_90306",90298,90306,9,"ENSG00000129084.18",1,2,"UMVVVVVVV",1,7,0.786749482401656,82,88,133,136,140,146,177,180,"GTGATGA","GTGA","TTGAATA","CTGA",2.68315678499925,45,4,31,89,0.945220372484008,4.70823306811976,7.85523099772638,101,"ENSG00000079974.19"
"6170","ENSG00000108375.13_6723",6715,6723,9,"ENSG00000108375.13",1,1,"MVVVVUVVV",1,7,0.82815734989648,103,109,133,136,139,145,156,159,"ATAAAAA","ATGA","GTGATGA","CTGA",2.43937552498139,24,3,11,47,1.90743934913589,4.54248571225295,7.85511511183887,101,"ENSG00000079974.19"
"45780","ENSG00000285897.1_6723",6715,6723,9,"ENSG00000285897.1",1,1,"MVVVVUVVV",1,7,0.82815734989648,103,109,133,136,139,145,156,159,"ATAAAAA","ATGA","GTGATGA","CTGA",2.43937552498139,24,3,11,47,1.90743934913589,4.54248571225295,7.85511511183887,101,"ENSG00000079974.19"
"18442","ENSG00000157423.18_188289",188281,188289,9,"ENSG00000157423.18",1,8,"VVVVVVVMV",0,8,0.884057971014493,108,114,133,136,146,152,176,179,"ATGGAGA","ATTA","ATGGGGA","CTGA",2.32300079070519,19,10,24,62,1.78884506310612,4.31887925028518,7.85511113434315,101,"ENSG00000079974.19"
"44022","ENSG00000276975.4_121127",121119,121127,9,"ENSG00000276975.4",1,8,"VVVVVVVMV",0,8,0.884057971014493,108,114,133,136,146,152,176,179,"ATGGAGA","ATTA","ATGGGGA","CTGA",2.32300079070519,19,10,24,62,1.78884506310612,4.31887925028518,7.85511113434315,101,"ENSG00000079974.19"
"47206","ENSG00000287856.1_23126",23118,23126,9,"ENSG00000287856.1",0,NA,"VVVVVVUVV",1,8,0.886128364389234,98,104,133,136,149,155,210,213,"TTGATAA","CTCA","TTGAAGG","CTGA",2.47332069798262,29,13,55,106,0.753534335787946,4.31058474725135,7.85509820480828,101,"ENSG00000079974.19"
"19486","ENSG00000163116.10_195440",195432,195440,9,"ENSG00000163116.10",1,8,"VVVVVVVMV",0,8,0.884057971014493,112,118,133,136,139,145,154,157,"TTGACAA","CAGG","CAGATGG","CTGA",2.18453851423802,15,3,9,36,2.71154812569429,4.3187845551536,7.85501643921157,101,"ENSG00000079974.19"
"7929","ENSG00000116117.19_321123",321115,321123,9,"ENSG00000116117.19",1,7,"VVVVVVMVV",0,8,0.885300207039338,90,96,133,136,143,149,166,169,"ATTCTGG","GTCA","GTGATGA","CTGA",2.33298106401527,37,7,17,70,1.70187916790854,4.31377156533592,7.85497239349327,101,"ENSG00000079974.19"
"17779","ENSG00000155052.15_792287",792279,792287,9,"ENSG00000155052.15",1,6,"UVVVVMVVV",1,7,0.805383022774327,83,89,133,136,140,146,163,166,"ATGATGT","TTGA","GCTATAA","CTGA",2.54970745115016,44,4,17,74,1.53570925330757,4.63343973191049,7.8549718230078,101,"ENSG00000079974.19"
"28996","ENSG00000196912.13_4360",4352,4360,9,"ENSG00000196912.13",1,5,"VVVVMVVVV",0,8,0.886542443064182,116,122,133,136,178,184,200,203,"GTGGTGA","CTAA","TTGAAGA","CTAA",2.32453355333348,11,42,16,78,1.73824031755055,4.30878266827676,7.85495244053349,101,"ENSG00000079974.19"
"45064","ENSG00000284959.3_88910",88902,88910,9,"ENSG00000284959.3",1,2,"VMVVVVVVV",0,8,0.884057971014493,114,120,133,136,156,162,175,178,"ATATTTA","TTGA","GAAATGA","CTGA",2.2623110436276,13,20,13,55,2.19279348636474,4.31871677763719,7.85494866169516,101,"ENSG00000079974.19"
"23359","ENSG00000172765.19_180473",180465,180473,9,"ENSG00000172765.19",1,8,"VVVVVVVMV",0,8,0.884057971014493,114,120,133,136,152,158,182,185,"TGGATGG","CAGG","ATGATCA","CTGA",2.32148174937506,13,16,24,62,1.79805754093523,4.31865063419224,7.85488251825021,101,"ENSG00000079974.19"
"18695","ENSG00000158169.14_177657",177649,177657,9,"ENSG00000158169.14",1,6,"VVVVUMVVV",1,7,0.792546583850932,115,121,133,136,162,168,178,181,"AGGAAGA","TTGA","ATAATGA","CTGA",2.49514944174697,12,26,10,57,2.1044481582225,4.68469444246723,7.85488077787096,101,"ENSG00000079974.19"
"14975","ENSG00000146426.19_172382",172374,172382,9,"ENSG00000146426.19",0,NA,"VVUVVUVVV",2,7,0.805797101449275,90,96,133,136,142,148,195,198,"ATGATGA","TGGA","GTAATGG","CTGA",2.63005858251869,37,6,47,99,0.992933455495097,4.63166433473826,7.85485274053536,101,"ENSG00000079974.19"
"23538","ENSG00000173198.6_44185",44177,44185,9,"ENSG00000173198.6",0,NA,"VVUVVVVVV",1,8,0.883643892339545,85,91,133,136,144,150,191,194,"CTTATGA","TTGA","AAGAAGG","CTGA",2.44150904234969,42,8,41,100,1.00417893530995,4.32022647107696,7.85480204043514,101,"ENSG00000079974.19"
"46581","ENSG00000286857.1_10617",10609,10617,9,"ENSG00000286857.1",0,NA,"VVUVVUVVV",2,7,0.805797101449275,64,70,87,90,107,113,133,136,"ATGATGC","CTGA","GTGAGGT","CGGA",2.52403222436193,17,17,20,63,1.69950599087715,4.63159687165583,7.85478527745293,101,"ENSG00000079974.19"
"14292","ENSG00000144645.16_49141",49133,49141,9,"ENSG00000144645.16",0,NA,"VVVUVVVVV",1,8,0.880745341614907,115,121,133,136,172,178,188,191,"AGGTTGA","AAGA","GTGGTAG","CTGA",2.29659576897021,12,36,10,67,2.01647788887428,4.33177908716892,7.85476045362855,101,"ENSG00000079974.19"
"13948","ENSG00000144036.16_233435",233427,233435,9,"ENSG00000144036.16",1,2,"VMVVVUVVV",1,7,0.806211180124223,57,63,78,81,110,116,133,136,"ATGAAGA","CTTA","GTCAAAA","CTGA",2.52768616236498,15,29,17,70,1.66837488154266,4.62990399099396,7.85474871149085,101,"ENSG00000079974.19"
"16462","ENSG00000151575.15_107451",107443,107451,9,"ENSG00000151575.15",1,2,"VMVVVVVVV",0,8,0.884057971014493,103,109,133,136,187,193,207,210,"AAGAAGA","CTCA","GTTATGT","CTGA",2.42759367906179,24,51,14,98,1.09009062250923,4.31851212073029,7.85474400478826,101,"ENSG00000079974.19"
"36197","ENSG00000238266.3_757",749,757,9,"ENSG00000238266.3",1,8,"VVVVVUVMV",1,7,0.806211180124224,115,121,133,136,144,150,159,162,"ATGACCT","CTGG","ATGATTG","CTGA",2.32109109874106,12,8,9,38,3.04524255703313,4.62979580382671,7.8546405243236,101,"ENSG00000079974.19"
"45621","ENSG00000285743.1_97793",97785,97793,9,"ENSG00000285743.1",1,8,"VVVVVUVMV",1,7,0.806211180124224,115,121,133,136,144,150,159,162,"ATGACCT","CTGG","ATGATTG","CTGA",2.32109109874106,12,8,9,38,3.04524255703313,4.62979580382671,7.8546405243236,101,"ENSG00000079974.19"
"45734","ENSG00000285845.1_698",690,698,9,"ENSG00000285845.1",1,8,"VVVVVUVMV",1,7,0.806211180124224,115,121,133,136,144,150,159,162,"ATGACCT","CTGG","ATGATTG","CTGA",2.32109109874106,12,8,9,38,3.04524255703313,4.62979580382671,7.8546405243236,101,"ENSG00000079974.19"
"45863","ENSG00000285988.1_42888",42880,42888,9,"ENSG00000285988.1",1,8,"VVVVVUVMV",1,7,0.806211180124224,115,121,133,136,144,150,159,162,"ATGACCT","CTGG","ATGATTG","CTGA",2.32109109874106,12,8,9,38,3.04524255703313,4.62979580382671,7.8546405243236,101,"ENSG00000079974.19"
"17021","ENSG00000152954.12_9092",9084,9092,9,"ENSG00000152954.12",0,NA,"VVUVVUVVV",2,7,0.805797101449275,114,120,133,136,163,169,185,188,"ATGCTGA","TTCA","AGGATGA","CTGA",2.50260141726682,13,27,16,65,1.84173494442779,4.63143609821832,7.85462450401542,101,"ENSG00000079974.19"
"12674","ENSG00000138771.16_15602",15594,15602,9,"ENSG00000138771.16",1,2,"VMVVVVVVV",0,8,0.884057971014493,60,66,74,77,86,92,133,136,"ATAATGG","CTGA","GTTCTGA","ATGA",2.33622511260126,8,9,41,67,1.6984493250274,4.31832085225895,7.85455273631692,101,"ENSG00000079974.19"
"16434","ENSG00000151491.14_50021",50013,50021,9,"ENSG00000151491.14",0,NA,"VVVUVVVVV",1,8,0.880745341614907,81,87,95,98,113,119,133,136,"CTGAAGA","CTGC","GTGAAGG","CTCA",2.2748703000897,8,15,14,46,2.1604246531536,4.3315566634379,7.85453802989753,101,"ENSG00000079974.19"
"34677","ENSG00000233766.8_141190",141182,141190,9,"ENSG00000233766.8",1,7,"UVVVVVMVV",1,7,0.787991718426501,53,59,71,74,110,116,133,136,"CTGATGA","CTGA","GAGATGA","CTGC",2.56437489952398,12,36,17,74,1.71414724462553,4.70249497702969,7.85446185073569,101,"ENSG00000079974.19"
"6733","ENSG00000111728.11_128156",128148,128156,9,"ENSG00000111728.11",1,8,"UVVVVVVMV",1,7,0.786749482401656,55,61,74,77,114,120,133,136,"ATGATTA","CTGA","GTGATGG","CTGT",2.53522237897238,13,37,13,72,1.92819405635931,4.70741914571046,7.85441707531708,101,"ENSG00000079974.19"
"32214","ENSG00000226330.1_51558",51550,51558,9,"ENSG00000226330.1",1,8,"VVVVVVVMV",0,8,0.884057971014493,47,53,70,73,114,120,133,136,"ATTATGG","CTGA","ATGCTAA","CAGA",2.33880161997995,17,41,13,80,1.68016226570903,4.31804326639383,7.85427515045181,101,"ENSG00000079974.19"
"46298","ENSG00000286469.1_12522",12514,12522,9,"ENSG00000286469.1",1,6,"VVUVVMVVV",1,7,0.786335403726708,109,115,133,136,143,149,174,177,"AAGATGA","CTTA","ATGGAGC","CTGA",2.53444858154139,18,7,25,59,1.93937129448877,4.70892379285783,7.85426540776467,101,"ENSG00000079974.19"
"8550","ENSG00000119522.18_127152",127144,127152,9,"ENSG00000119522.18",1,1,"MVVVVVUVV",1,7,0.792132505175983,93,99,133,136,177,183,195,198,"ATCATGT","CTGA","CTGAGGA","CTGA",2.66499426605505,34,41,12,96,0.97628650438522,4.68572873618805,7.85425875689198,101,"ENSG00000079974.19"
"16389","ENSG00000151445.16_29732",29724,29732,9,"ENSG00000151445.16",1,7,"VVVVVVMVV",0,8,0.885300207039338,94,100,133,136,138,144,158,161,"TGGATGT","CTGC","TTGAATA","CTGA",2.37581159433661,33,2,14,58,1.41347541511196,4.31305484433901,7.85425567249636,101,"ENSG00000079974.19"
"29784","ENSG00000198729.5_26550",26542,26550,9,"ENSG00000198729.5",1,7,"VVVVVVMVV",0,8,0.885300207039338,86,92,133,136,175,181,192,195,"ATGCTGC","GAGA","ATGAAGA","CTGA",2.4384457266554,41,39,11,100,0.99588797245134,4.31304820420517,7.85424903236252,101,"ENSG00000079974.19"
"18723","ENSG00000158321.19_100843",100835,100843,9,"ENSG00000158321.19",1,7,"VVVVVVMVV",0,8,0.885300207039338,116,122,133,136,181,187,198,201,"ATGTAGA","AAGA","CTTATTA","CTGA",2.29333928162542,11,45,11,76,1.96317474763225,4.31302582295043,7.85422665110778,101,"ENSG00000079974.19"
"22520","ENSG00000170743.17_161534",161526,161534,9,"ENSG00000170743.17",1,8,"UVVVVVVMV",1,7,0.786749482401656,115,121,133,136,160,166,177,180,"ATCATGA","ATCA","GTGAGGG","CTGA",2.50441818266188,12,24,11,56,2.13262501577844,4.70718655838108,7.8541844879877,101,"ENSG00000079974.19"
"24206","ENSG00000175497.17_1329160",1329152,1329160,9,"ENSG00000175497.17",1,7,"VVVVVVMVV",0,8,0.885300207039338,78,84,101,104,113,119,133,136,"ATCATTA","TTGA","ATGATTC","CTTA",2.20104511051534,17,9,14,49,2.57813038670168,4.31294111420099,7.85414194235834,101,"ENSG00000079974.19"
"32351","ENSG00000226829.2_12986",12978,12986,9,"ENSG00000226829.2",1,1,"MVVVVUVVV",1,7,0.82815734989648,77,83,102,105,115,121,133,136,"ATACTGA","CTAA","AAGAAGG","CTGA",2.35978064685179,19,10,12,50,2.43387182890351,4.54143570197885,7.85406510156477,101,"ENSG00000079974.19"
"19345","ENSG00000162814.11_207612",207604,207612,9,"ENSG00000162814.11",1,8,"VVVVVUVMV",1,7,0.806211180124224,68,74,92,95,106,112,133,136,"ATCATTA","ATGA","TTGCTGA","CTGA",2.48326851597873,18,11,21,59,1.96172589178912,4.62921233291184,7.85405705340873,101,"ENSG00000079974.19"
"13597","ENSG00000142599.20_437970",437962,437970,9,"ENSG00000142599.20",1,3,"VVMVVVVVV",0,8,0.882815734989648,112,118,133,136,145,151,173,176,"ATAGTGT","CCTA","CTGATGC","CTGA",2.25351492322139,15,9,22,55,2.26769030406227,4.32278078138456,7.85404372134315,101,"ENSG00000079974.19"
"42445","ENSG00000263300.1_15685",15677,15685,9,"ENSG00000263300.1",1,1,"MVVVVUVVV",1,7,0.82815734989648,112,118,133,136,138,144,156,159,"ATGAAGA","CTAA","ATGAAGT","CTAA",2.35694256122987,15,2,12,38,2.45259901227958,4.54138735511968,7.8540167547056,101,"ENSG00000079974.19"
"28273","ENSG00000188596.11_253890",253882,253890,9,"ENSG00000188596.11",1,8,"VVVVVVVMV",0,8,0.884057971014493,73,79,93,96,106,112,133,136,"AGGATGA","CTGA","ATGAAGT","CAGG",2.2422850809462,14,10,21,54,2.32249507455705,4.31776557021627,7.85399745427424,101,"ENSG00000079974.19"
"25110","ENSG00000179454.14_100577",100569,100577,9,"ENSG00000179454.14",1,3,"VVMVVVVVV",0,8,0.882815734989648,111,117,133,136,148,154,171,174,"GTGATCA","CTGG","AAGATAA","CTTA",2.24840883354159,16,12,17,54,2.30144443589389,4.32270916487612,7.85397210483472,101,"ENSG00000079974.19"
"24727","ENSG00000177694.16_427234",427226,427234,9,"ENSG00000177694.16",1,8,"VVVVVVVMV",0,8,0.884057971014493,112,118,133,136,137,143,153,156,"GTGACCA","TTCA","CTGGTCA","CTGA",2.23557690554621,15,1,10,35,2.36680658625476,4.31766315580738,7.85389503986535,101,"ENSG00000079974.19"
"5380","ENSG00000104381.14_84796",84788,84796,9,"ENSG00000104381.14",1,8,"UVVVVVVMV",1,7,0.786749482401656,113,119,133,136,145,151,180,183,"ATAATGA","TTTA","GTGTAGA","CTGA",2.51462688374726,14,9,29,61,2.06340885232197,4.70689701932592,7.85389494893255,101,"ENSG00000079974.19"
"24904","ENSG00000178568.15_637102",637094,637102,9,"ENSG00000178568.15",1,8,"VVVVVVVMV",0,8,0.884057971014493,110,116,133,136,185,191,222,225,"ATGATAA","ATTA","GTAATAA","CTGA",2.46108306625879,17,49,31,106,0.863328118505489,4.3176371400577,7.85386902411567,101,"ENSG00000079974.19"
"26519","ENSG00000184347.15_86312",86304,86312,9,"ENSG00000184347.15",1,1,"MVVVVVUVV",1,7,0.792132505175983,109,115,133,136,148,154,165,168,"ATCATGA","GGGA","TTGCTCA","CTGA",2.44836416243389,18,12,11,50,2.41874360150039,4.68529283776492,7.85382285846885,101,"ENSG00000079974.19"
"4625","ENSG00000101349.17_17410",17402,17410,9,"ENSG00000101349.17",1,8,"UVVVVVVMV",1,7,0.786749482401656,116,122,133,136,141,147,160,163,"TTGATCA","AAGA","ATGTTGG","CTGA",2.39130927437752,11,5,13,38,2.88521413468769,4.7068189909678,7.85381692057442,101,"ENSG00000079974.19"
"23762","ENSG00000173926.6_73750",73742,73750,9,"ENSG00000173926.6",1,3,"UVMVVVVVV",1,7,0.785507246376811,114,120,133,136,154,160,200,203,"CTGATGA","CACA","GTGAGGA","CTGA",2.61870922669936,13,18,40,80,1.38888549124747,4.71173675064414,7.85376573615138,101,"ENSG00000079974.19"
"41996","ENSG00000260271.4_42597",42589,42597,9,"ENSG00000260271.4",1,6,"UVVVVMVVV",1,7,0.805383022774327,92,98,133,136,149,155,175,178,"ATGATGT","GTGA","ATGAGCT","CTGA",2.59645560340128,35,13,20,77,1.21921289764667,4.63222923008048,7.85376132117778,101,"ENSG00000079974.19"
"4502","ENSG00000100749.9_106140",106132,106140,9,"ENSG00000100749.9",1,2,"VMVVVVVVV",0,8,0.884057971014493,101,107,133,136,145,151,161,164,"ATAATGA","ATGA","ATTATTT","ATGA",2.27782954477141,26,9,10,54,2.08423214627897,4.31744061118876,7.85367249524674,101,"ENSG00000079974.19"
"21198","ENSG00000166821.9_8791",8783,8791,9,"ENSG00000166821.9",0,NA,"VVVVVUUVV",2,7,0.808281573498965,110,116,133,136,146,152,166,169,"GTGATTG","CAGG","GTGAAGA","CTGA",2.3935017669226,17,10,14,50,2.52532700015,4.62050136157517,7.85362765557102,101,"ENSG00000079974.19"
"32128","ENSG00000226051.10_69156",69148,69156,9,"ENSG00000226051.10",1,2,"UMVVVVVVV",1,7,0.786749482401656,90,96,105,108,112,118,133,136,"ATGATAA","CTGA","CTAAAGA","TTGA",2.4384440275352,9,4,15,37,2.56997130980686,4.70656620667704,7.85356413628367,101,"ENSG00000079974.19"
"24466","ENSG00000176463.14_162428",162420,162428,9,"ENSG00000176463.14",1,8,"VVVVVVVMV",0,8,0.884057971014493,116,122,133,136,150,156,168,171,"ATGATGT","CAAA","GAGATAG","TTGA",2.20637510491379,11,14,12,46,2.55977849698248,4.31723646576861,7.85346834982658,101,"ENSG00000079974.19"
"33188","ENSG00000228980.4_134743",134735,134743,9,"ENSG00000228980.4",1,2,"VMVVVVVVV",0,8,0.884057971014493,97,103,133,136,147,153,173,176,"TTGATTA","TAGA","GAGATTA","CTGA",2.38106921271513,30,11,20,70,1.39506983447252,4.31721614647669,7.85344803053466,101,"ENSG00000079974.19"
"2262","ENSG00000072210.19_34730",34722,34730,9,"ENSG00000072210.19",1,8,"UVVVVVVMV",1,7,0.786749482401656,106,112,133,136,164,170,179,182,"AAGATGA","CTGT","GTGATTC","CTGA",2.60156319693901,21,28,9,67,1.48177937099479,4.70638350431372,7.85338143392034,101,"ENSG00000079974.19"
"35019","ENSG00000234710.3_73272",73264,73272,9,"ENSG00000234710.3",1,7,"VVUVVVMVV",1,7,0.768944099378882,114,120,133,136,140,146,155,158,"GTGATTA","CTGA","CAGATGA","CAGA",2.42200253216595,13,4,9,35,2.9636559347714,4.7775848706361,7.85336126815163,101,"ENSG00000079974.19"
"20164","ENSG00000164344.17_8417",8409,8417,9,"ENSG00000164344.17",0,NA,"UVVVVVUVV",2,7,0.788819875776397,112,118,133,136,147,153,165,168,"CTGATAA","CTGA","CTGATGG","CTTA",2.41302042319818,15,11,12,47,2.70540742960106,4.69805256273056,7.85333206583615,101,"ENSG00000079974.19"
"48050","ENSG00000290316.1_25876",25868,25876,9,"ENSG00000290316.1",0,NA,"UVVVVVUVV",2,7,0.788819875776397,112,118,133,136,147,153,165,168,"CTGATAA","CTGA","CTGATGG","CTTA",2.41302042319818,15,11,12,47,2.70540742960106,4.69805256273056,7.85333206583615,101,"ENSG00000079974.19"
"10504","ENSG00000131374.15_414409",414401,414409,9,"ENSG00000131374.15",1,2,"VMVVVUVVV",1,7,0.806211180124223,110,116,133,136,147,153,164,167,"GCTATGA","CAGA","TTGAATA","CTGA",2.39035076335788,17,11,11,48,2.57770401839711,4.62834394352907,7.85318866402596,101,"ENSG00000079974.19"
"11234","ENSG00000134318.16_168394",168386,168394,9,"ENSG00000134318.16",1,5,"UVVVMVVVV",1,7,0.789233954451346,101,107,133,136,165,171,182,185,"ATAATGA","ATGA","TTGATCA","CTGA",2.64064325133512,26,29,11,75,1.18066973029365,4.69623951813195,7.85317533593733,101,"ENSG00000079974.19"
"14621","ENSG00000145526.12_249726",249718,249726,9,"ENSG00000145526.12",1,6,"UVVVVMVVV",1,7,0.805383022774327,112,118,133,136,147,153,181,184,"GTGATGT","GAGA","TGGATGA","CTGA",2.49112202460119,15,11,28,63,1.91907586450088,4.63163900712721,7.85317109822452,101,"ENSG00000079974.19"
"13250","ENSG00000140836.17_1070289",1070281,1070289,9,"ENSG00000140836.17",1,1,"MVVUVVVVV",1,7,0.786749482401656,110,116,133,136,155,161,173,176,"ATGATGC","CTTG","GTGAAAA","CTGA",2.51831278772298,17,19,12,57,2.03578639942086,4.70613457939352,7.85313250900014,101,"ENSG00000079974.19"
"1595","ENSG00000063169.12_48466",48458,48466,9,"ENSG00000063169.12",1,3,"VVMVVVVVV",0,8,0.882815734989648,113,119,133,136,138,144,162,165,"TTTATGT","CAAA","CTGAAGC","CTGA",2.27247829838224,14,2,18,43,2.13757834694207,4.32185841737258,7.85312135733117,101,"ENSG00000079974.19"
"43110","ENSG00000268746.1_49138",49130,49138,9,"ENSG00000268746.1",1,3,"VVMVVVVVV",0,8,0.882815734989648,113,119,133,136,138,144,162,165,"TTTATGT","CAAA","CTGAAGC","CTGA",2.27247829838224,14,2,18,43,2.13757834694207,4.32185841737258,7.85312135733117,101,"ENSG00000079974.19"
"42961","ENSG00000267440.2_8415",8407,8415,9,"ENSG00000267440.2",1,8,"VVVVVVVMV",0,8,0.884057971014493,80,86,100,103,110,116,133,136,"GAGGTGA","CTGA","GGGAGGG","CTGG",2.19046561778787,14,7,17,47,2.6642800549706,4.31684604338909,7.85307792744706,101,"ENSG00000079974.19"
"43050","ENSG00000267761.3_150208",150200,150208,9,"ENSG00000267761.3",1,2,"VMVVVUVVV",1,7,0.806211180124223,87,93,104,107,116,122,133,136,"TAAATGA","CTGT","TTGAAAA","CTGA",2.33527569383958,11,9,11,40,2.94427865833799,4.6281958209838,7.85304054148069,101,"ENSG00000079974.19"
"42592","ENSG00000264813.6_15746",15738,15746,9,"ENSG00000264813.6",1,6,"UVVVVMVVV",1,7,0.805383022774327,115,121,133,136,154,160,173,176,"GAGATGA","CTAG","ATAATGA","CTGA",2.43505359151781,12,18,13,52,2.2923301966638,4.63150520169563,7.85303729279294,101,"ENSG00000079974.19"
"22832","ENSG00000171502.15_240637",240629,240637,9,"ENSG00000171502.15",1,2,"VMVVVVVVV",0,8,0.884057971014493,79,85,94,97,115,121,133,136,"ATTATGC","CTGA","TACATGA","CAGA",2.26474372740141,9,18,12,48,2.16892597460812,4.31680437265438,7.85303625671235,101,"ENSG00000079974.19"
"42519","ENSG00000263765.5_87710",87702,87710,9,"ENSG00000263765.5",1,8,"VVVVVVVMV",0,8,0.884057971014493,110,116,133,136,181,187,200,203,"AGGTTGA","CCAA","GTGAGCA","CTGA",2.33856757494389,17,45,13,84,1.67674946797681,4.31679999190069,7.85303187595866,101,"ENSG00000079974.19"
"12830","ENSG00000139173.10_39330",39322,39330,9,"ENSG00000139173.10",1,1,"MVVVVUVVV",1,7,0.82815734989648,116,122,133,136,146,152,160,163,"AGGATAA","TTGT","GTGCCGG","CTGA",2.28727600771838,11,10,8,38,2.91299138763703,4.5403745264399,7.85300392602582,101,"ENSG00000079974.19"
"21897","ENSG00000169288.18_40156",40148,40156,9,"ENSG00000169288.18",1,2,"VMVUVVVVV",1,7,0.764803312629399,116,122,133,136,146,152,166,169,"ATAGTGA","TTGA","TTTATGA","CTGA",2.46330995405885,11,10,14,44,2.7530661077662,4.79378311703964,7.85299636755724,101,"ENSG00000079974.19"
"21581","ENSG00000168398.7_4017",4009,4017,9,"ENSG00000168398.7",1,8,"VVVVVVVMV",0,8,0.884057971014493,113,119,133,136,164,170,182,185,"AGGGTGT","CTGT","GCAATGA","CTGA",2.2907616248129,14,28,12,63,1.99529336809803,4.31675938337933,7.85299126743731,101,"ENSG00000079974.19"
"41208","ENSG00000258691.1_3852",3844,3852,9,"ENSG00000258691.1",1,8,"VVVVVVVMV",0,8,0.884057971014493,113,119,133,136,164,170,182,185,"AGGGTGT","CTGT","GCAATGA","CTGA",2.2907616248129,14,28,12,63,1.99529336809803,4.31675938337933,7.85299126743731,101,"ENSG00000079974.19"
"19348","ENSG00000162814.11_231152",231144,231152,9,"ENSG00000162814.11",1,2,"UMVVVVVVV",1,7,0.786749482401656,112,118,133,136,147,153,167,170,"ATGAAGC","TAGA","TTGAAGA","CTGA",2.43098821031188,15,11,14,49,2.61712918035591,4.70592931227545,7.85292724188208,101,"ENSG00000079974.19"
"9117","ENSG00000122735.16_7352",7344,7352,9,"ENSG00000122735.16",1,7,"VVVVUVMVV",1,7,0.775155279503105,115,121,133,136,141,147,160,163,"ATGATGA","CTTG","ATGTTGA","CTGT",2.41703032204831,12,5,13,39,2.89554315851381,4.75226965970898,7.8528907777214,101,"ENSG00000079974.19"
"5567","ENSG00000105877.19_259937",259929,259937,9,"ENSG00000105877.19",1,2,"VMVVVVVVV",0,8,0.884057971014493,115,121,133,136,145,151,168,171,"ATAATGT","CTGC","TTAATGG","GTGA",2.19232435530178,12,9,17,47,2.6511251156644,4.31665520441907,7.85288708847704,101,"ENSG00000079974.19"
"46913","ENSG00000287359.1_11702",11694,11702,9,"ENSG00000287359.1",1,8,"VVVVVVVMV",0,8,0.884057971014493,87,93,133,136,151,157,170,173,"ATGATTT","CTGA","GTGGTGT","CTGG",2.36881365751779,40,15,13,77,1.47440432277516,4.31662384322343,7.8528557272814,101,"ENSG00000079974.19"
"108","ENSG00000005108.17_111741",111733,111741,9,"ENSG00000005108.17",1,1,"MVVVVUVVV",1,7,0.82815734989648,106,112,133,136,151,157,175,178,"CTGATGG","ATTA","GTGATCA","CTGA",2.48415086985986,21,15,18,63,1.59967370403029,4.540169875774,7.85279927535992,101,"ENSG00000079974.19"
"1354","ENSG00000054282.16_83561",83553,83561,9,"ENSG00000054282.16",1,2,"VMVVVVVVV",0,8,0.884057971014493,107,113,133,136,144,150,164,167,"TTGATGA","ATAA","ATGAAAT","CAGA",2.23755498516031,20,8,14,51,2.34882965321937,4.31646572190536,7.85269760596333,101,"ENSG00000079974.19"
"8179","ENSG00000117114.21_685723",685715,685723,9,"ENSG00000117114.21",0,NA,"VVVVVVUVV",1,8,0.886128364389234,109,115,133,136,146,152,163,166,"GTGAAGA","CTTG","GTTATGA","CTTA",2.20204514992438,18,10,11,48,2.55217806762677,4.30811976678066,7.85263322433759,101,"ENSG00000079974.19"
"12714","ENSG00000138796.18_38393",38385,38393,9,"ENSG00000138796.18",1,2,"VMVVVVVVV",0,8,0.884057971014493,115,121,133,136,145,151,180,183,"ATCATAA","CTAG","ATCTTGA","CTGA",2.27488132283063,12,9,29,59,2.09966542519814,4.31638522768392,7.85261711174189,101,"ENSG00000079974.19"
"10170","ENSG00000129636.13_35502",35494,35502,9,"ENSG00000129636.13",1,8,"UVVVVVVMV",1,7,0.786749482401656,71,77,91,94,108,114,133,136,"ATGTTGA","AGGA","GTGATTT","CTGA",2.49897686854164,14,14,19,56,2.16198171640419,4.70545687667045,7.85245480627708,101,"ENSG00000079974.19"
"22075","ENSG00000169762.17_35526",35518,35526,9,"ENSG00000169762.17",1,1,"MVVVVVUVV",1,7,0.792132505175983,45,51,93,96,111,117,133,136,"CTGATGA","CAGA","ATGTAGC","CTGA",2.61331449764615,42,15,16,82,1.31307429129289,4.68379273556681,7.85232275627074,101,"ENSG00000079974.19"
"43792","ENSG00000273550.2_1304",1296,1304,9,"ENSG00000273550.2",0,NA,"VVVUVVVVV",1,8,0.880745341614907,114,120,133,136,185,191,240,243,"ATTATGA","TTGC","TTGGTCA","CTGA",2.44759950191356,13,49,49,120,0.999863275572965,4.32929832208251,7.85227968854213,101,"ENSG00000079974.19"
"22897","ENSG00000171714.13_406327",406319,406327,9,"ENSG00000171714.13",1,1,"MVVUVVVVV",1,7,0.786749482401656,88,94,106,109,111,117,133,136,"AGAATGA","CAGA","ATGAACA","CTGA",2.47385774422724,12,2,16,39,2.32871798235984,4.7052757359687,7.85227366557532,101,"ENSG00000079974.19"
"29432","ENSG00000197971.16_107486",107478,107486,9,"ENSG00000197971.16",0,NA,"VVVVVVUVV",1,8,0.886128364389234,112,118,133,136,177,183,195,198,"GTCAAGC","CTGA","ACGAGGC","CTGA",2.30360761696771,15,41,12,77,1.8735695791074,4.30773842305636,7.8522518806133,101,"ENSG00000079974.19"
"19483","ENSG00000163110.15_88800",88792,88800,9,"ENSG00000163110.15",1,7,"UVVVVUMVV",2,6,0.710144927536232,114,120,133,136,147,153,171,174,"GTGATGA","CTAA","GTGACTT","CTGA",2.63690333896874,13,11,18,51,2.46725140640158,5.01165174988163,7.85223146002656,101,"ENSG00000079974.19"
"48100","ENSG00000290421.1_84689",84681,84689,9,"ENSG00000290421.1",1,8,"VVUVVVVMV",1,7,0.767701863354037,114,120,133,136,141,147,180,183,"ATGAAGA","CAGA","TTAAGGA","CTGA",2.56840376122165,13,5,33,60,2.00297512683157,4.78141671707732,7.85222417049347,101,"ENSG00000079974.19"
"27907","ENSG00000187672.15_181504",181496,181504,9,"ENSG00000187672.15",1,8,"VVUVVVVMV",1,7,0.767701863354037,80,86,97,100,106,112,133,136,"TTGCTGA","CTCA","GTGAAAA","CTGA",2.50554850845011,11,6,21,47,2.42168604320477,4.78133569155137,7.85214314496752,101,"ENSG00000079974.19"
"10747","ENSG00000132623.16_10966",10958,10966,9,"ENSG00000132623.16",0,NA,"VVVUVVVVV",1,8,0.880745341614907,102,108,133,136,143,149,174,177,"AAGATAA","CTTA","ATGCAGC","CTGA",2.38074130598778,25,7,25,66,1.44479430061776,4.32910075180074,7.85208211826037,101,"ENSG00000079974.19"
"36968","ENSG00000243961.2_11004",10996,11004,9,"ENSG00000243961.2",0,NA,"VVVUVVVVV",1,8,0.880745341614907,102,108,133,136,143,149,174,177,"AAGATAA","CTTA","ATGCAGC","CTGA",2.38074130598778,25,7,25,66,1.44479430061776,4.32910075180074,7.85208211826037,101,"ENSG00000079974.19"
"12496","ENSG00000138411.13_286940",286932,286940,9,"ENSG00000138411.13",1,8,"VVVVVVVMV",0,8,0.884057971014493,83,89,133,136,146,152,193,196,"ATTAAGA","TTGG","ATGATGA","CTGA",2.45218510361149,44,10,41,104,0.915414465063618,4.31582878895171,7.85206067300968,101,"ENSG00000079974.19"
"9017","ENSG00000122194.19_39261",39253,39261,9,"ENSG00000122194.19",1,8,"VVVVVUVMV",1,7,0.806211180124224,112,118,133,136,149,155,171,174,"ATGATCA","GTGC","ATGAATG","CTGA",2.42197895077534,15,13,16,53,2.36232001779433,4.62721158907415,7.85205630957104,101,"ENSG00000079974.19"
"27370","ENSG00000186094.18_1025678",1025670,1025678,9,"ENSG00000186094.18",0,NA,"VVVUVUVVV",2,7,0.802898550724638,111,117,133,136,145,151,175,178,"AAAATGA","CAGA","ATGCAGA","CTGA",2.46891773011292,16,9,24,58,2.10227343302933,4.64043124177886,7.85202544467741,101,"ENSG00000079974.19"
"10570","ENSG00000131620.18_87644",87636,87644,9,"ENSG00000131620.18",0,NA,"UVVUVVVVV",2,7,0.78343685300207,108,114,133,136,138,144,153,156,"AGGATGG","CAGA","ATGAAGC","CTGA",2.50912657207061,19,2,9,39,2.14549758127257,4.71825201543583,7.85199942744411,101,"ENSG00000079974.19"
"8379","ENSG00000118492.18_41762",41754,41762,9,"ENSG00000118492.18",1,2,"VMVVVVVVV",0,8,0.884057971014493,98,104,133,136,149,155,211,214,"TTGATAA","CTTA","TTGAAGG","CTGA",2.47644960912154,29,13,56,107,0.753362046034443,4.31575652671118,7.85198841076915,101,"ENSG00000079974.19"
"5749","ENSG00000106546.14_95921",95913,95921,9,"ENSG00000106546.14",1,2,"VMVVVVVVV",0,8,0.884057971014493,30,36,64,67,71,77,133,136,"ATGAAGA","CTGA","GTTATTA","ATGA",2.45195692371724,28,4,56,97,0.916321448543918,4.31567523499805,7.85190711905603,101,"ENSG00000079974.19"
"47752","ENSG00000289189.2_22147",22139,22147,9,"ENSG00000289189.2",1,2,"VMVVVVVVV",0,8,0.884057971014493,30,36,64,67,71,77,133,136,"ATGAAGA","CTGA","GTTATTA","ATGA",2.45195692371724,28,4,56,97,0.916321448543918,4.31567523499805,7.85190711905603,101,"ENSG00000079974.19"
"30927","ENSG00000214803.3_21247",21239,21247,9,"ENSG00000214803.3",1,2,"VMUVVVVVV",1,7,0.767701863354037,114,120,133,136,161,167,175,178,"TTGAAGA","GTGA","TTGAAGA","CTGA",2.55369628842293,13,25,8,55,2.09970561257444,4.7810868838485,7.85189433726464,101,"ENSG00000079974.19"
"27025","ENSG00000185420.19_749006",748998,749006,9,"ENSG00000185420.19",1,8,"VVVVVUVMV",1,7,0.806211180124224,76,82,103,106,111,117,133,136,"AGGAAGA","CAGA","ATGATCT","CTGA",2.46117750046902,21,5,16,51,2.10026507700415,4.62702877003273,7.85187349052963,101,"ENSG00000079974.19"
"9503","ENSG00000124831.20_83662",83654,83662,9,"ENSG00000124831.20",1,3,"VVMVVVVVV",0,8,0.882815734989648,71,77,90,93,100,106,133,136,"CTGATGA","CGGA","CTGATGA","ATGG",2.26246306233367,13,7,27,56,2.19918658332961,4.32056841638852,7.85183135634712,101,"ENSG00000079974.19"
"22643","ENSG00000171044.11_59695",59687,59695,9,"ENSG00000171044.11",1,1,"MVVUVUVVV",2,6,0.708902691511387,47,53,62,65,72,78,133,136,"ATGATGC","CTGA","ATGCTGG","CTGA",2.73418545795266,9,7,55,80,1.83694184634341,5.01621122484029,7.85182199088583,101,"ENSG00000079974.19"
"4616","ENSG00000101333.19_372052",372044,372052,9,"ENSG00000101333.19",1,5,"VVVVMVVVV",0,8,0.886542443064182,116,122,133,136,176,182,235,238,"TTGATGT","ATCA","CTCATGA","CTGA",2.43585313516908,11,40,53,113,0.983472825634855,4.30562343169051,7.85179320394724,101,"ENSG00000079974.19"
"29333","ENSG00000197771.13_21126",21118,21126,9,"ENSG00000197771.13",1,8,"VVVVVVVMV",0,8,0.884057971014493,114,120,133,136,157,163,172,175,"ATTATAT","TGGA","GTGAACA","CTGA",2.25438237040326,13,21,9,52,2.23290610558131,4.31553047706742,7.85176236112539,101,"ENSG00000079974.19"
"31915","ENSG00000225249.6_250341",250333,250341,9,"ENSG00000225249.6",1,5,"VVUVMVVVV",1,7,0.770186335403727,74,80,97,100,113,119,133,136,"ATGTTCA","CTGA","TGGAGGA","CTGA",2.51450920530622,17,13,14,53,2.32066559344437,4.77101507387146,7.85176041548637,101,"ENSG00000079974.19"
"36486","ENSG00000241359.1_90014",90006,90014,9,"ENSG00000241359.1",1,2,"VMVVVUVVV",1,7,0.806211180124223,116,122,133,136,147,153,163,166,"CAGAAGA","GTGA","GGGATGT","CTGA",2.35103083848111,11,11,10,41,2.83404292477404,4.62689546199535,7.85174018249225,101,"ENSG00000079974.19"
"20897","ENSG00000165973.19_153362",153354,153362,9,"ENSG00000165973.19",1,1,"MVVUVVVVV",1,7,0.786749482401656,108,114,133,136,142,148,203,206,"ATGATGC","CTAA","GTGTAGT","CTGA",2.5885859120676,19,6,55,89,1.56136865078655,4.70465201614264,7.85164994574927,101,"ENSG00000079974.19"
"37768","ENSG00000248779.1_3177",3169,3177,9,"ENSG00000248779.1",1,7,"VVVVVVMVV",0,8,0.885300207039338,94,100,133,136,187,193,204,207,"AGGAGGA","TTGA","CAGAGGA","CTGA",2.43575006354025,33,51,11,104,1.00342668414493,4.31044011026998,7.85164093842733,101,"ENSG00000079974.19"
"2473","ENSG00000075151.24_61932",61924,61932,9,"ENSG00000075151.24",1,2,"UMVVVVVVV",1,7,0.786749482401656,109,115,133,136,137,143,152,155,"ATAAGGA","CTGT","GTGCTGA","CTGA",2.5123455168383,18,1,9,37,2.06953411318097,4.70462605635908,7.85162398596571,101,"ENSG00000079974.19"
"40231","ENSG00000255297.1_892",884,892,9,"ENSG00000255297.1",1,2,"VMVVVVVVV",0,8,0.884057971014493,72,78,96,99,108,114,133,136,"ATGTTGA","CTGA","GAGATGA","ATGT",2.2603797261194,18,9,19,55,2.19224701547607,4.31536129740136,7.85159318145933,101,"ENSG00000079974.19"
"38973","ENSG00000251372.7_174529",174521,174529,9,"ENSG00000251372.7",1,6,"UVVVVMVVV",1,7,0.805383022774327,109,115,133,136,145,151,166,169,"ATGAAGA","CAGG","GTTTTGT","CTGA",2.4128419102593,18,9,15,51,2.43450289211067,4.63002890679317,7.85156099789048,101,"ENSG00000079974.19"
"43368","ENSG00000271584.2_65010",65002,65010,9,"ENSG00000271584.2",1,8,"VVVVVVVMV",0,8,0.884057971014493,101,107,133,136,142,148,182,185,"AAGATGA","ATGG","ATGTTCC","CTGA",2.41201830552068,26,6,34,75,1.18098915492864,4.3152777979333,7.85150968199127,101,"ENSG00000079974.19"
"47293","ENSG00000287946.1_7425",7417,7425,9,"ENSG00000287946.1",1,1,"MVVVVVUVV",1,7,0.792132505175983,82,88,106,109,114,120,133,136,"ATCATTT","CTGA","AGGATGT","CTGA",2.4313339230197,18,5,13,45,2.52296193527474,4.68296368885152,7.85149370955546,101,"ENSG00000079974.19"
"37762","ENSG00000248752.3_823569",823561,823569,9,"ENSG00000248752.3",0,NA,"VVVVVVUVV",1,8,0.886128364389234,83,89,133,136,143,149,159,162,"CTGAAGA","ATGT","GGAATGC","CTGA",2.28414411635859,44,7,10,70,2.00028215621315,4.30697739965094,7.85149085720787,101,"ENSG00000079974.19"
"45486","ENSG00000285637.2_48655",48647,48655,9,"ENSG00000285637.2",1,7,"VVVVVVMVV",0,8,0.885300207039338,62,68,84,87,115,121,133,136,"ATGATTA","CAGA","GTGCTTT","CAGA",2.30571723771231,16,28,12,65,1.86929737404098,4.31018640636409,7.85138723452144,101,"ENSG00000079974.19"
"33122","ENSG00000228740.3_5400",5392,5400,9,"ENSG00000228740.3",0,NA,"VVVUUVVVV",2,7,0.770600414078675,91,97,109,112,116,122,133,136,"ATGGTGG","CTCA","AGGCTGA","CTGA",2.42244951981786,12,4,11,36,2.92626049687161,4.768980990581,7.8513826468957,101,"ENSG00000079974.19"
"19418","ENSG00000162946.23_212117",212109,212117,9,"ENSG00000162946.23",1,5,"VVUVMVVVV",1,7,0.770186335403727,93,99,133,136,148,154,165,168,"ATGTTGA","CTGG","GTGACAA","CTGA",2.59781980565898,34,12,11,66,1.76373737434265,4.77063401968397,7.85137936129888,101,"ENSG00000079974.19"
"13978","ENSG00000144218.21_127040",127032,127040,9,"ENSG00000144218.21",1,1,"MVVVUVVVV",1,7,0.795859213250517,55,61,71,74,80,86,133,136,"ATAATGA","CTGT","ATAAATA","CTGA",2.51457561611542,10,6,47,72,1.90786663080124,4.66792601789268,7.85136287089475,101,"ENSG00000079974.19"
"26069","ENSG00000183230.18_732225",732217,732225,9,"ENSG00000183230.18",1,1,"MVVVVUVVV",1,7,0.82815734989648,104,110,133,136,148,154,176,179,"GTGATAA","ATAA","GTGAAGA","CTGA",2.50627019746784,23,12,22,66,1.44645032815851,4.53872957781936,7.85135897740528,101,"ENSG00000079974.19"
"6522","ENSG00000110436.13_139440",139432,139440,9,"ENSG00000110436.13",1,7,"UVVVVVMVV",1,7,0.787991718426501,110,116,133,136,138,144,153,156,"ATTATGA","CAGT","ATAAGGA","CTGA",2.46597709806415,17,2,9,37,2.35770501516269,4.69938808389759,7.8513549576036,101,"ENSG00000079974.19"
"28037","ENSG00000188001.10_79798",79790,79798,9,"ENSG00000188001.10",1,3,"UVMVVVVVV",1,7,0.785507246376811,84,90,101,104,109,115,133,136,"AAAATGT","CTGA","TTGATTT","CTGA",2.44233630242805,11,5,18,43,2.55470979196342,4.7092379520376,7.85126693754484,101,"ENSG00000079974.19"
"44547","ENSG00000282987.1_160824",160816,160824,9,"ENSG00000282987.1",1,8,"VVVVVUVMV",1,7,0.806211180124224,84,90,133,136,149,155,164,167,"ATGATGG","CTAG","GTGAGGG","CTGA",2.52186235908919,43,13,9,74,1.69325391156004,4.62641740970533,7.85126213020222,101,"ENSG00000079974.19"
"12542","ENSG00000138614.16_24912",24904,24912,9,"ENSG00000138614.16",1,8,"UVVVVVVMV",1,7,0.786749482401656,111,117,133,136,140,146,155,158,"GTGTTGA","TTGG","TTGAAGC","CTGA",2.41243789786657,16,4,9,38,2.73410937113347,4.70425717256099,7.85125510216761,101,"ENSG00000079974.19"
"29664","ENSG00000198586.14_50805",50797,50805,9,"ENSG00000198586.14",0,NA,"VVUVVVVVV",1,8,0.883643892339545,114,120,133,136,156,162,176,179,"GTCATCA","ATAA","ATGTTGT","CTGA",2.26825366558663,13,20,14,56,2.14499639046004,4.31667187359272,7.8512474429509,101,"ENSG00000079974.19"
"12594","ENSG00000138670.19_470221",470213,470221,9,"ENSG00000138670.19",1,8,"VVVVUVVMV",1,7,0.773913043478261,115,121,133,136,148,154,174,177,"GGGATGG","CTGA","ATAATTA","CTGA",2.51096929895668,12,12,20,53,2.28257303038071,4.75559208918965,7.8512442631027,101,"ENSG00000079974.19"
"4219","ENSG00000099250.18_100690",100682,100690,9,"ENSG00000099250.18",1,8,"VVVVVVVMV",0,8,0.884057971014493,81,87,100,103,114,120,133,136,"TTGGTGA","CTGC","ATGGAAA","CTCA",2.17587987971167,13,11,13,46,2.75395732407148,4.31495579720398,7.85118768126195,101,"ENSG00000079974.19"
"22763","ENSG00000171385.11_134236",134228,134236,9,"ENSG00000171385.11",0,NA,"UVVVVVUVV",2,7,0.788819875776397,107,113,133,136,144,150,188,191,"ATGATGT","ATTA","GTGATCA","CTGA",2.59141974777094,20,8,38,75,1.50723986425196,4.69584287901455,7.85112238212014,101,"ENSG00000079974.19"
"34298","ENSG00000232558.1_1473",1465,1473,9,"ENSG00000232558.1",0,NA,"UVVVVVUVV",2,7,0.788819875776397,107,113,133,136,144,150,188,191,"ATGATGT","ATTA","GTGATCA","CTGA",2.59141974777094,20,8,38,75,1.50723986425196,4.69584287901455,7.85112238212014,101,"ENSG00000079974.19"
"10728","ENSG00000132554.21_116458",116450,116458,9,"ENSG00000132554.21",0,NA,"VVVUVUVVV",2,7,0.802898550724638,114,120,133,136,187,193,210,213,"AAGATGA","TAGA","GTGAGAA","CTGA",2.52957868504915,13,51,17,90,1.69392311263923,4.63944525324172,7.85103945614027,101,"ENSG00000079974.19"
"30127","ENSG00000203733.6_520",512,520,9,"ENSG00000203733.6",1,8,"VVVVVVVMV",0,8,0.884057971014493,109,115,133,136,163,169,181,184,"ATTAAGA","TTAA","GTTAAGA","CTGA",2.33207984112121,18,27,12,66,1.71200400006189,4.31480073521749,7.85103261927546,101,"ENSG00000079974.19"
"9889","ENSG00000127995.17_44809",44801,44809,9,"ENSG00000127995.17",1,7,"VVVVVVMVV",0,8,0.885300207039338,113,119,133,136,150,156,164,167,"ATGAAGA","ATGC","ATCATGG","CGGA",2.19996673539062,14,14,8,45,2.57287265732546,4.3098293899824,7.85103021813975,101,"ENSG00000079974.19"
"343","ENSG00000009307.17_9908",9900,9908,9,"ENSG00000009307.17",1,7,"VVVVVVMVV",0,8,0.885300207039338,81,87,105,108,113,119,133,136,"ATGGTGA","CTGA","GGGAAGA","GTGG",2.21489855413307,18,5,14,46,2.47328676243841,4.30981928083139,7.85102010898874,101,"ENSG00000079974.19"
"13149","ENSG00000140396.13_123035",123027,123035,9,"ENSG00000140396.13",1,8,"VVVVVVVMV",0,8,0.884057971014493,102,108,133,136,146,152,175,178,"ATGAGGC","CCAA","GTGTAGA","CTGA",2.37453645666966,25,10,23,67,1.42865884235378,4.31472547170454,7.85095735576251,101,"ENSG00000079974.19"
"24146","ENSG00000175274.19_46436",46428,46436,9,"ENSG00000175274.19",0,NA,"VVVVUUVVV",2,7,0.812008281573499,50,56,85,88,97,103,133,136,"CTGATGA","CAGA","GGGATTT","CTGA",2.59135503818669,29,9,30,77,1.13580178415221,4.60287550968254,7.85090863597654,101,"ENSG00000079974.19"
"20111","ENSG00000164306.11_35750",35742,35750,9,"ENSG00000164306.11",1,2,"VMVVVUVVV",1,7,0.806211180124223,115,121,133,136,146,152,160,163,"CTGTTGC","TTGA","GTGTTCT","CTGA",2.3371339589035,12,10,8,39,2.92332041146315,4.62605336770496,7.85089808820185,101,"ENSG00000079974.19"
"12335","ENSG00000137872.17_331514",331506,331514,9,"ENSG00000137872.17",1,6,"UVVVVMVVV",1,7,0.805383022774327,42,48,87,90,115,121,133,136,"CTGATGC","CTGA","CAGAGGA","CTGA",2.61498168952297,39,25,12,85,1.0840853784845,4.62932416049275,7.85085625159006,101,"ENSG00000079974.19"
"5723","ENSG00000106483.12_191",183,191,9,"ENSG00000106483.12",0,NA,"VVVUVVVVV",1,8,0.880745341614907,100,106,133,136,138,144,171,174,"ATTATGA","TGGA","GTCATCA","CTGA",2.47200078053887,27,2,27,65,0.831445612097355,4.32786270392245,7.85084407038208,101,"ENSG00000079974.19"
"26014","ENSG00000183145.9_10234",10226,10234,9,"ENSG00000183145.9",1,2,"VMVVVVVVV",0,8,0.884057971014493,115,121,133,136,155,161,184,187,"CTTATGA","ATCA","GTGTTTT","CTGA",2.33651134675046,12,19,23,63,1.68157379896492,4.31457902765866,7.85081091171663,101,"ENSG00000079974.19"
"28064","ENSG00000188107.15_1386596",1386588,1386596,9,"ENSG00000188107.15",1,2,"VMUVVVVVV",1,7,0.767701863354037,114,120,133,136,144,150,164,167,"ATGATCA","TTAA","ATTATCA","CTGA",2.43860604799145,13,8,14,44,2.86230846435328,4.77992052940741,7.85072798282356,101,"ENSG00000079974.19"
"20423","ENSG00000164808.17_175989",175981,175989,9,"ENSG00000164808.17",1,1,"MVVVVUVVV",1,7,0.82815734989648,113,119,133,136,147,153,168,171,"AGGATGT","CTTT","GTGTAAA","CTGA",2.33025423017698,14,11,15,49,2.61728620527664,4.53807860161412,7.85070800120004,101,"ENSG00000079974.19"
"4410","ENSG00000100485.12_72033",72025,72033,9,"ENSG00000100485.12",1,2,"VMUVVVVVV",1,7,0.767701863354037,67,73,87,90,103,109,133,136,"AAGAAGA","CTGA","CTGAAGT","CTGA",2.57211449054912,14,13,24,60,1.97184490609458,4.77981871077218,7.85062616418833,101,"ENSG00000079974.19"
"30587","ENSG00000205913.7_11656",11648,11656,9,"ENSG00000205913.7",1,2,"VMVVVVVVV",0,8,0.884057971014493,90,96,133,136,144,150,162,165,"AGGAGGA","CATA","ATGAAAT","CTGA",2.29628149218416,37,8,12,66,1.94894962854841,4.31437322744404,7.85060511150201,101,"ENSG00000079974.19"
"26750","ENSG00000185008.19_1649648",1649640,1649648,9,"ENSG00000185008.19",1,8,"VVVVVVVMV",0,8,0.884057971014493,115,121,133,136,142,148,204,207,"AATTTGA","GTGA","ATGATTC","CTGA",2.2909060745146,12,6,56,83,1.98448610371589,4.31429831678664,7.85053020084461,101,"ENSG00000079974.19"
"6525","ENSG00000110448.11_8337",8329,8337,9,"ENSG00000110448.11",0,NA,"VVUVVVVVV",1,8,0.883643892339545,100,106,133,136,179,185,197,200,"GTGAGGA","CGGA","GTGATGA","GTGA",2.42982692328985,27,43,12,91,1.06475580509349,4.31590049008979,7.85047605944797,101,"ENSG00000079974.19"
"37509","ENSG00000248359.2_49814",49806,49814,9,"ENSG00000248359.2",1,1,"MVVVUVVVV",1,7,0.795859213250517,86,92,108,111,113,119,133,136,"ATGCTGA","CTGA","GTGCTCA","CTTA",2.46141146155481,16,2,14,41,2.2586551665396,4.66701622755958,7.85045308056165,101,"ENSG00000079974.19"
"39994","ENSG00000254632.2_7618",7610,7618,9,"ENSG00000254632.2",1,8,"VVVVVVUMV",1,7,0.770186335403727,113,119,133,136,142,148,158,161,"AATACGA","CTGA","CTGAGGG","CTGA",2.41292867496996,14,6,10,39,2.9924830300038,4.76966854911755,7.85041389073245,101,"ENSG00000079974.19"
"27240","ENSG00000185774.16_13828",13820,13828,9,"ENSG00000185774.16",1,7,"VVVVVVMVV",0,8,0.885300207039338,42,48,61,64,75,81,133,136,"GTGATGG","CAGA","CAGAAGA","TTGA",2.31068607481991,13,11,52,85,1.83224861302956,4.30920561129057,7.85040643944792,101,"ENSG00000079974.19"
"28408","ENSG00000189056.15_514541",514533,514541,9,"ENSG00000189056.15",1,1,"MVVVVUVVV",1,7,0.82815734989648,94,100,107,110,114,120,133,136,"GTGATGT","CTGG","ATGAGGC","CTCA",2.33610543019748,7,4,13,33,2.57688492756612,4.53773028222066,7.85035968180658,101,"ENSG00000079974.19"
"16508","ENSG00000151704.16_10603",10595,10603,9,"ENSG00000151704.16",1,1,"MVVVVUVVV",1,7,0.82815734989648,85,91,110,113,116,122,133,136,"ATGAAGA","CTGA","ATATTGT","CAGA",2.38049818819601,19,3,11,42,2.28090284055374,4.53772269046512,7.85035209005104,101,"ENSG00000079974.19"
"31587","ENSG00000224184.7_178726",178718,178726,9,"ENSG00000224184.7",1,1,"MVVVVVUVV",1,7,0.792132505175983,114,120,133,136,150,156,172,175,"ATAAAGA","CAGC","ATGATGA","CTGA",2.45250483990853,13,14,16,52,2.37723020157233,4.6818156169073,7.85034563761124,101,"ENSG00000079974.19"
"11799","ENSG00000136111.14_42847",42839,42847,9,"ENSG00000136111.14",1,2,"UMVVVVVVV",1,7,0.786749482401656,91,97,108,111,115,121,133,136,"ATGATAA","TTGA","GTGAAAA","ATGA",2.39101652253377,11,4,12,36,2.87319208064017,4.70332555771633,7.85032348732295,101,"ENSG00000079974.19"
"38423","ENSG00000250149.2_213490",213482,213490,9,"ENSG00000250149.2",1,5,"VVUVMVVVV",1,7,0.770186335403727,99,105,133,136,140,146,186,189,"ATGATGA","TTGA","TGGAGGA","CTGA",2.72130439654298,28,4,40,81,0.936242646575904,4.7695679892156,7.85031333083051,101,"ENSG00000079974.19"
"323","ENSG00000008256.16_22424",22416,22424,9,"ENSG00000008256.16",0,NA,"UVVVVUVVV",2,7,0.824844720496894,114,120,133,136,143,149,193,196,"ATGTTGT","TTTA","CTGAAGA","CTGA",2.42985599120687,13,7,44,73,2.00467367390207,4.5509284038203,7.85030728580788,101,"ENSG00000079974.19"
"26631","ENSG00000184672.12_212691",212683,212691,9,"ENSG00000184672.12",0,NA,"UVVUVVVVV",2,7,0.78343685300207,68,74,86,89,98,104,133,136,"ATTTTGA","GTGA","GTGATCA","CTGA",2.51498113316535,12,9,29,59,2.09966542519814,4.71655157824178,7.85029899025006,101,"ENSG00000079974.19"
"46229","ENSG00000286328.1_379",371,379,9,"ENSG00000286328.1",1,8,"VVVVVVVMV",0,8,0.884057971014493,108,114,133,136,146,152,180,183,"TTAAAGA","CAGA","TTGGGGA","CTGA",2.34096760947358,19,10,28,66,1.64956075872779,4.31400287213791,7.85023475619588,101,"ENSG00000079974.19"
"2268","ENSG00000072315.4_9016",9008,9016,9,"ENSG00000072315.4",1,5,"VVVVMVVVV",0,8,0.886542443064182,3,9,26,29,79,85,133,136,"GTGATGA","CTGC","GTGAAGG","TTGA",2.46846655475247,17,50,48,124,0.759797758787964,4.30406036428444,7.85023013654117,101,"ENSG00000079974.19"
"28993","ENSG00000196876.19_78111",78103,78111,9,"ENSG00000196876.19",1,7,"VVVVVVMVV",0,8,0.885300207039338,111,117,133,136,143,149,177,180,"GTGAAGT","CACA","TTGGTGG","CTGA",2.28352199730342,16,7,28,60,2.01238239940712,4.30896559535747,7.85016642351482,101,"ENSG00000079974.19"
"21859","ENSG00000169180.12_28169",28161,28169,9,"ENSG00000169180.12",1,8,"VVVVVUVMV",1,7,0.806211180124224,116,122,133,136,145,151,173,176,"ATGATTG","CTTA","GGCATGA","CTGA",2.42516745849879,11,9,22,51,2.33345423372692,4.62530932259639,7.85015404309328,101,"ENSG00000079974.19"
"22267","ENSG00000170091.11_176512",176504,176512,9,"ENSG00000170091.11",0,NA,"VVUVVUVVV",2,7,0.805797101449275,86,92,98,101,113,119,133,136,"CAGATGA","CAGA","GAGAGGG","CTGA",2.45385092548189,6,12,14,41,2.1488194301353,4.62695640000364,7.85014480580075,101,"ENSG00000079974.19"
"35413","ENSG00000235979.9_70902",70894,70902,9,"ENSG00000235979.9",1,8,"VVVVVVVMV",0,8,0.884057971014493,112,118,133,136,173,179,194,197,"GCAATTA","CTGA","ATAATAA","CTGA",2.32733285729272,15,37,15,76,1.74003989471379,4.31389806916631,7.85012995322428,101,"ENSG00000079974.19"
"46378","ENSG00000286533.1_52548",52540,52548,9,"ENSG00000286533.1",0,NA,"VVUVVVVVV",1,8,0.883643892339545,90,96,133,136,143,149,160,163,"TTGAGGG","TGGA","CAGATGA","CTGA",2.29081318636389,37,7,11,64,1.99001475857051,4.31552566691578,7.85010123627395,101,"ENSG00000079974.19"
"4036","ENSG00000092345.14_78988",78980,78988,9,"ENSG00000092345.14",1,1,"MVVVVUVVV",1,7,0.82815734989648,116,122,133,136,140,146,200,203,"ATGTTGA","TTGG","TTGATTC","CTGA",2.45045866166142,11,4,54,78,1.81346374500614,4.53746370568723,7.85009310527315,101,"ENSG00000079974.19"
"33721","ENSG00000230937.13_3631",3623,3631,9,"ENSG00000230937.13",1,8,"VVVVVVVMV",0,8,0.884057971014493,109,115,133,136,168,174,227,230,"GTGATGG","CCGC","TTGATGC","CTGA",2.48287438120917,18,32,53,112,0.7028787202402,4.313843648742,7.85007553279997,101,"ENSG00000079974.19"
"46880","ENSG00000287299.1_80928",80920,80928,9,"ENSG00000287299.1",1,8,"VVVVVVVMV",0,8,0.884057971014493,111,117,133,136,152,158,174,177,"ATCATGT","ATGC","ATAGTAA","CTGA",2.27554630745815,16,16,16,57,2.08504899530997,4.31383942792441,7.85007131198238,101,"ENSG00000079974.19"
"9043","ENSG00000122432.19_55155",55147,55155,9,"ENSG00000122432.19",1,3,"VVMVVVVVV",0,8,0.882815734989648,41,47,59,62,73,79,133,136,"GTGATAA","ATGA","CTTATGA","GTGA",2.31581158698224,12,11,54,86,1.836181673098,4.31873139657824,7.84999433653683,101,"ENSG00000079974.19"
"41449","ENSG00000259053.1_208005",207997,208005,9,"ENSG00000259053.1",1,8,"VVVVVVVMV",0,8,0.884057971014493,112,118,133,136,169,175,183,186,"ATGAAGA","ATCA","GTGATAA","CAGA",2.30043664589651,15,33,8,65,1.9187750879075,4.31375484847106,7.84998673252903,101,"ENSG00000079974.19"
"534","ENSG00000017797.13_13758",13750,13758,9,"ENSG00000017797.13",1,5,"VVUVMVVVV",1,7,0.770186335403727,106,112,133,136,153,159,172,175,"TTGTTGA","CTGA","TTGAGGG","CTGA",2.59798787407732,21,17,13,60,1.7570274044916,4.76923664125177,7.84998198286668,101,"ENSG00000079974.19"
"8901","ENSG00000121350.16_9667",9659,9667,9,"ENSG00000121350.16",1,8,"UVVVVVVMV",1,7,0.786749482401656,114,120,133,136,142,148,162,165,"AATTTGA","CTGA","ATCAGGA","CTGA",2.39151906626104,13,6,14,42,2.86819816555468,4.70291465182374,7.84991258143036,101,"ENSG00000079974.19"
"28457","ENSG00000189195.15_102871",102863,102871,9,"ENSG00000189195.15",1,8,"VVVVVVVMV",0,8,0.884057971014493,111,117,133,136,148,154,164,167,"ATGATAA","CAGG","TTGTTTA","CTGT",2.19719942913517,16,12,10,47,2.60649490525957,4.31362277487351,7.84985465893148,101,"ENSG00000079974.19"
"3980","ENSG00000091536.20_10077",10069,10077,9,"ENSG00000091536.20",1,8,"VVVVVUVMV",1,7,0.806211180124224,116,122,133,136,148,154,187,190,"ATGAGGA","AAGA","GGGAAGA","CTGA",2.50251770625683,11,12,33,65,1.81656270865366,4.62500352092479,7.84984824142169,101,"ENSG00000079974.19"
"20884","ENSG00000165966.16_269783",269775,269783,9,"ENSG00000165966.16",1,7,"VVVVVVMVV",0,8,0.885300207039338,115,121,133,136,152,158,169,172,"GTAAAGA","GAGA","ATCTAGA","CTGA",2.21372425809792,12,16,11,48,2.47640955718845,4.30864281946032,7.84984364761767,101,"ENSG00000079974.19"
"40794","ENSG00000257677.2_6764",6756,6764,9,"ENSG00000257677.2",1,3,"UVMVVVVVV",1,7,0.785507246376811,113,119,133,136,148,154,183,186,"GTGATCA","CTAA","GTGGGGA","CTGA",2.5428788606266,14,12,29,64,1.87868886307644,4.70780365014678,7.84983263565403,101,"ENSG00000079974.19"
"38023","ENSG00000249362.3_2399",2391,2399,9,"ENSG00000249362.3",1,2,"VMVVVUVVV",1,7,0.806211180124223,79,85,99,102,116,122,133,136,"ATGATAA","ATGT","ATTATTT","CTGA",2.38883957354831,14,14,11,48,2.57431153672816,4.62497717342923,7.84982189392612,101,"ENSG00000079974.19"
"12774","ENSG00000139116.19_98363",98355,98363,9,"ENSG00000139116.19",1,5,"VVVVMVVVV",0,8,0.886542443064182,112,118,133,136,141,147,165,168,"ATTCTGC","CCCA","GTGCAGA","CTGA",2.21021680706235,15,5,18,47,2.47977441635378,4.30363828252569,7.84980805478242,101,"ENSG00000079974.19"
"32672","ENSG00000227528.6_12791",12783,12791,9,"ENSG00000227528.6",1,8,"VVUVVVVMV",1,7,0.767701863354037,116,122,133,136,144,150,164,167,"AAAATGA","GTGA","AAGAGGA","CTGA",2.43984052634469,11,8,14,42,2.85020883553461,4.77895308612481,7.84976053954096,101,"ENSG00000079974.19"
"11394","ENSG00000134775.16_65883",65875,65883,9,"ENSG00000134775.16",1,8,"VVVVVVVMV",0,8,0.884057971014493,103,109,133,136,142,148,159,162,"ATTATGA","ATGG","GTGAAAA","CGGA",2.25985867995223,24,6,11,50,2.18836011145014,4.31352116111625,7.84975304517422,101,"ENSG00000079974.19"
"25048","ENSG00000179242.16_525966",525958,525966,9,"ENSG00000179242.16",1,8,"VVVVUVVMV",1,7,0.773913043478261,82,88,133,136,148,154,162,165,"CTGATGA","CCAA","GTGGTGA","CTGA",2.5905225998347,45,12,8,74,1.74623405447091,4.75409618000889,7.84974835392193,101,"ENSG00000079974.19"
"3225","ENSG00000082458.12_47448",47440,47448,9,"ENSG00000082458.12",1,1,"MVVVUVVVV",1,7,0.795859213250517,54,60,104,107,113,119,133,136,"ATGATGA","CAGA","GTGATCC","GTGA",2.52146010970518,44,6,14,73,1.85549024159492,4.66630607657403,7.8497429295761,101,"ENSG00000079974.19"
"39193","ENSG00000253288.2_231956",231948,231956,9,"ENSG00000253288.2",1,8,"VVVVUVVMV",1,7,0.773913043478261,109,115,133,136,146,152,163,166,"GTGATGG","CTGT","AGGCTGG","CTGA",2.46959395043421,18,10,11,48,2.55217806762677,4.75403443429705,7.84968660821009,101,"ENSG00000079974.19"
"19254","ENSG00000162620.16_52979",52971,52979,9,"ENSG00000162620.16",1,8,"VVVVVVVMV",0,8,0.884057971014493,61,67,104,107,111,117,133,136,"GTCATGA","CTGA","GTAAAAA","CCGA",2.3479792314368,37,4,16,66,1.60054384900107,4.3134346813116,7.84966656536957,101,"ENSG00000079974.19"
"3477","ENSG00000084764.12_25065",25057,25065,9,"ENSG00000084764.12",1,7,"UVVVVVMVV",1,7,0.787991718426501,115,121,133,136,170,176,190,193,"ATGATGG","AAGA","ATGGGGA","CTGA",2.53427493984892,12,34,14,69,1.895607386057,4.69769341292912,7.84966028663512,101,"ENSG00000079974.19"
"651","ENSG00000021852.14_27043",27035,27043,9,"ENSG00000021852.14",0,NA,"UVVVVUVVV",2,7,0.824844720496894,104,110,133,136,143,149,170,173,"ATGCTGA","GTAA","GAGAAGA","CTGA",2.47014583512022,23,7,21,60,1.73328032377929,4.55022980614519,7.84960868813277,101,"ENSG00000079974.19"
"33257","ENSG00000229140.12_838420",838412,838420,9,"ENSG00000229140.12",1,7,"VVVVVVMVV",0,8,0.885300207039338,95,101,133,136,150,156,170,173,"TGGATGA","CCCA","GTCTTGA","CTGA",2.35739114044654,32,14,14,69,1.51754988928515,4.30837270639886,7.84957353455621,101,"ENSG00000079974.19"
"37644","ENSG00000248601.1_10190",10182,10190,9,"ENSG00000248601.1",0,NA,"VVVVVVUVV",1,8,0.886128364389234,74,80,91,94,106,112,133,136,"ATAATGA","TAGA","CTGAAAA","CTGT",2.25285896136842,11,12,21,53,2.20111816010627,4.30504447564059,7.84955793319753,101,"ENSG00000079974.19"
"39209","ENSG00000253311.3_168279",168271,168279,9,"ENSG00000253311.3",1,1,"MVVVVUVVV",1,7,0.82815734989648,115,121,133,136,182,188,198,201,"GTGAGGA","GCGA","TTGAAGG","CTGA",2.42181003230401,12,46,10,77,2.00222084180957,4.53690526429241,7.84953466387833,101,"ENSG00000079974.19"
"8282","ENSG00000117859.19_199144",199136,199144,9,"ENSG00000117859.19",0,NA,"UVVVVUVVV",2,7,0.824844720496894,103,109,133,136,186,192,201,204,"ATGATGA","CACA","ATTAATA","CTGA",2.54745691404796,24,50,9,92,1.2175211486068,4.55014181056498,7.84952069255255,101,"ENSG00000079974.19"
"3075","ENSG00000080709.16_303029",303021,303029,9,"ENSG00000080709.16",1,3,"VVMVVVVVV",0,8,0.882815734989648,75,81,94,97,107,113,133,136,"ATGATGA","CTTA","GTTATAA","TTAA",2.22932479849329,13,10,20,52,2.41052112524927,4.31817161213447,7.84943455209306,101,"ENSG00000079974.19"
"5309","ENSG00000104320.15_54411",54403,54411,9,"ENSG00000104320.15",1,3,"UVMVVVVVV",1,7,0.785507246376811,68,74,104,107,114,120,133,136,"AGGATGG","CTGA","ATAAAGG","CTGA",2.52998668437315,30,7,13,59,1.96265332716144,4.70730780574561,7.84933679125286,101,"ENSG00000079974.19"
"5336","ENSG00000104332.12_10274",10266,10274,9,"ENSG00000104332.12",1,2,"VMVVVVVVV",0,8,0.884057971014493,114,120,133,136,145,151,176,179,"TTTATGT","GAGA","TTGCTTA","CTGA",2.25496485252086,13,9,25,56,2.21925648892861,4.31308887643358,7.84932076049155,101,"ENSG00000079974.19"
"31386","ENSG00000223685.8_177724",177716,177724,9,"ENSG00000223685.8",1,8,"VVVVVVVMV",0,8,0.884057971014493,89,95,133,136,142,148,165,168,"AAAATGA","ATAA","GGGAAGA","CTGA",2.3351578359885,38,6,17,70,1.68439894581443,4.31302946310111,7.84926134715908,101,"ENSG00000079974.19"
"27822","ENSG00000187391.22_788645",788637,788645,9,"ENSG00000187391.22",1,3,"VVMVVVVVV",0,8,0.882815734989648,97,103,133,136,145,151,168,171,"ATGATTA","GTGA","ATGCTTA","CTCA",2.3370285474576,30,9,17,65,1.69174572075437,4.31798400928459,7.84924694924318,101,"ENSG00000079974.19"
"22181","ENSG00000169933.17_61016",61008,61016,9,"ENSG00000169933.17",0,NA,"VVUVVVVVV",1,8,0.883643892339545,109,115,133,136,142,148,158,161,"TTTATGG","CTCT","TTCTTGA","CTGA",2.1894227236233,18,6,10,43,2.66252010637791,4.31466789929998,7.84924346865816,101,"ENSG00000079974.19"
"37507","ENSG00000248359.2_31244",31236,31244,9,"ENSG00000248359.2",0,NA,"VVUVVVVVV",1,8,0.883643892339545,93,99,133,136,160,166,175,178,"ATGATTA","TTGA","CTGAGGA","CTTA",2.41512957474315,34,24,9,76,1.15746633820535,4.31458254245659,7.84915811181477,101,"ENSG00000079974.19"
"29164","ENSG00000197372.10_106372",106364,106372,9,"ENSG00000197372.10",1,8,"VVVVUVVMV",1,7,0.773913043478261,114,120,133,136,149,155,183,186,"GTGATGG","CTGG","TTTATGA","CTGA",2.57243100604427,13,13,28,63,1.86427536305312,4.75345385083706,7.8491060247501,101,"ENSG00000079974.19"
"25561","ENSG00000182168.15_123248",123240,123248,9,"ENSG00000182168.15",1,1,"MVUVVVVVV",1,7,0.789648033126294,113,119,133,136,145,151,159,162,"ATGAAAA","GTGC","ATGATTA","CTGA",2.37512421627726,14,9,8,40,2.92774994011655,4.69047784549123,7.84906997799641,101,"ENSG00000079974.19"
"24340","ENSG00000175868.14_50800",50792,50800,9,"ENSG00000175868.14",1,3,"VVMVVVVVV",0,8,0.882815734989648,55,61,78,81,89,95,133,136,"AGGATGA","CAGA","GAAATGA","CTCA",2.3248878064815,17,8,38,72,1.77185951866031,4.31777789046758,7.84904083042617,101,"ENSG00000079974.19"
"26652","ENSG00000184719.12_150744",150736,150744,9,"ENSG00000184719.12",1,8,"VVVVVUVMV",1,7,0.806211180124224,114,120,133,136,143,149,159,162,"AGTATAA","TTAA","GTGATGA","CTGA",2.31845337723672,13,7,10,39,3.04039141490683,4.62418681578791,7.8490315362848,101,"ENSG00000079974.19"
"25204","ENSG00000179915.25_64569",64561,64569,9,"ENSG00000179915.25",1,5,"VVVVMUVVV",1,7,0.808695652173913,111,117,133,136,150,156,168,171,"ATTATGT","TTTA","GTGAAAA","CTGA",2.40566315422734,16,14,12,51,2.41922814617163,4.6142456269218,7.84902823561745,101,"ENSG00000079974.19"
"42733","ENSG00000266094.8_34301",34293,34301,9,"ENSG00000266094.8",1,8,"VVVVVVVMV",0,8,0.884057971014493,104,110,133,136,155,161,172,175,"ATCCTGT","CTCA","ACGATGA","CTGA",2.35042980029241,23,19,11,62,1.58150728718511,4.31275982228362,7.84899170634159,101,"ENSG00000079974.19"
"44231","ENSG00000279946.1_74",66,74,9,"ENSG00000279946.1",1,8,"VVVVVVVMV",0,8,0.884057971014493,47,53,76,79,98,104,115,118,"ATCCTGT","CTCA","ACGATGA","CTGA",2.35042980029241,23,19,11,62,1.58150728718511,4.31275982228362,7.84899170634159,101,"ENSG00000079974.19"
"16266","ENSG00000151240.17_88752",88744,88752,9,"ENSG00000151240.17",1,5,"VVVVMVVVV",0,8,0.886542443064182,109,115,133,136,184,190,204,207,"AAGATGT","TTGG","TTGACCA","CTGA",2.3508137847803,18,48,14,89,1.53908857073613,4.30279511731787,7.8489648895746,101,"ENSG00000079974.19"
"48143","ENSG00000290531.1_13055",13047,13055,9,"ENSG00000290531.1",1,8,"VVVVVVVMV",0,8,0.884057971014493,70,76,93,96,102,108,133,136,"CTGAAAA","CTGA","GTGATGC","CTGT",2.28582676776484,17,6,25,57,2.01184009593864,4.31267130359273,7.8489031876507,101,"ENSG00000079974.19"
"39070","ENSG00000251574.8_681067",681059,681067,9,"ENSG00000251574.8",1,8,"VVVVVVVMV",0,8,0.884057971014493,69,75,99,102,112,118,133,136,"AAGATGA","CAGA","GTCAATA","CTAA",2.29756603561042,24,10,15,58,1.93329903347571,4.31260148438629,7.84883336844426,101,"ENSG00000079974.19"
"5395","ENSG00000104408.11_75763",75755,75763,9,"ENSG00000104408.11",0,NA,"VVVUVVVVV",1,8,0.880745341614907,61,67,104,107,116,122,133,136,"GTGATGA","CTGA","CTGATAT","TAGA",2.30440201612793,37,9,11,66,1.94061037428869,4.32582262045206,7.84880398691169,101,"ENSG00000079974.19"
"837","ENSG00000036565.15_2517",2509,2517,9,"ENSG00000036565.15",1,8,"VVVVVVVMV",0,8,0.884057971014493,89,95,104,107,113,119,133,136,"ATGCTCA","CAGA","TTGGGGA","CTGC",2.17483285546612,9,6,14,38,2.7512514839343,4.31253429676043,7.8487661808184,101,"ENSG00000079974.19"
"7557","ENSG00000114805.18_247491",247483,247491,9,"ENSG00000114805.18",1,8,"VVVUVVVMV",1,7,0.764803312629399,83,89,103,106,113,119,133,136,"GTGAGGA","CTGT","ATTTTGT","CTGA",2.44712725738266,14,7,14,44,2.84394342984433,4.78953128643218,7.84874453694978,101,"ENSG00000079974.19"
"38718","ENSG00000250938.8_138952",138944,138952,9,"ENSG00000250938.8",1,1,"MVUVVVVVV",1,7,0.789648033126294,108,114,133,136,156,162,177,180,"ATCATTA","CTGA","GTAAAGA","CTGA",2.56323492246657,19,20,15,63,1.67192770639014,4.69004013070849,7.84863226321367,101,"ENSG00000079974.19"
"6409","ENSG00000109689.20_165355",165347,165355,9,"ENSG00000109689.20",1,8,"VVVVVVVMV",0,8,0.884057971014493,108,114,133,136,155,161,178,181,"ATAATGG","ATCA","AAGAAGA","CTGA",2.34786241200061,19,19,17,64,1.59718139578121,4.31239936894631,7.84863125300428,101,"ENSG00000079974.19"
"39542","ENSG00000253773.5_274868",274860,274868,9,"ENSG00000253773.5",1,8,"VVVVVUVMV",1,7,0.806211180124224,43,49,62,65,114,120,133,136,"CTGATGA","TTTA","TTCACGA","CTGA",2.48689116019731,13,49,13,84,1.91582365635157,4.62377451441675,7.84861923491364,101,"ENSG00000079974.19"
"15995","ENSG00000150556.17_148373",148365,148373,9,"ENSG00000150556.17",1,8,"VVVVUVVMV",1,7,0.773913043478261,114,120,133,136,157,163,172,175,"AGGATGA","ATGC","GTGAAGC","CTGA",2.51683929416398,13,21,9,52,2.23290610558131,4.7529586833353,7.84861085724834,101,"ENSG00000079974.19"
"37518","ENSG00000248360.7_29239",29231,29239,9,"ENSG00000248360.7",1,8,"VVVVVVVMV",0,8,0.884057971014493,90,96,133,136,139,145,154,157,"AGGATGA","TTGA","GTGCAGG","CAGA",2.33183272073242,37,3,9,58,1.70374238826806,4.31232346495439,7.84855534901236,101,"ENSG00000079974.19"
"13517","ENSG00000141639.12_33604",33596,33604,9,"ENSG00000141639.12",1,2,"VMVVVVUVV",1,7,0.770186335403727,109,115,133,136,145,151,162,165,"TTGATGC","TGGA","TTGAAGA","CTGA",2.46982998765707,18,9,11,47,2.60548191312479,4.76775379104298,7.84849913265788,101,"ENSG00000079974.19"
"26977","ENSG00000185352.9_275787",275779,275787,9,"ENSG00000185352.9",1,7,"VVVVVVMVV",0,8,0.885300207039338,81,87,98,101,106,112,133,136,"GTGTTAC","CTTA","CTGATAC","CTGA",2.22877149920146,11,5,21,46,2.37068326431302,4.30728998141402,7.84849080957137,101,"ENSG00000079974.19"
"38899","ENSG00000251260.2_12470",12462,12470,9,"ENSG00000251260.2",1,7,"VVVVVVMVV",0,8,0.885300207039338,116,122,133,136,184,190,204,207,"ATGGTAA","ATAA","TTGAAAA","CTGA",2.30724091500966,11,48,14,82,1.8475096284786,4.30727893213574,7.84847976029309,101,"ENSG00000079974.19"
"8260","ENSG00000117643.15_162380",162372,162380,9,"ENSG00000117643.15",1,2,"VMVVVVVVV",0,8,0.884057971014493,113,119,133,136,149,155,168,171,"AAGATTT","CAGG","TTGACAA","CTGA",2.20058014911566,14,13,13,49,2.57837416635746,4.3122271234488,7.84845900750677,101,"ENSG00000079974.19"
"21404","ENSG00000167380.17_10968",10960,10968,9,"ENSG00000167380.17",1,2,"VMVVVVVVV",0,8,0.884057971014493,114,120,133,136,138,144,153,156,"GTAATGA","CTTC","GTGATCT","TTGA",2.17817417709189,13,2,9,33,2.72772849389642,4.31222241862725,7.84845430268522,101,"ENSG00000079974.19"
"22728","ENSG00000171234.14_50096",50088,50096,9,"ENSG00000171234.14",1,1,"MVVUVVVVV",1,7,0.786749482401656,112,118,133,136,180,186,196,199,"GTGATGA","TCGA","CTAGTGA","CTGA",2.5339642766273,15,44,10,78,1.91268265852628,4.70144445901041,7.84844238861703,101,"ENSG00000079974.19"
"8949","ENSG00000121895.8_43416",43408,43416,9,"ENSG00000121895.8",1,6,"VVVVVMUVV",1,7,0.788819875776397,111,117,133,136,154,160,169,172,"CTGATCA","CTGT","CTGTGGA","CTGA",2.48445392773685,16,18,9,52,2.20956987332187,4.69314901455855,7.84842851766414,101,"ENSG00000079974.19"
"25780","ENSG00000182732.18_484767",484759,484767,9,"ENSG00000182732.18",0,NA,"VVVVVVUVV",1,8,0.886128364389234,111,117,133,136,148,154,203,206,"CAGCTGA","CTCA","ATGAGAA","CTGA",2.34131211256234,16,12,49,86,1.60683700603049,4.30389610577818,7.84840956333512,101,"ENSG00000079974.19"
"7412","ENSG00000114062.22_39084",39076,39084,9,"ENSG00000114062.22",1,1,"MVVVVVUVV",1,7,0.792132505175983,116,122,133,136,138,144,156,159,"GTCATGA","CAAA","CTGGAGA","CTGA",2.41420538406001,11,2,12,34,2.6248058813537,4.67987711043845,7.84840713114238,101,"ENSG00000079974.19"
"37545","ENSG00000248441.9_25776",25768,25776,9,"ENSG00000248441.9",1,8,"VVVVVVUMV",1,7,0.770186335403727,51,57,71,74,81,87,133,136,"ATTATGA","CACA","GTGAGGA","CTGA",2.56507478774382,14,7,46,76,1.9698210561926,4.76757991028785,7.84832525190276,101,"ENSG00000079974.19"
"4028","ENSG00000092199.19_37862",37854,37862,9,"ENSG00000092199.19",1,2,"UMVVVVVVV",1,7,0.786749482401656,104,110,133,136,148,154,167,170,"AAGATGA","GTGA","ATTAAAA","CTGA",2.52708559825146,23,12,13,57,1.95797361541807,4.70130273427362,7.84830066388025,101,"ENSG00000079974.19"
"3052","ENSG00000080503.25_68758",68750,68758,9,"ENSG00000080503.25",1,8,"VVVVVVVMV",0,8,0.884057971014493,61,67,80,83,92,98,133,136,"ATGTGGA","CTGA","GAGCTGA","CTGT",2.28734846854113,13,9,35,66,1.99922361310955,4.31205335084594,7.84828523490391,101,"ENSG00000079974.19"
"47100","ENSG00000287670.1_2542",2534,2542,9,"ENSG00000287670.1",1,1,"MVVVVVUVV",1,7,0.792132505175983,106,112,133,136,152,158,171,174,"TTGCTGA","CGGA","GCGATGA","CTGA",2.5351748572645,21,16,13,59,1.81754338453652,4.6796772749083,7.84820729561223,101,"ENSG00000079974.19"
"40479","ENSG00000256538.2_7602",7594,7602,9,"ENSG00000256538.2",1,7,"VVUVVVMVV",1,7,0.768944099378882,82,88,133,136,146,152,172,175,"TTCATGA","CTGA","CTGGTGA","CTGA",2.65121432079574,45,10,20,84,1.41488941914508,4.77241288944584,7.84818928696137,101,"ENSG00000079974.19"
"25862","ENSG00000183020.15_61457",61449,61457,9,"ENSG00000183020.15",1,8,"VVVVVUVMV",1,7,0.806211180124224,54,60,70,73,96,102,133,136,"ATGATGA","CTGA","GTTATTA","CTGT",2.59405164092664,10,23,31,73,1.19958819601151,4.62331645054728,7.84816117104417,101,"ENSG00000079974.19"
"24329","ENSG00000175806.15_179644",179636,179644,9,"ENSG00000175806.15",1,1,"MVVVVUVVV",1,7,0.82815734989648,100,106,133,136,150,156,165,168,"ATAATGA","AAGA","GAAATGA","CTGA",2.46268854443799,27,14,9,59,1.72405416122039,4.53549444770174,7.84812384728766,101,"ENSG00000079974.19"
"21124","ENSG00000166477.13_6316",6308,6316,9,"ENSG00000166477.13",1,1,"MVVVUVVVV",1,7,0.795859213250517,83,89,103,106,113,119,133,136,"AAGAGGA","CTTA","GGGATAT","CTGA",2.37216780658859,14,7,14,44,2.84394342984433,4.66459886844207,7.84803572144414,101,"ENSG00000079974.19"
"47112","ENSG00000287691.1_18497",18489,18497,9,"ENSG00000287691.1",1,3,"VVMVVVVVV",0,8,0.882815734989648,54,60,88,91,109,115,133,136,"ATGAAAA","CTCA","ATGACAA","CTGA",2.42701551621299,28,18,18,73,1.0868256839913,4.3167322813528,7.8479952213114,101,"ENSG00000079974.19"
"40172","ENSG00000255171.7_32251",32243,32251,9,"ENSG00000255171.7",1,2,"VMVVVVVVV",0,8,0.884057971014493,76,82,96,99,106,112,133,136,"ATTATCA","CAGA","GTGTTGG","TTGA",2.22334742397782,14,7,21,51,2.42466892800458,4.31174627196417,7.84797815602214,101,"ENSG00000079974.19"
"15628","ENSG00000148948.8_266412",266404,266412,9,"ENSG00000148948.8",1,5,"VVVUMVVVV",1,7,0.767287784679089,116,122,133,136,148,154,165,168,"ATGATGT","TTAA","ATGCTCT","CTGA",2.45647277012996,11,12,11,43,2.73881508114728,4.77882505383676,7.84797619255312,101,"ENSG00000079974.19"
"37201","ENSG00000245857.4_25702",25694,25702,9,"ENSG00000245857.4",1,1,"MVUVVVVVV",1,7,0.789648033126294,116,122,133,136,165,171,188,191,"TTGTTGA","CTCA","GTGATGG","CTGA",2.55355152204945,11,29,17,66,1.7336816457359,4.68933961484973,7.8479317473549,101,"ENSG00000079974.19"
"4437","ENSG00000100592.16_93561",93553,93561,9,"ENSG00000100592.16",1,2,"VMVVVVVVV",0,8,0.884057971014493,108,114,133,136,145,151,161,164,"ATAATGG","CTCA","CTGATTG","TTGA",2.20748012157725,19,9,10,47,2.53016588800147,4.31167500796245,7.84790689202042,101,"ENSG00000079974.19"
"10889","ENSG00000133059.17_63267",63259,63267,9,"ENSG00000133059.17",1,7,"VVVVVVMVV",0,8,0.885300207039338,111,117,133,136,167,173,183,186,"GAGATAA","TTGG","GTGTAGA","CTGA",2.30196647460845,16,31,10,66,1.88031136421995,4.30668863206908,7.84788946022643,101,"ENSG00000079974.19"
"4029","ENSG00000092199.19_42582",42574,42582,9,"ENSG00000092199.19",1,2,"VMVVVVVVV",0,8,0.884057971014493,69,75,86,89,111,117,133,136,"AAGATGG","CTGA","ATGTAAA","CTGT",2.29646317605033,11,22,16,58,1.93683415865543,4.31164716641441,7.84787905047238,101,"ENSG00000079974.19"
"912","ENSG00000040341.18_273229",273221,273229,9,"ENSG00000040341.18",0,NA,"UVVVVUVVV",2,7,0.824844720496894,116,122,133,136,158,164,178,181,"ATTGTGA","TTGA","AAGATAA","CTGA",2.42163573749932,11,22,14,56,2.04968990058827,4.54848203764593,7.84786091963351,101,"ENSG00000079974.19"
"22164","ENSG00000169933.17_103800",103792,103800,9,"ENSG00000169933.17",1,5,"VVVUMVVVV",1,7,0.767287784679089,53,59,103,106,111,117,133,136,"TGGATGA","CTGA","CTGAACA","CTGA",2.61364684859524,44,5,16,74,1.69031752476571,4.7786574621835,7.84780860089986,101,"ENSG00000079974.19"
"34259","ENSG00000232310.10_150895",150887,150895,9,"ENSG00000232310.10",1,6,"UVVVVMVVV",1,7,0.805383022774327,64,70,85,88,104,110,133,136,"ATGCTGT","CTGA","ATTATTT","CTGA",2.51224453546701,15,16,23,63,1.75679354398881,4.62627261177556,7.84780470287286,101,"ENSG00000079974.19"
"17970","ENSG00000155966.14_286378",286370,286378,9,"ENSG00000155966.14",1,5,"VVVVMVVVV",0,8,0.886542443064182,114,120,133,136,148,154,207,210,"TTAATGG","CTAA","ATGCAAA","CTGA",2.31654211235752,13,12,53,87,1.76267854533304,4.30157315692912,7.84774292918585,101,"ENSG00000079974.19"
"41191","ENSG00000258658.1_24222",24214,24222,9,"ENSG00000258658.1",1,8,"UVVVVVVMV",1,7,0.786749482401656,109,115,133,136,175,181,194,197,"ATGATGT","CTCA","CAGATTA","CTGA",2.58126399987661,18,39,13,79,1.59453347300438,4.70074003471211,7.84773796431873,101,"ENSG00000079974.19"
"6983","ENSG00000112419.15_100541",100533,100541,9,"ENSG00000112419.15",0,NA,"VVVUVVVVV",1,8,0.880745341614907,110,116,133,136,147,153,169,172,"AGGATGA","CAGG","ATGATAT","CTGG",2.2425342084149,17,11,16,53,2.34877699722068,4.32475126333001,7.84773262978964,101,"ENSG00000079974.19"
"5043","ENSG00000102786.15_57244",57236,57244,9,"ENSG00000102786.15",1,8,"VVVVVVVMV",0,8,0.884057971014493,34,40,55,58,73,79,133,136,"GTGAAGA","ATGA","GTGATCA","CTAA",2.36724074764305,15,15,54,93,1.4642669905942,4.31146799372031,7.84769987777828,101,"ENSG00000079974.19"
"32343","ENSG00000226803.9_41940",41932,41940,9,"ENSG00000226803.9",1,8,"VVVVVUVMV",1,7,0.806211180124224,113,119,133,136,144,150,163,166,"AGGATGG","GGGA","AGGATAA","CTGA",2.3419285542781,14,8,13,44,2.87835395180259,4.62280274508082,7.84764746557771,101,"ENSG00000079974.19"
"40634","ENSG00000257242.9_58685",58677,58685,9,"ENSG00000257242.9",1,2,"VMVVVVVVV",0,8,0.884057971014493,101,107,133,136,139,145,156,159,"ATGATGA","ATTA","GAGTTGG","ATGA",2.3136320406541,26,3,11,49,1.82144419352115,4.31141444947045,7.84764633352842,101,"ENSG00000079974.19"
"20392","ENSG00000164796.18_1148442",1148434,1148442,9,"ENSG00000164796.18",1,7,"VVVVVVMVV",0,8,0.885300207039338,79,85,97,100,109,115,133,136,"CTGATGA","TTGT","ATTTTCA","GTGA",2.19556586246753,12,9,18,48,2.5886365687257,4.3064355796273,7.84763640778465,101,"ENSG00000079974.19"
"11422","ENSG00000134882.16_32890",32882,32890,9,"ENSG00000134882.16",1,2,"VMVVVVVVV",0,8,0.884057971014493,81,87,101,104,115,121,133,136,"ACGTTGG","CTGA","TTGACTA","ATGA",2.17265479607796,14,11,12,46,2.76117004326452,4.31138383761273,7.8476157216707,101,"ENSG00000079974.19"
"21102","ENSG00000166439.6_42454",42446,42454,9,"ENSG00000166439.6",1,8,"VVVVVVVMV",0,8,0.884057971014493,85,91,100,103,111,117,133,136,"GGGAGGA","CTGA","ATGGGCA","CTGT",2.19699681439934,9,8,16,42,2.59883718200385,4.31137065283319,7.84760253689116,101,"ENSG00000079974.19"
"13088","ENSG00000140057.9_21633",21625,21633,9,"ENSG00000140057.9",0,NA,"VVVVVVUVV",1,8,0.886128364389234,58,64,83,86,115,121,133,136,"ATGCTGT","CTGA","TTGAGTA","ATGA",2.34242069376817,19,29,12,69,1.5961721372116,4.30307752391652,7.84759098147345,101,"ENSG00000079974.19"
"40935","ENSG00000258131.1_27369",27361,27369,9,"ENSG00000258131.1",1,2,"VMVVVVVVV",0,8,0.884057971014493,111,117,133,136,185,191,205,208,"TTGATAA","TGGA","GTGGTTG","CTGA",2.33024806496161,16,49,14,88,1.71034663471232,4.3113334336141,7.84756531767207,101,"ENSG00000079974.19"
"20759","ENSG00000165548.11_73676",73668,73676,9,"ENSG00000165548.11",0,NA,"UVVVVUVVV",2,7,0.824844720496894,113,119,133,136,144,150,160,163,"ATCAGGA","CCAA","ATAATCA","CTGA",2.2826854534081,14,8,10,41,2.97467924659022,4.54814556732773,7.8475244493153,101,"ENSG00000079974.19"
"41524","ENSG00000259164.1_91933",91925,91933,9,"ENSG00000259164.1",0,NA,"UVVVVUVVV",2,7,0.824844720496894,113,119,133,136,144,150,160,163,"ATCAGGA","CCAA","ATAATCA","CTGA",2.2826854534081,14,8,10,41,2.97467924659022,4.54814556732773,7.8475244493153,101,"ENSG00000079974.19"
"15709","ENSG00000149256.16_501795",501787,501795,9,"ENSG00000149256.16",0,NA,"VVVVVVUVV",1,8,0.886128364389234,110,116,133,136,142,148,169,172,"CTTCTGA","CAGC","GTGGAGA","CTGA",2.2519139217144,17,6,21,53,2.19926566457026,4.30300628566657,7.84751974322351,101,"ENSG00000079974.19"
"22984","ENSG00000171864.5_1212",1204,1212,9,"ENSG00000171864.5",0,NA,"VVVVVVUVV",1,8,0.886128364389234,109,115,133,136,139,145,156,159,"ATCATAC","CAGT","GTGAGCA","CTGA",2.22522591551251,18,3,11,41,2.37717512748084,4.30300364105773,7.84751709861467,101,"ENSG00000079974.19"
"34642","ENSG00000233682.3_3150",3142,3150,9,"ENSG00000233682.3",1,7,"VVVVVVMVV",0,8,0.885300207039338,102,108,133,136,150,156,192,195,"CAGATGA","GAGA","CTGAGGA","CTGA",2.45796766346518,25,14,36,84,0.83872389876909,4.30629374713424,7.84749457529159,101,"ENSG00000079974.19"
"22307","ENSG00000170266.16_40860",40852,40860,9,"ENSG00000170266.16",0,NA,"VVUVVVVVV",1,8,0.883643892339545,103,109,133,136,174,180,189,192,"CTGATGT","CTTC","GGGATGT","CTGA",2.4035961039903,24,38,9,80,1.22770105261256,4.31291876980365,7.84749433916183,101,"ENSG00000079974.19"
"47432","ENSG00000288102.1_49646",49638,49646,9,"ENSG00000288102.1",0,NA,"VVUVVVVVV",1,8,0.883643892339545,111,117,133,136,152,158,197,200,"CTTATGA","CTTT","GTGATTT","CTGA",2.38502532537238,16,16,39,80,1.35147734286963,4.31291154467138,7.84748711402956,101,"ENSG00000079974.19"
"9694","ENSG00000126351.13_19007",18999,19007,9,"ENSG00000126351.13",1,8,"VVVVVUVMV",1,7,0.806211180124224,115,121,133,136,137,143,154,157,"TAGATCA","CTGA","ATGGGCA","CTGA",2.39559451830094,12,1,11,33,2.51988511000256,4.62262880800221,7.8474735284991,101,"ENSG00000079974.19"
"20418","ENSG00000164796.18_923690",923682,923690,9,"ENSG00000164796.18",1,7,"VVVVVUMVV",1,7,0.807453416149068,97,103,133,136,141,147,181,184,"ATGATGA","CAAA","CTGATAG","CTGA",2.6147903418124,30,5,34,78,1.03862158627885,4.61763929959038,7.84745296418665,101,"ENSG00000079974.19"
"27239","ENSG00000185774.16_1199462",1199454,1199462,9,"ENSG00000185774.16",1,7,"UVVVVVMVV",1,7,0.787991718426501,115,121,133,136,179,185,206,209,"ATGATAA","CTGT","ATGTAGA","CTGA",2.59760665571183,12,43,21,85,1.4644748591733,4.6954631409797,7.84743001468571,101,"ENSG00000079974.19"
"26088","ENSG00000183283.16_26497",26489,26497,9,"ENSG00000183283.16",1,5,"UVVVMVVVV",1,7,0.789233954451346,99,105,133,136,139,145,153,156,"ATGATGA","TTGG","AGGTTGT","CTGA",2.55011754558062,28,3,8,48,1.76084361681691,4.69040681350527,7.84734263131065,101,"ENSG00000079974.19"
"23047","ENSG00000172116.23_20729",20721,20729,9,"ENSG00000172116.23",1,8,"VVVVVVVMV",0,8,0.884057971014493,115,121,133,136,141,147,200,203,"TTGGAGA","AGGA","GTGCTGA","CTGA",2.29672268907989,12,5,53,79,1.93278889437266,4.31106837205965,7.84730025611762,101,"ENSG00000079974.19"
"39724","ENSG00000254126.8_20688",20680,20688,9,"ENSG00000254126.8",1,8,"VVVVVVVMV",0,8,0.884057971014493,115,121,133,136,141,147,200,203,"TTGGAGA","AGGA","GTGCTGA","CTGA",2.29672268907989,12,5,53,79,1.93278889437266,4.31106837205965,7.84730025611762,101,"ENSG00000079974.19"
"9467","ENSG00000124786.12_15417",15409,15417,9,"ENSG00000124786.12",1,8,"VVUVVVVMV",1,7,0.767701863354037,48,54,65,68,114,120,133,136,"ATCATGG","CTGA","ATGCTCA","CTGA",2.58148996738446,11,46,13,79,1.89602581918196,4.77648973376959,7.84729718718574,101,"ENSG00000079974.19"
"13068","ENSG00000140009.19_154001",153993,154001,9,"ENSG00000140009.19",1,8,"VVVVVVVMV",0,8,0.884057971014493,110,116,133,136,164,170,183,186,"ATAAAGA","GGGA","TTGTGGA","CTGA",2.32451810395481,17,28,13,67,1.74747022765429,4.31106439683825,7.84729628089622,101,"ENSG00000079974.19"
"34182","ENSG00000232053.7_293132",293124,293132,9,"ENSG00000232053.7",1,7,"VVVUVVMVV",1,7,0.766045548654244,87,93,106,109,113,119,133,136,"TTTATGC","TTGA","ATGAAGA","CTGA",2.45918354024207,13,4,14,40,2.73786037673368,4.78310432792021,7.84728652253719,101,"ENSG00000079974.19"
"8232","ENSG00000117543.22_2094",2086,2094,9,"ENSG00000117543.22",1,1,"MVUVVVVVV",1,7,0.789648033126294,83,89,102,105,109,115,133,136,"ATGATGG","CTAA","GTGATTA","CTTA",2.44148067723301,13,4,18,44,2.47814042209791,4.68866956757949,7.84726170008467,101,"ENSG00000079974.19"
"25621","ENSG00000182247.10_147463",147455,147463,9,"ENSG00000182247.10",1,2,"VMVVVVVVV",0,8,0.884057971014493,94,100,133,136,182,188,204,207,"AGGAGGA","TTGA","GTGCTTA","CTGA",2.46995614462133,33,46,16,104,0.777635179552552,4.31100236925702,7.84723425331499,101,"ENSG00000079974.19"
"29011","ENSG00000196935.10_71888",71880,71888,9,"ENSG00000196935.10",1,2,"VMVVVVUVV",1,7,0.770186335403727,57,63,80,83,113,119,133,136,"TTGAAGA","CTGA","CTGTGGA","CTGA",2.60827887476397,17,30,14,70,1.67741692850896,4.76648569006718,7.84723103168209,101,"ENSG00000079974.19"
"1025","ENSG00000044459.15_59903",59895,59903,9,"ENSG00000044459.15",1,8,"VVVVVVVMV",0,8,0.884057971014493,110,116,133,136,158,164,185,188,"ATCGTGA","CTTC","ATGAGGA","CTGA",2.37375217219683,17,22,21,69,1.41882908714048,4.31096089211317,7.84719277617114,101,"ENSG00000079974.19"
"44388","ENSG00000281566.4_350851",350843,350851,9,"ENSG00000281566.4",1,7,"UVVVVVMVV",1,7,0.787991718426501,113,119,133,136,145,151,175,178,"ATGGGGA","TTGA","TTGATCA","CTGA",2.48286884560742,14,9,24,56,2.22830231433488,4.69519032126276,7.84715719496877,101,"ENSG00000079974.19"
"19794","ENSG00000163697.17_15802",15794,15802,9,"ENSG00000163697.17",1,8,"VVVVVUVMV",1,7,0.806211180124224,94,100,133,136,143,149,182,185,"ATGAAGA","CTCA","GTGAATA","CTGA",2.60943900798281,33,7,33,82,1.09287788087539,4.62228448352353,7.84712920402042,101,"ENSG00000079974.19"
"24444","ENSG00000176406.25_321483",321475,321483,9,"ENSG00000176406.25",1,8,"VVVVVVVMV",0,8,0.884057971014493,105,111,133,136,143,149,161,164,"ATGATCT","ATCA","ACAATTA","CTGA",2.24215487180339,22,7,12,50,2.29584283740129,4.3108854956893,7.84711737974727,101,"ENSG00000079974.19"
"18567","ENSG00000157657.15_50949",50941,50949,9,"ENSG00000157657.15",1,1,"MVUVVVVVV",1,7,0.789648033126294,111,117,133,136,138,144,155,158,"ATGATGT","CTGA","GTAAATA","GTGA",2.45180435769599,16,2,11,38,2.40872996841283,4.68852308826319,7.84711522076836,101,"ENSG00000079974.19"
"3644","ENSG00000087253.13_67953",67945,67953,9,"ENSG00000087253.13",1,8,"VVVVVUVMV",1,7,0.806211180124224,82,88,133,136,141,147,159,162,"TAGATGA","TAGA","GTGAGGA","CTGA",2.4898943619646,45,5,12,71,1.88973908805857,4.6222587086223,7.8471034291192,101,"ENSG00000079974.19"
"30943","ENSG00000214851.5_3329",3321,3329,9,"ENSG00000214851.5",1,7,"VVVVVVMVV",0,8,0.885300207039338,108,114,133,136,158,164,174,177,"ATGAAGA","CTAA","TTGATTG","ATGA",2.31649251296732,19,22,10,60,1.78031240827057,4.30589895701318,7.84709978517053,101,"ENSG00000079974.19"
"1894","ENSG00000067208.16_217091",217083,217091,9,"ENSG00000067208.16",1,3,"UVMVVVVVV",1,7,0.785507246376811,57,63,93,96,105,111,133,136,"ATGATGA","CTTA","ATGATGA","ATGA",2.61277074443924,30,9,22,70,1.40174678028168,4.70505460246915,7.84708358797639,101,"ENSG00000079974.19"
"40705","ENSG00000257431.1_2017",2009,2017,9,"ENSG00000257431.1",0,NA,"VVVVVUUVV",2,7,0.808281573498965,116,122,133,136,146,152,201,204,"TTAATGT","CTGA","CTGGTAA","CTGA",2.48694663258883,11,10,49,79,1.8760753487311,4.6139298914975,7.84705618549336,101,"ENSG00000079974.19"
"18744","ENSG00000158321.19_536173",536165,536173,9,"ENSG00000158321.19",1,5,"VVVUMVVVV",1,7,0.767287784679089,98,104,133,136,147,153,163,166,"GTGATGA","GTGT","GTGTTAA","CTGA",2.58269706761604,29,11,10,59,1.89363080976044,4.77790281513351,7.84705395384986,101,"ENSG00000079974.19"
"13372","ENSG00000141255.13_18589",18581,18589,9,"ENSG00000141255.13",1,7,"VVVVVUMVV",1,7,0.807453416149068,82,88,133,136,142,148,167,170,"ATGATGT","CTGG","ATAATCC","CTGA",2.5364391766178,45,6,19,79,1.55933909952013,4.61723340257637,7.84704706717265,101,"ENSG00000079974.19"
"31895","ENSG00000225205.5_34645",34637,34645,9,"ENSG00000225205.5",1,8,"VVUVVVVMV",1,7,0.767701863354037,23,29,62,65,76,82,133,136,"CTGATGA","CTGA","ATATTGA","CTGA",2.73763744778653,33,11,51,104,0.854027130975406,4.77623586238807,7.84704331580422,101,"ENSG00000079974.19"
"46795","ENSG00000287180.1_14381",14373,14381,9,"ENSG00000287180.1",1,2,"UMVVVVVVV",1,7,0.786749482401656,68,74,83,86,114,120,133,136,"ATGATGA","TTGA","ATAATGA","GTGA",2.54571921314529,9,28,13,59,1.82871498334684,4.70004410107886,7.84704203068549,101,"ENSG00000079974.19"
"38477","ENSG00000250320.7_23029",23021,23029,9,"ENSG00000250320.7",1,8,"VVVVVVVMV",0,8,0.884057971014493,113,119,133,136,145,151,184,187,"TTAATGG","GTGG","GTGAATA","CTGA",2.28789249120946,14,9,33,65,1.99038750027353,4.31075102708415,7.84698291114212,101,"ENSG00000079974.19"
"3843","ENSG00000089250.20_30330",30322,30330,9,"ENSG00000089250.20",0,NA,"VVVUVVVVV",1,8,0.880745341614907,112,118,133,136,165,171,212,215,"AGGTTGA","ATGA","CTGAGCA","CTGA",2.44625655694843,15,29,41,94,0.987606953479849,4.32399599995067,7.8469773664103,101,"ENSG00000079974.19"
"6868","ENSG00000112164.6_36862",36854,36862,9,"ENSG00000112164.6",0,NA,"UVUVVVVVV",2,7,0.786335403726708,113,119,133,136,182,188,197,200,"GTGATGG","CTTA","AAGCTGA","CTGA",2.5262124431447,14,46,9,78,1.96461757771102,4.70150846633558,7.84685008124241,101,"ENSG00000079974.19"
"41776","ENSG00000259709.1_1674",1666,1674,9,"ENSG00000259709.1",0,NA,"UVVUVVVVV",2,7,0.78343685300207,43,49,61,64,115,121,133,136,"AAGATGA","CTTA","ATGAGTC","CTGA",2.53402628424409,12,51,12,84,1.958877246195,4.71309645195556,7.84684386396384,101,"ENSG00000079974.19"
"21526","ENSG00000168214.22_183662",183654,183662,9,"ENSG00000168214.22",0,NA,"VVUVVVVVV",1,8,0.883643892339545,109,115,133,136,159,165,174,177,"GAGATGG","CAGT","GAGAAGA","CTGA",2.31165202272417,18,23,9,59,1.83804899109538,4.31226561898079,7.84684118833897,101,"ENSG00000079974.19"
"37830","ENSG00000248932.8_275763",275755,275763,9,"ENSG00000248932.8",1,6,"VVUVVMVVV",1,7,0.786335403726708,110,116,133,136,143,149,160,163,"ATGATGG","CTGT","AGGATGA","TTGA",2.40846534164219,17,7,11,44,2.74945851448307,4.70147353135775,7.84681514626458,101,"ENSG00000079974.19"
"30294","ENSG00000204442.4_311100",311092,311100,9,"ENSG00000204442.4",1,8,"UVVVVVVMV",1,7,0.786749482401656,58,64,78,81,106,112,133,136,"ATAATGA","CTGC","ATGTTAA","CTGA",2.58764837598418,14,25,21,69,1.54810682425398,4.69977399937045,7.84677192897708,101,"ENSG00000079974.19"
"11511","ENSG00000135249.8_4567",4559,4567,9,"ENSG00000135249.8",1,3,"VVMVVVVVV",0,8,0.882815734989648,93,99,133,136,146,152,163,166,"TTGATAA","GTTA","GTAAGTA","CTGA",2.30489067142916,34,10,11,64,1.89608922816622,4.31550675942348,7.84676969938207,101,"ENSG00000079974.19"
"18152","ENSG00000156273.16_422985",422977,422985,9,"ENSG00000156273.16",1,2,"VMVVVVVVV",0,8,0.884057971014493,116,122,133,136,140,146,160,163,"ATAATAA","GTGA","AAGATGG","CTAA",2.17475343492446,11,4,14,38,2.74374898397205,4.31052630420045,7.84675818825842,101,"ENSG00000079974.19"
"5042","ENSG00000102786.15_5170",5162,5170,9,"ENSG00000102786.15",0,NA,"UVVUVVVVV",2,7,0.78343685300207,111,117,133,136,169,175,185,188,"ATGATAA","TTGA","TTCATCA","CTGA",2.5477491480164,16,33,10,68,1.8670267251542,4.71300526131588,7.84675267332416,101,"ENSG00000079974.19"
"1270","ENSG00000050767.18_64501",64493,64501,9,"ENSG00000050767.18",0,NA,"UVVUVVVVV",2,7,0.78343685300207,113,119,133,136,175,181,192,195,"CTGATGA","TTGG","CTGTGGA","CTGA",2.53395431769148,14,39,11,73,1.95870497037854,4.7129334387471,7.84668085075538,101,"ENSG00000079974.19"
"910","ENSG00000040341.18_259434",259426,259434,9,"ENSG00000040341.18",1,7,"VVVVVVMVV",0,8,0.885300207039338,112,118,133,136,150,156,165,168,"ATAAACA","CTGT","ATAATAT","CTGA",2.20322717345964,15,14,9,47,2.53367669746204,4.30546446346491,7.84666529162226,101,"ENSG00000079974.19"
"22969","ENSG00000171843.17_38466",38458,38466,9,"ENSG00000171843.17",1,7,"VVVVVVMVV",0,8,0.885300207039338,106,112,133,136,146,152,182,185,"GAGATGA","TTTA","GGGAAGC","CTGA",2.36807005212735,21,10,30,70,1.43462139487414,4.30543876893079,7.84663959708814,101,"ENSG00000079974.19"
"24660","ENSG00000177338.14_54997",54989,54997,9,"ENSG00000177338.14",0,NA,"VVVVVVUVV",1,8,0.886128364389234,114,120,133,136,142,148,202,205,"ATGACAA","CTTT","CTGGTGC","CTGA",2.28421548015313,13,6,54,82,1.98034225301844,4.30211136350983,7.84662482106677,101,"ENSG00000079974.19"
"19086","ENSG00000161040.18_174725",174717,174725,9,"ENSG00000161040.18",1,2,"VMVVVVUVV",1,7,0.770186335403727,100,106,133,136,140,146,156,159,"ATGATGA","ATTA","ATGTTTT","CTGA",2.5683376391097,27,4,10,50,1.94115726429182,4.76585204792245,7.84659738953736,101,"ENSG00000079974.19"
"26336","ENSG00000183873.18_6964",6956,6964,9,"ENSG00000183873.18",1,2,"VMVVVVVVV",0,8,0.884057971014493,96,102,133,136,141,147,159,162,"TAGATCA","CAAA","GTGTTGA","CTGA",2.2979693195728,31,5,12,57,1.92157754372729,4.31034325188649,7.84657513594446,101,"ENSG00000079974.19"
"35895","ENSG00000237442.3_2207",2199,2207,9,"ENSG00000237442.3",0,NA,"VVVVVVUVV",1,8,0.886128364389234,91,97,105,108,111,117,133,136,"ATGCTTA","ATTA","ATACAGA","CTGA",2.23726877693418,8,3,16,36,2.29309380951448,4.30205474726893,7.84656820482586,101,"ENSG00000079974.19"
"606","ENSG00000021645.20_1149242",1149234,1149242,9,"ENSG00000021645.20",1,1,"MVVVVVUVV",1,7,0.792132505175983,77,83,99,102,112,118,133,136,"GTGATGA","CTGT","AGGAAGA","GTGA",2.42368771380263,16,10,15,50,2.553965310048,4.67797085051639,7.84650087122032,101,"ENSG00000079974.19"
"21160","ENSG00000166689.18_159099",159091,159099,9,"ENSG00000166689.18",1,8,"VVVVVVVMV",0,8,0.884057971014493,76,82,93,96,105,111,133,136,"GTGCTGA","CAGA","GTAAATA","GTGA",2.23611528622962,11,9,22,51,2.33345423372692,4.31022236881444,7.84645425287241,101,"ENSG00000079974.19"
"17746","ENSG00000155011.9_306906",306898,306906,9,"ENSG00000155011.9",1,8,"VVVVVVVMV",0,8,0.884057971014493,75,81,104,107,115,121,133,136,"ATGCTGA","CTGC","GAGATCC","CTCA",2.25343208126043,23,8,12,52,2.21798894371276,4.31021737136223,7.84644925542021,101,"ENSG00000079974.19"
"12772","ENSG00000139116.19_19120",19112,19120,9,"ENSG00000139116.19",1,8,"VVVVVUVMV",1,7,0.806211180124224,115,121,133,136,141,147,172,175,"GTGAGGT","GTGA","ATGTTGT","CTGA",2.44218447005905,12,5,25,51,2.20514088557258,4.62159267149156,7.84643739198846,101,"ENSG00000079974.19"
"19274","ENSG00000162636.16_7623",7615,7623,9,"ENSG00000162636.16",1,3,"VVMVVVVVV",0,8,0.882815734989648,116,122,133,136,143,149,182,185,"AAGATAA","GCGA","TTTATGG","CTGA",2.28149139900946,11,7,33,60,2.05068975827797,4.31515810458526,7.84642104454385,101,"ENSG00000079974.19"
"10348","ENSG00000130635.17_173314",173306,173314,9,"ENSG00000130635.17",1,8,"VVVVVUVMV",1,7,0.806211180124224,98,104,133,136,137,143,167,170,"GAGATGA","CTGA","GTGATTC","CTGA",2.66822512350035,29,1,24,63,0.698090416939145,4.62156447673537,7.84640919723227,101,"ENSG00000079974.19"
"2519","ENSG00000075413.19_60497",60489,60497,9,"ENSG00000075413.19",1,5,"VVVVMVVVV",0,8,0.886542443064182,112,118,133,136,160,166,175,178,"GTGACAA","TTGT","GTGGTCA","CTGA",2.27189777000643,15,24,9,57,2.05478191127613,4.30019176116308,7.84636153341981,101,"ENSG00000079974.19"
"18684","ENSG00000158104.11_19247",19239,19247,9,"ENSG00000158104.11",0,NA,"UVVVVUVVV",2,7,0.824844720496894,108,114,133,136,141,147,201,204,"ATAATGA","CTCA","GGGCTCA","CTGA",2.5017645220113,19,5,54,87,1.50923243826154,4.54691564625089,7.84629452823847,101,"ENSG00000079974.19"
"24566","ENSG00000176927.16_92749",92741,92749,9,"ENSG00000176927.16",0,NA,"VVVUVVVVV",1,8,0.880745341614907,113,119,133,136,148,154,168,171,"CAGATCA","ATGT","AGGATGG","CTGA",2.20363881394962,14,12,14,49,2.60230465969489,4.32330752150642,7.84628888796604,101,"ENSG00000079974.19"
"18701","ENSG00000158169.14_70478",70470,70478,9,"ENSG00000158169.14",1,2,"VMVVVVVVV",0,8,0.884057971014493,111,117,133,136,148,154,192,195,"ATGAAGT","TTTA","ATAATTA","CTGA",2.34090712702865,16,12,38,75,1.63398803017102,4.31000888592384,7.84624076998181,101,"ENSG00000079974.19"
"47028","ENSG00000287526.1_61259",61251,61259,9,"ENSG00000287526.1",1,8,"VVVVVVUMV",1,7,0.770186335403727,115,121,133,136,143,149,192,195,"ATGACTA","CTGA","CTGAGGG","CTGA",2.55760051688951,12,7,43,71,2.01129740178583,4.76549187859564,7.84623722021054,101,"ENSG00000079974.19"
"2026","ENSG00000069188.17_259310",259302,259310,9,"ENSG00000069188.17",1,7,"VVVVVVMVV",0,8,0.885300207039338,50,56,67,70,81,87,133,136,"CTGAAGT","CTCA","CACATGA","CTGA",2.31061464551166,11,11,46,77,1.81583154354178,4.30498229507154,7.84618312322889,101,"ENSG00000079974.19"
"12414","ENSG00000138109.11_37225",37217,37225,9,"ENSG00000138109.11",1,8,"VVVVVVVMV",0,8,0.884057971014493,93,99,133,136,143,149,157,160,"ATCATAA","GTGT","GTGAGTG","CTGA",2.28713217271055,34,7,8,58,1.99224050797665,4.30994708151174,7.84617896556971,101,"ENSG00000079974.19"
"46911","ENSG00000287352.1_8638",8630,8638,9,"ENSG00000287352.1",1,2,"VMVVVVVVV",0,8,0.884057971014493,63,69,86,89,100,106,133,136,"CAGACGA","CAGA","CTCATAA","CTGA",2.31690232594728,17,11,27,64,1.79364330777396,4.30991470352229,7.84614658758027,101,"ENSG00000079974.19"
"43003","ENSG00000267586.7_132936",132928,132936,9,"ENSG00000267586.7",1,2,"VMVVVVVVV",0,8,0.884057971014493,86,92,133,136,140,146,155,158,"ATAATGA","ATGA","TTTATTA","ATGA",2.31034643666331,41,4,9,63,1.83733870868522,4.30991207161015,7.84614395566812,101,"ENSG00000079974.19"
"5105","ENSG00000103091.15_62825",62817,62825,9,"ENSG00000103091.15",0,NA,"UVVVVUVVV",2,7,0.824844720496894,83,89,98,101,110,116,133,136,"CTGGTGG","CTGC","ATGCTTA","CTGA",2.35407892968537,9,9,17,44,2.49315300576152,4.54675313424933,7.84613201623691,101,"ENSG00000079974.19"
"36908","ENSG00000243550.3_8470",8462,8470,9,"ENSG00000243550.3",1,2,"VMVVVUVVV",1,7,0.806211180124223,115,121,133,136,139,145,157,160,"TTGATGT","CAGA","ATGATAA","CTCA",2.35850171767569,12,3,12,36,2.76165893118511,4.62125092892243,7.84609564941932,101,"ENSG00000079974.19"
"210","ENSG00000006634.8_26418",26410,26418,9,"ENSG00000006634.8",1,1,"MVVVUVVVV",1,7,0.795859213250517,116,122,133,136,147,153,205,208,"AGGATGA","CTTA","GAGGGGA","CTGA",2.5258750821422,11,11,52,83,1.81142231388203,4.66264738204084,7.84608423504291,101,"ENSG00000079974.19"
"26790","ENSG00000185022.12_12859",12851,12859,9,"ENSG00000185022.12",0,NA,"VVVUVVVVV",1,8,0.880745341614907,93,99,133,136,139,145,156,159,"ATGATGA","CAGC","GTGCACA","CTGG",2.33899955180462,34,3,11,57,1.69875770082378,4.32302201154698,7.84600337800661,101,"ENSG00000079974.19"
"22285","ENSG00000170153.11_72528",72520,72528,9,"ENSG00000170153.11",1,8,"VVVVUVVMV",1,7,0.773913043478261,113,119,133,136,143,149,162,165,"ATGATAA","CAAA","GTCAAAA","CTGA",2.41589725544798,14,7,13,43,2.89540137332488,4.75034576907786,7.8459979429909,101,"ENSG00000079974.19"
"19832","ENSG00000163785.13_19985",19977,19985,9,"ENSG00000163785.13",1,2,"VMVVVVVVV",0,8,0.884057971014493,89,95,106,109,113,119,133,136,"ATGATTT","TTGA","AAGCAGA","TTGA",2.17424570850092,11,4,14,38,2.74374898397205,4.30968009349454,7.84591197755251,101,"ENSG00000079974.19"
"11321","ENSG00000134532.20_542126",542118,542126,9,"ENSG00000134532.20",0,NA,"VVVUVVVVV",1,8,0.880745341614907,57,63,75,78,81,87,133,136,"ATGAAGA","CAGA","GAGATTA","CTGC",2.33770878052667,12,3,46,70,1.70693748433265,4.32291567196095,7.84589703842058,101,"ENSG00000079974.19"
"21400","ENSG00000167355.8_197752",197744,197752,9,"ENSG00000167355.8",1,2,"VMVVVVVVV",0,8,0.884057971014493,113,119,133,136,148,154,166,169,"AGGCTGA","CTTA","TTGAGGC","ATGA",2.18220691049237,14,12,12,47,2.69058290894004,4.3096572447223,7.84588912878027,101,"ENSG00000079974.19"
"28821","ENSG00000196565.15_197705",197697,197705,9,"ENSG00000196565.15",1,2,"VMVVVVVVV",0,8,0.884057971014493,113,119,133,136,148,154,166,169,"AGGCTGA","CTTA","TTGAGGC","ATGA",2.18220691049237,14,12,12,47,2.69058290894004,4.3096572447223,7.84588912878027,101,"ENSG00000079974.19"
"30819","ENSG00000213931.7_197752",197744,197752,9,"ENSG00000213931.7",1,2,"VMVVVVVVV",0,8,0.884057971014493,113,119,133,136,148,154,166,169,"AGGCTGA","CTTA","TTGAGGC","ATGA",2.18220691049237,14,12,12,47,2.69058290894004,4.3096572447223,7.84588912878027,101,"ENSG00000079974.19"
"36323","ENSG00000239920.2_370534",370526,370534,9,"ENSG00000239920.2",1,2,"VMVVVVVVV",0,8,0.884057971014493,113,119,133,136,148,154,166,169,"AGGCTGA","CTTA","TTGAGGC","ATGA",2.18220691049237,14,12,12,47,2.69058290894004,4.3096572447223,7.84588912878027,101,"ENSG00000079974.19"
"10124","ENSG00000129493.15_13150",13142,13150,9,"ENSG00000129493.15",1,2,"VMVVVVVVV",0,8,0.884057971014493,114,120,133,136,144,150,181,184,"ATCTTGT","CTAA","TTAATGC","CTGA",2.27235407949403,13,8,31,61,2.08939579386473,4.30960574762289,7.84583763168086,101,"ENSG00000079974.19"
"30077","ENSG00000203546.7_50041",50033,50041,9,"ENSG00000203546.7",1,2,"VMVVVVVVV",0,8,0.884057971014493,114,120,133,136,144,150,181,184,"ATCTTGT","CTAA","TTAATGC","CTGA",2.27235407949403,13,8,31,61,2.08939579386473,4.30960574762289,7.84583763168086,101,"ENSG00000079974.19"
"11112","ENSG00000133962.8_164420",164412,164420,9,"ENSG00000133962.8",1,6,"UVVVVMVVV",1,7,0.805383022774327,115,121,133,136,144,150,196,199,"TTTATGA","ATGA","AAGATAA","CTGA",2.47566984682617,12,8,46,75,1.99271678985944,4.6242956088418,7.84582769993911,101,"ENSG00000079974.19"
"7761","ENSG00000115594.12_53696",53688,53696,9,"ENSG00000115594.12",1,2,"VMVVUVVVV",1,7,0.773913043478261,99,105,133,136,147,153,166,169,"GTGATGT","CAGA","TTGGGGA","CTGA",2.57526542175304,28,11,13,61,1.83217212070949,4.75015206643244,7.84580424034548,101,"ENSG00000079974.19"
"8718","ENSG00000120471.16_7790",7782,7790,9,"ENSG00000120471.16",1,8,"VVVVVVVMV",0,8,0.884057971014493,116,122,133,136,147,153,166,169,"ATGATCA","CCGT","GTGAGCC","CTGC",2.17507917016154,11,11,13,44,2.73771762998642,4.30956135776584,7.84579324182381,101,"ENSG00000079974.19"
"43227","ENSG00000270139.1_656",648,656,9,"ENSG00000270139.1",1,8,"VVVVUVVMV",1,7,0.773913043478261,111,117,133,136,142,148,161,164,"ATGTGGA","CAGA","GTAATAA","CTGA",2.43763941801465,16,6,13,44,2.74952189876665,4.75011283804941,7.84576501196246,101,"ENSG00000079974.19"
"6268","ENSG00000109118.14_41293",41285,41293,9,"ENSG00000109118.14",1,2,"VMVVVVVVV",0,8,0.884057971014493,112,118,133,136,151,157,176,179,"ATGCTGT","CTTG","ATGCCAA","CTGA",2.27990227064274,15,15,19,58,2.03856563267926,4.30947852590771,7.84571040996568,101,"ENSG00000079974.19"
"32572","ENSG00000227240.2_473377",473369,473377,9,"ENSG00000227240.2",1,8,"VVVVVVVMV",0,8,0.884057971014493,108,114,133,136,143,149,182,185,"AAAATGA","GTAA","ATGAGAA","CTGA",2.33773760208126,19,7,33,68,1.65275019000311,4.30941688430287,7.84564876836084,101,"ENSG00000079974.19"
"15302","ENSG00000147655.12_40758",40750,40758,9,"ENSG00000147655.12",0,NA,"VVVVUVUVV",2,7,0.775983436853002,113,119,133,136,147,153,175,178,"AAGATGT","CTTA","GTGAAGG","CTGA",2.514034068581,14,11,22,56,2.20659396723971,4.74170527277826,7.84563902019027,101,"ENSG00000079974.19"
"3673","ENSG00000087470.21_10940",10932,10940,9,"ENSG00000087470.21",1,8,"VVVVVVVMV",0,8,0.884057971014493,82,88,99,102,110,116,133,136,"GGGAAGA","GGGA","ATCACCA","CTGA",2.18585736753031,11,8,17,45,2.66507824251817,4.30936517318006,7.84559705723803,101,"ENSG00000079974.19"
"23602","ENSG00000173406.16_1435424",1435416,1435424,9,"ENSG00000173406.16",1,5,"VVUVMVVVV",1,7,0.770186335403727,55,61,67,70,80,86,133,136,"GTCATGA","CTGA","CTGAACA","CTGA",2.65034409630166,6,10,47,72,1.39040509777613,4.76484143494681,7.84558677656172,101,"ENSG00000079974.19"
"7415","ENSG00000114098.18_33909",33901,33909,9,"ENSG00000114098.18",1,6,"VVVUVMVVV",1,7,0.78343685300207,115,121,133,136,146,152,166,169,"CTGGTGA","CTGT","ATAAAAA","CTGA",2.41068511658272,12,10,14,45,2.77574796086026,4.71174551785293,7.84549292986121,101,"ENSG00000079974.19"
"10611","ENSG00000131848.10_31883",31875,31883,9,"ENSG00000131848.10",1,7,"VVVVVVMVV",0,8,0.885300207039338,94,100,133,136,172,178,195,198,"AGGAGGA","TTGA","ATGCAGA","CTGA",2.47291222570241,33,36,17,95,0.730985262692525,4.30426669184382,7.84546752000116,101,"ENSG00000079974.19"
"15753","ENSG00000149380.12_17277",17269,17277,9,"ENSG00000149380.12",1,7,"VVVVVVMVV",0,8,0.885300207039338,94,100,133,136,172,178,195,198,"AGGAGGA","TTGA","ATGCAGA","CTGA",2.47291222570241,33,36,17,95,0.730985262692525,4.30426669184382,7.84546752000116,101,"ENSG00000079974.19"
"38775","ENSG00000251012.2_18362",18354,18362,9,"ENSG00000251012.2",1,7,"VVVVVVMVV",0,8,0.885300207039338,94,100,133,136,172,178,195,198,"AGGAGGA","TTGA","ATGCAGA","CTGA",2.47291222570241,33,36,17,95,0.730985262692525,4.30426669184382,7.84546752000116,101,"ENSG00000079974.19"
"45908","ENSG00000286044.1_181870",181862,181870,9,"ENSG00000286044.1",1,7,"VVVVVVMVV",0,8,0.885300207039338,94,100,133,136,172,178,195,198,"AGGAGGA","TTGA","ATGCAGA","CTGA",2.47291222570241,33,36,17,95,0.730985262692525,4.30426669184382,7.84546752000116,101,"ENSG00000079974.19"
"22608","ENSG00000170949.18_20552",20544,20552,9,"ENSG00000170949.18",1,7,"VVVVVVMVV",0,8,0.885300207039338,105,111,133,136,156,162,177,180,"CTGATTA","CAGG","CTGTTGG","CTGA",2.36767338472954,22,20,15,66,1.43212836772972,4.30415439981499,7.84535522797234,101,"ENSG00000079974.19"
"5858","ENSG00000107099.18_105321",105313,105321,9,"ENSG00000107099.18",1,8,"VVVVVVVMV",0,8,0.884057971014493,87,93,133,136,141,147,168,171,"GAGATGG","CAGG","GTGATCA","CTGA",2.37648232157747,40,5,21,75,1.39320769964178,4.30910579420622,7.84533767826419,101,"ENSG00000079974.19"
"5859","ENSG00000107099.18_105443",105435,105443,9,"ENSG00000107099.18",1,8,"VVVVVVVMV",0,8,0.884057971014493,87,93,133,136,141,147,168,171,"GAGATGG","CAGG","GTGATCA","CTGA",2.37648232157747,40,5,21,75,1.39320769964178,4.30910579420622,7.84533767826419,101,"ENSG00000079974.19"
"5860","ENSG00000107099.18_105504",105496,105504,9,"ENSG00000107099.18",1,8,"VVVVVVVMV",0,8,0.884057971014493,87,93,133,136,141,147,168,171,"GAGATGG","CAGG","GTGATCA","CTGA",2.37648232157747,40,5,21,75,1.39320769964178,4.30910579420622,7.84533767826419,101,"ENSG00000079974.19"
"5861","ENSG00000107099.18_105565",105557,105565,9,"ENSG00000107099.18",1,8,"VVVVVVVMV",0,8,0.884057971014493,87,93,133,136,141,147,168,171,"GAGATGG","CAGG","GTGATCA","CTGA",2.37648232157747,40,5,21,75,1.39320769964178,4.30910579420622,7.84533767826419,101,"ENSG00000079974.19"
"5862","ENSG00000107099.18_105687",105679,105687,9,"ENSG00000107099.18",1,8,"VVVVVVVMV",0,8,0.884057971014493,87,93,133,136,141,147,168,171,"GAGATGG","CAGG","GTGATCA","CTGA",2.37648232157747,40,5,21,75,1.39320769964178,4.30910579420622,7.84533767826419,101,"ENSG00000079974.19"
"5863","ENSG00000107099.18_105748",105740,105748,9,"ENSG00000107099.18",1,8,"VVVVVVVMV",0,8,0.884057971014493,87,93,133,136,141,147,168,171,"GAGATGG","CAGG","GTGATCA","CTGA",2.37648232157747,40,5,21,75,1.39320769964178,4.30910579420622,7.84533767826419,101,"ENSG00000079974.19"
"5864","ENSG00000107099.18_105992",105984,105992,9,"ENSG00000107099.18",1,8,"VVVVVVVMV",0,8,0.884057971014493,87,93,133,136,141,147,168,171,"GAGATGG","CAGG","GTGATCA","CTGA",2.37648232157747,40,5,21,75,1.39320769964178,4.30910579420622,7.84533767826419,101,"ENSG00000079974.19"
"5865","ENSG00000107099.18_106236",106228,106236,9,"ENSG00000107099.18",1,8,"VVVVVVVMV",0,8,0.884057971014493,87,93,133,136,141,147,168,171,"GAGATGG","CAGG","GTGATCA","CTGA",2.37648232157747,40,5,21,75,1.39320769964178,4.30910579420622,7.84533767826419,101,"ENSG00000079974.19"
"5866","ENSG00000107099.18_106297",106289,106297,9,"ENSG00000107099.18",1,8,"VVVVVVVMV",0,8,0.884057971014493,87,93,133,136,141,147,168,171,"GAGATGG","CAGG","GTGATCA","CTGA",2.37648232157747,40,5,21,75,1.39320769964178,4.30910579420622,7.84533767826419,101,"ENSG00000079974.19"
"5867","ENSG00000107099.18_106358",106350,106358,9,"ENSG00000107099.18",1,8,"VVVVVVVMV",0,8,0.884057971014493,87,93,133,136,141,147,168,171,"GAGATGG","CAGG","GTGATCA","CTGA",2.37648232157747,40,5,21,75,1.39320769964178,4.30910579420622,7.84533767826419,101,"ENSG00000079974.19"
"5868","ENSG00000107099.18_106419",106411,106419,9,"ENSG00000107099.18",1,8,"VVVVVVVMV",0,8,0.884057971014493,87,93,133,136,141,147,168,171,"GAGATGG","CAGG","GTGATCA","CTGA",2.37648232157747,40,5,21,75,1.39320769964178,4.30910579420622,7.84533767826419,101,"ENSG00000079974.19"
"5869","ENSG00000107099.18_106480",106472,106480,9,"ENSG00000107099.18",1,8,"VVVVVVVMV",0,8,0.884057971014493,87,93,133,136,141,147,168,171,"GAGATGG","CAGG","GTGATCA","CTGA",2.37648232157747,40,5,21,75,1.39320769964178,4.30910579420622,7.84533767826419,101,"ENSG00000079974.19"
"5870","ENSG00000107099.18_106663",106655,106663,9,"ENSG00000107099.18",1,8,"VVVVVVVMV",0,8,0.884057971014493,87,93,133,136,141,147,168,171,"GAGATGG","CAGG","GTGATCA","CTGA",2.37648232157747,40,5,21,75,1.39320769964178,4.30910579420622,7.84533767826419,101,"ENSG00000079974.19"
"5871","ENSG00000107099.18_106724",106716,106724,9,"ENSG00000107099.18",1,8,"VVVVVVVMV",0,8,0.884057971014493,87,93,133,136,141,147,168,171,"GAGATGG","CAGG","GTGATCA","CTGA",2.37648232157747,40,5,21,75,1.39320769964178,4.30910579420622,7.84533767826419,101,"ENSG00000079974.19"
"5872","ENSG00000107099.18_106785",106777,106785,9,"ENSG00000107099.18",1,8,"VVVVVVVMV",0,8,0.884057971014493,87,93,133,136,141,147,168,171,"GAGATGG","CAGG","GTGATCA","CTGA",2.37648232157747,40,5,21,75,1.39320769964178,4.30910579420622,7.84533767826419,101,"ENSG00000079974.19"
"5873","ENSG00000107099.18_106846",106838,106846,9,"ENSG00000107099.18",1,8,"VVVVVVVMV",0,8,0.884057971014493,87,93,133,136,141,147,168,171,"GAGATGG","CAGG","GTGATCA","CTGA",2.37648232157747,40,5,21,75,1.39320769964178,4.30910579420622,7.84533767826419,101,"ENSG00000079974.19"
"5874","ENSG00000107099.18_106968",106960,106968,9,"ENSG00000107099.18",1,8,"VVVVVVVMV",0,8,0.884057971014493,87,93,133,136,141,147,168,171,"GAGATGG","CAGG","GTGATCA","CTGA",2.37648232157747,40,5,21,75,1.39320769964178,4.30910579420622,7.84533767826419,101,"ENSG00000079974.19"
"5875","ENSG00000107099.18_107029",107021,107029,9,"ENSG00000107099.18",1,8,"VVVVVVVMV",0,8,0.884057971014493,87,93,133,136,141,147,168,171,"GAGATGG","CAGG","GTGATCA","CTGA",2.37648232157747,40,5,21,75,1.39320769964178,4.30910579420622,7.84533767826419,101,"ENSG00000079974.19"
"5876","ENSG00000107099.18_107090",107082,107090,9,"ENSG00000107099.18",1,8,"VVVVVVVMV",0,8,0.884057971014493,87,93,133,136,141,147,168,171,"GAGATGG","CAGG","GTGATCA","CTGA",2.37648232157747,40,5,21,75,1.39320769964178,4.30910579420622,7.84533767826419,101,"ENSG00000079974.19"
"5877","ENSG00000107099.18_107151",107143,107151,9,"ENSG00000107099.18",1,8,"VVVVVVVMV",0,8,0.884057971014493,87,93,133,136,141,147,168,171,"GAGATGG","CAGG","GTGATCA","CTGA",2.37648232157747,40,5,21,75,1.39320769964178,4.30910579420622,7.84533767826419,101,"ENSG00000079974.19"
"5878","ENSG00000107099.18_107212",107204,107212,9,"ENSG00000107099.18",1,8,"VVVVVVVMV",0,8,0.884057971014493,87,93,133,136,141,147,168,171,"GAGATGG","CAGG","GTGATCA","CTGA",2.37648232157747,40,5,21,75,1.39320769964178,4.30910579420622,7.84533767826419,101,"ENSG00000079974.19"
"5879","ENSG00000107099.18_107456",107448,107456,9,"ENSG00000107099.18",1,8,"VVVVVVVMV",0,8,0.884057971014493,87,93,133,136,141,147,168,171,"GAGATGG","CAGG","GTGATCA","CTGA",2.37648232157747,40,5,21,75,1.39320769964178,4.30910579420622,7.84533767826419,101,"ENSG00000079974.19"
"5880","ENSG00000107099.18_107517",107509,107517,9,"ENSG00000107099.18",1,8,"VVVVVVVMV",0,8,0.884057971014493,87,93,133,136,141,147,168,171,"GAGATGG","CAGG","GTGATCA","CTGA",2.37648232157747,40,5,21,75,1.39320769964178,4.30910579420622,7.84533767826419,101,"ENSG00000079974.19"
"5881","ENSG00000107099.18_107578",107570,107578,9,"ENSG00000107099.18",1,8,"VVVVVVVMV",0,8,0.884057971014493,87,93,133,136,141,147,168,171,"GAGATGG","CAGG","GTGATCA","CTGA",2.37648232157747,40,5,21,75,1.39320769964178,4.30910579420622,7.84533767826419,101,"ENSG00000079974.19"
"15013","ENSG00000146592.17_275308",275300,275308,9,"ENSG00000146592.17",1,6,"VVVUVMVVV",1,7,0.78343685300207,79,85,98,101,113,119,133,136,"ATGAAGA","TGGA","ATGGATA","CTGA",2.43173799658342,13,12,14,48,2.63466801651755,4.71156366510176,7.84531107711004,101,"ENSG00000079974.19"
"39600","ENSG00000253897.3_37851",37843,37851,9,"ENSG00000253897.3",1,2,"VMVUVVVVV",1,7,0.764803312629399,113,119,133,136,141,147,159,162,"ATGACAA","TTGA","ACGAAGA","CTGA",2.43867217010341,14,5,12,40,2.88653824664236,4.78608817849961,7.8453014290172,101,"ENSG00000079974.19"
"48334","ENSG00000290991.1_43452",43444,43452,9,"ENSG00000290991.1",1,2,"VMVUVVVVV",1,7,0.764803312629399,113,119,133,136,141,147,159,162,"ATGACAA","TTGA","ACGAAGA","CTGA",2.43867217010341,14,5,12,40,2.88653824664236,4.78608817849961,7.8453014290172,101,"ENSG00000079974.19"
"18509","ENSG00000157542.11_406768",406760,406768,9,"ENSG00000157542.11",1,2,"VMVVVVVVV",0,8,0.884057971014493,110,116,133,136,180,186,210,213,"GGGATGC","CTCA","GTGATCT","CTGA",2.42456964894487,17,44,24,94,1.07210801133469,4.30897641774179,7.84520830179976,101,"ENSG00000079974.19"
"14176","ENSG00000144504.16_12108",12100,12108,9,"ENSG00000144504.16",1,2,"VMVVVVVVV",0,8,0.884057971014493,91,97,133,136,150,156,175,178,"AGGGTTA","CTGA","CTGAGAA","CTGA",2.4047491607698,36,14,19,78,1.20420205389696,4.30896578142391,7.84519766548188,101,"ENSG00000079974.19"
"34718","ENSG00000233891.8_263777",263769,263777,9,"ENSG00000233891.8",1,8,"VVVVVVVMV",0,8,0.884057971014493,116,122,133,136,179,185,199,202,"GAAATGA","TTTA","GTGTAGA","CTGA",2.30785200724761,11,43,14,77,1.85014241732739,4.3089556164112,7.84518750046917,101,"ENSG00000079974.19"
"43494","ENSG00000271955.2_630581",630573,630581,9,"ENSG00000271955.2",1,8,"VVVVVVVMV",0,8,0.884057971014493,116,122,133,136,179,185,199,202,"GAAATGA","TTTA","GTGTAGA","CTGA",2.30785200724761,11,43,14,77,1.85014241732739,4.3089556164112,7.84518750046917,101,"ENSG00000079974.19"
"13457","ENSG00000141449.16_61768",61760,61768,9,"ENSG00000141449.16",1,8,"VVVVVVVMV",0,8,0.884057971014493,101,107,133,136,187,193,201,204,"TTGTTGA","TTAA","TTGATGT","CTGA",2.41820285987038,26,51,8,94,1.11444834222823,4.30895018534102,7.84518206939899,101,"ENSG00000079974.19"
"36015","ENSG00000237720.2_4974",4966,4974,9,"ENSG00000237720.2",1,8,"VVVUVVVMV",1,7,0.764803312629399,116,122,133,136,142,148,156,159,"GAGAGGA","GTGA","GTGACCA","CTGA",2.40575365409842,11,6,8,34,3.10547079730643,4.78595712282397,7.84517037334157,101,"ENSG00000079974.19"
"38161","ENSG00000249738.10_187928",187920,187928,9,"ENSG00000249738.10",1,8,"VVVVVVVMV",0,8,0.884057971014493,113,119,133,136,184,190,210,213,"ATCAGAA","TTGA","ATGATGC","CTGA",2.36310688180876,14,48,20,91,1.48169101898083,4.30893422442648,7.84516610848445,101,"ENSG00000079974.19"
"27733","ENSG00000187240.17_270723",270715,270723,9,"ENSG00000187240.17",0,NA,"VVVUVVVVV",1,8,0.880745341614907,113,119,133,136,167,173,185,188,"TTGTTGA","GCGA","GTATTTA","CTGA",2.29864674242627,14,31,12,66,1.96439936790042,4.32217774601889,7.84515911247852,101,"ENSG00000079974.19"
"18705","ENSG00000158258.16_354786",354778,354786,9,"ENSG00000158258.16",1,1,"MVUVVVVVV",1,7,0.789648033126294,111,117,133,136,146,152,165,168,"CTTATGT","CTCA","TTGATCA","CTGA",2.4133774294671,16,10,13,48,2.65706975281283,4.68656315398171,7.84515528648688,101,"ENSG00000079974.19"
"3809","ENSG00000089169.15_105557",105549,105557,9,"ENSG00000089169.15",1,8,"VVVVVUVMV",1,7,0.806211180124224,97,103,133,136,141,147,183,186,"ATGATGA","GTCA","CTGAGGC","CTGA",2.6193087643338,30,5,36,80,1.01917115958361,4.6203073971189,7.84515211761579,101,"ENSG00000079974.19"
"23739","ENSG00000173769.4_6290",6282,6290,9,"ENSG00000173769.4",1,2,"VMVVVVVVV",0,8,0.884057971014493,78,84,105,108,115,121,133,136,"ATTATAT","CTGA","GTGTTGT","TTGA",2.22998860448688,21,7,12,49,2.36905436570871,4.30891126557199,7.84514314962996,101,"ENSG00000079974.19"
"26272","ENSG00000183763.9_8504",8496,8504,9,"ENSG00000183763.9",1,8,"VVVUVVVMV",1,7,0.764803312629399,89,95,107,110,116,122,133,136,"CTGAAGA","CAGA","GGAATGT","CTGA",2.41710539819737,12,6,11,38,3.02956426608759,4.78590006351752,7.84511331403512,101,"ENSG00000079974.19"
"30367","ENSG00000204740.11_701074",701066,701074,9,"ENSG00000204740.11",1,2,"VMVVVVVVV",0,8,0.884057971014493,68,74,87,90,106,112,133,136,"AGGATAA","CTGA","TTGACCA","TTGA",2.2936333073231,13,16,21,59,1.94453887295792,4.30885689711132,7.84508878116929,101,"ENSG00000079974.19"
"23860","ENSG00000174469.23_1668615",1668607,1668615,9,"ENSG00000174469.23",1,1,"MVUVVVVVV",1,7,0.789648033126294,111,117,133,136,142,148,159,162,"GAGATGA","CTTG","AGGAGGA","CTGA",2.38816326408148,16,6,11,42,2.82489093175048,4.68649483974009,7.84508697224527,101,"ENSG00000079974.19"
"12402","ENSG00000138095.20_106613",106605,106613,9,"ENSG00000138095.20",0,NA,"VVVUVVUVV",2,7,0.766873706004141,106,112,133,136,138,144,154,157,"ATGAGGA","CTCA","GGGATGG","CTGA",2.57368827842474,21,2,10,42,1.95242585596718,4.77758692803303,7.84508175204959,101,"ENSG00000079974.19"
"8512","ENSG00000119335.18_3233",3225,3233,9,"ENSG00000119335.18",1,7,"UVVVVVMVV",1,7,0.787991718426501,115,121,133,136,143,149,161,164,"GTCATGA","CTTC","TTGGTCA","CTGA",2.36712267087123,12,7,12,40,2.99132810114279,4.69303647673775,7.84500335044375,101,"ENSG00000079974.19"
"26747","ENSG00000185008.19_1425744",1425736,1425744,9,"ENSG00000185008.19",1,7,"VVVVVVMVV",0,8,0.885300207039338,108,114,133,136,146,152,160,163,"ATTATGG","CTGG","TTGTAGA","CCGA",2.21337369758902,19,10,8,46,2.45931604094766,4.30378517288529,7.84498600104263,101,"ENSG00000079974.19"
"29808","ENSG00000198742.10_94727",94719,94727,9,"ENSG00000198742.10",0,NA,"VVVUVVUVV",2,7,0.766873706004141,70,76,88,91,101,107,133,136,"ATGATGT","CGGA","ATTTTAA","CTGA",2.54627886220452,12,10,26,57,2.13469969700818,4.77747302792624,7.8449678519428,101,"ENSG00000079974.19"
"115","ENSG00000005108.17_28086",28078,28086,9,"ENSG00000005108.17",1,2,"VMVVVVVVV",0,8,0.884057971014493,62,68,84,87,98,104,133,136,"ATAATGA","ATGA","TTAATGG","CTAA",2.3119451335745,16,11,29,65,1.82193258941871,4.30872503664552,7.84495692070349,101,"ENSG00000079974.19"
"45885","ENSG00000286021.3_91461",91453,91461,9,"ENSG00000286021.3",1,7,"VVVVVVMVV",0,8,0.885300207039338,112,118,133,136,144,150,186,189,"AGGAAAA","CTGT","ATGATTT","CTGA",2.29121521442933,15,8,36,68,1.94021575251309,4.30374596217716,7.84494679033451,101,"ENSG00000079974.19"
"226","ENSG00000006715.16_5254",5246,5254,9,"ENSG00000006715.16",1,7,"UVVVVVMVV",1,7,0.787991718426501,105,111,133,136,150,156,171,174,"TTGATCA","CTTA","GTGGTGA","CTGA",2.54922362254922,22,14,15,60,1.77689466803799,4.69292970459154,7.84489657829754,101,"ENSG00000079974.19"
"47760","ENSG00000289197.2_7872",7864,7872,9,"ENSG00000289197.2",0,NA,"VVVUVVVVV",1,8,0.880745341614907,41,47,58,61,72,78,133,136,"CTGAGGA","CTGA","CCGATTA","CTGG",2.32155599715806,11,11,55,86,1.81061011687602,4.32191252448244,7.84489389094207,101,"ENSG00000079974.19"
"32652","ENSG00000227486.4_102535",102527,102535,9,"ENSG00000227486.4",0,NA,"VVUVVVVVV",1,8,0.883643892339545,56,62,75,78,86,92,133,136,"ATGATGA","CACA","ATATTAA","CAGA",2.28632636385491,13,8,41,71,1.99901769927377,4.31029836457664,7.84487393393481,101,"ENSG00000079974.19"
"15695","ENSG00000149256.16_284539",284531,284539,9,"ENSG00000149256.16",0,NA,"UVVVVUVVV",2,7,0.824844720496894,89,95,102,105,108,114,133,136,"AAGATGA","CTGA","CTAAGGA","CTGG",2.43513102243033,7,3,19,38,1.94773108150487,4.54548447442677,7.84486335641435,101,"ENSG00000079974.19"
"46764","ENSG00000287150.1_739",731,739,9,"ENSG00000287150.1",1,2,"UMVVVVVVV",1,7,0.786749482401656,110,116,133,136,138,144,158,161,"CTGATGG","ATGA","GTGCTTT","CTGA",2.49336371615421,17,2,14,42,2.16899865994483,4.69785585857656,7.84485378818318,101,"ENSG00000079974.19"
"7962","ENSG00000116147.17_2611",2603,2611,9,"ENSG00000116147.17",0,NA,"VVVUVVVVV",1,8,0.880745341614907,105,111,133,136,185,191,199,202,"AAGATGG","CTCT","CTGATGT","CTGA",2.39535330355044,22,49,8,88,1.31827194328438,4.3218234917385,7.84480485819812,101,"ENSG00000079974.19"
"10179","ENSG00000129675.16_99837",99829,99837,9,"ENSG00000129675.16",1,2,"VMVVVVVVV",0,8,0.884057971014493,84,90,133,136,174,180,195,198,"ATGGTGA","AGGA","GTAATCA","CTGA",2.46082557107268,43,38,15,105,0.828711062323366,4.30855371736865,7.84478560142662,101,"ENSG00000079974.19"
"15058","ENSG00000146938.16_131034",131026,131034,9,"ENSG00000146938.16",0,NA,"VVUUVVVVV",2,7,0.764389233954451,112,118,133,136,146,152,163,166,"ATGTTGT","ATGA","GTGTTAT","CTGA",2.4524095209569,15,10,11,45,2.79949049047824,4.78722182421439,7.84477876003219,101,"ENSG00000079974.19"
"25139","ENSG00000179709.8_10086",10078,10086,9,"ENSG00000179709.8",1,8,"VVVVVVVMV",0,8,0.884057971014493,83,89,99,102,112,118,133,136,"ATTTTGG","TGGA","CTTAAGA","CTGA",2.18860889579951,10,10,15,44,2.64330834057714,4.30850857814346,7.84474046220143,101,"ENSG00000079974.19"
"47990","ENSG00000289911.1_74122",74114,74122,9,"ENSG00000289911.1",1,8,"UVVVVVVMV",1,7,0.786749482401656,112,118,133,136,139,145,155,158,"ATGAAGA","GTGA","ATGATGC","TTGA",2.41526164432602,15,3,10,37,2.68918365767444,4.6977319882953,7.84472991790193,101,"ENSG00000079974.19"
"12558","ENSG00000138640.15_364433",364425,364433,9,"ENSG00000138640.15",1,8,"VVVVVUVMV",1,7,0.806211180124224,104,110,133,136,170,176,187,190,"CTAATGA","CTGT","GTGATGT","CTGA",2.57949346930736,23,34,11,77,1.2829131446784,4.61988406834853,7.84472878884542,101,"ENSG00000079974.19"
"41989","ENSG00000260242.1_13252",13244,13252,9,"ENSG00000260242.1",1,2,"VMVVVVVVV",0,8,0.884057971014493,113,119,133,136,141,147,195,198,"TTTATCA","CTCA","TTGTTTA","CTGA",2.30019907159264,14,5,48,76,1.89918036374649,4.30846021025769,7.84469209431566,101,"ENSG00000079974.19"
"24297","ENSG00000175764.17_259194",259186,259194,9,"ENSG00000175764.17",1,3,"VVMVVVVVV",0,8,0.882815734989648,105,111,133,136,153,159,177,180,"ATACTGA","TTGA","GAGCTGG","CTGA",2.37786702171225,22,17,18,66,1.40120464337965,4.31341286369867,7.84467580365726,101,"ENSG00000079974.19"
"30663","ENSG00000206199.11_30795",30787,30795,9,"ENSG00000206199.11",1,3,"VVMVVVVVV",0,8,0.882815734989648,113,119,133,136,144,150,166,169,"ATCAAAA","GTGA","AAAATGG","CTGA",2.18124765550985,14,8,16,47,2.71183369767137,4.31337118360092,7.84463412355952,101,"ENSG00000079974.19"
"31470","ENSG00000223797.8_131285",131277,131285,9,"ENSG00000223797.8",1,8,"VVVVUVVMV",1,7,0.773913043478261,115,121,133,136,144,150,195,198,"ATGAAGA","ATGA","GTGCCTA","CTGA",2.55026030487419,12,8,45,74,1.99412940814238,4.74896619349258,7.84461836740563,101,"ENSG00000079974.19"
"2009","ENSG00000069020.19_218199",218191,218199,9,"ENSG00000069020.19",1,3,"VVMVVVUVV",1,7,0.768944099378882,75,81,99,102,115,121,133,136,"ATGATCC","CTGA","GAGACAA","CTGA",2.51347179042133,18,13,12,52,2.31884957010788,4.76883204322919,7.84460844074472,101,"ENSG00000079974.19"
"33387","ENSG00000229618.3_198033",198025,198033,9,"ENSG00000229618.3",1,2,"VMUVVVVVV",1,7,0.767701863354037,116,122,133,136,140,146,159,162,"GTGATGT","TTGG","CGGAAGA","CTGA",2.44269578233891,11,4,13,37,2.81054232819474,4.7737952192802,7.84460267269634,101,"ENSG00000079974.19"
"10544","ENSG00000131504.18_99285",99277,99285,9,"ENSG00000131504.18",0,NA,"VVVVVUUVV",2,7,0.808281573498965,112,118,133,136,147,153,167,170,"ATGGTGA","GGGA","AACAAGA","CTGA",2.3743006074357,15,11,14,49,2.61712918035591,4.61144997414848,7.84457626814434,101,"ENSG00000079974.19"
"46266","ENSG00000286386.1_4564",4556,4564,9,"ENSG00000286386.1",1,8,"VVVVVVVMV",0,8,0.884057971014493,113,119,133,136,149,155,168,171,"TGGGTGA","TAGA","TGGATAA","CTGA",2.19824041090698,14,13,13,49,2.57837416635746,4.30832755976766,7.84455944382563,101,"ENSG00000079974.19"
"76","ENSG00000004534.15_26451",26443,26451,9,"ENSG00000004534.15",1,3,"VVMVVVVVV",0,8,0.882815734989648,108,114,133,136,149,155,167,170,"CTGAAGC","CTGA","GGGAAGA","ATGA",2.25359401864562,19,13,12,53,2.22921042219788,4.31329263662551,7.8445555765841,101,"ENSG00000079974.19"
"7363","ENSG00000113658.18_21080",21072,21080,9,"ENSG00000113658.18",1,8,"VVVVVUVMV",1,7,0.806211180124224,38,44,59,62,71,77,133,136,"GTGATGA","CAGA","TTGATGC","TTGA",2.49272988645088,15,9,56,89,1.86060885463915,4.61970202441125,7.84454674490814,101,"ENSG00000079974.19"
"26064","ENSG00000183230.18_608461",608453,608461,9,"ENSG00000183230.18",0,NA,"UVUVVVVVV",2,7,0.786335403726708,82,88,96,99,106,112,133,136,"TTGATAA","TTGA","GTTATGC","CTGA",2.48990604114806,8,7,21,45,2.1974441328555,4.69920443512731,7.84454605003414,101,"ENSG00000079974.19"
"38962","ENSG00000251364.9_39659",39651,39659,9,"ENSG00000251364.9",1,2,"VMVVVVVVV",0,8,0.884057971014493,115,121,133,136,178,184,193,196,"ACCATTA","GTGA","ATGGTCA","CTGA",2.28443839918224,12,42,9,72,2.00366666275412,4.30831399765894,7.84454588171691,101,"ENSG00000079974.19"
"13318","ENSG00000140945.17_666283",666275,666283,9,"ENSG00000140945.17",0,NA,"VVVUVVVVV",1,8,0.880745341614907,94,100,133,136,165,171,187,190,"ATGATAA","TTCA","TTGAAGC","CTGA",2.46741752571825,33,29,16,87,0.836783259400892,4.32155835771398,7.84453972417361,101,"ENSG00000079974.19"
"20534","ENSG00000165060.15_33906",33898,33906,9,"ENSG00000165060.15",0,NA,"VVVUVVVVV",1,8,0.880745341614907,105,111,133,136,168,174,183,186,"CTGAAGA","TGGA","CTGGAGA","CTGA",2.38728084977536,22,32,9,72,1.37088463442917,4.32152257489956,7.84450394135919,101,"ENSG00000079974.19"
"45151","ENSG00000285130.2_33910",33902,33910,9,"ENSG00000285130.2",0,NA,"VVVUVVVVV",1,8,0.880745341614907,105,111,133,136,168,174,183,186,"CTGAAGA","TGGA","CTGGAGA","CTGA",2.38728084977536,22,32,9,72,1.37088463442917,4.32152257489956,7.84450394135919,101,"ENSG00000079974.19"
"46778","ENSG00000287159.1_11443",11435,11443,9,"ENSG00000287159.1",1,2,"VMVVVVVVV",0,8,0.884057971014493,67,73,86,89,96,102,133,136,"ATCTTGA","TTTA","GTGGCTA","CTGA",2.26954752642593,13,7,31,60,2.10275184953179,4.30826717309283,7.8444990571508,101,"ENSG00000079974.19"
"11841","ENSG00000136167.15_78707",78699,78707,9,"ENSG00000136167.15",1,3,"VVMVVVVVV",0,8,0.882815734989648,113,119,133,136,147,153,185,188,"ATGGTGA","CAAA","GTGATGT","CTAA",2.30453204266362,14,11,32,66,1.88935100965064,4.31322449018536,7.84448743014395,101,"ENSG00000079974.19"
"7541","ENSG00000114757.19_14084",14076,14084,9,"ENSG00000114757.19",1,2,"VMVVVUVVV",1,7,0.806211180124223,81,87,98,101,107,113,133,136,"ATGATTT","CTGG","GCGGTGG","CTGA",2.39990721196084,11,6,20,46,2.47913190750884,4.61962833014528,7.84447305064217,101,"ENSG00000079974.19"
"22445","ENSG00000170579.17_596350",596342,596350,9,"ENSG00000170579.17",1,8,"VVVVVVVMV",0,8,0.884057971014493,62,68,79,82,114,120,133,136,"CTGTTAA","CTGC","CTCATGT","CTGA",2.29556676323169,11,32,13,65,1.92913235465042,4.30822769404876,7.84445957810673,101,"ENSG00000079974.19"
"46502","ENSG00000286749.1_166697",166689,166697,9,"ENSG00000286749.1",1,1,"MVVVVUVVV",1,7,0.82815734989648,114,120,133,136,139,145,169,172,"TTGATGG","GAGA","CTGAGCA","CTGA",2.41735619366793,13,3,24,49,2.01151440851396,4.53180559157504,7.84443499116096,101,"ENSG00000079974.19"
"9168","ENSG00000123066.9_106792",106784,106792,9,"ENSG00000123066.9",1,2,"UMVVVVVVV",1,7,0.786749482401656,112,118,133,136,147,153,179,182,"GTGATGA","GTCA","CTCATGC","CTGA",2.52132178432273,15,11,26,61,1.98089549196964,4.69742684686363,7.84442477647026,101,"ENSG00000079974.19"
"26119","ENSG00000183454.18_150891",150883,150891,9,"ENSG00000183454.18",1,5,"UVVVMVVVV",1,7,0.789233954451346,113,119,133,136,169,175,188,191,"ACGATGC","CTGT","CTGAGGA","CTGA",2.52564356038291,14,33,13,69,1.9121837517194,4.68745187190136,7.84438768970674,101,"ENSG00000079974.19"
"7205","ENSG00000113300.13_4850",4842,4850,9,"ENSG00000113300.13",1,7,"VVVVVVMVV",0,8,0.885300207039338,115,121,133,136,177,183,197,200,"TGGAAGA","GTCA","GTGTTGA","CTGA",2.30026002699377,12,41,14,76,1.87753846801041,4.30315132865889,7.84435215681624,101,"ENSG00000079974.19"
"18154","ENSG00000156298.13_95972",95964,95972,9,"ENSG00000156298.13",1,6,"VVVUVMVVV",1,7,0.78343685300207,116,122,133,136,159,165,180,183,"AGGATGA","CAGC","CTGTTGA","CTGA",2.53160437213306,11,23,15,58,1.96497295833737,4.71058385980612,7.8443312718144,101,"ENSG00000079974.19"
"38515","ENSG00000250349.3_1308184",1308176,1308184,9,"ENSG00000250349.3",1,6,"VVVUVMVVV",1,7,0.78343685300207,116,122,133,136,159,165,180,183,"AGGATGA","CAGC","CTGTTGA","CTGA",2.53160437213306,11,23,15,58,1.96497295833737,4.71058385980612,7.8443312718144,101,"ENSG00000079974.19"
"19350","ENSG00000162814.11_77125",77117,77125,9,"ENSG00000162814.11",1,2,"VMVVVVVVV",0,8,0.884057971014493,100,106,133,136,184,190,201,204,"ATGAATA","TAGA","ATGAAGA","CTGA",2.42133497689145,27,48,11,95,1.08983443476295,4.30801690350982,7.84424878756779,101,"ENSG00000079974.19"
"45940","ENSG00000286062.2_83496",83488,83496,9,"ENSG00000286062.2",1,1,"MVVVVVUVV",1,7,0.792132505175983,74,80,92,95,108,114,133,136,"ATGATGT","CTGA","CTCACGA","CGGA",2.46495590209753,12,13,19,53,2.26974941647059,4.67569719094687,7.8442272116508,101,"ENSG00000079974.19"
"16012","ENSG00000150636.17_205364",205356,205364,9,"ENSG00000150636.17",0,NA,"VVUVVVUVV",2,7,0.769772256728778,113,119,133,136,144,150,159,162,"ATGGTGA","CTTC","GCTATGA","CTGA",2.41173866345167,14,8,9,40,2.98227872674073,4.7651341207713,7.84422314768641,101,"ENSG00000079974.19"
"44485","ENSG00000282564.3_189668",189660,189668,9,"ENSG00000282564.3",0,NA,"VVVUVUVVV",2,7,0.802898550724638,103,109,133,136,153,159,169,172,"ATTATGC","TTGA","GTTATGA","CTGA",2.53265164711041,24,17,10,60,1.64608791792898,4.63260805799959,7.84420226089814,101,"ENSG00000079974.19"
"10175","ENSG00000129667.13_7823",7815,7823,9,"ENSG00000129667.13",1,8,"VVVVVVVMV",0,8,0.884057971014493,94,100,133,136,145,151,160,163,"AAGGGGA","CAGA","GGGATGG","CTGA",2.28985562946251,33,9,9,60,1.96608671128481,4.30794772692539,7.84417961098336,101,"ENSG00000079974.19"
"15407","ENSG00000148180.22_112470",112462,112470,9,"ENSG00000148180.22",1,8,"VVVVVVVMV",0,8,0.884057971014493,113,119,133,136,147,153,175,178,"GTGACCA","GTGT","CTGCGGA","CTGA",2.25375101676632,14,11,22,56,2.20659396723971,4.30790018642046,7.84413207047843,101,"ENSG00000079974.19"
"43502","ENSG00000271978.2_8787",8779,8787,9,"ENSG00000271978.2",0,NA,"VVUVUVVVV",2,7,0.773498964803312,71,77,84,87,92,98,133,136,"ATAATGA","CAGA","GAGAGGA","CTGA",2.61064481579069,7,5,35,56,1.59624172539898,4.75013512433423,7.84413098354748,101,"ENSG00000079974.19"
"23006","ENSG00000171914.17_375006",374998,375006,9,"ENSG00000171914.17",1,3,"VVMVVVVVV",0,8,0.882815734989648,115,121,133,136,140,146,199,202,"GTGCAGA","CAGT","CTGATGC","CTGA",2.31182219333585,12,4,53,78,1.83908745629933,4.31280885296792,7.84407179292652,101,"ENSG00000079974.19"
"11086","ENSG00000133818.14_65310",65302,65310,9,"ENSG00000133818.14",1,2,"VMVVVVVVV",0,8,0.884057971014493,80,86,96,99,109,115,133,136,"ATTATTA","CTGA","ATCTTTA","CTAA",2.21623914262962,10,10,18,47,2.45635247620392,4.30782002343369,7.84405190749166,101,"ENSG00000079974.19"
"22709","ENSG00000171180.3_5483",5475,5483,9,"ENSG00000171180.3",1,5,"UVVVMVVVV",1,7,0.789233954451346,94,100,111,114,116,122,133,136,"AGGAAGA","TTGA","TAGATCA","CTGA",2.40815619850372,11,2,11,33,2.69406087293081,4.68710888240557,7.84404470021096,101,"ENSG00000079974.19"
"23935","ENSG00000174482.11_464317",464309,464317,9,"ENSG00000174482.11",0,NA,"VVUVVVVVV",1,8,0.883643892339545,91,97,133,136,177,183,191,194,"AGGATGC","CTCA","TTGCTAA","CTGA",2.43683027760458,36,41,8,94,0.992332543756542,4.30946693194677,7.84404250130495,101,"ENSG00000079974.19"
"23108","ENSG00000172262.12_104185",104177,104185,9,"ENSG00000172262.12",1,8,"VVVVVVVMV",0,8,0.884057971014493,24,30,45,48,95,101,133,136,"ATGATGA","CTGT","TTACTGA","CAGA",2.43444013782914,15,47,32,103,1.00162423570436,4.30780628864132,7.84403817269929,101,"ENSG00000079974.19"
"26806","ENSG00000185046.20_232799",232791,232799,9,"ENSG00000185046.20",0,NA,"VVUVVVUVV",2,7,0.769772256728778,115,121,133,136,144,150,161,164,"AATATGA","CAGG","GTGATAA","CTGA",2.40808368961805,12,8,11,40,3.00568632882915,4.76489439823738,7.84398342515249,101,"ENSG00000079974.19"
"38769","ENSG00000251003.9_277874",277866,277874,9,"ENSG00000251003.9",1,2,"VMVVVVVVV",0,8,0.884057971014493,107,113,133,136,155,161,214,217,"ATGAAGA","CATA","TTGAGCA","CTGA",2.46248483384622,20,19,53,101,0.81437115619201,4.3077341787917,7.84396606284967,101,"ENSG00000079974.19"
"23353","ENSG00000172748.14_28945",28937,28945,9,"ENSG00000172748.14",1,8,"VVVVUVVMV",1,7,0.773913043478261,58,64,74,77,83,89,133,136,"TTGATGA","CTGC","AAGAGGG","CTGA",2.56215169237396,10,6,44,69,1.9121570802399,4.74829209068324,7.84394426459628,101,"ENSG00000079974.19"
"21681","ENSG00000168702.18_1870193",1870185,1870193,9,"ENSG00000168702.18",1,7,"VVVVVVMVV",0,8,0.885300207039338,112,118,133,136,173,179,192,195,"ATGTTAA","GTTA","TTGAGGG","CTGA",2.30530462410802,15,37,13,74,1.84206120526224,4.30268967482892,7.84389050298627,101,"ENSG00000079974.19"
"36662","ENSG00000242536.2_121739",121731,121739,9,"ENSG00000242536.2",1,2,"VMVUVVVVV",1,7,0.764803312629399,113,119,133,136,149,155,184,187,"ATGATGA","TTGT","CAGATGT","CTGA",2.5997298142949,14,13,29,65,1.8069943250151,4.7846316050786,7.8438448555962,101,"ENSG00000079974.19"
"10662","ENSG00000132256.20_137490",137482,137490,9,"ENSG00000132256.20",1,8,"VVUVVVVMV",1,7,0.767701863354037,112,118,133,136,142,148,178,181,"GTGAAGA","GGGA","GTGATGA","CTGA",2.56082011476943,15,6,30,60,2.01985826741474,4.77299809146941,7.84380554488555,101,"ENSG00000079974.19"
"34424","ENSG00000233005.2_578227",578219,578227,9,"ENSG00000233005.2",1,8,"VVVVVUVMV",1,7,0.806211180124224,111,117,133,136,147,153,169,172,"GTGCTGA","GTCA","GGGAGGA","CTGA",2.40659907599337,16,11,16,52,2.43180036479835,4.61894855118854,7.84379327168544,101,"ENSG00000079974.19"
"1718","ENSG00000065600.13_31666",31658,31666,9,"ENSG00000065600.13",1,2,"VMVVVVVVV",0,8,0.884057971014493,114,120,133,136,182,188,203,206,"CTAAAGA","TTGA","ATGCAGC","CTGA",2.31231199729828,13,46,15,83,1.81483080889289,4.3075610310537,7.84379291511167,101,"ENSG00000079974.19"
"9107","ENSG00000122694.16_4737",4729,4737,9,"ENSG00000122694.16",0,NA,"VVUVVVVVV",1,8,0.883643892339545,89,95,133,136,147,153,192,195,"GTGTTGA","GTGC","CTGTTGA","CTGA",2.45602648410613,38,11,39,97,0.863075326233349,4.30914630506855,7.84372187442673,101,"ENSG00000079974.19"
"8123","ENSG00000116981.4_15693",15685,15693,9,"ENSG00000116981.4",1,8,"VVVVVVVMV",0,8,0.884057971014493,105,111,133,136,146,152,162,165,"ATGAGCA","TTCA","ATAAAAA","CTGA",2.24911008851747,22,10,10,51,2.2356869146,4.30743854284578,7.84367042690375,101,"ENSG00000079974.19"
"37884","ENSG00000249035.7_33055",33047,33055,9,"ENSG00000249035.7",1,2,"VMVVUVVVV",1,7,0.773913043478261,74,80,94,97,102,108,133,136,"GTGATGA","CTGA","ATCATTA","CTCA",2.52348382114724,14,5,25,53,2.16856984860036,4.74794883072882,7.84360100464186,101,"ENSG00000079974.19"
"23187","ENSG00000172292.15_182478",182470,182478,9,"ENSG00000172292.15",0,NA,"VVVUVVVVV",1,8,0.880745341614907,29,35,52,55,75,81,133,136,"ATGATAA","CTGA","TTGTTTA","TTGA",2.43717713564331,17,20,52,98,1.03459628244175,4.32061096334928,7.84359232980891,101,"ENSG00000079974.19"
"38044","ENSG00000249409.1_2532",2524,2532,9,"ENSG00000249409.1",1,8,"VVUVVVVMV",1,7,0.767701863354037,110,116,133,136,144,150,204,207,"ATGATGC","ATGA","AGGATAA","CTGA",2.60227648389725,17,8,54,88,1.74257000639654,4.77276997476122,7.84357742817737,101,"ENSG00000079974.19"
"29602","ENSG00000198382.9_257931",257923,257931,9,"ENSG00000198382.9",1,2,"UMVVVVVVV",1,7,0.786749482401656,112,118,133,136,139,145,156,159,"TTAATGA","TTGA","ATATTAA","CTGA",2.41954392047057,15,3,11,38,2.65595836413498,4.69656279181803,7.84356072142466,101,"ENSG00000079974.19"
"11697","ENSG00000135842.17_130064",130056,130064,9,"ENSG00000135842.17",1,2,"VMUVVVVVV",1,7,0.767701863354037,58,64,84,87,95,101,133,136,"ATGATTA","ATGA","GTGAGAA","CTGA",2.62851852074709,20,8,32,69,1.56736841889488,4.77270630596887,7.84351375938502,101,"ENSG00000079974.19"
"27650","ENSG00000187054.16_15237",15229,15237,9,"ENSG00000187054.16",1,1,"MVVVUVVVV",1,7,0.795859213250517,51,57,72,75,85,91,133,136,"ATGATAA","TTGA","ATCGAGA","CTGA",2.52283360747586,15,10,42,76,1.82140187015379,4.66007314666487,7.84350999966694,101,"ENSG00000079974.19"
"35945","ENSG00000237505.8_40163",40155,40163,9,"ENSG00000237505.8",0,NA,"VVUVVVVVV",1,8,0.883643892339545,113,119,133,136,169,175,219,222,"ATGGTGT","CTTG","GTGAGGA","CTGA",2.43502425704339,14,33,44,100,1.00222610725232,4.30893028855207,7.84350585791025,101,"ENSG00000079974.19"
"9449","ENSG00000124749.17_269877",269869,269877,9,"ENSG00000124749.17",1,8,"VVVVVVVMV",0,8,0.884057971014493,79,85,100,103,111,117,133,136,"ATGCTGG","CTGG","GTGAGTT","CTTA",2.18588350166419,15,8,16,48,2.65648061531143,4.30725932326818,7.84349120732615,101,"ENSG00000079974.19"
"37511","ENSG00000248360.7_1169",1161,1169,9,"ENSG00000248360.7",1,8,"VVVVVVVMV",0,8,0.884057971014493,113,119,133,136,145,151,171,174,"ATGATAT","CCAA","CTGATGA","ATGA",2.21966587318669,14,9,20,52,2.43116828496716,4.3072351932196,7.84346707727757,101,"ENSG00000079974.19"
"23269","ENSG00000172456.18_423411",423403,423411,9,"ENSG00000172456.18",1,2,"VMVVVVVVV",0,8,0.884057971014493,105,111,133,136,142,148,197,200,"GTGATTT","CTGT","GTGAGTG","CTGA",2.38573858174513,22,6,49,86,1.32392345264925,4.30721183273753,7.8434437167955,101,"ENSG00000079974.19"
"6996","ENSG00000112425.16_160457",160449,160457,9,"ENSG00000112425.16",1,8,"UVVVVVVMV",1,7,0.786749482401656,89,95,133,136,143,149,187,190,"ATCATGA","ATGA","ATGTTGA","CTGA",2.66287480496002,38,7,38,92,1.03327221786133,4.6964427293987,7.84344065900533,101,"ENSG00000079974.19"
"36427","ENSG00000240708.2_66243",66235,66243,9,"ENSG00000240708.2",0,NA,"VVVUVVVVV",1,8,0.880745341614907,116,122,133,136,161,167,176,179,"ATGATGT","CCAA","GTGCTGG","GTGA",2.27766248271713,11,25,9,54,2.09741020404487,4.3204566888731,7.84343805533272,101,"ENSG00000079974.19"
"6030","ENSG00000107771.17_145400",145392,145400,9,"ENSG00000107771.17",1,6,"UVVVVMVVV",1,7,0.805383022774327,114,120,133,136,149,155,175,178,"ACGTTGA","TTGA","CTGATTT","CTGA",2.44219508919399,13,13,20,55,2.20621285680535,4.62187836285799,7.8434104539553,101,"ENSG00000079974.19"
"44655","ENSG00000283258.2_14525",14517,14525,9,"ENSG00000283258.2",1,2,"VMVVVVVVV",0,8,0.884057971014493,85,91,133,136,149,155,169,172,"AAGATTA","TTTA","GTGGGGA","CTGA",2.34937304045442,42,13,14,78,1.5662140244916,4.30717524021361,7.84340712427158,101,"ENSG00000079974.19"
"27186","ENSG00000185736.16_522783",522775,522783,9,"ENSG00000185736.16",1,8,"VVVVVVVMV",0,8,0.884057971014493,116,122,133,136,170,176,187,190,"ATGATGA","GTAA","AAGATAG","CTAA",2.28657583109437,11,34,11,65,1.98465685087369,4.30712393120904,7.84335581526701,101,"ENSG00000079974.19"
"7037","ENSG00000112541.19_478936",478928,478936,9,"ENSG00000112541.19",1,2,"UMVVVVVVV",1,7,0.786749482401656,74,80,94,97,102,108,133,136,"ATGATAA","CTGA","ATCATGA","CTTA",2.49252824568192,14,5,25,53,2.16856984860036,4.69635620495328,7.84335413455991,101,"ENSG00000079974.19"
"21855","ENSG00000169126.16_66290",66282,66290,9,"ENSG00000169126.16",1,7,"VVVVVVMVV",0,8,0.885300207039338,109,115,133,136,152,158,168,171,"ATGATTT","ATGA","GTGATTG","CTGG",2.25801954832724,18,16,10,53,2.15512816204668,4.30214795439041,7.84334878254776,101,"ENSG00000079974.19"
"46614","ENSG00000286924.1_121714",121706,121714,9,"ENSG00000286924.1",1,2,"VMVVVVVVV",0,8,0.884057971014493,83,89,133,136,141,147,162,165,"ATTAAGA","AAGA","CAGAAGA","CTGA",2.32193360680805,44,5,15,73,1.74888187396044,4.30710981317019,7.84334169722816,101,"ENSG00000079974.19"
"27812","ENSG00000187391.22_629846",629838,629846,9,"ENSG00000187391.22",1,8,"VVVVVVVMV",0,8,0.884057971014493,113,119,133,136,143,149,193,196,"ATGAATA","CCAA","TTGATTG","CTGA",2.28830287172621,14,7,44,74,1.97295544729953,4.30707698136857,7.84330886542654,101,"ENSG00000079974.19"
"22858","ENSG00000171587.15_505778",505770,505778,9,"ENSG00000171587.15",1,2,"VMVVVVVVV",0,8,0.884057971014493,80,86,103,106,114,120,133,136,"CTGAAGA","TTGA","GAGCTTA","GTGA",2.18469823715872,17,8,13,47,2.66352836419091,4.30704581964559,7.84327770370357,101,"ENSG00000079974.19"
"37647","ENSG00000248601.1_65608",65600,65608,9,"ENSG00000248601.1",0,NA,"VVUVVVVVV",1,8,0.883643892339545,113,119,133,136,144,150,187,190,"GTGGTGG","CTTC","GTGGTGG","CTGA",2.28711327721505,14,8,37,68,1.98709224361307,4.30862852292834,7.84320409228652,101,"ENSG00000079974.19"
"19766","ENSG00000163638.13_89972",89964,89972,9,"ENSG00000163638.13",1,8,"VVVVUVVMV",1,7,0.773913043478261,113,119,133,136,149,155,163,166,"AAGATGA","ATGT","ATCTTGA","CTGA",2.45149543909982,14,13,8,44,2.64689792610785,4.74755021336,7.84320238727304,101,"ENSG00000079974.19"
"23463","ENSG00000172987.13_639429",639421,639429,9,"ENSG00000172987.13",1,2,"VMVVVVVVV",0,8,0.884057971014493,58,64,79,82,110,116,133,136,"ATGCTAA","CTGA","GTGAAAA","CTGG",2.33207677287379,15,28,17,69,1.68045401394874,4.30690812494351,7.84314000900148,101,"ENSG00000079974.19"
"13365","ENSG00000141198.16_7864",7856,7864,9,"ENSG00000141198.16",1,2,"VMVVVUVVV",1,7,0.806211180124223,110,116,133,136,148,154,168,171,"GTGAGGC","CAGA","CTGATAG","CTGA",2.41209475284843,17,12,14,52,2.39248726025171,4.61827973647697,7.84312445697386,101,"ENSG00000079974.19"
"27447","ENSG00000186153.18_965038",965030,965038,9,"ENSG00000186153.18",0,NA,"UVVVVVUVV",2,7,0.788819875776397,97,103,111,114,116,122,133,136,"ATTTTGA","ATGA","ATAATGC","CTGA",2.42034055626178,8,2,11,30,2.6154655359637,4.6877673110939,7.84304681419949,101,"ENSG00000079974.19"
"33826","ENSG00000231252.4_135941",135933,135941,9,"ENSG00000231252.4",1,1,"MVVVVVUVV",1,7,0.792132505175983,116,122,133,136,138,144,160,163,"CTGTTGA","CTGC","GTGAAAG","CTGA",2.45687539013665,11,2,16,38,2.31838895853372,4.67438955652784,7.84291957723178,101,"ENSG00000079974.19"
"24796","ENSG00000178031.18_462253",462245,462253,9,"ENSG00000178031.18",1,2,"UMVVVVVVV",1,7,0.786749482401656,87,93,133,136,143,149,164,167,"ATGATCA","TAGA","GTAATGA","CTGA",2.54476440049289,40,7,15,71,1.81851559951315,4.69590290069977,7.8429008303064,101,"ENSG00000079974.19"
"16609","ENSG00000151892.16_152178",152170,152178,9,"ENSG00000151892.16",1,7,"VVVVVUMVV",1,7,0.807453416149068,115,121,133,136,158,164,179,182,"ATGATGT","TTCA","TTTCTGA","CTGA",2.46473055858175,12,22,15,58,2.02075550430165,4.61307314037832,7.8428868049746,101,"ENSG00000079974.19"
"43121","ENSG00000268873.1_4735",4727,4735,9,"ENSG00000268873.1",1,1,"MVVUVVVVV",1,7,0.786749482401656,115,121,133,136,141,147,155,158,"AGGATGC","ATGT","ATGCTGC","CTGA",2.35573915441005,12,5,8,34,3.07847702438505,4.69585118011301,7.84284910971964,101,"ENSG00000079974.19"
"13918","ENSG00000143951.16_301165",301157,301165,9,"ENSG00000143951.16",1,2,"VMVVVVVVV",0,8,0.884057971014493,101,107,133,136,155,161,177,180,"ATCATGA","CAGG","AAGAACA","CTGA",2.40172330223703,26,19,16,70,1.21487370418814,4.30659059644208,7.84282248050005,101,"ENSG00000079974.19"
"40408","ENSG00000255944.1_45932",45924,45932,9,"ENSG00000255944.1",1,7,"VVVVVVMVV",0,8,0.885300207039338,78,84,98,101,110,116,133,136,"ATGCAGA","GTGA","ATGACTA","CTGG",2.18896195723218,14,9,17,49,2.61329259943963,4.30159307858021,7.84279390673756,101,"ENSG00000079974.19"
"40517","ENSG00000256732.2_45928",45920,45928,9,"ENSG00000256732.2",1,7,"VVVVVVMVV",0,8,0.885300207039338,78,84,98,101,110,116,133,136,"ATGCAGA","GTGA","ATGACTA","CTGG",2.18896195723218,14,9,17,49,2.61329259943963,4.30159307858021,7.84279390673756,101,"ENSG00000079974.19"
"23451","ENSG00000172987.13_147782",147774,147782,9,"ENSG00000172987.13",1,2,"VMVVVVVVV",0,8,0.884057971014493,116,122,133,136,146,152,187,190,"ATCATGG","ATGA","ATGTTGA","CTGG",2.29502018251825,11,10,35,65,1.92603211803864,4.30654166704007,7.84277355109804,101,"ENSG00000079974.19"
"30577","ENSG00000205838.15_37446",37438,37446,9,"ENSG00000205838.15",1,2,"VMVVVUVVV",1,7,0.806211180124223,108,114,133,136,156,162,178,181,"ATAATAA","ATGA","ATGAAGA","CTGA",2.52874340821395,19,20,16,64,1.61336278063946,4.61791304218311,7.84275776268001,101,"ENSG00000079974.19"
"40003","ENSG00000254659.3_60469",60461,60469,9,"ENSG00000254659.3",1,2,"VMVVVVVVV",0,8,0.884057971014493,85,91,133,136,182,188,203,206,"ATGAGGA","CAGT","ATAATGT","CTGA",2.46090953049659,42,46,15,112,0.819992055942454,4.30651389814659,7.84274578220456,101,"ENSG00000079974.19"
"13889","ENSG00000143858.12_71151",71143,71151,9,"ENSG00000143858.12",1,3,"VVMVVVVVV",0,8,0.882815734989648,107,113,133,136,145,151,160,163,"AAAATCA","TTGA","GAAAGGA","CTGA",2.22052059845413,20,9,9,47,2.44234172667085,4.31145309575793,7.84271603571652,101,"ENSG00000079974.19"
"11743","ENSG00000135951.16_40542",40534,40542,9,"ENSG00000135951.16",1,3,"VVMVVUVVV",1,7,0.804968944099379,54,60,75,78,85,91,133,136,"TTGCTGA","CAGA","ATAAAGA","CTGA",2.48520582925652,15,7,42,73,1.92317112084246,4.62280249563815,7.84267827203566,101,"ENSG00000079974.19"
"41051","ENSG00000258484.4_35332",35324,35332,9,"ENSG00000258484.4",1,1,"MVVVVVUVV",1,7,0.792132505175983,110,116,133,136,143,149,157,160,"ATGATGA","CAGA","AGCTTGA","CTTA",2.39057811163568,17,7,8,41,2.75930899248065,4.6741241008463,7.84265412155024,101,"ENSG00000079974.19"
"15863","ENSG00000149972.12_565922",565914,565922,9,"ENSG00000149972.12",1,2,"VMVVVVVVV",0,8,0.884057971014493,11,17,33,36,85,91,133,136,"GTGATGA","CTGA","AACAAGA","CTAA",2.45591625357967,16,49,42,116,0.852783035303498,4.30638951479199,7.84262139884996,101,"ENSG00000079974.19"
"12634","ENSG00000138738.11_219764",219756,219764,9,"ENSG00000138738.11",1,8,"VVVVVVVMV",0,8,0.884057971014493,93,99,106,109,114,120,133,136,"TTCATGA","CTGG","GAGAAGG","ATGA",2.18942660110752,7,5,13,34,2.62904279243274,4.30630503328739,7.84253691734536,101,"ENSG00000079974.19"
"13804","ENSG00000143499.14_31387",31379,31387,9,"ENSG00000143499.14",1,8,"VVVVVUVMV",1,7,0.806211180124224,100,106,133,136,145,151,165,168,"GTGGTGA","AGGA","ATGATGG","CTGA",2.48192642889946,27,9,14,59,1.92456781166404,4.61768600108177,7.84253072157867,101,"ENSG00000079974.19"
"13701","ENSG00000143199.18_73307",73299,73307,9,"ENSG00000143199.18",1,3,"UVMVVVVVV",1,7,0.785507246376811,31,37,55,58,107,113,133,136,"ATGATGG","CTGA","ATTCTCA","CTGA",2.64270280999065,18,49,20,96,1.18388590337297,4.700476159161,7.84250514466824,101,"ENSG00000079974.19"
"44201","ENSG00000279479.1_1266",1258,1266,9,"ENSG00000279479.1",0,NA,"VVVUVVVVV",1,8,0.880745341614907,114,120,133,136,187,193,234,237,"TTGTTGA","AAGA","GAGATGA","CTGA",2.43972892285451,13,51,41,114,1.01315520530929,4.31950367275151,7.84248503921113,101,"ENSG00000079974.19"
"36831","ENSG00000243193.4_557",549,557,9,"ENSG00000243193.4",1,1,"MVVVVVUVV",1,7,0.792132505175983,111,117,133,136,150,156,172,175,"ATTATGC","CTTA","ATGCAGA","CTGA",2.4714756204893,16,14,16,55,2.21925416276112,4.67393957483911,7.84246959554304,101,"ENSG00000079974.19"
"21671","ENSG00000168702.18_151086",151078,151086,9,"ENSG00000168702.18",1,2,"VMVVVVVVV",0,8,0.884057971014493,112,118,133,136,150,156,173,176,"GACATGA","ATTA","ATCATGT","CTGA",2.24925194703089,15,14,17,55,2.22992779161346,4.30623519295484,7.84246707701281,101,"ENSG00000079974.19"
"7835","ENSG00000115896.16_275232",275224,275232,9,"ENSG00000115896.16",1,1,"MVVVVUVVV",1,7,0.82815734989648,86,92,101,104,115,121,133,136,"ATGATAA","CTTA","ATTAGGA","TTGA",2.31985618124084,9,11,12,41,2.65358613555105,4.5298235026225,7.84245290220842,101,"ENSG00000079974.19"
"28011","ENSG00000187955.13_58422",58414,58422,9,"ENSG00000187955.13",1,8,"VVVVVVVMV",0,8,0.884057971014493,112,118,133,136,150,156,211,214,"AGGAAGA","AAGA","CTGAAAA","CTGA",2.35376176965685,15,14,55,93,1.53302009688979,4.30619130698387,7.84242319104184,101,"ENSG00000079974.19"
"32488","ENSG00000227088.2_30017",30009,30017,9,"ENSG00000227088.2",1,8,"VVVVVVVMV",0,8,0.884057971014493,114,120,133,136,162,168,178,181,"AGAATGA","CAAA","CAAATGA","CTGA",2.26871427942326,13,26,10,58,2.09990454275303,4.3061666013937,7.84239848545167,101,"ENSG00000079974.19"
"37129","ENSG00000245532.11_21616",21608,21616,9,"ENSG00000245532.11",0,NA,"VVUVVUVVV",2,7,0.805797101449275,116,122,133,136,148,154,166,169,"AGGATGA","CCCA","GGCCTGA","CTGA",2.3654031662338,11,12,12,44,2.70740943193863,4.61919096837432,7.84237937417142,101,"ENSG00000079974.19"
"13448","ENSG00000141446.11_62971",62963,62971,9,"ENSG00000141446.11",1,8,"VVVVVVVMV",0,8,0.884057971014493,114,120,133,136,166,172,184,187,"ATGTTTA","CTAC","TTGTTGT","CTGA",2.28296791829458,13,30,12,64,2.00472153873148,4.30612691517384,7.84235879923181,101,"ENSG00000079974.19"
"20469","ENSG00000164916.11_39140",39132,39140,9,"ENSG00000164916.11",1,3,"VVMVVVVVV",0,8,0.882815734989648,52,58,96,99,109,115,133,136,"CTGATGA","CTGT","GTGACAG","TTGA",2.35601822268131,38,10,18,75,1.53726975127681,4.31101447562138,7.84227741557997,101,"ENSG00000079974.19"
"18602","ENSG00000157827.20_186889",186881,186889,9,"ENSG00000157827.20",1,8,"UVVVVVVMV",1,7,0.786749482401656,61,67,81,84,88,94,133,136,"ATAATGA","CTGA","GTGATCA","ATGA",2.54318446477277,14,4,39,66,1.82654610940077,4.69527730197147,7.8422752315781,101,"ENSG00000079974.19"
"37604","ENSG00000248515.2_70935",70927,70935,9,"ENSG00000248515.2",1,7,"VVVVVVMVV",0,8,0.885300207039338,112,118,133,136,157,163,176,179,"ATGAAGA","GAGA","GTGAATA","CTGG",2.27057793163738,15,21,13,58,2.06695966377329,4.30103646867228,7.84223729682963,101,"ENSG00000079974.19"
"42699","ENSG00000265943.1_220662",220654,220662,9,"ENSG00000265943.1",1,8,"VVVVVVVMV",0,8,0.884057971014493,113,119,133,136,141,147,190,193,"ATGAGCG","CTCA","GGGTTGA","CTGA",2.29761998845163,14,5,43,71,1.9065075472854,4.30599353424074,7.84222541829871,101,"ENSG00000079974.19"
"38824","ENSG00000251129.3_170780",170772,170780,9,"ENSG00000251129.3",1,8,"VVVVVVVMV",0,8,0.884057971014493,57,63,80,83,86,92,133,136,"ATGATCA","CTAA","GTGAATA","GTGA",2.36266241399674,17,3,41,70,1.47262916778778,4.30592798194151,7.84215986599948,101,"ENSG00000079974.19"
"15051","ENSG00000146872.19_5323",5315,5323,9,"ENSG00000146872.19",1,8,"VVVVVUVMV",1,7,0.806211180124224,108,114,133,136,169,175,197,200,"GAGATGA","CTCA","GTGAAGA","CTGA",2.61829890660762,19,33,22,83,1.01365186877008,4.61724447820521,7.84208919870211,101,"ENSG00000079974.19"
"28767","ENSG00000196470.12_54475",54467,54475,9,"ENSG00000196470.12",1,6,"VVVVVMUVV",1,7,0.788819875776397,48,54,69,72,83,89,133,136,"CAGATGA","CTGA","GTCATTT","CTGA",2.54903536210876,15,11,44,79,1.75365938562386,4.68680711658723,7.84208661969281,101,"ENSG00000079974.19"
"25973","ENSG00000183117.20_1617653",1617645,1617653,9,"ENSG00000183117.20",1,2,"VMVVVVVVV",0,8,0.884057971014493,109,115,133,136,186,192,203,206,"ATAAAGA","ATTA","CTGAGGT","CTGA",2.33555914342983,18,50,11,88,1.65299373790121,4.30584700685835,7.84207889091632,101,"ENSG00000079974.19"
"36902","ENSG00000243486.1_12886",12878,12886,9,"ENSG00000243486.1",0,NA,"VVUVVVVVV",1,8,0.883643892339545,93,99,133,136,149,155,168,171,"ATGAAGA","CTAC","ACAATAA","CTGA",2.34068615390846,34,13,13,69,1.62540060721354,4.30749374165082,7.84206931100899,101,"ENSG00000079974.19"
"25384","ENSG00000181215.16_217340",217332,217340,9,"ENSG00000181215.16",1,1,"MVVVVVUVV",1,7,0.792132505175983,101,107,133,136,165,171,179,182,"ATGATGT","CTGT","TTGAAGG","CTGA",2.62785887776451,26,29,8,72,1.17503294306156,4.67352303203957,7.8420530527435,101,"ENSG00000079974.19"
"7297","ENSG00000113448.20_799092",799084,799092,9,"ENSG00000113448.20",1,7,"VVVVVUMVV",1,7,0.807453416149068,114,120,133,136,142,148,163,166,"CTGATCA","TTTA","ATTATTA","CTGA",2.34599168185518,13,6,15,43,2.80890812931346,4.61221316875366,7.84202683334993,101,"ENSG00000079974.19"
"24132","ENSG00000175198.17_51228",51220,51228,9,"ENSG00000175198.17",0,NA,"VVVUVVVVV",1,8,0.880745341614907,116,122,133,136,170,176,190,193,"AGGACGT","CAGA","CTCTTGA","CTGA",2.31083429823361,11,34,14,68,1.8702504209252,4.31895310228732,7.84193446874695,101,"ENSG00000079974.19"
"40762","ENSG00000257545.5_94990",94982,94990,9,"ENSG00000257545.5",0,NA,"VVUVVVVVV",1,8,0.883643892339545,71,77,103,106,111,117,133,136,"CTGAAGA","CTCA","GTGGTGA","GTGA",2.31084938047976,26,5,16,56,1.82358523732077,4.30731194346313,7.84188751282131,101,"ENSG00000079974.19"
"40801","ENSG00000257711.2_4771",4763,4771,9,"ENSG00000257711.2",0,NA,"VVUVVVVVV",1,8,0.883643892339545,71,77,103,106,111,117,133,136,"CTGAAGA","CTCA","GTGGTGA","GTGA",2.31084938047976,26,5,16,56,1.82358523732077,4.30731194346313,7.84188751282131,101,"ENSG00000079974.19"
"31361","ENSG00000223561.8_12213",12205,12213,9,"ENSG00000223561.8",1,3,"VVMVVVVVV",0,8,0.882815734989648,85,91,100,103,108,114,133,136,"AAGATAA","CTGA","ATTAATA","CTAA",2.23228643992692,9,5,19,42,2.36041529509093,4.31058122365094,7.84184416360953,101,"ENSG00000079974.19"
"16920","ENSG00000152749.8_19165",19157,19165,9,"ENSG00000152749.8",1,8,"VVVVVVVMV",0,8,0.884057971014493,109,115,133,136,146,152,161,164,"AAGATGT","CTAA","ATTGTGA","TTGA",2.19826150991694,18,10,9,46,2.56730584202412,4.30559564370092,7.84182752775889,101,"ENSG00000079974.19"
"20620","ENSG00000165181.17_38722",38714,38722,9,"ENSG00000165181.17",1,2,"VMVVVVVVV",0,8,0.884057971014493,64,70,85,88,94,100,133,136,"TAGATGA","TTGA","GTGAGAA","CTTA",2.28790215766482,15,6,33,63,1.96918749215196,4.30546713581269,7.84169901987066,101,"ENSG00000079974.19"
"17729","ENSG00000154975.14_35124",35116,35124,9,"ENSG00000154975.14",1,1,"MVVVVUVVV",1,7,0.82815734989648,99,105,133,136,142,148,164,167,"ATCATGA","ATGG","ATCCTGA","CTGA",2.44439065670037,28,6,16,59,1.82028539123525,4.52905577564277,7.84168517522869,101,"ENSG00000079974.19"
"40399","ENSG00000255929.6_119496",119488,119496,9,"ENSG00000255929.6",1,8,"UVVVVVVMV",1,7,0.786749482401656,91,97,105,108,116,122,133,136,"ATGGTGC","CTGA","CTGAGGA","TTGA",2.39587455262627,8,8,11,36,2.80610115474832,4.6946495430642,7.84164747267083,101,"ENSG00000079974.19"
"1066","ENSG00000047365.13_227855",227847,227855,9,"ENSG00000047365.13",1,6,"UVVVVMVVV",1,7,0.805383022774327,87,93,133,136,148,154,168,171,"ATGATCA","CAAA","CTGATGT","CTGA",2.52625572833513,40,12,14,75,1.63865260527805,4.62008936521139,7.8416214563087,101,"ENSG00000079974.19"
"10283","ENSG00000130340.17_50849",50841,50849,9,"ENSG00000130340.17",1,2,"VMVVVUVVV",1,7,0.806211180124223,56,62,106,109,115,121,133,136,"ATCATGG","ATGA","ATGCTAA","CTGA",2.47871950684257,44,6,12,71,1.94218490650877,4.61674540469814,7.84159012519503,101,"ENSG00000079974.19"
"20823","ENSG00000165733.8_14299",14291,14299,9,"ENSG00000165733.8",1,8,"VVVVVVVMV",0,8,0.884057971014493,108,114,133,136,149,155,167,170,"ATGAAGA","TTCA","GTGAGCA","CTGG",2.24881772885011,19,13,12,53,2.22921042219788,4.30533215363298,7.84156403769095,101,"ENSG00000079974.19"
"28730","ENSG00000196376.11_378159",378151,378159,9,"ENSG00000196376.11",1,3,"VVMVVVUVV",1,7,0.768944099378882,74,80,97,100,110,116,133,136,"AAGATGA","ATGA","GGAATGC","CTGA",2.50676934567222,17,10,17,53,2.35098235425796,4.7656944980182,7.84147089553373,101,"ENSG00000079974.19"
"23494","ENSG00000173068.19_398897",398889,398897,9,"ENSG00000173068.19",1,8,"VVVVVUVMV",1,7,0.806211180124224,64,70,89,92,106,112,133,136,"AAGGTGA","CAGA","ATGAGGA","CTGA",2.52097086387477,19,14,21,63,1.65992038989631,4.61659820393202,7.84144292442892,101,"ENSG00000079974.19"
"47920","ENSG00000289707.1_55346",55338,55346,9,"ENSG00000289707.1",1,7,"VVVVVVMVV",0,8,0.885300207039338,106,112,133,136,146,152,182,185,"GAGATGA","TTCA","GGGAAGC","CTGA",2.36494114098843,21,10,30,70,1.43462139487414,4.30022391703258,7.84142474518993,101,"ENSG00000079974.19"
"4852","ENSG00000102078.16_11708",11700,11708,9,"ENSG00000102078.16",1,7,"VVVVVVMVV",0,8,0.885300207039338,78,84,95,98,116,122,133,136,"ATGGTAA","CTTA","ATGATTA","CTAA",2.22994657900326,11,18,11,49,2.33454197024237,4.30021312423269,7.84141395239004,101,"ENSG00000079974.19"
"28400","ENSG00000189056.15_279993",279985,279993,9,"ENSG00000189056.15",1,8,"VVVUVVVMV",1,7,0.764803312629399,66,72,83,86,100,106,133,136,"TTTATGA","CTGA","CTGTTGG","CTGA",2.59913287493563,11,14,27,61,1.80114602373066,4.78217463082538,7.84138788134297,101,"ENSG00000079974.19"
"15523","ENSG00000148655.15_137692",137684,137692,9,"ENSG00000148655.15",1,8,"VVVVVVVMV",0,8,0.884057971014493,66,72,83,86,114,120,133,136,"GTGTTGA","CTGA","ACTATGT","CTGG",2.28799602796162,11,28,13,61,1.96725704337215,4.30514097411241,7.84137285817038,101,"ENSG00000079974.19"
"23333","ENSG00000172613.8_15146",15138,15146,9,"ENSG00000172613.8",1,8,"VVVVVVVMV",0,8,0.884057971014493,89,95,101,104,112,118,133,136,"AGGATTA","CTGA","ATCATTG","ATGA",2.23042131126993,6,8,15,38,2.35099795015465,4.30511833965522,7.84135022371319,101,"ENSG00000079974.19"
"29946","ENSG00000198911.12_25389",25381,25389,9,"ENSG00000198911.12",1,2,"VMVVVVVVV",0,8,0.884057971014493,115,121,133,136,143,149,171,174,"ATCATGC","CGGA","ATGTTGG","CTAA",2.22177868356156,12,7,22,50,2.40850884980784,4.30509168505457,7.84132356911254,101,"ENSG00000079974.19"
"6932","ENSG00000112304.11_3704",3696,3704,9,"ENSG00000112304.11",1,7,"VVVVVVMVV",0,8,0.885300207039338,99,105,133,136,146,152,164,167,"TTGTTGA","GTCA","AAGAAAA","CTGA",2.28993177354625,28,10,12,59,1.93422290438583,4.30010868200688,7.84130951016423,101,"ENSG00000079974.19"
"10976","ENSG00000133321.11_5173",5165,5173,9,"ENSG00000133321.11",1,2,"VMVVVVVVV",0,8,0.884057971014493,61,67,79,82,111,117,133,136,"ATTATGA","CTGG","GTGAACC","ATGA",2.31005312698061,12,29,16,66,1.81994547698175,4.30507491421312,7.84130679827109,101,"ENSG00000079974.19"
"36023","ENSG00000237742.8_99451",99443,99451,9,"ENSG00000237742.8",1,7,"VVVVVVMVV",0,8,0.885300207039338,116,122,133,136,143,149,169,172,"TGGAAGA","CCCA","CTGACAA","CTGA",2.20594555451128,11,7,20,47,2.49397407532822,4.30006944301752,7.84127027117487,101,"ENSG00000079974.19"
"9531","ENSG00000125257.16_174276",174268,174276,9,"ENSG00000125257.16",1,7,"VVVUVVMVV",1,7,0.766045548654244,92,98,106,109,116,122,133,136,"ATGATGA","CAGA","AGGAAAA","ATGA",2.43896131626889,8,7,11,35,2.84853916022757,4.77707031717171,7.84125251178868,101,"ENSG00000079974.19"
"48511","ENSG00000291212.1_25030",25022,25030,9,"ENSG00000291212.1",1,2,"VMVVVVVVV",0,8,0.884057971014493,49,55,70,73,83,89,133,136,"CTGAGGA","CTGA","GTTAAAA","CAGA",2.31042544696501,15,10,44,78,1.81677157604596,4.30490197228651,7.84113385634448,101,"ENSG00000079974.19"
"16907","ENSG00000152611.12_16268",16260,16268,9,"ENSG00000152611.12",0,NA,"VVVUVVVVV",1,8,0.880745341614907,116,122,133,136,152,158,176,179,"ATGTGGA","GGGA","TTCTTGA","CTGA",2.275931265087,11,16,18,54,2.09958612615639,4.31811530668411,7.84109667314373,101,"ENSG00000079974.19"
"25577","ENSG00000182185.19_267700",267692,267700,9,"ENSG00000182185.19",1,2,"VMVVVUVVV",1,7,0.806211180124223,76,82,93,96,106,112,133,136,"ATTATGA","TTGA","ATGATGG","CTGG",2.41966551348207,11,10,21,51,2.33379160592645,4.61622375728507,7.84106847778196,101,"ENSG00000079974.19"
"4195","ENSG00000099139.14_244145",244137,244145,9,"ENSG00000099139.14",1,5,"UVVVMVVVV",1,7,0.789233954451346,88,94,101,104,112,118,133,136,"ATAATGT","CTTA","GTGCACA","CTGA",2.44140459586552,7,8,15,39,2.46028092755748,4.68407789166523,7.84101370947062,101,"ENSG00000079974.19"
"17777","ENSG00000155052.15_759071",759063,759071,9,"ENSG00000155052.15",1,1,"MVUVVVVVV",1,7,0.789648033126294,110,116,133,136,155,161,171,174,"GTGCTCA","CTGA","ATGAGCA","CTGA",2.49774218466879,17,19,10,55,2.07774774365381,4.6823405770281,7.84093270953328,101,"ENSG00000079974.19"
"39703","ENSG00000254101.8_367840",367832,367840,9,"ENSG00000254101.8",0,NA,"VVVUVVVVV",1,8,0.880745341614907,114,120,133,136,184,190,228,231,"GTTAGGA","ATGA","GTGAAGT","CTGA",2.4366742527847,13,48,38,108,1.02729028277376,4.31794632533461,7.84092769179423,101,"ENSG00000079974.19"
"45256","ENSG00000285280.2_34645",34637,34645,9,"ENSG00000285280.2",1,6,"VVVVVMUVV",1,7,0.788819875776397,113,119,133,136,183,189,207,210,"AAGATAA","CTGA","TTAATGA","CTGA",2.57111969282267,14,47,18,88,1.60167712132739,4.68561876836964,7.84089827147523,101,"ENSG00000079974.19"
"46262","ENSG00000286385.1_292664",292656,292664,9,"ENSG00000286385.1",1,8,"VVVVVVVMV",0,8,0.884057971014493,115,121,133,136,178,184,194,197,"AGTTTGA","TTGA","TTGATTC","CTGA",2.28203712556699,12,42,10,73,2.00502100007192,4.3046504592963,7.84088234335427,101,"ENSG00000079974.19"
"27531","ENSG00000186439.14_47542",47534,47542,9,"ENSG00000186439.14",1,2,"VMVVVVVVV",0,8,0.884057971014493,97,103,133,136,150,156,170,173,"ATGAAAA","CACA","ATCATGA","CTGA",2.35210134985639,30,14,14,67,1.53771315576389,4.30459720536829,7.84082908942626,101,"ENSG00000079974.19"
"9762","ENSG00000127124.16_34822",34814,34822,9,"ENSG00000127124.16",0,NA,"VVVUVVVVV",1,8,0.880745341614907,80,86,98,101,108,114,133,136,"ATTATGA","TAGA","GTGTCTA","CAGA",2.20397552666216,12,7,19,47,2.57820166525888,4.31784296075165,7.84082432721128,101,"ENSG00000079974.19"
"34609","ENSG00000233607.1_118253",118245,118253,9,"ENSG00000233607.1",1,8,"VVVVVVVMV",0,8,0.884057971014493,116,122,133,136,157,163,178,181,"AGGATAA","ATGA","ATGAGGA","CTGG",2.27818789504376,11,21,15,56,2.03027869949424,4.30454949994648,7.84078138400446,101,"ENSG00000079974.19"
"35898","ENSG00000237453.1_1302",1294,1302,9,"ENSG00000237453.1",1,1,"MVUVVVVVV",1,7,0.789648033126294,116,122,133,136,141,147,158,161,"TTAGTGA","CAGA","GTGATCC","CTGA",2.36009287888554,11,5,11,36,2.9946049370839,4.68213936574688,7.84073149825206,101,"ENSG00000079974.19"
"2901","ENSG00000079156.17_165795",165787,165795,9,"ENSG00000079156.17",1,1,"MVVVVUVVV",1,7,0.82815734989648,112,118,133,136,145,151,190,193,"AGGATGA","CTAA","GTGAAGA","CTAA",2.43410107560169,15,9,39,72,1.88496976177746,4.52807756644718,7.8407069660331,101,"ENSG00000079974.19"
"39185","ENSG00000253270.1_6498",6490,6498,9,"ENSG00000253270.1",0,NA,"VVVUVVVVV",1,8,0.880745341614907,111,117,133,136,162,168,222,225,"TTTATGA","CAAA","ATGAGGA","CTGA",2.44914281134262,16,26,54,105,0.943234762987307,4.31771337631786,7.84069474277749,101,"ENSG00000079974.19"
"42284","ENSG00000261502.4_57331",57323,57331,9,"ENSG00000261502.4",1,1,"MVVVVVUVV",1,7,0.792132505175983,110,116,133,136,160,166,180,183,"CTGATGA","CGCA","CTCATGA","CTGA",2.53734379524788,17,24,14,64,1.77302640465622,4.67216292657719,7.84069294728113,101,"ENSG00000079974.19"
"21241","ENSG00000166887.16_34594",34586,34594,9,"ENSG00000166887.16",1,5,"UVVVMVVVV",1,7,0.789233954451346,84,90,133,136,154,160,172,175,"TTGATGA","GTGA","CTAATGG","CTGA",2.6105472797636,43,18,12,82,1.33133468510639,4.68374580421593,7.84068162202132,101,"ENSG00000079974.19"
"18968","ENSG00000159712.10_39787",39779,39787,9,"ENSG00000159712.10",1,7,"VVVVUVMVV",1,7,0.775155279503105,65,71,101,104,116,122,133,136,"GTGTTGA","CTGA","AAGTAGA","CTGA",2.57473589282649,30,12,11,62,1.79516576216245,4.74001792858476,7.84063904659718,101,"ENSG00000079974.19"
"32761","ENSG00000227757.3_66512",66504,66512,9,"ENSG00000227757.3",1,8,"VVVVVVVMV",0,8,0.884057971014493,43,49,65,68,75,81,133,136,"TTGTTGA","ATGG","GAGTTGT","CTGA",2.30671637338389,16,7,52,84,1.83941674242265,4.30438147457881,7.84061335863678,101,"ENSG00000079974.19"
"21712","ENSG00000168734.14_71791",71783,71791,9,"ENSG00000168734.14",1,8,"VVVUVVVMV",1,7,0.764803312629399,113,119,133,136,144,150,190,193,"GTGATGT","CTGG","GTTAGGA","CTGA",2.57316503444458,14,8,40,71,1.97099535797442,4.78135723023457,7.84057048075217,101,"ENSG00000079974.19"
"33120","ENSG00000228740.3_39692",39684,39692,9,"ENSG00000228740.3",0,NA,"VVVUVVVVV",1,8,0.880745341614907,84,90,133,136,179,185,193,196,"GTTATGA","TGGA","GTGGTGG","CTGA",2.44284825998727,43,43,8,103,0.984691734883468,4.31758670036631,7.84056806682594,101,"ENSG00000079974.19"
"22120","ENSG00000169855.21_604244",604236,604244,9,"ENSG00000169855.21",1,2,"VMUVVVVVV",1,7,0.767701863354037,116,122,133,136,141,147,192,195,"AAGATGA","CTCA","TTGAGGC","CTGA",2.57481629202408,11,5,45,70,1.91358468943282,4.76975665906501,7.84056411248116,101,"ENSG00000079974.19"
"48016","ENSG00000290067.1_203977",203969,203977,9,"ENSG00000290067.1",1,2,"VMVVVVVVV",0,8,0.884057971014493,94,100,133,136,172,178,195,198,"AGGAGGA","TTGA","ATGCAGA","CTGA",2.47291222570241,33,36,17,95,0.730985262692525,4.30426669184382,7.84049857590179,101,"ENSG00000079974.19"
"22825","ENSG00000171495.17_15540",15532,15540,9,"ENSG00000171495.17",0,NA,"UVVVUVVVV",2,7,0.792546583850932,112,118,133,136,167,173,187,190,"TTGATGA","ATAA","GTTAAGA","CTGA",2.52866864346147,15,31,14,69,1.82328989070634,4.67027021177903,7.84045654718276,101,"ENSG00000079974.19"
"15171","ENSG00000147246.10_134617",134609,134617,9,"ENSG00000147246.10",1,1,"MVVVVUVVV",1,7,0.82815734989648,111,117,133,136,150,156,174,177,"GTGATTT","TTGA","GTGTGTA","CTGA",2.40218174972538,16,14,18,57,2.09674297912128,4.52782199432261,7.84045139390853,101,"ENSG00000079974.19"
"24495","ENSG00000176571.13_653529",653521,653529,9,"ENSG00000176571.13",1,3,"VVMVVVVVV",0,8,0.882815734989648,53,59,73,76,87,93,133,136,"ATGGTGT","ATGA","ATGATGT","TTGA",2.31257506711728,14,11,40,74,1.81946710071628,4.30915855370787,7.84042149366646,101,"ENSG00000079974.19"
"14526","ENSG00000145348.17_158965",158957,158965,9,"ENSG00000145348.17",1,8,"VVUVVVVMV",1,7,0.767701863354037,81,87,101,104,112,118,133,136,"TAGATGA","CTGG","TTCATGT","CTGA",2.44596592946451,14,8,15,46,2.77174603734722,4.76954639177766,7.84035384519381,101,"ENSG00000079974.19"
"8317","ENSG00000118217.7_197810",197802,197810,9,"ENSG00000118217.7",1,8,"VVVVVVVMV",0,8,0.884057971014493,110,116,133,136,149,155,180,183,"ATGTAGA","CCCA","GTGTTGG","CTGA",2.32414320037521,17,13,25,64,1.72218372827356,4.30411793269374,7.84034981675171,101,"ENSG00000079974.19"
"16499","ENSG00000151693.11_89747",89739,89747,9,"ENSG00000151693.11",1,3,"VVMVVVVVV",0,8,0.882815734989648,114,120,133,136,140,146,162,165,"CTAATGA","ATGA","GTAAGCA","CTGC",2.19403842112937,13,4,16,42,2.60932401206168,4.30906170489771,7.8403246448563,101,"ENSG00000079974.19"
"28682","ENSG00000196353.13_174624",174616,174624,9,"ENSG00000196353.13",1,5,"UVVVMVVVV",1,7,0.789233954451346,94,100,133,136,185,191,200,203,"ATGAAGA","ATGA","CTGATGT","CTGA",2.65752381838771,33,49,9,100,1.01667605921476,4.6833753787832,7.84031119658858,101,"ENSG00000079974.19"
"22707","ENSG00000171163.16_3023",3015,3023,9,"ENSG00000171163.16",1,1,"MVVVVVUVV",1,7,0.792132505175983,115,121,133,136,143,149,161,164,"CTGAGGG","GTGA","GTGCAGG","CTGA",2.35435527486174,12,7,12,40,2.99132810114279,4.67175748338859,7.84028750409252,101,"ENSG00000079974.19"
"38180","ENSG00000249742.2_19803",19795,19803,9,"ENSG00000249742.2",1,8,"UVVVVVVMV",1,7,0.786749482401656,112,118,133,136,148,154,162,165,"ATGATTC","ATGA","ATGCTAT","CTGA",2.4163357354565,15,12,8,44,2.66417751031479,4.69327060333954,7.84026853294616,101,"ENSG00000079974.19"
"42762","ENSG00000266573.6_132630",132622,132630,9,"ENSG00000266573.6",1,8,"VVVVVVVMV",0,8,0.884057971014493,113,119,133,136,186,192,200,203,"AGAATGC","TTAA","ATGAAGA","CTGA",2.29067235432955,14,50,8,81,1.94488607742849,4.30400877657304,7.84024066063101,101,"ENSG00000079974.19"
"30696","ENSG00000206579.9_14009",14001,14009,9,"ENSG00000206579.9",0,NA,"VVVUVVUVV",2,7,0.766873706004141,73,79,95,98,112,118,133,136,"ATGCTGA","CAGA","AAGAATA","CTGA",2.52193407125999,16,14,15,54,2.27787128706874,4.77269127386717,7.84018609788373,101,"ENSG00000079974.19"
"13017","ENSG00000139915.21_447820",447812,447820,9,"ENSG00000139915.21",1,2,"VMVVVVVVV",0,8,0.884057971014493,76,82,105,108,116,122,133,136,"ATGATGA","CAGA","GAGATAA","CCAA",2.24545866182873,23,8,11,51,2.24589501421982,4.30390485660284,7.84013674066082,101,"ENSG00000079974.19"
"38265","ENSG00000249858.2_404",396,404,9,"ENSG00000249858.2",0,NA,"UVVVVVUVV",2,7,0.788819875776397,43,49,66,69,77,83,133,136,"AAGATGA","CTAA","GTGGAAA","CTGA",2.54924431438311,17,8,50,84,1.74408389649748,4.68476149809622,7.84004100120181,101,"ENSG00000079974.19"
"35938","ENSG00000237505.8_235395",235387,235395,9,"ENSG00000237505.8",1,2,"VMVVVVVVV",0,8,0.884057971014493,106,112,133,136,149,155,211,214,"ATGATGT","CTTG","GCCAGGA","CTGA",2.41658443843156,21,13,56,99,1.10454702108811,4.30377748599129,7.84000937004926,101,"ENSG00000079974.19"
"32162","ENSG00000226197.4_318325",318317,318325,9,"ENSG00000226197.4",1,3,"VVMVVVVVV",0,8,0.882815734989648,102,108,133,136,149,155,179,182,"TTGATGA","TTGA","CTGAAGG","CTGT",2.40827306573642,25,13,24,71,1.17974333821795,4.30872427744851,7.83998721740711,101,"ENSG00000079974.19"
"786","ENSG00000033327.13_164648",164640,164648,9,"ENSG00000033327.13",1,6,"UVVVVMVVV",1,7,0.805383022774327,67,73,96,99,107,113,133,136,"ATGATGA","CTGC","GTGTTTA","ATGA",2.50464730889481,23,8,20,60,1.77602500550864,4.6184184328685,7.83995052396581,101,"ENSG00000079974.19"
"14417","ENSG00000144893.13_12628",12620,12628,9,"ENSG00000144893.13",1,6,"UVVVVMVVV",1,7,0.805383022774327,84,90,102,105,114,120,133,136,"ATGAGGA","CAGA","AAGAGGA","CTGT",2.33869791583347,12,9,13,43,2.88224643401867,4.61839146822712,7.83992355932443,101,"ENSG00000079974.19"
"29732","ENSG00000198648.12_194534",194526,194534,9,"ENSG00000198648.12",1,3,"VVMVVVUVV",1,7,0.768944099378882,111,117,133,136,150,156,164,167,"ATTTTGA","CTTA","CTGAAGA","CTGA",2.49193871104986,16,14,8,47,2.44361812123082,4.76413571539081,7.83991211290634,101,"ENSG00000079974.19"
"6433","ENSG00000109832.14_28668",28660,28668,9,"ENSG00000109832.14",1,8,"VVVVVUVMV",1,7,0.806211180124224,64,70,93,96,107,113,133,136,"ATGCTGA","CTGA","ATGAGGA","CTGT",2.52535933800269,23,11,20,63,1.6244911990493,4.6150550297668,7.8398997502637,101,"ENSG00000079974.19"
"42804","ENSG00000266893.1_23284",23276,23284,9,"ENSG00000266893.1",0,NA,"VVVUVVVVV",1,8,0.880745341614907,92,98,133,136,149,155,167,170,"ATGATGA","GTGC","ATAGTGA","CTAA",2.34102152757308,35,13,12,69,1.66083427653154,4.31691111508801,7.83989248154764,101,"ENSG00000079974.19"
"42983","ENSG00000267537.1_38859",38851,38859,9,"ENSG00000267537.1",0,NA,"VVVUVVVVV",1,8,0.880745341614907,92,98,133,136,149,155,167,170,"ATGATGA","GTGC","ATAGTGA","CTAA",2.34102152757308,35,13,12,69,1.66083427653154,4.31691111508801,7.83989248154764,101,"ENSG00000079974.19"
"44703","ENSG00000283403.1_118236",118228,118236,9,"ENSG00000283403.1",0,NA,"VVVUVVVVV",1,8,0.880745341614907,92,98,133,136,149,155,167,170,"ATGATGA","GTGC","ATAGTGA","CTAA",2.34102152757308,35,13,12,69,1.66083427653154,4.31691111508801,7.83989248154764,101,"ENSG00000079974.19"
"29551","ENSG00000198216.14_349738",349730,349738,9,"ENSG00000198216.14",1,8,"VVVVVVVMV",0,8,0.884057971014493,51,57,102,105,115,121,133,136,"ATGATCC","CTGA","TAGAAGA","CTTA",2.30371069003523,45,10,12,76,1.85651075997686,4.3036455067196,7.83987739077757,101,"ENSG00000079974.19"
"18162","ENSG00000156304.15_2833",2825,2833,9,"ENSG00000156304.15",0,NA,"VVVVUUVVV",2,7,0.812008281573499,115,121,133,136,150,156,175,178,"CAGAAGA","GTGA","GTGCTGA","CTGA",2.42535516280543,12,14,19,54,2.19831680019697,4.59183780472496,7.83987093101896,101,"ENSG00000079974.19"
"32951","ENSG00000228340.8_288860",288852,288860,9,"ENSG00000228340.8",1,8,"VVVVVUVMV",1,7,0.806211180124224,116,122,133,136,140,146,170,173,"GTGCTGA","GTGA","ATCATTT","CTGA",2.44976853612935,11,4,24,48,2.12822338841365,4.615003407319,7.8398481278159,101,"ENSG00000079974.19"
"47803","ENSG00000289368.2_143907",143899,143907,9,"ENSG00000289368.2",1,7,"VVVVUVMVV",1,7,0.775155279503105,79,85,98,101,112,118,133,136,"TTGAAGA","CTGA","GTGATGG","ATGA",2.44605638441648,13,11,15,48,2.64964956209931,4.73917303121895,7.83979414923138,101,"ENSG00000079974.19"
"38684","ENSG00000250891.3_132099",132091,132099,9,"ENSG00000250891.3",1,5,"UVVVMVVVV",1,7,0.789233954451346,100,106,133,136,139,145,155,158,"ATGATGA","GAGA","GAACTGA","CTGA",2.53899986892399,27,3,10,49,1.80470511861652,4.68284272786078,7.83977854566617,101,"ENSG00000079974.19"
"26643","ENSG00000184672.12_657428",657420,657428,9,"ENSG00000184672.12",1,2,"VMVVVVVVV",0,8,0.884057971014493,94,100,133,136,173,179,196,199,"AGGAGGA","TTGA","ATGCAGA","CTGA",2.47291222570241,33,37,17,96,0.728070278497448,4.30353794579505,7.83976982985302,101,"ENSG00000079974.19"
"7609","ENSG00000115170.16_104150",104142,104150,9,"ENSG00000115170.16",1,8,"VVVVVVVMV",0,8,0.884057971014493,112,118,133,136,152,158,208,211,"ATGATGA","TTTA","TTGAAAA","CTGT",2.37202156955364,15,16,50,90,1.40059764185455,4.30351869305304,7.83975057711101,101,"ENSG00000079974.19"
"5314","ENSG00000104321.11_25833",25825,25833,9,"ENSG00000104321.11",1,8,"VVVVVVVMV",0,8,0.884057971014493,55,61,75,78,110,116,133,136,"ATTATGA","GTGA","CTCAAGA","CTTA",2.32759851129304,14,32,17,72,1.69674751785094,4.30351773161781,7.83974961567578,101,"ENSG00000079974.19"
"20487","ENSG00000164951.16_22588",22580,22588,9,"ENSG00000164951.16",1,8,"VVVVVVVMV",0,8,0.884057971014493,97,103,133,136,166,172,180,183,"ATTATGT","TTTA","TTGATGT","CTGA",2.42086585693004,30,30,8,77,1.07480577833428,4.3034778728003,7.83970975685827,101,"ENSG00000079974.19"
"17628","ENSG00000154654.15_221442",221434,221442,9,"ENSG00000154654.15",1,2,"VMUVVVVVV",1,7,0.767701863354037,115,121,133,136,139,145,154,157,"GTGTGGA","GTGA","TTGATAA","CTGA",2.42501780180293,12,3,9,33,2.90790712619639,4.76867311788732,7.83948057130346,101,"ENSG00000079974.19"
"19774","ENSG00000163659.13_18820",18812,18820,9,"ENSG00000163659.13",1,8,"VVVVVVVMV",0,8,0.884057971014493,91,97,133,136,145,151,201,204,"GTGATGT","TTGG","ATTATAA","CTGA",2.43805051206864,36,9,50,104,0.959197931567515,4.30321700300627,7.83944888706424,101,"ENSG00000079974.19"
"45870","ENSG00000286015.1_10907",10899,10907,9,"ENSG00000286015.1",1,1,"MVUVVUVVV",2,6,0.711801242236025,115,121,133,136,139,145,153,156,"ATGCTGA","CTGT","CTGCTCA","CTGA",2.5546655472604,12,3,8,32,2.93775089458213,4.99221363574619,7.83941860469029,101,"ENSG00000079974.19"
"18664","ENSG00000158019.21_355637",355629,355637,9,"ENSG00000158019.21",1,2,"VMVVUVVVV",1,7,0.773913043478261,115,121,133,136,145,151,168,171,"CTGATTA","GTGA","GTCAGGT","CTGA",2.44854992381556,12,9,17,47,2.6511251156644,4.7436978186087,7.83934999252174,101,"ENSG00000079974.19"
"8474","ENSG00000119121.22_145868",145860,145868,9,"ENSG00000119121.22",1,8,"VVVVVUVMV",1,7,0.806211180124224,111,117,133,136,145,151,166,169,"ATAATAA","ATAA","ATGGTGA","CTGA",2.37765399746402,16,9,15,49,2.60676869659968,4.61444883658996,7.83929355708685,101,"ENSG00000079974.19"
"15484","ENSG00000148488.17_41392",41384,41392,9,"ENSG00000148488.17",1,8,"VVVVVVVMV",0,8,0.884057971014493,82,88,133,136,140,146,158,161,"ATAATAA","CACA","GTAATAA","CTGA",2.31241672874975,45,4,12,70,1.79603765965009,4.30303729616211,7.83926918022008,101,"ENSG00000079974.19"
"38226","ENSG00000249803.6_50189",50181,50189,9,"ENSG00000249803.6",1,8,"VVVVUVVMV",1,7,0.773913043478261,115,121,133,136,159,165,180,183,"ATGAGGA","GTGC","ATGAGGA","CTGA",2.54755711362414,12,23,15,59,1.99032205288544,4.74350903592827,7.83916120984131,101,"ENSG00000079974.19"
"13336","ENSG00000140992.19_12202",12194,12202,9,"ENSG00000140992.19",1,3,"VVMVVVVVV",0,8,0.882815734989648,111,117,133,136,142,148,161,164,"ACGATAA","CAGA","GTGTGGC","CTTA",2.17228527751716,16,6,13,44,2.74952189876665,4.30785593722026,7.83911887717886,101,"ENSG00000079974.19"
"45367","ENSG00000285520.1_23308",23300,23308,9,"ENSG00000285520.1",0,NA,"VVVUVVUVV",2,7,0.766873706004141,110,116,133,136,139,145,180,183,"ATGATGG","CAGA","CTGAGGC","CTGA",2.63662310309352,17,3,35,64,1.50888626555646,4.77159340487831,7.83908822889488,101,"ENSG00000079974.19"
"38382","ENSG00000250075.7_32195",32187,32195,9,"ENSG00000250075.7",0,NA,"VVVUVVVVV",1,8,0.880745341614907,87,93,108,111,115,121,133,136,"TTAAAGA","TTCA","ATGCAGG","CTGA",2.17889846899392,15,4,12,40,2.73842218679623,4.31610299502226,7.83908436148189,101,"ENSG00000079974.19"
"5901","ENSG00000107164.17_14932",14924,14932,9,"ENSG00000107164.17",0,NA,"UVVVUVVVV",2,7,0.792546583850932,80,86,104,107,116,122,133,136,"ATGAAGA","CTGA","TAGATAA","CTGC",2.41051146039678,18,9,11,47,2.60548191312479,4.6688895789425,7.83907591434623,101,"ENSG00000079974.19"
"19277","ENSG00000162641.20_132149",132141,132149,9,"ENSG00000162641.20",1,8,"VVVVVVVMV",0,8,0.884057971014493,116,122,133,136,142,148,166,169,"AAGATGT","ATGT","ATGATGC","ATGA",2.19115573308924,11,6,18,44,2.6033663319076,4.3027678047923,7.83899968885027,101,"ENSG00000079974.19"
"14566","ENSG00000145375.9_211721",211713,211721,9,"ENSG00000145375.9",0,NA,"VVVVVUUVV",2,7,0.808281573498965,116,122,133,136,139,145,154,157,"GTCATCA","CAGA","CACATGA","CTGA",2.32388855971104,11,3,9,32,2.93087201071515,4.60586560219719,7.83899189619305,101,"ENSG00000079974.19"
"34427","ENSG00000233005.2_721908",721900,721908,9,"ENSG00000233005.2",1,2,"VMVVVVVVV",0,8,0.884057971014493,85,91,133,136,137,143,153,156,"ATCATGA","TTGC","AGGCTTA","CTGA",2.38270459642232,42,1,10,62,1.32631966988322,4.30275424484135,7.83898612889932,101,"ENSG00000079974.19"
"20338","ENSG00000164684.13_192450",192442,192450,9,"ENSG00000164684.13",1,8,"VVVVVUVMV",1,7,0.806211180124224,77,83,94,97,103,109,133,136,"ACCATGA","CTGT","AGGAAGA","CTGA",2.42745809766189,11,6,24,50,2.27319246399895,4.61406161210289,7.83890633259979,101,"ENSG00000079974.19"
"41227","ENSG00000258703.1_376",368,376,9,"ENSG00000258703.1",1,1,"MVVUVVVVV",1,7,0.786749482401656,22,28,44,47,97,103,133,136,"CTGATGA","CAGA","TTTATGA","CTGA",2.67032463278129,16,50,30,105,0.965428525495158,4.69189818600927,7.83889611561589,101,"ENSG00000079974.19"
"12953","ENSG00000139684.15_872",864,872,9,"ENSG00000139684.15",1,3,"VVMVVVVVV",0,8,0.882815734989648,102,108,133,136,144,150,165,168,"TTGACAA","CTCA","GTGGGGG","CTGA",2.28823020655612,25,8,15,57,1.97547636653598,4.30758610256086,7.83884904251945,101,"ENSG00000079974.19"
"28669","ENSG00000196335.13_20505",20497,20505,9,"ENSG00000196335.13",1,3,"VVMVVVVVV",0,8,0.882815734989648,106,112,133,136,143,149,203,206,"CTGTTGT","CAGA","TTGATTG","CTGA",2.37288637103683,21,7,54,91,1.41074865590052,4.30749778236985,7.83876072232844,101,"ENSG00000079974.19"
"18464","ENSG00000157445.15_423849",423841,423849,9,"ENSG00000157445.15",0,NA,"VVVUVUVVV",2,7,0.802898550724638,56,62,71,74,115,121,133,136,"ATTTTGA","TTGA","TTGAAGA","CTGA",2.50623973767098,9,41,12,71,1.80032642863333,4.62714783660996,7.83874203950851,101,"ENSG00000079974.19"
"19594","ENSG00000163399.16_18853",18845,18853,9,"ENSG00000163399.16",1,6,"UVVVVMVVV",1,7,0.805383022774327,113,119,133,136,139,145,153,156,"ATCATGA","CTGT","GAGAAGA","GTGA",2.34855306742372,14,3,8,34,2.81163651498766,4.61716424111978,7.83869633221709,101,"ENSG00000079974.19"
"42224","ENSG00000261183.7_1187",1179,1187,9,"ENSG00000261183.7",1,2,"VMVVVVVVV",0,8,0.884057971014493,116,122,133,136,138,144,162,165,"CTCCTGA","CTTA","GAGACCA","CTGA",2.25603634785392,11,2,18,40,2.16921713251291,4.30236486288476,7.83859674694273,101,"ENSG00000079974.19"
"8054","ENSG00000116678.20_18586",18578,18586,9,"ENSG00000116678.20",1,2,"VMVVVVVVV",0,8,0.884057971014493,96,102,133,136,143,149,166,169,"ATGATTT","CGGT","TTTAGGA","CTGA",2.32195609908326,31,7,17,64,1.72966329885494,4.30234265651916,7.83857454057713,101,"ENSG00000079974.19"
"24183","ENSG00000175471.20_227008",227000,227008,9,"ENSG00000175471.20",1,2,"UMVVVVVVV",1,7,0.786749482401656,105,111,133,136,144,150,162,165,"ATGAATA","CTGA","AGGATTT","CTGA",2.4725798818402,22,8,12,51,2.28219589181153,4.69151544268655,7.83851337229318,101,"ENSG00000079974.19"
"38839","ENSG00000251138.7_334022",334014,334022,9,"ENSG00000251138.7",1,1,"MVVVVVUVV",1,7,0.792132505175983,86,92,133,136,145,151,167,170,"ATGATGC","CTGT","ATCAGGT","CTGA",2.54546560543431,41,9,16,75,1.7101065371036,4.66996930999975,7.83849933070368,101,"ENSG00000079974.19"
"4552","ENSG00000101040.20_62410",62402,62410,9,"ENSG00000101040.20",1,5,"VVVVMUVVV",1,7,0.808695652173913,96,102,133,136,185,191,204,207,"ATGATGC","CTGT","GTAAAGA","CTGA",2.61936763246134,31,49,13,102,0.952347410700469,4.60369957344401,7.83848218213966,101,"ENSG00000079974.19"
"36189","ENSG00000238212.3_30886",30878,30886,9,"ENSG00000238212.3",1,3,"VVMVVVVVV",0,8,0.882815734989648,111,117,133,136,186,192,202,205,"AAGATAA","TTGT","ACGATGT","CTGA",2.30851842603649,16,50,10,85,1.83872344764789,4.30721157197279,7.83847451193138,101,"ENSG00000079974.19"
"32743","ENSG00000227712.3_16437",16429,16437,9,"ENSG00000227712.3",1,1,"MVVVVUVVV",1,7,0.82815734989648,97,103,109,112,114,120,133,136,"AAGAAGA","CAGT","TTGATAA","CTGA",2.36971357978229,6,2,13,30,2.30513208050417,4.52580565309652,7.83843505268244,101,"ENSG00000079974.19"
"25272","ENSG00000180287.17_386771",386763,386771,9,"ENSG00000180287.17",1,1,"MVVVVUUVV",2,6,0.714285714285714,88,94,104,107,115,121,133,136,"TTGATGA","CTTA","ATAAGCA","CTGA",2.55245418197244,10,8,12,39,2.90880467451024,4.98129147191497,7.83843432905782,101,"ENSG00000079974.19"
"47674","ENSG00000288932.2_16665",16657,16665,9,"ENSG00000288932.2",0,NA,"UVVVVUVVV",2,7,0.824844720496894,114,120,133,136,177,183,193,196,"GTGAAGA","GGGA","ATGGTGT","CTGA",2.42315119585051,13,41,10,73,2.00160950901689,4.53898770367174,7.83836658565932,101,"ENSG00000079974.19"
"3905","ENSG00000090612.22_20812",20804,20812,9,"ENSG00000090612.22",1,8,"VVVVVVVMV",0,8,0.884057971014493,70,76,91,94,100,106,133,136,"TTGATGA","ATCA","ATAAAGA","TTGA",2.26674665392097,15,6,27,57,2.09684269601269,4.30212176387146,7.83835364792943,101,"ENSG00000079974.19"
"40523","ENSG00000256825.4_71237",71229,71237,9,"ENSG00000256825.4",1,8,"VVVVVVVMV",0,8,0.884057971014493,70,76,91,94,100,106,133,136,"TTGATGA","ATCA","ATAAAGA","TTGA",2.26674665392097,15,6,27,57,2.09684269601269,4.30212176387146,7.83835364792943,101,"ENSG00000079974.19"
"33822","ENSG00000231246.3_106481",106473,106481,9,"ENSG00000231246.3",0,NA,"VVUVUVVVV",2,7,0.773498964803312,114,120,133,136,147,153,163,166,"AAAATCA","GTGA","ATGATGA","CTGA",2.42014037232688,13,11,10,43,2.84307618458625,4.74433633335803,7.83833219257128,101,"ENSG00000079974.19"
"28380","ENSG00000188917.15_42723",42715,42723,9,"ENSG00000188917.15",1,8,"VVVVVVVMV",0,8,0.884057971014493,115,121,133,136,150,156,172,175,"GTGTGGA","CCAA","ATAATAA","CTGA",2.22395513478673,12,14,16,51,2.38195555252395,4.3020807794422,7.83831266350017,101,"ENSG00000079974.19"
"45881","ENSG00000286021.3_127062",127054,127062,9,"ENSG00000286021.3",0,NA,"VVUVVUVVV",2,7,0.805797101449275,107,113,133,136,144,150,181,184,"TTGATGT","GTGA","GTAATAA","CTGA",2.53143344247889,20,8,31,68,1.58416297023573,4.61509648002375,7.83828488582086,101,"ENSG00000079974.19"
"32648","ENSG00000227474.1_625",617,625,9,"ENSG00000227474.1",1,2,"VMVVVVVVV",0,8,0.884057971014493,111,117,133,136,145,151,195,198,"GTTATCA","CAAA","CTGATGC","CTGA",2.31159608147938,16,9,44,78,1.7975564987197,4.30204926047889,7.83828114453686,101,"ENSG00000079974.19"
"7928","ENSG00000116117.19_309056",309048,309056,9,"ENSG00000116117.19",1,8,"UVVVVUVMV",2,6,0.708902691511387,115,121,133,136,187,193,204,207,"ATAATGA","GTGA","TTGATGA","CTGA",2.70361153094139,12,51,11,83,1.98658866451506,5.00266638436441,7.83827715040995,101,"ENSG00000079974.19"
"30743","ENSG00000213047.13_255483",255475,255483,9,"ENSG00000213047.13",1,5,"UVVVMVVVV",1,7,0.789233954451346,114,120,133,136,149,155,167,170,"AGTATGC","CTTA","GTGAAGA","CTGA",2.41112435973666,13,13,12,47,2.65060692815329,4.68119233159942,7.8381281494048,101,"ENSG00000079974.19"
"38194","ENSG00000249776.5_170645",170637,170645,9,"ENSG00000249776.5",1,7,"VVVVUVMVV",1,7,0.775155279503105,116,122,133,136,140,146,154,157,"ATAATTA","CAGA","CCTATGA","CTGA",2.385008121404,11,4,8,32,3.04928404403719,4.73733454668262,7.83795566469504,101,"ENSG00000079974.19"
"47775","ENSG00000289298.2_977",969,977,9,"ENSG00000289298.2",1,8,"VVVVVUVMV",1,7,0.806211180124224,115,121,133,136,145,151,176,179,"TTCATGA","CAGG","TTGAAGA","CTGA",2.43425181699031,12,9,25,55,2.22382057100596,4.61304150440201,7.8378862248989,101,"ENSG00000079974.19"
"11906","ENSG00000136478.9_9123",9115,9123,9,"ENSG00000136478.9",1,1,"MVVVVVUVV",1,7,0.792132505175983,72,78,90,93,104,110,133,136,"ATGATGT","CAGA","ATGAGGA","CTCA",2.47251036508457,12,11,23,55,2.19397689199859,4.66934483147392,7.83787485217786,101,"ENSG00000079974.19"
"38920","ENSG00000251301.8_28516",28508,28516,9,"ENSG00000251301.8",1,7,"VVVVUVMVV",1,7,0.775155279503105,84,90,106,109,114,120,133,136,"AGGATGC","CTGG","TGGAAGA","CTGA",2.43719126515659,16,5,13,43,2.70086535882246,4.73720178163327,7.83782289964569,101,"ENSG00000079974.19"
"38971","ENSG00000251372.7_151571",151563,151571,9,"ENSG00000251372.7",1,2,"VMVVVVVVV",0,8,0.884057971014493,76,82,98,101,112,118,133,136,"ACGCTGA","CTGA","GCCTTGA","CAGA",2.20736523696673,16,11,15,51,2.49055936472019,4.30158190279126,7.83781378684923,101,"ENSG00000079974.19"
"23125","ENSG00000172264.19_1376164",1376156,1376164,9,"ENSG00000172264.19",1,1,"MVUVVVVVV",1,7,0.789648033126294,59,65,83,86,92,98,133,136,"CTGCTGA","CTTA","GTGGTGA","CTGA",2.55204648775741,18,6,35,68,1.70318979390453,4.67920826140515,7.83780039391033,101,"ENSG00000079974.19"
"23234","ENSG00000172348.16_257301",257293,257301,9,"ENSG00000172348.16",1,2,"VMVVVUVVV",1,7,0.806211180124223,50,56,99,102,111,117,133,136,"ATGAGAA","CTGA","TTCATGG","CTGA",2.51129235489901,43,9,16,77,1.70959549214637,4.6128861312016,7.8377308516985,101,"ENSG00000079974.19"
"46200","ENSG00000286277.1_1932",1924,1932,9,"ENSG00000286277.1",1,1,"MVVVUUVVV",2,6,0.718012422360248,83,89,101,104,113,119,133,136,"GTGAGGA","TTGA","ATGGGGA","CTGA",2.55478664157912,12,9,14,44,2.83078849053812,4.96567485859973,7.83772454804073,101,"ENSG00000079974.19"
"10555","ENSG00000131558.15_361270",361262,361270,9,"ENSG00000131558.15",0,NA,"UVVVUVVVV",2,7,0.792546583850932,87,93,133,136,168,174,182,185,"AAGATGA","TTGA","TTGATGC","CTGA",2.64798947302736,40,32,8,89,1.01686941928229,4.66753314319951,7.83771947860324,101,"ENSG00000079974.19"
"28429","ENSG00000189108.13_293293",293285,293293,9,"ENSG00000189108.13",1,8,"VVVVVUVMV",1,7,0.806211180124224,90,96,133,136,139,145,153,156,"ATAATGT","CTTA","ATAATGA","CTGA",2.51488432559525,37,3,8,57,1.68527719092851,4.61279317372421,7.8376378942211,101,"ENSG00000079974.19"
"27860","ENSG00000187474.5_22009",22001,22009,9,"ENSG00000187474.5",1,2,"VMVVUVVVV",1,7,0.773913043478261,78,84,93,96,104,110,133,136,"AAGATGA","ATGA","AAGGTGT","CTGA",2.51774907540195,9,8,23,49,2.18278757149857,4.7419453518779,7.83759752579094,101,"ENSG00000079974.19"
"15200","ENSG00000147274.14_13124",13116,13124,9,"ENSG00000147274.14",1,3,"VVMVVVUVV",1,7,0.768944099378882,67,73,97,100,108,114,133,136,"ATGGTGA","ATGA","TTGAAAA","CTGA",2.59007814185373,24,8,19,60,1.77990390892887,4.76177288032176,7.83754927783729,101,"ENSG00000079974.19"
"24464","ENSG00000176438.13_33152",33144,33152,9,"ENSG00000176438.13",1,8,"VVVVVVVMV",0,8,0.884057971014493,86,92,133,136,141,147,163,166,"GTGATAA","TTGG","AAGACCA","CTGA",2.32713950623217,41,5,16,71,1.69096947993149,4.30130821370316,7.83754009776113,101,"ENSG00000079974.19"
"486","ENSG00000013364.19_5004",4996,5004,9,"ENSG00000013364.19",1,3,"VVMVVVVVV",0,8,0.882815734989648,109,115,133,136,145,151,177,180,"CTGATCT","CTAA","GTCATCT","CTGA",2.30572391059895,18,9,26,62,1.85325685931672,4.30618739916076,7.83745033911935,101,"ENSG00000079974.19"
"44370","ENSG00000281348.1_8159",8151,8159,9,"ENSG00000281348.1",1,3,"VVMVVVVVV",0,8,0.882815734989648,109,115,133,136,145,151,177,180,"CTGATCT","CTAA","GTCATCT","CTGA",2.30572391059895,18,9,26,62,1.85325685931672,4.30618739916076,7.83745033911935,101,"ENSG00000079974.19"
"31831","ENSG00000224944.2_63240",63232,63240,9,"ENSG00000224944.2",0,NA,"VVUVVVVVV",1,8,0.883643892339545,59,65,105,108,115,121,133,136,"ATGGTGA","ATGA","ATGCCGG","GTGA",2.28780376926685,40,7,12,68,1.95946791366823,4.30287326052848,7.83744882988666,101,"ENSG00000079974.19"
"32929","ENSG00000228262.11_700954",700946,700954,9,"ENSG00000228262.11",0,NA,"VVUVVVVVV",1,8,0.883643892339545,110,116,133,136,161,167,176,179,"TTTATGA","CAGA","CTGATTA","CTTA",2.30009950008482,17,25,9,60,1.87749464285935,4.30287282752288,7.83744839688106,101,"ENSG00000079974.19"
"1563","ENSG00000060982.15_126587",126579,126587,9,"ENSG00000060982.15",1,8,"VVVVVVVMV",0,8,0.884057971014493,115,121,133,136,145,151,207,210,"ATTATTA","TAGA","ATGTTTT","CTGA",2.2880335716577,12,9,56,86,1.95127240026471,4.30120738616235,7.83743927022032,101,"ENSG00000079974.19"
"9551","ENSG00000125386.16_70251",70243,70251,9,"ENSG00000125386.16",1,8,"VVVVVVUMV",1,7,0.770186335403727,115,121,133,136,187,193,207,210,"ATGATTA","CAGA","TTGTTCA","CTGA",2.57318224736482,12,51,14,86,1.87218258926925,4.75668272625868,7.83742806787359,101,"ENSG00000079974.19"
"48029","ENSG00000290180.1_94421",94413,94421,9,"ENSG00000290180.1",1,8,"VVVVVVUMV",1,7,0.770186335403727,115,121,133,136,187,193,207,210,"ATGATTA","CAGA","TTGTTCA","CTGA",2.57318224736482,12,51,14,86,1.87218258926925,4.75668272625868,7.83742806787359,101,"ENSG00000079974.19"
"2866","ENSG00000078725.13_151069",151061,151069,9,"ENSG00000078725.13",1,7,"VVVUVVMVV",1,7,0.766045548654244,115,121,133,136,152,158,175,178,"ATCATGA","CAAA","ATGTTGA","CTGA",2.53584101271972,12,16,17,54,2.18649321036899,4.77302499045845,7.83720718507543,101,"ENSG00000079974.19"
"37362","ENSG00000247728.2_7137",7129,7137,9,"ENSG00000247728.2",1,8,"VVVVVVVMV",0,8,0.884057971014493,107,113,133,136,145,151,175,178,"GTGGGGA","TTGT","GAGATGA","CTGA",2.31736133740234,20,9,24,62,1.75474062672592,4.30095405235204,7.83718593641001,101,"ENSG00000079974.19"
"42420","ENSG00000262728.6_7121",7113,7121,9,"ENSG00000262728.6",1,8,"VVVVVVVMV",0,8,0.884057971014493,107,113,133,136,145,151,175,178,"GTGGGGA","TTGT","GAGATGA","CTGA",2.31736133740234,20,9,24,62,1.75474062672592,4.30095405235204,7.83718593641001,101,"ENSG00000079974.19"
"23019","ENSG00000171944.2_7631",7623,7631,9,"ENSG00000171944.2",1,3,"UVMVVVVVV",1,7,0.785507246376811,57,63,73,76,87,93,133,136,"AAGTTGA","CTGA","TTGAAAA","CTGA",2.55084376013275,10,11,40,70,1.77485887548611,4.69512098575944,7.83714997126669,101,"ENSG00000079974.19"
"33498","ENSG00000230021.10_176682",176674,176682,9,"ENSG00000230021.10",0,NA,"UVVVVUVVV",2,7,0.824844720496894,100,106,133,136,143,149,189,192,"ATGATGA","TTGA","TTGATGG","TTGA",2.55416515909124,27,7,40,83,1.12315919463166,4.53773173047665,7.83711061246422,101,"ENSG00000079974.19"
"33573","ENSG00000230423.3_63569",63561,63569,9,"ENSG00000230423.3",0,NA,"UVVVVUVVV",2,7,0.824844720496894,100,106,133,136,143,149,189,192,"ATGATGA","TTGA","TTGATGG","TTGA",2.55416515909124,27,7,40,83,1.12315919463166,4.53773173047665,7.83711061246422,101,"ENSG00000079974.19"
"48082","ENSG00000290385.1_107562",107554,107562,9,"ENSG00000290385.1",0,NA,"UVVVVUVVV",2,7,0.824844720496894,100,106,133,136,143,149,189,192,"ATGATGA","TTGA","TTGATGG","TTGA",2.55416515909124,27,7,40,83,1.12315919463166,4.53773173047665,7.83711061246422,101,"ENSG00000079974.19"
"36897","ENSG00000243422.4_16716",16708,16716,9,"ENSG00000243422.4",1,1,"MVUVVVVVV",1,7,0.789648033126294,64,70,85,88,97,103,133,136,"TTGCTGA","CTAA","AAGATGA","CTGA",2.50911504432265,15,9,30,63,1.98663900531437,4.67851815853301,7.83711029103819,101,"ENSG00000079974.19"
"44545","ENSG00000282968.1_2179",2171,2179,9,"ENSG00000282968.1",1,1,"MVUVVVVVV",1,7,0.789648033126294,64,70,85,88,97,103,133,136,"TTGCTGA","CTAA","AAGATGA","CTGA",2.50911504432265,15,9,30,63,1.98663900531437,4.67851815853301,7.83711029103819,101,"ENSG00000079974.19"
"30016","ENSG00000198947.18_857130",857122,857130,9,"ENSG00000198947.18",1,8,"UVVVVUVMV",2,6,0.708902691511387,60,66,108,111,115,121,133,136,"GTGATGA","CTGA","ATAAAAA","CTGA",2.73140491188083,42,4,12,67,1.79648123013945,5.00146182733624,7.83707259338179,101,"ENSG00000079974.19"
"43205","ENSG00000269964.4_94760",94752,94760,9,"ENSG00000269964.4",1,2,"VMVUVVVVV",1,7,0.764803312629399,110,116,133,136,141,147,159,162,"ATCATGC","TTGA","AGGAGGA","CTGA",2.46817903891647,17,5,12,43,2.65690039645844,4.77785683064206,7.83707008115966,101,"ENSG00000079974.19"
"38141","ENSG00000249675.1_28787",28779,28787,9,"ENSG00000249675.1",1,2,"VMVVVVVVV",0,8,0.884057971014493,101,107,133,136,150,156,173,176,"ATGAAGG","CAAA","CTGAAGG","CTGA",2.36238202532725,26,14,17,66,1.45400128142916,4.30080369590271,7.83703557996068,101,"ENSG00000079974.19"
"34737","ENSG00000233926.2_47375",47367,47375,9,"ENSG00000233926.2",1,8,"VVVVVUVMV",1,7,0.806211180124224,61,67,78,81,102,108,133,136,"ATGAATA","CTGA","CTGGTGT","CTGA",2.54437042238074,11,21,25,66,1.48622256225089,4.61217301119729,7.83701773169419,101,"ENSG00000079974.19"
"23749","ENSG00000173838.12_16251",16243,16251,9,"ENSG00000173838.12",1,8,"VVVVUVVMV",1,7,0.773913043478261,114,120,133,136,147,153,167,170,"AGGAGGG","CTGA","AGGAAGA","CTGA",2.4390741526636,13,11,14,47,2.70484561953851,4.7413349926573,7.83698716657034,101,"ENSG00000079974.19"
"34491","ENSG00000233183.3_6255",6247,6255,9,"ENSG00000233183.3",1,8,"UVVVVVVMV",1,7,0.786749482401656,45,51,68,71,116,122,133,136,"GAGATGG","CTGA","GTGTTAA","CTGA",2.55248198754506,17,45,11,82,1.74339183063414,4.68998460356697,7.8369825331736,101,"ENSG00000079974.19"
"26702","ENSG00000184903.10_703548",703540,703548,9,"ENSG00000184903.10",1,1,"MVVVVUVVV",1,7,0.82815734989648,84,90,103,106,112,118,133,136,"ATGATTG","CAGA","ATGATCA","GTGA",2.29325595503887,13,6,15,43,2.80890812931346,4.52432029072648,7.83694969031241,101,"ENSG00000079974.19"
"36388","ENSG00000240405.7_407284",407276,407284,9,"ENSG00000240405.7",1,2,"VMVVVUVVV",1,7,0.806211180124223,111,117,133,136,142,148,160,163,"TAGTTGA","ATGA","ATGATAG","CTGA",2.34842276029009,16,6,12,43,2.79214707399092,4.61207470231454,7.83691942281144,101,"ENSG00000079974.19"
"39687","ENSG00000254101.8_1042246",1042238,1042246,9,"ENSG00000254101.8",1,2,"VMVVVVVVV",0,8,0.884057971014493,104,110,133,136,143,149,157,160,"ATGAAGA","ATAA","ATGAGGT","CTGC",2.24195564315902,23,7,8,47,2.25592676159266,4.30057442899653,7.8368063130545,101,"ENSG00000079974.19"
"30118","ENSG00000203727.4_148446",148438,148446,9,"ENSG00000203727.4",1,8,"VVVVVVVMV",0,8,0.884057971014493,113,119,133,136,147,153,204,207,"ATACTGA","ATGT","ATAAGGA","CTGA",2.31017366346038,14,11,51,85,1.80094018743903,4.3005244859604,7.83675637001837,101,"ENSG00000079974.19"
"17349","ENSG00000153944.12_136491",136483,136491,9,"ENSG00000153944.12",0,NA,"VVVUVUVVV",2,7,0.802898550724638,110,116,133,136,144,150,175,178,"AGGAGGG","CTGA","GTGGGGA","CTGA",2.47285793644739,17,8,25,59,2.01465624499716,4.62509395532827,7.83668815822682,101,"ENSG00000079974.19"
"27831","ENSG00000187398.12_177532",177524,177532,9,"ENSG00000187398.12",1,8,"VVVVVVVMV",0,8,0.884057971014493,115,121,133,136,149,155,164,167,"AAGGTGA","CTAA","GTCATGG","ATGA",2.17446502102584,12,13,9,43,2.70531919494812,4.30043816711343,7.8366700511714,101,"ENSG00000079974.19"
"39952","ENSG00000254530.2_45431",45423,45431,9,"ENSG00000254530.2",1,8,"VVVVVUVMV",1,7,0.806211180124224,90,96,133,136,141,147,177,180,"ATGATTA","ATCA","GTGATGA","CTGA",2.60773081736786,37,5,30,81,1.06237380945675,4.61181148131063,7.83665620180752,101,"ENSG00000079974.19"
"602","ENSG00000021574.14_76377",76369,76377,9,"ENSG00000021574.14",1,6,"VVVVVMUVV",1,7,0.788819875776397,87,93,99,102,113,119,133,136,"CTGATGA","GTGA","ATGAGGA","CTGC",2.47474163750727,6,11,14,40,2.22701239275917,4.68132249403524,7.83660199714083,101,"ENSG00000079974.19"
"4439","ENSG00000100593.18_24099",24091,24099,9,"ENSG00000100593.18",1,8,"VVVVVVVMV",0,8,0.884057971014493,116,122,133,136,160,166,208,211,"GGGAGGG","CTGA","GTGGTGT","CTGA",2.409921632112,11,24,42,86,1.13524496355878,4.30034729440969,7.83657917846767,101,"ENSG00000079974.19"
"25109","ENSG00000179452.2_813",805,813,9,"ENSG00000179452.2",1,1,"MVVVVUVVV",1,7,0.82815734989648,86,92,104,107,113,119,133,136,"ATCATGG","CTGA","GTCATTT","ATGA",2.28244315271265,12,6,14,41,2.87948946421436,4.52394428724134,7.83657368682726,101,"ENSG00000079974.19"
"10655","ENSG00000132204.14_123827",123819,123827,9,"ENSG00000132204.14",1,8,"VVVVVVVMV",0,8,0.884057971014493,60,66,93,96,112,118,133,136,"ATGATGT","CAGA","GTGAATC","CTTA",2.36889670678341,27,16,15,67,1.40838671582323,4.30025785692815,7.83648974098612,101,"ENSG00000079974.19"
"13982","ENSG00000144218.21_357705",357697,357705,9,"ENSG00000144218.21",0,NA,"UVVVVVUVV",2,7,0.788819875776397,114,120,133,136,163,169,179,182,"ATTATGA","ATGG","GTGGTGT","CTGA",2.49619434597539,13,27,10,59,2.0831698788514,4.68111637967184,7.83639588277743,101,"ENSG00000079974.19"
"19271","ENSG00000162636.16_52857",52849,52857,9,"ENSG00000162636.16",1,2,"UMVVVVVVV",1,7,0.786749482401656,82,88,133,136,147,153,164,167,"ATGATGG","GTGT","GTGAAGC","CTGA",2.54044766842857,45,11,11,76,1.82110998792517,4.68935694436223,7.83635487396886,101,"ENSG00000079974.19"
"19384","ENSG00000162849.16_383586",383578,383586,9,"ENSG00000162849.16",1,8,"VVVVVVVMV",0,8,0.884057971014493,82,88,100,103,110,116,133,136,"GGGATGT","CTGG","GAGATAA","ATGA",2.17449331037148,12,7,17,45,2.70378843106325,4.30010262505161,7.83633450910958,101,"ENSG00000079974.19"
"6184","ENSG00000108510.10_47591",47583,47591,9,"ENSG00000108510.10",1,8,"VVVVVUVMV",1,7,0.806211180124224,89,95,107,110,115,121,133,136,"ATCATAA","CTGA","GTGGTGG","GTGA",2.32444402276684,12,5,12,38,2.94950207693477,4.61144889051176,7.83629361100866,101,"ENSG00000079974.19"
"30356","ENSG00000204740.11_351635",351627,351635,9,"ENSG00000204740.11",0,NA,"UVVVVVUVV",2,7,0.788819875776397,108,114,133,136,143,149,160,163,"ATGATGA","CTGT","GCGACAA","ATGA",2.4235509003774,19,7,11,46,2.56672208124723,4.68093202094081,7.8362115240464,101,"ENSG00000079974.19"
"26506","ENSG00000184305.16_967472",967464,967472,9,"ENSG00000184305.16",0,NA,"VVVUVVVVV",1,8,0.880745341614907,92,98,133,136,149,155,163,166,"ATGATAA","CTGT","ATGGTGT","CTTA",2.33548069046086,35,13,8,65,1.6829092901064,4.31319513996137,7.836176506421,101,"ENSG00000079974.19"
"10011","ENSG00000128805.15_55797",55789,55797,9,"ENSG00000128805.15",1,3,"VVMVVVVVV",0,8,0.882815734989648,111,117,133,136,143,149,163,166,"ATAATTT","CAAA","GTGTTCT","CTGA",2.17591973823423,16,7,14,46,2.71336174087338,4.30487333227539,7.83613627223398,101,"ENSG00000079974.19"
"34364","ENSG00000232855.7_172799",172791,172799,9,"ENSG00000232855.7",1,8,"UVVVVVVMV",1,7,0.786749482401656,101,107,133,136,147,153,162,165,"ATCATGA","CCGA","GGGACCA","CTGA",2.51835293640812,26,11,9,55,1.96734745438401,4.68909175760953,7.83608968721616,101,"ENSG00000079974.19"
"3637","ENSG00000087206.17_78971",78963,78971,9,"ENSG00000087206.17",1,6,"VVUVVMVVV",1,7,0.786335403726708,57,63,77,80,95,101,133,136,"ATGAGTA","CTGA","ATGTAGA","CTGA",2.57323117930916,14,15,32,70,1.60809965629163,4.69074354625484,7.83608516116167,101,"ENSG00000079974.19"
"47606","ENSG00000288714.1_514933",514925,514933,9,"ENSG00000288714.1",1,1,"MVVVVVUVV",1,7,0.792132505175983,112,118,133,136,140,146,155,158,"AGGAAGA","CCAA","TTGAAGA","CTGA",2.37673019725216,15,4,9,37,2.82471946495099,4.66739686165801,7.83592688236195,101,"ENSG00000079974.19"
"38554","ENSG00000250421.5_109953",109945,109953,9,"ENSG00000250421.5",1,8,"UVVVVVVMV",1,7,0.786749482401656,111,117,133,136,162,168,177,180,"ATGATGG","CAGT","ATGAACA","CTGA",2.52222757489949,16,26,9,60,1.94082420631238,4.68891867641058,7.83591660601721,101,"ENSG00000079974.19"
"17862","ENSG00000155621.15_29489",29481,29489,9,"ENSG00000155621.15",1,1,"MVVVVUVVV",1,7,0.82815734989648,65,71,83,86,115,121,133,136,"ATGCTGG","CTGT","GGGAGGT","CTGA",2.41105078968348,12,29,12,62,2.01946417328746,4.52328402612767,7.83591342571359,101,"ENSG00000079974.19"
"39001","ENSG00000251432.8_188602",188594,188602,9,"ENSG00000251432.8",1,3,"VVMVVVVVV",0,8,0.882815734989648,112,118,133,136,148,154,167,170,"ATGAAGA","TTGG","GAAATGA","CTGG",2.19343547315887,15,12,13,49,2.5956537505644,4.30463922623922,7.83590216619781,101,"ENSG00000079974.19"
"7829","ENSG00000115866.11_64955",64947,64955,9,"ENSG00000115866.11",1,8,"VVUVVVVMV",1,7,0.767701863354037,85,91,133,136,145,151,169,172,"AAGATGA","CTGA","AGGCTGG","CTGA",2.62094183324115,42,9,18,78,1.58734608386453,4.76507290970137,7.83588036311752,101,"ENSG00000079974.19"
"40808","ENSG00000257756.6_57801",57793,57801,9,"ENSG00000257756.6",0,NA,"UVVVVUVVV",2,7,0.824844720496894,85,91,133,136,145,151,160,163,"CTGCTGA","CTCA","TTATTGA","CTGA",2.42940744148335,42,9,9,69,1.94987238365264,4.53648049838541,7.83585938037299,101,"ENSG00000079974.19"
"10178","ENSG00000129675.16_86490",86482,86490,9,"ENSG00000129675.16",1,2,"UMVVVVVVV",1,7,0.786749482401656,64,70,106,109,115,121,133,136,"ATGAAGA","CTGG","GGGAGCA","CTGA",2.52111756310238,36,6,12,63,1.9479288894554,4.68884482753449,7.83584275714111,101,"ENSG00000079974.19"
"8433","ENSG00000118922.19_125073",125065,125073,9,"ENSG00000118922.19",1,6,"UVVVVMVVV",1,7,0.805383022774327,116,122,133,136,162,168,184,187,"ATAATGT","CTTA","TTTATGA","CTGA",2.49292486613579,11,26,16,62,1.83763731172445,4.6142841048241,7.8358161959214,101,"ENSG00000079974.19"
"18469","ENSG00000157445.15_552927",552919,552927,9,"ENSG00000157445.15",1,8,"UVVVVVVMV",1,7,0.786749482401656,77,83,101,104,111,117,133,136,"GTGTTGA","CTGA","CTGTTGA","GTGA",2.44940408780718,18,7,16,50,2.42563616254537,4.68874918698165,7.83574711658827,101,"ENSG00000079974.19"
"8225","ENSG00000117501.15_52930",52922,52930,9,"ENSG00000117501.15",1,8,"VVVUVVVMV",1,7,0.764803312629399,115,121,133,136,146,152,168,171,"GTGAAGT","CTCA","GAGATGA","CTGA",2.46696656906542,12,10,16,47,2.65966656413832,4.77652758947694,7.83574083999454,101,"ENSG00000079974.19"
"47244","ENSG00000287907.1_159157",159149,159157,9,"ENSG00000287907.1",1,5,"UVVVMVVVV",1,7,0.789233954451346,113,119,133,136,143,149,164,167,"AAGATGA","TTGA","GTGGAGA","TTGA",2.38921172206211,14,7,15,45,2.78701068822528,4.67877220882651,7.83570802663189,101,"ENSG00000079974.19"
"17478","ENSG00000154229.12_151818",151810,151818,9,"ENSG00000154229.12",1,2,"VMVVVUVVV",1,7,0.806211180124223,97,103,133,136,142,148,200,203,"ATGATAA","CAGA","GTGTTTA","CTGA",2.61217247700872,30,6,52,97,1.02895026330055,4.61085836083967,7.83570308133656,101,"ENSG00000079974.19"
"12349","ENSG00000137936.18_239074",239066,239074,9,"ENSG00000137936.18",1,1,"MVVVVUVVV",1,7,0.82815734989648,115,121,133,136,170,176,193,196,"ATAGTTA","CTGA","TTGAGGA","CTGA",2.45555805231837,12,34,17,72,1.72187857532573,4.52306639769539,7.83569579728131,101,"ENSG00000079974.19"
"37458","ENSG00000248238.2_169488",169480,169488,9,"ENSG00000248238.2",1,2,"VMVVVUVVV",1,7,0.806211180124223,116,122,133,136,143,149,158,161,"CTAATGA","GAGA","ATTCTGC","CTGA",2.30510170426321,11,7,9,36,3.07598718949591,4.610832971146,7.83567769164289,101,"ENSG00000079974.19"
"26552","ENSG00000184408.10_158011",158003,158011,9,"ENSG00000184408.10",1,1,"MVVUVVVVV",1,7,0.786749482401656,74,80,92,95,104,110,133,136,"AAGATGA","CAAA","AAGAAGA","CTGA",2.46672879667517,12,9,23,53,2.30958973611223,4.68861209515334,7.83561002475996,101,"ENSG00000079974.19"
"34415","ENSG00000233005.2_40711",40703,40711,9,"ENSG00000233005.2",0,NA,"VVVUVVVVV",1,8,0.880745341614907,114,120,133,136,140,146,170,173,"AGGAGGC","CCGG","CTGAAGA","CTGA",2.26537153948838,13,4,24,50,2.14796655418926,4.31261087102794,7.83559223748757,101,"ENSG00000079974.19"
"35733","ENSG00000236922.10_133213",133205,133213,9,"ENSG00000236922.10",1,1,"MVVVVVUVV",1,7,0.792132505175983,73,79,90,93,101,107,133,136,"ATAATTA","CTGT","TTGCTGA","CTGA",2.47052675956656,11,8,26,54,2.19786579711406,4.66701104855612,7.83554106926006,101,"ENSG00000079974.19"
"2646","ENSG00000077092.20_652232",652224,652232,9,"ENSG00000077092.20",1,3,"VVMVVVVVV",0,8,0.882815734989648,104,110,133,136,180,186,204,207,"GGGATGA","GAGA","GTGCTCA","CTGA",2.44569541194408,23,44,18,94,0.912365324569861,4.30425035104926,7.83551329100785,101,"ENSG00000079974.19"
"41228","ENSG00000258710.8_12208",12200,12208,9,"ENSG00000258710.8",0,NA,"UVVVUVVVV",2,7,0.792546583850932,116,122,133,136,142,148,184,187,"ATGATTT","ATGA","ATGGGGA","CTGA",2.4987290077867,11,6,36,62,2.00268759171064,4.66522024423883,7.83540657964256,101,"ENSG00000079974.19"
"46897","ENSG00000287345.1_12195",12187,12195,9,"ENSG00000287345.1",0,NA,"UVVVUVVVV",2,7,0.792546583850932,116,122,133,136,142,148,184,187,"ATGATTT","ATGA","ATGGGGA","CTGA",2.4987290077867,11,6,36,62,2.00268759171064,4.66522024423883,7.83540657964256,101,"ENSG00000079974.19"
"32909","ENSG00000228262.11_276849",276841,276849,9,"ENSG00000228262.11",0,NA,"VVVVUUVVV",2,7,0.812008281573499,109,115,133,136,146,152,164,167,"GTGATGG","CTGT","ATGATTA","TTGA",2.37382295622572,18,10,12,49,2.5238215176267,4.58732697311621,7.8353600994102,101,"ENSG00000079974.19"
"13813","ENSG00000143603.19_106693",106685,106693,9,"ENSG00000143603.19",1,2,"UMVVVVVVV",1,7,0.786749482401656,108,114,133,136,138,144,200,203,"ATGATGA","AGGA","GTGACCA","CTGA",2.64762223894733,19,2,56,86,1.10260607116918,4.68835524937118,7.83535317897781,101,"ENSG00000079974.19"
"29569","ENSG00000198277.6_4879",4871,4879,9,"ENSG00000198277.6",1,1,"MVVVVUVVV",1,7,0.82815734989648,109,115,133,136,152,158,209,212,"ATGATCA","AGGA","ATGATAA","CTGA",2.54008424709168,18,16,51,94,1.1569766799757,4.52271791514673,7.83534731473265,101,"ENSG00000079974.19"
"44280","ENSG00000280560.3_277352",277344,277352,9,"ENSG00000280560.3",1,1,"MVVVUVVVV",1,7,0.795859213250517,110,116,133,136,141,147,156,159,"ACAATGA","CACA","ATGGTGA","CTGA",2.38337966195466,17,5,9,40,2.7181999961723,4.65184943563417,7.83528628863624,101,"ENSG00000079974.19"
"13790","ENSG00000143473.14_80993",80985,80993,9,"ENSG00000143473.14",0,NA,"UVVVVUVVV",2,7,0.824844720496894,58,64,84,87,105,111,133,136,"CTTATGA","GTGA","GTGAACA","CTGA",2.53090922162784,20,18,22,69,1.27073015316568,4.53586457433782,7.8352434563254,101,"ENSG00000079974.19"
"14490","ENSG00000145147.20_128831",128823,128831,9,"ENSG00000145147.20",1,8,"UVVVVVVMV",1,7,0.786749482401656,86,92,107,110,115,121,133,136,"TTGAAGA","ATAA","ATGAAGC","CTGA",2.38946967914782,15,5,12,41,2.82316980467952,4.68824191641625,7.83523984602288,101,"ENSG00000079974.19"
"33299","ENSG00000229267.3_53927",53919,53927,9,"ENSG00000229267.3",0,NA,"UVVUVVVVV",2,7,0.78343685300207,115,121,133,136,145,151,164,167,"ATCAAGA","CAGA","GAGGGGA","CTGA",2.38852537807492,12,9,13,43,2.88224643401867,4.70143723862954,7.83518465063782,101,"ENSG00000079974.19"
"40715","ENSG00000257454.1_22715",22707,22715,9,"ENSG00000257454.1",1,8,"VVVVVVUMV",1,7,0.770186335403727,114,120,133,136,140,146,159,162,"AGGATCA","TTGA","CTAAAGA","CTGA",2.43306041420496,13,4,13,39,2.79731102162552,4.75442844574797,7.83517378736288,101,"ENSG00000079974.19"
"40893","ENSG00000258053.1_36436",36428,36436,9,"ENSG00000258053.1",1,8,"VVVVVVUMV",1,7,0.770186335403727,114,120,133,136,140,146,159,162,"AGGATCA","TTGA","CTAAAGA","CTGA",2.43306041420496,13,4,13,39,2.79731102162552,4.75442844574797,7.83517378736288,101,"ENSG00000079974.19"
"34031","ENSG00000231772.5_192657",192649,192657,9,"ENSG00000231772.5",1,7,"VVUVVVMVV",1,7,0.768944099378882,113,119,133,136,143,149,163,166,"ATGATGA","CTAA","GAGTAGA","CAGA",2.42899625527324,14,7,14,44,2.84394342984433,4.75931294958315,7.83508934709868,101,"ENSG00000079974.19"
"26243","ENSG00000183715.14_743558",743550,743558,9,"ENSG00000183715.14",1,6,"UVVVVMVVV",1,7,0.805383022774327,40,46,91,94,100,106,133,136,"ATGAAGC","CTGA","GAGAGGA","CTGA",2.58991892607145,45,6,27,87,1.1876608305403,4.61344675108749,7.8349788421848,101,"ENSG00000079974.19"
"493","ENSG00000013523.11_9574",9566,9574,9,"ENSG00000013523.11",1,8,"VVVVVUVMV",1,7,0.806211180124224,32,38,82,85,100,106,133,136,"ATGATGA","CTGA","AAGATGA","ATGA",2.652388996139,44,15,27,95,0.757813462599905,4.6101016925483,7.8349464130452,101,"ENSG00000079974.19"
"16926","ENSG00000152767.17_42686",42678,42686,9,"ENSG00000152767.17",1,2,"UMVVVVVVV",1,7,0.786749482401656,25,31,66,69,77,83,133,136,"GTGATGA","CTTA","TTGATAT","CTGA",2.66307044396485,35,8,50,102,0.997779915846871,4.68789571890314,7.83489364850976,101,"ENSG00000079974.19"
"10402","ENSG00000130856.18_63638",63630,63638,9,"ENSG00000130856.18",1,8,"VVVVVUVMV",1,7,0.806211180124224,81,87,105,108,114,120,133,136,"TTGATTA","CTGC","ATTCTCA","CTGA",2.38001161960889,18,6,13,46,2.57340124586314,4.61003634414727,7.83488106464416,101,"ENSG00000079974.19"
"29388","ENSG00000197912.16_49581",49573,49581,9,"ENSG00000197912.16",0,NA,"VVVUVVVVV",1,8,0.880745341614907,86,92,133,136,161,167,183,186,"ATTTTGA","GTGA","GTGATCC","CTGA",2.45459261965183,41,25,16,91,0.883492402016976,4.31186079992396,7.83484216638359,101,"ENSG00000079974.19"
"2946","ENSG00000079691.19_144083",144075,144083,9,"ENSG00000079691.19",1,6,"VVVVVMUVV",1,7,0.788819875776397,111,117,133,136,145,151,166,169,"TTTATAA","CTGA","TAGATGT","CTGA",2.4167093831658,16,9,15,49,2.60676869659968,4.67954114609293,7.83482064919852,101,"ENSG00000079974.19"
"34961","ENSG00000234464.2_84137",84129,84137,9,"ENSG00000234464.2",1,1,"MVVVVUVVV",1,7,0.82815734989648,80,86,96,99,114,120,133,136,"ATGATGC","CTGT","CTGGGGA","CTGC",2.35404427338798,10,15,13,47,2.39503172571225,4.52216505374136,7.83479445332728,101,"ENSG00000079974.19"
"35337","ENSG00000235749.3_57002",56994,57002,9,"ENSG00000235749.3",1,5,"UVVVMVVVV",1,7,0.789233954451346,85,91,133,136,147,153,161,164,"TTGATGA","CTAA","AAGGTTA","CTGA",2.53431072562498,42,11,8,70,1.81591667644501,4.67783037848622,7.83476619629161,101,"ENSG00000079974.19"
"3966","ENSG00000091436.17_147750",147742,147750,9,"ENSG00000091436.17",0,NA,"UVVVVUVVV",2,7,0.824844720496894,88,94,133,136,168,174,191,194,"ATGCTGT","CTGG","GTGATGA","CTGA",2.61090565747763,39,32,17,97,0.735006892158774,4.53526115216908,7.83464003415666,101,"ENSG00000079974.19"
"33657","ENSG00000230600.1_130",122,130,9,"ENSG00000230600.1",1,8,"VVVVVUVMV",1,7,0.806211180124224,112,118,132,135,166,172,183,186,"AGCATGT","CTGA","GAGAAGA","CTGA",2.46697408638349,14,31,11,65,1.99211097515687,4.60965122109503,7.83449594159193,101,"ENSG00000079974.19"
"17226","ENSG00000153707.19_1839322",1839314,1839322,9,"ENSG00000153707.19",0,NA,"VVVUVVVVV",1,8,0.880745341614907,97,103,133,136,147,153,161,164,"ATTATGA","TGGA","ATGATGG","ATGA",2.30808910100219,30,11,8,58,1.85878536250918,4.31151150896428,7.8344928754239,101,"ENSG00000079974.19"
"27948","ENSG00000187715.13_10527",10519,10527,9,"ENSG00000187715.13",1,7,"VVVVUVMVV",1,7,0.775155279503105,112,118,133,136,145,151,161,164,"ATAATGA","TTGC","TAAATGA","CTGA",2.40945952928391,15,9,10,43,2.87242091295343,4.7338711103782,7.83449222839063,101,"ENSG00000079974.19"
"20570","ENSG00000165091.18_250075",250067,250075,9,"ENSG00000165091.18",1,2,"VMVVVVUVV",1,7,0.770186335403727,114,120,133,136,141,147,199,202,"ATGCTGA","CAGT","GTGAGGA","CTGA",2.56294394847137,13,5,52,79,1.92858912092354,4.75372052768317,7.83446586929808,101,"ENSG00000079974.19"
"47785","ENSG00000289320.1_21205",21197,21205,9,"ENSG00000289320.1",1,3,"VVMVVVVVV",0,8,0.882815734989648,90,96,133,136,174,180,190,193,"AAGAGGA","CTAA","TTGAAAA","CTGA",2.42961556645735,37,38,10,94,1.01535702163146,4.30319853283678,7.83446147279537,101,"ENSG00000079974.19"
"12166","ENSG00000137502.10_8386",8378,8386,9,"ENSG00000137502.10",1,2,"VMVVVUVVV",1,7,0.806211180124223,107,113,133,136,176,182,192,195,"TTGATGT","CTGG","GTGTTTA","CTGA",2.54109606974947,20,40,10,79,1.49774043476135,4.60959522493945,7.83443994543635,101,"ENSG00000079974.19"
"45355","ENSG00000285473.1_38558",38550,38558,9,"ENSG00000285473.1",1,3,"VVMVVVUVV",1,7,0.768944099378882,51,57,77,80,88,94,133,136,"ATGATGC","TTGA","GTCATGT","CTGA",2.62989863827942,20,8,39,76,1.5019244106691,4.75864549979964,7.83442189731517,101,"ENSG00000079974.19"
"5024","ENSG00000102763.18_327343",327335,327343,9,"ENSG00000102763.18",1,2,"VMVVVUVVV",1,7,0.806211180124223,113,119,133,136,146,152,173,176,"ATGTTCG","CTGA","GTCATTA","CTGA",2.41734715043201,14,10,21,54,2.32249507455705,4.60953568602595,7.83438040652284,101,"ENSG00000079974.19"
"22354","ENSG00000170390.16_107693",107685,107693,9,"ENSG00000170390.16",1,1,"MVVVVUVVV",1,7,0.82815734989648,85,91,133,136,149,155,164,167,"CTGATGA","TTTA","AAGAGGC","CTGA",2.45901953857569,42,13,9,73,1.69346142447516,4.52173125374494,7.83436065333086,101,"ENSG00000079974.19"
"44692","ENSG00000283380.1_534507",534499,534507,9,"ENSG00000283380.1",1,8,"VVVVVUVMV",1,7,0.806211180124224,115,121,133,136,149,155,166,169,"TTGAAGA","GGGA","GTCATCA","CTGA",2.36278831223648,12,13,11,45,2.68610849742335,4.60950764474998,7.83435236524687,101,"ENSG00000079974.19"
"18403","ENSG00000157212.19_24928",24920,24928,9,"ENSG00000157212.19",1,2,"VMUVVVVVV",1,7,0.767701863354037,112,118,133,136,142,148,163,166,"AAGAGGA","TTGA","CTGGGGA","CTGA",2.4506580223989,15,6,15,45,2.71640590674244,4.7635315140171,7.83433896743325,101,"ENSG00000079974.19"
"3532","ENSG00000085433.17_5183",5175,5183,9,"ENSG00000085433.17",0,NA,"VVVUVVVVV",1,8,0.880745341614907,89,95,133,136,171,177,186,189,"ATGATGA","TAGA","TTGATCA","CTGG",2.43355239234854,38,35,9,91,1.02155407068415,4.31130917158528,7.8342905380449,101,"ENSG00000079974.19"
"35825","ENSG00000237312.2_20927",20919,20927,9,"ENSG00000237312.2",1,1,"MVVVVUVVV",1,7,0.82815734989648,87,93,133,136,147,153,173,176,"ATGATGG","CAGC","CTGAGAA","CTGA",2.50999628071419,40,11,20,80,1.35296506338187,4.52156840036912,7.83419779995504,101,"ENSG00000079974.19"
"43760","ENSG00000273507.7_43069",43061,43069,9,"ENSG00000273507.7",1,2,"VMVVVUVVV",1,7,0.806211180124223,110,116,133,136,138,144,153,156,"ATGAGGA","GGGA","AGGAAGG","CTGA",2.41190771657378,17,2,9,37,2.35770501516269,4.6092724480803,7.8341171685772,101,"ENSG00000079974.19"
"6394","ENSG00000109684.16_108589",108581,108589,9,"ENSG00000109684.16",1,6,"VVVVVMUVV",1,7,0.788819875776397,113,119,133,136,144,150,182,185,"ATGAGGG","CTGT","GTGAGGG","CTGA",2.50116164197897,14,8,32,63,2.04088035654689,4.67882282576834,7.83410232887393,101,"ENSG00000079974.19"
"9214","ENSG00000123119.12_22525",22517,22525,9,"ENSG00000123119.12",1,3,"VVMVVVVVV",0,8,0.882815734989648,92,98,133,136,156,162,178,181,"ATTATGT","ATTA","ATGATCA","CTGA",2.42491599984517,35,20,16,80,1.04520786990139,4.30282863388396,7.83409157384255,101,"ENSG00000079974.19"
"44355","ENSG00000281131.1_68245",68237,68245,9,"ENSG00000281131.1",1,6,"UVVVVMVVV",1,7,0.805383022774327,105,111,133,136,160,166,181,184,"ATGAGGC","CTGA","GGGATCA","CTGA",2.57232698029716,22,24,15,70,1.30082000256089,4.61241663446883,7.83394872556614,101,"ENSG00000079974.19"
"29442","ENSG00000197992.7_304",296,304,9,"ENSG00000197992.7",1,2,"VMVVUVVVV",1,7,0.773913043478261,99,105,133,136,168,174,188,191,"CTGATGA","CTGG","ATGCTGA","CTGA",2.69525127249985,28,32,14,83,0.984612767614288,4.73823864607,7.83389081998304,101,"ENSG00000079974.19"
"35908","ENSG00000237461.3_50575",50567,50575,9,"ENSG00000237461.3",1,2,"UMVVVVVVV",1,7,0.786749482401656,65,71,105,108,115,121,133,136,"ATGATGA","ATGA","ATGAATA","CTAA",2.51658885412992,34,7,12,62,1.97014863169334,4.68685191480654,7.83384984441316,101,"ENSG00000079974.19"
"40155","ENSG00000255145.3_137259",137251,137259,9,"ENSG00000255145.3",1,2,"UMVVVVVVV",1,7,0.786749482401656,65,71,105,108,115,121,133,136,"ATGATGA","ATGA","ATGAATA","CTAA",2.51658885412992,34,7,12,62,1.97014863169334,4.68685191480654,7.83384984441316,101,"ENSG00000079974.19"
"32484","ENSG00000227088.2_246755",246747,246755,9,"ENSG00000227088.2",1,1,"MVVVVUVVV",1,7,0.82815734989648,116,122,133,136,147,153,161,164,"CTGATGA","ATAA","TTGAAGT","TTGA",2.28749982552946,11,11,8,39,2.83485122318002,4.52121251501077,7.8338419145967,101,"ENSG00000079974.19"
"9011","ENSG00000122121.12_21941",21933,21941,9,"ENSG00000122121.12",1,6,"VVVVVMUVV",1,7,0.788819875776397,87,93,101,104,115,121,133,136,"ATTATGG","CTTA","GTGTCAA","CTGA",2.42348959414891,8,11,12,40,2.5573981424906,4.67849885920417,7.83377836230976,101,"ENSG00000079974.19"
"26126","ENSG00000183454.18_349370",349362,349370,9,"ENSG00000183454.18",1,2,"VMVVVVUVV",1,7,0.770186335403727,60,66,103,106,115,121,133,136,"CTGATGG","CTGA","GTTGTTA","CTGA",2.5648841766961,37,9,12,67,1.91289884955375,4.75303167354861,7.83377701516351,101,"ENSG00000079974.19"
"43780","ENSG00000273540.5_557371",557363,557371,9,"ENSG00000273540.5",0,NA,"VVUVUVVVV",2,7,0.773498964803312,99,105,133,136,146,152,208,211,"GTGATGT","ATGA","CTGATGA","CTGA",2.69732466810828,28,10,56,103,0.976794569195591,4.7397397558127,7.83373561502595,101,"ENSG00000079974.19"
"32418","ENSG00000226983.3_170351",170343,170351,9,"ENSG00000226983.3",1,1,"MVVVVVUVV",1,7,0.792132505175983,112,118,133,136,150,156,173,176,"AAGATGA","GTGT","CTGCTGT","CTGA",2.464632637625,15,14,17,55,2.22992779161346,4.6652030106117,7.83373303131564,101,"ENSG00000079974.19"
"17375","ENSG00000153993.14_52268",52260,52268,9,"ENSG00000153993.14",1,1,"MVVUVVVVV",1,7,0.786749482401656,115,121,133,136,172,178,189,192,"ATGATAC","TTGA","GTGAAGC","CTGA",2.51166433569879,12,36,11,68,2.00228216761606,4.68667776806866,7.83367569767528,101,"ENSG00000079974.19"
"13452","ENSG00000141447.19_63561",63553,63561,9,"ENSG00000141447.19",1,1,"MVVVVUVVV",1,7,0.82815734989648,61,67,83,86,93,99,133,136,"ATAATGA","CTGA","GTGGATA","CTCA",2.42738451303532,16,7,34,66,1.90143907334485,4.52100062339507,7.83363002298099,101,"ENSG00000079974.19"
"34216","ENSG00000232160.7_47619",47611,47619,9,"ENSG00000232160.7",0,NA,"VVVVVUUVV",2,7,0.808281573498965,51,57,86,89,94,100,133,136,"ATGATAC","CTGA","GTGATAC","CTGA",2.60032615537203,29,5,33,76,1.06599950035797,4.60037680070954,7.8335030947054,101,"ENSG00000079974.19"
"15207","ENSG00000147316.15_38775",38767,38775,9,"ENSG00000147316.15",1,8,"VVVVUUVMV",2,6,0.696066252587992,103,109,133,136,141,147,159,162,"ATGATGA","TTGA","ATGAAAG","CTGA",2.71328074789433,24,5,12,50,2.10829792229732,5.04920906039821,7.83347407075017,101,"ENSG00000079974.19"
"9034","ENSG00000122406.14_4255",4247,4255,9,"ENSG00000122406.14",0,NA,"VVVVVUUVV",2,7,0.808281573498965,109,115,133,136,166,172,216,219,"GTGATGA","TTGA","TGGATGC","CTGA",2.65118903815354,18,30,44,101,0.726584873424162,4.6002946152786,7.83342090927446,101,"ENSG00000079974.19"
"31246","ENSG00000220744.1_402",394,402,9,"ENSG00000220744.1",0,NA,"VVVVVUUVV",2,7,0.808281573498965,109,115,133,136,166,172,216,219,"GTGATGA","TTGA","TGGATGC","CTGA",2.65118903815354,18,30,44,101,0.726584873424162,4.6002946152786,7.83342090927446,101,"ENSG00000079974.19"
"39325","ENSG00000253474.2_116726",116718,116726,9,"ENSG00000253474.2",1,6,"UVVVVMVVV",1,7,0.805383022774327,103,109,133,136,182,188,196,199,"AGGATGA","TTGA","TTGGTGG","CTGA",2.58705110876331,24,46,8,87,1.20029642070717,4.61182595311565,7.83335804421296,101,"ENSG00000079974.19"
"22477","ENSG00000170624.14_373768",373760,373768,9,"ENSG00000170624.14",1,3,"VVMVVVVVV",0,8,0.882815734989648,95,101,133,136,146,152,201,204,"GTGATGA","GTAA","AACATCA","CTGA",2.4425403472223,32,10,49,100,0.924748845076867,4.30208778997306,7.83335072993165,101,"ENSG00000079974.19"
"27211","ENSG00000185737.13_869764",869756,869764,9,"ENSG00000185737.13",1,6,"VVUVVMVVV",1,7,0.786335403726708,77,83,99,102,107,113,133,136,"ATTATTA","CTGT","TTGATTA","CTGA",2.46981538084486,16,5,20,50,2.28652454082128,4.68799010328009,7.83333171818693,101,"ENSG00000079974.19"
"34218","ENSG00000232164.1_6142",6134,6142,9,"ENSG00000232164.1",1,8,"VVVVVUVMV",1,7,0.806211180124224,115,121,133,136,143,149,157,160,"AAGAAGA","CTCT","TTGAAGC","CTGA",2.30264071843533,12,7,8,36,3.08286607336289,4.60845104906628,7.83329576956317,101,"ENSG00000079974.19"
"32995","ENSG00000228436.4_8418",8410,8418,9,"ENSG00000228436.4",1,8,"VVVVUVVMV",1,7,0.773913043478261,45,51,65,68,114,120,133,136,"GTGATGG","GTGA","GTAATTA","CTGA",2.55981229769261,14,46,13,82,1.88513389314551,4.73763730277406,7.83328947668711,101,"ENSG00000079974.19"
"5492","ENSG00000105220.17_31688",31680,31688,9,"ENSG00000105220.17",1,6,"VVVVUMVVV",1,7,0.792546583850932,99,105,133,136,175,181,199,202,"CTGAGGA","CTGA","ATGAGGA","CTGA",2.68937694310401,28,39,18,94,0.723156505636425,4.66308403158245,7.83327036698618,101,"ENSG00000079974.19"
"34864","ENSG00000234323.10_255367",255359,255367,9,"ENSG00000234323.10",0,NA,"VVVUVVVVV",1,8,0.880745341614907,99,105,111,114,116,122,133,136,"GTTATGA","ATGA","ATTATAG","CTAA",2.20944609916607,6,2,11,28,2.5112723306893,4.3102282479491,7.83320961440873,101,"ENSG00000079974.19"
"23358","ENSG00000172765.19_166686",166678,166686,9,"ENSG00000172765.19",1,1,"MVVVVUVVV",1,7,0.82815734989648,115,121,133,136,153,159,168,171,"ATGGTTT","CAGA","ATGTGGA","CTGA",2.347812282746,12,17,9,47,2.4296781435354,4.52044000712719,7.83306940671311,101,"ENSG00000079974.19"
"12696","ENSG00000138785.16_150868",150860,150868,9,"ENSG00000138785.16",1,7,"VVUVVVMVV",1,7,0.768944099378882,115,121,133,136,143,149,168,171,"ATAATGA","ATTA","CTGTTGG","CTGA",2.46757905368942,12,7,19,47,2.57820166525888,4.75718217246374,7.83295856997927,101,"ENSG00000079974.19"
"35545","ENSG00000236283.5_198619",198611,198619,9,"ENSG00000236283.5",1,3,"VVMVVUVVV",1,7,0.804968944099379,89,95,110,113,116,122,133,136,"CTGATGA","CTGT","TTGTTGG","CTGT",2.36932058754617,15,3,11,38,2.65595836413498,4.61285723694403,7.83273301334155,101,"ENSG00000079974.19"
"30554","ENSG00000205683.12_88110",88102,88110,9,"ENSG00000205683.12",1,8,"VVVVUVVMV",1,7,0.773913043478261,80,86,102,105,112,118,133,136,"AGGAGGC","CTGA","CTGAGAA","CTGA",2.44356355738236,16,7,15,47,2.65775615213065,4.73704496700327,7.83269714091631,101,"ENSG00000079974.19"
"9580","ENSG00000125675.20_155601",155593,155601,9,"ENSG00000125675.20",0,NA,"UVVVUVVVV",2,7,0.792546583850932,84,90,100,103,113,119,133,136,"AGTATGA","CTTA","ATGAACG","CTGA",2.39231052340562,10,10,14,43,2.70126016826745,4.6624992477429,7.83268558314662,101,"ENSG00000079974.19"
"41052","ENSG00000258484.4_4228",4220,4228,9,"ENSG00000258484.4",1,6,"VVVVVMUVV",1,7,0.788819875776397,109,115,133,136,174,180,195,198,"CTGATGG","CTGC","ATGATAA","CTGA",2.58226073269516,18,38,15,80,1.49450996986339,4.67739538029111,7.8326748833967,101,"ENSG00000079974.19"
"3585","ENSG00000086200.17_206850",206842,206850,9,"ENSG00000086200.17",1,2,"VMVVVVUVV",1,7,0.770186335403727,112,118,133,136,142,148,158,161,"ATGCTTA","TTGA","ATAATCA","CTGA",2.41219499382692,15,6,10,40,2.92638147598147,4.7519203587069,7.83266570032181,101,"ENSG00000079974.19"
"27573","ENSG00000186501.15_6266",6258,6266,9,"ENSG00000186501.15",0,NA,"VVVVUUVVV",2,7,0.812008281573499,111,117,133,136,141,147,166,169,"ATTATAA","ATTA","GTGTTGA","CTGA",2.39888675076546,16,5,19,49,2.34583313453169,4.58460286824202,7.83263599453602,101,"ENSG00000079974.19"
"31051","ENSG00000215386.15_450295",450287,450295,9,"ENSG00000215386.15",1,8,"UVVVVVVMV",1,7,0.786749482401656,72,78,95,98,109,115,133,136,"ATGATTA","CTGA","GTGCTGG","ATGA",2.47742797742798,17,11,18,55,2.22618480870365,4.68559283122254,7.83259076082917,101,"ENSG00000079974.19"
"33016","ENSG00000228536.3_27053",27045,27053,9,"ENSG00000228536.3",0,NA,"UVVVVVUVV",2,7,0.788819875776397,111,117,133,136,138,144,159,162,"ATGTTGA","ATGT","GTTAAGA","CTGA",2.4766717489665,16,2,15,42,2.19763696984283,4.6771954907382,7.83247499384379,101,"ENSG00000079974.19"
"15597","ENSG00000148848.15_372646",372638,372646,9,"ENSG00000148848.15",1,3,"VVMVVVVVV",0,8,0.882815734989648,115,121,133,136,177,183,201,204,"CAGATAA","ATGA","TTGACAA","CTGA",2.33436505844569,12,41,18,80,1.64225960346108,4.30117333160809,7.83243627156668,101,"ENSG00000079974.19"
"45228","ENSG00000285219.4_806293",806285,806293,9,"ENSG00000285219.4",1,8,"VVVVUVVMV",1,7,0.773913043478261,111,117,133,136,144,150,160,163,"ATGATTC","CTGT","GTGTTCT","CTGA",2.4165349921287,16,8,10,43,2.8368911233464,4.73678110105109,7.83243327496414,101,"ENSG00000079974.19"
"19128","ENSG00000161850.3_1925",1917,1925,9,"ENSG00000161850.3",1,1,"MVVVVVUVV",1,7,0.792132505175983,106,112,133,136,144,150,161,164,"AGGATGC","CTTA","TTGATCC","CTGA",2.4408037833381,21,8,11,49,2.38341259339507,4.66385945391227,7.8323894746162,101,"ENSG00000079974.19"
"11618","ENSG00000135540.12_18703",18695,18703,9,"ENSG00000135540.12",1,1,"MVUVVVVVV",1,7,0.789648033126294,78,84,100,103,112,118,133,136,"ATGCTGA","CCCA","ATGCAGT","CTGA",2.41322766460302,16,9,15,49,2.60676869659968,4.67373828182162,7.8323304143268,101,"ENSG00000079974.19"
"32380","ENSG00000226887.8_22487",22479,22487,9,"ENSG00000226887.8",1,8,"VVVVUUVMV",2,6,0.696066252587992,114,120,133,136,143,149,160,163,"ATTATGA","CTGG","GAGATAA","CTGA",2.57658304976053,13,7,11,40,3.01450882069823,5.04793228810877,7.83219729846074,101,"ENSG00000079974.19"
"26638","ENSG00000184672.12_519574",519566,519574,9,"ENSG00000184672.12",1,3,"VVMVVVVVV",0,8,0.882815734989648,105,111,133,136,151,157,165,168,"ATATTGG","CTCA","GTCATGC","CTGA",2.29987601565032,22,15,8,54,1.87108652783633,4.30089832470962,7.83216126466821,101,"ENSG00000079974.19"
"42953","ENSG00000267413.1_51325",51317,51325,9,"ENSG00000267413.1",1,2,"UMVVVVVVV",1,7,0.786749482401656,115,121,133,136,146,152,166,169,"AGGAAGA","TTTA","ATGATAA","CTGA",2.3947203792364,12,10,14,45,2.77574796086026,4.68513762227572,7.83213555188235,101,"ENSG00000079974.19"
"5972","ENSG00000107518.18_567333",567325,567333,9,"ENSG00000107518.18",1,8,"VVVVVUVMV",1,7,0.806211180124224,110,116,133,136,149,155,200,203,"ATGATAA","TAGA","GAGATGA","CTGA",2.54589241409223,17,13,45,84,1.4565278959516,4.60728599747496,7.83213071797185,101,"ENSG00000079974.19"
"26160","ENSG00000183579.16_96204",96196,96204,9,"ENSG00000183579.16",1,6,"VVVVVMUVV",1,7,0.788819875776397,116,122,133,136,142,148,156,159,"CTGTTGG","CTGT","GTGAAAG","CTGA",2.34027233215044,11,6,8,34,3.10547079730643,4.67682158624401,7.8321010893496,101,"ENSG00000079974.19"
"32117","ENSG00000226022.1_47525",47517,47525,9,"ENSG00000226022.1",1,1,"MVVVVUVVV",1,7,0.82815734989648,65,71,85,88,114,120,133,136,"ATTATGA","CTGA","ATGGAGG","CTCA",2.4135819180974,14,26,13,62,1.98733104285708,4.5194692908766,7.83209869046252,101,"ENSG00000079974.19"
"40377","ENSG00000255850.2_15081",15073,15081,9,"ENSG00000255850.2",1,1,"MVVVVUVVV",1,7,0.82815734989648,111,117,133,136,151,157,213,216,"ATGATGG","ATGC","ATGTTCA","CTGA",2.50283255409646,16,15,56,96,1.39229968034624,4.51946251024733,7.83209190983325,101,"ENSG00000079974.19"
"7313","ENSG00000113494.17_42261",42253,42261,9,"ENSG00000113494.17",1,1,"MVVUVVVVV",1,7,0.786749482401656,82,88,133,136,153,159,172,175,"GTGATGA","ATAA","CTGCTGA","CTGA",2.60887950004847,45,17,13,84,1.3475220530403,4.68501301334086,7.83201094294749,101,"ENSG00000079974.19"
"8700","ENSG00000120279.7_284",276,284,9,"ENSG00000120279.7",1,2,"VMVVVVUVV",1,7,0.770186335403727,87,93,104,107,114,120,133,136,"AGGATGT","CTGC","ATTAAAA","CTGA",2.41169524174549,11,7,13,40,2.92704015889572,4.75125210929975,7.83199745091465,101,"ENSG00000079974.19"
"40227","ENSG00000255282.6_39194",39186,39194,9,"ENSG00000255282.6",1,8,"VVVVUVVMV",1,7,0.773913043478261,68,74,97,100,115,121,133,136,"CTGTTGA","CTGG","GTGAGGA","CTGA",2.57405522641849,23,15,12,59,1.78487174518495,4.73630998032705,7.83196215424009,101,"ENSG00000079974.19"
"22289","ENSG00000170209.5_4348",4340,4348,9,"ENSG00000170209.5",0,NA,"VVVVUUVVV",2,7,0.812008281573499,78,84,98,101,109,115,133,136,"ATGATGA","CAGT","CTCAAGA","ATGA",2.36215024753432,14,8,18,49,2.58779318571819,4.58386537565342,7.83189850194741,101,"ENSG00000079974.19"
"12028","ENSG00000136895.19_67861",67853,67861,9,"ENSG00000136895.19",0,NA,"VVVUVVVVV",1,8,0.880745341614907,49,55,96,99,107,113,133,136,"TTGATGG","CTGA","CTAATGC","ATGA",2.35971491547753,41,8,20,78,1.50405247001503,4.30887130996631,7.83185267642594,101,"ENSG00000079974.19"
"15034","ENSG00000146776.15_27698",27690,27698,9,"ENSG00000146776.15",1,8,"VVVVVUVMV",1,7,0.806211180124224,116,122,133,136,144,150,170,173,"GAGAGGA","GTGA","CTGAGAA","CTGA",2.3922401405849,11,8,20,48,2.47968242405704,4.6069875069891,7.83183222748599,101,"ENSG00000079974.19"
"15721","ENSG00000149256.16_752113",752105,752113,9,"ENSG00000149256.16",1,1,"MVVUVVVVV",1,7,0.786749482401656,84,90,133,136,146,152,169,172,"ATGATGG","TTAA","ATGATGC","CTGA",2.57144820118911,43,10,17,79,1.59632327379962,4.68482782043176,7.83182575003838,101,"ENSG00000079974.19"
"17881","ENSG00000155657.29_255258",255250,255258,9,"ENSG00000155657.29",1,2,"VMUVVVVVV",1,7,0.767701863354037,69,75,82,85,94,100,133,136,"GTGATGG","ATGA","TTGGTGA","CTGA",2.61086428835662,7,9,33,58,1.63822691875262,4.76099721028252,7.83180466369866,101,"ENSG00000079974.19"
"2583","ENSG00000075914.13_9379",9371,9379,9,"ENSG00000075914.13",1,7,"VVVUVVMVV",1,7,0.766045548654244,47,53,63,66,80,86,133,136,"GTGAAGG","CTGA","GTGAAGA","CTGA",2.62848983863892,10,14,47,80,1.54689187407411,4.76753936625006,7.83172156086704,101,"ENSG00000079974.19"
"20351","ENSG00000164741.15_116509",116501,116509,9,"ENSG00000164741.15",1,1,"MVVVUVVVV",1,7,0.795859213250517,113,119,133,136,150,156,168,171,"AGCATGA","ATGA","TTCATTA","CTGA",2.40699989555874,14,14,12,49,2.54595498672809,4.64815523927992,7.83159209228199,101,"ENSG00000079974.19"
"20023","ENSG00000164162.14_47510",47502,47510,9,"ENSG00000164162.14",1,7,"VVVVVUMVV",1,7,0.807453416149068,110,116,133,136,177,183,198,201,"ATGAAGA","AAGA","GTGAATA","CTGA",2.52433262500408,17,41,15,82,1.5781409562992,4.60175628074827,7.83156994534455,101,"ENSG00000079974.19"
"45574","ENSG00000285713.1_47143",47135,47143,9,"ENSG00000285713.1",1,7,"VVVVVUMVV",1,7,0.807453416149068,110,116,133,136,177,183,198,201,"ATGAAGA","AAGA","GTGAATA","CTGA",2.52433262500408,17,41,15,82,1.5781409562992,4.60175628074827,7.83156994534455,101,"ENSG00000079974.19"
"18514","ENSG00000157551.19_110339",110331,110339,9,"ENSG00000157551.19",0,NA,"VVUVUVVVV",2,7,0.773498964803312,42,48,66,69,114,120,133,136,"GTGATGA","CTGA","GGGATGA","CTGG",2.60429342539434,18,45,13,85,1.58811132683548,4.73751687403278,7.83151273324603,101,"ENSG00000079974.19"
"30418","ENSG00000204941.14_15984",15976,15984,9,"ENSG00000204941.14",1,3,"VVMVVVUVV",1,7,0.768944099378882,114,120,133,136,167,173,213,216,"GTGATGA","CGGA","ATGGAGA","CTGA",2.69463544920789,13,31,40,93,1.05862189754851,4.75571455640028,7.83149095391581,101,"ENSG00000079974.19"
"46253","ENSG00000286371.1_84528",84520,84528,9,"ENSG00000286371.1",0,NA,"UVUVVVVVV",2,7,0.786335403726708,115,121,133,136,146,152,164,167,"TTTATGA","AAGA","GTCATTA","CTGA",2.3813300047939,12,10,12,43,2.86881199349382,4.68608633969662,7.83142795460345,101,"ENSG00000079974.19"
"30564","ENSG00000205754.13_3144",3136,3144,9,"ENSG00000205754.13",1,7,"UVVVVVMVV",1,7,0.787991718426501,115,121,133,136,146,152,161,164,"CTGATGA","CTAA","TTGATTT","CTGT",2.36809967796325,12,10,9,40,2.93011159320768,4.67936069490733,7.83132756861334,101,"ENSG00000079974.19"
"40568","ENSG00000257046.5_150238",150230,150238,9,"ENSG00000257046.5",1,7,"UVVVVVMVV",1,7,0.787991718426501,115,121,133,136,146,152,161,164,"CTGATGA","CTAA","TTGATTT","CTGT",2.36809967796325,12,10,9,40,2.93011159320768,4.67936069490733,7.83132756861334,101,"ENSG00000079974.19"
"41011","ENSG00000258343.2_9391",9383,9391,9,"ENSG00000258343.2",1,7,"VVVVUVMVV",1,7,0.775155279503105,81,87,106,109,116,122,133,136,"ATGAAGT","CTGG","ATCATGG","CTGA",2.4534057528447,19,7,11,46,2.56672208124723,4.73069010838631,7.83131122639873,101,"ENSG00000079974.19"
"26905","ENSG00000185274.12_149450",149442,149450,9,"ENSG00000185274.12",1,1,"MVVVVUVVV",1,7,0.82815734989648,109,115,133,136,140,146,157,160,"CTAATGA","ATCA","CTTATTA","CTGA",2.33511123898567,18,4,11,42,2.50730467495223,4.51867823371418,7.8313076333001,101,"ENSG00000079974.19"
"30165","ENSG00000203876.10_48220",48212,48220,9,"ENSG00000203876.10",1,3,"VVMVVVVVV",0,8,0.882815734989648,74,80,87,90,99,105,133,136,"ATAATGT","CTCA","GTGAGGA","CAGA",2.31945932372273,7,9,28,53,1.73700901937728,4.30001779438221,7.8312807343408,101,"ENSG00000079974.19"
"28835","ENSG00000196569.14_37719",37711,37719,9,"ENSG00000196569.14",1,6,"VVVVUMVVV",1,7,0.792546583850932,114,120,133,136,144,150,175,178,"ATGTTGA","CTAT","GAGAAGA","CTGA",2.45833590686657,13,8,25,55,2.25534054482111,4.66106164764957,7.8312479830533,101,"ENSG00000079974.19"
"46376","ENSG00000286533.1_110860",110852,110860,9,"ENSG00000286533.1",1,5,"UVVVMVVVV",1,7,0.789233954451346,94,100,133,136,184,190,199,202,"ATGAAGA","ATGA","CTGATGG","CTGA",2.65203395352284,33,48,9,99,1.01695204307745,4.6742945999741,7.83123041777948,101,"ENSG00000079974.19"
"40379","ENSG00000255867.1_4346",4338,4346,9,"ENSG00000255867.1",0,NA,"UVVVVUVVV",2,7,0.824844720496894,50,56,74,77,80,86,133,136,"CTGAAGA","CTAA","GTGAACA","CTGA",2.51322745110134,18,3,47,77,1.37200338153107,4.531713263885,7.83109214587258,101,"ENSG00000079974.19"
"15903","ENSG00000150275.20_1515339",1515331,1515339,9,"ENSG00000150275.20",1,2,"VMVVVUVVV",1,7,0.806211180124223,114,120,133,136,146,152,179,182,"GGGAGGA","GTGA","GAGATGA","CTGA",2.4491227222668,13,10,27,59,2.097375634496,4.60621511240199,7.83105983289889,101,"ENSG00000079974.19"
"44687","ENSG00000283380.1_356396",356388,356396,9,"ENSG00000283380.1",1,3,"UVMVVVVVV",1,7,0.785507246376811,116,122,133,136,142,148,166,169,"CTGATAT","TTGA","ATGAAGT","CTGA",2.42291127203173,11,6,18,44,2.6033663319076,4.68902703636312,7.83105602187037,101,"ENSG00000079974.19"
"30058","ENSG00000198964.14_313536",313528,313536,9,"ENSG00000198964.14",0,NA,"UVVVVVUVV",2,7,0.788819875776397,80,86,95,98,114,120,133,136,"CTGGGGA","CTGA","GTGCTAA","CTGA",2.46837419414828,9,16,13,47,2.2467989482646,4.67565672731328,7.83093623041887,101,"ENSG00000079974.19"
"44402","ENSG00000281641.3_227764",227756,227764,9,"ENSG00000281641.3",1,1,"MVVVUUVVV",2,6,0.718012422360248,115,121,133,136,172,178,187,190,"AGGATGA","ATGA","CTGAAGA","CTGA",2.67302692735412,12,36,9,66,2.01512365519929,4.95882579272335,7.83087548216435,101,"ENSG00000079974.19"
"14342","ENSG00000144724.20_267248",267240,267248,9,"ENSG00000144724.20",1,1,"MVVVVVUVV",1,7,0.792132505175983,115,121,133,136,140,146,155,158,"GGGATTA","GTGA","GTGGTTT","CTGA",2.34691545148154,12,4,9,34,3.00325370030578,4.66233917754569,7.83086919824962,101,"ENSG00000079974.19"
"21325","ENSG00000167118.11_11442",11434,11442,9,"ENSG00000167118.11",0,NA,"UVVVUVVVV",2,7,0.792546583850932,112,118,133,136,144,150,167,170,"GTGCTGA","GTGT","GGGATGT","CTGA",2.40716354847587,15,8,17,49,2.59492865029695,4.66067141003402,7.83085774543775,101,"ENSG00000079974.19"
"28197","ENSG00000188428.20_2010",2002,2010,9,"ENSG00000188428.20",1,2,"UMVVVVVVV",1,7,0.786749482401656,112,118,133,136,144,150,159,162,"ATGATGA","TTGT","GGGATAA","CTAA",2.37238304788563,15,8,9,41,2.91891028477788,4.68369931767052,7.83069724727714,101,"ENSG00000079974.19"
"41438","ENSG00000259040.5_1978",1970,1978,9,"ENSG00000259040.5",1,2,"UMVVVVVVV",1,7,0.786749482401656,112,118,133,136,144,150,159,162,"ATGATGA","TTGT","GGGATAA","CTAA",2.37238304788563,15,8,9,41,2.91891028477788,4.68369931767052,7.83069724727714,101,"ENSG00000079974.19"
"42693","ENSG00000265818.1_40144",40136,40144,9,"ENSG00000265818.1",1,2,"UMVVVVVVV",1,7,0.786749482401656,112,118,133,136,144,150,159,162,"ATGATGA","TTGT","GGGATAA","CTAA",2.37238304788563,15,8,9,41,2.91891028477788,4.68369931767052,7.83069724727714,101,"ENSG00000079974.19"
"12768","ENSG00000139083.11_191860",191852,191860,9,"ENSG00000139083.11",1,8,"VVVVUUVMV",2,6,0.696066252587992,81,87,98,101,106,112,133,136,"ATGGTGA","CTGA","TAGAAGA","CTGA",2.67215603482805,11,5,21,46,2.37068326431302,5.04626420745834,7.83052921781031,101,"ENSG00000079974.19"
"8074","ENSG00000116711.10_91276",91268,91276,9,"ENSG00000116711.10",0,NA,"VVVUVVVVV",1,8,0.880745341614907,92,98,133,136,146,152,167,170,"ATGATAA","CTGT","GAGATGG","CTAA",2.32591867308634,35,10,15,69,1.72392756148678,4.30751301218227,7.8304943786419,101,"ENSG00000079974.19"
"26361","ENSG00000183960.9_339251",339243,339251,9,"ENSG00000183960.9",0,NA,"VVVUVVVVV",1,8,0.880745341614907,92,98,133,136,146,152,167,170,"ATGATAA","CTGT","GAGATGG","CTAA",2.32591867308634,35,10,15,69,1.72392756148678,4.30751301218227,7.8304943786419,101,"ENSG00000079974.19"
"42193","ENSG00000261058.1_16692",16684,16692,9,"ENSG00000261058.1",1,8,"VVUVVVVMV",1,7,0.767701863354037,108,114,133,136,138,144,154,157,"CTGAAGA","CTGA","ATAAGTA","CTGA",2.53551618617559,19,2,10,40,2.13516498906258,4.75965155755829,7.83045901097444,101,"ENSG00000079974.19"
"13049","ENSG00000139971.15_626",618,626,9,"ENSG00000139971.15",1,8,"VVVVVUVMV",1,7,0.806211180124224,112,118,133,136,148,154,170,173,"ATGAGGA","CTGG","CTGAGGA","CAGA",2.39822276983775,15,12,16,52,2.43414168460168,4.60557337088001,7.8304180913769,101,"ENSG00000079974.19"
"40781","ENSG00000257621.9_621",613,621,9,"ENSG00000257621.9",1,8,"VVVVVUVMV",1,7,0.806211180124224,112,118,133,136,148,154,170,173,"ATGAGGA","CTGG","CTGAGGA","CAGA",2.39822276983775,15,12,16,52,2.43414168460168,4.60557337088001,7.8304180913769,101,"ENSG00000079974.19"
"38156","ENSG00000249738.10_138819",138811,138819,9,"ENSG00000249738.10",1,2,"UMVVVUVVV",2,6,0.708902691511387,115,121,133,136,141,147,155,158,"ATTAGGA","CAGA","GTGATGG","CTGA",2.53506820265674,12,5,8,34,3.07847702438505,4.99473292719082,7.83034369323637,101,"ENSG00000079974.19"
"12735","ENSG00000138814.17_296726",296718,296726,9,"ENSG00000138814.17",1,1,"MVVVVUVVV",1,7,0.82815734989648,109,115,133,136,142,148,156,159,"AAGAGGC","CTGT","GTAATGT","CTGA",2.31240369074969,18,6,8,41,2.65448069157818,4.51762632414402,7.83025572372995,101,"ENSG00000079974.19"
"31939","ENSG00000225383.8_3922",3914,3922,9,"ENSG00000225383.8",1,1,"MVVVVUVVV",1,7,0.82815734989648,91,97,106,109,116,122,133,136,"TAGATCA","TTGA","GTTGTAA","CTGA",2.27188202295202,9,7,11,36,2.92459615868286,4.51761907792409,7.83024847751001,101,"ENSG00000079974.19"
"39499","ENSG00000253664.1_62137",62129,62137,9,"ENSG00000253664.1",1,7,"UVVVVVMVV",1,7,0.787991718426501,113,119,133,136,138,144,155,158,"GTGACTA","CTGA","GTCCTAA","CTGA",2.4203398882298,14,2,11,36,2.57747349206256,4.67826818673197,7.83023506043797,101,"ENSG00000079974.19"
"40256","ENSG00000255388.6_40691",40683,40691,9,"ENSG00000255388.6",1,2,"UMVVVVVVV",1,7,0.786749482401656,76,82,99,102,112,118,133,136,"GTGATTA","TAGA","CTGAGGG","CTGA",2.43932060984268,17,10,15,51,2.47077564839222,4.68322826183585,7.83022619144248,101,"ENSG00000079974.19"
"27767","ENSG00000187323.12_488247",488239,488247,9,"ENSG00000187323.12",0,NA,"VVVVUUVVV",2,7,0.812008281573499,105,111,133,136,144,150,160,163,"GTGATGA","TTTA","ATGAGGA","TTGA",2.40051263008312,22,8,10,49,2.32483472868752,4.58206306564374,7.83009619193774,101,"ENSG00000079974.19"
"5505","ENSG00000105426.18_177657",177649,177657,9,"ENSG00000105426.18",1,8,"VVVVVUVMV",1,7,0.806211180124224,111,117,133,136,139,145,153,156,"GTGAAGA","CCAA","GTGAGCC","CTGA",2.36992218069644,16,3,8,36,2.62148954946308,4.6052426885265,7.83008740902339,101,"ENSG00000079974.19"
"36406","ENSG00000240518.2_69",61,69,9,"ENSG00000240518.2",1,8,"VVVVVUVMV",1,7,0.806211180124224,49,55,71,74,91,97,112,115,"ATGATGG","CAGG","ATGGGCA","CTGA",2.45065584672576,16,17,15,57,2.08310214693543,4.60520194794346,7.83004666844036,101,"ENSG00000079974.19"
"10164","ENSG00000129625.13_34176",34168,34176,9,"ENSG00000129625.13",1,2,"UMVVVVVVV",1,7,0.786749482401656,96,102,110,113,115,121,133,136,"AAGATGT","CTAA","GAGAAGT","CTGA",2.43085682844976,8,2,12,31,2.52611419901312,4.68295659716954,7.82995452677617,101,"ENSG00000079974.19"
"40372","ENSG00000255794.11_25960",25952,25960,9,"ENSG00000255794.11",1,2,"UMVVVVVVV",1,7,0.786749482401656,102,108,133,136,144,150,159,162,"CTGATGT","CATA","ATGATGC","CTGA",2.48613646271574,25,8,9,51,2.15749300635472,4.68293402278158,7.8299319523882,101,"ENSG00000079974.19"
"30915","ENSG00000214719.13_72192",72184,72192,9,"ENSG00000214719.13",1,6,"VVVVVMUVV",1,7,0.788819875776397,67,73,87,90,112,118,133,136,"AGGAGGA","CTGA","GGGAACA","CTGA",2.5070976940243,14,22,15,60,1.98449389309553,4.67461962998105,7.82989913308664,101,"ENSG00000079974.19"
"43045","ENSG00000267723.1_1778",1770,1778,9,"ENSG00000267723.1",1,6,"VVVVVMUVV",1,7,0.788819875776397,67,73,87,90,112,118,133,136,"AGGAGGA","CTGA","GGGAACA","CTGA",2.5070976940243,14,22,15,60,1.98449389309553,4.67461962998105,7.82989913308664,101,"ENSG00000079974.19"
"42447","ENSG00000263307.2_47220",47212,47220,9,"ENSG00000263307.2",1,6,"UVVVVMVVV",1,7,0.805383022774327,68,74,86,89,107,113,133,136,"CTCATGT","CTGA","AAGATAA","CTGA",2.48160130843617,12,18,20,59,1.88930198673092,4.60832767740968,7.82985976850699,101,"ENSG00000079974.19"
"21283","ENSG00000166960.17_40243",40235,40243,9,"ENSG00000166960.17",1,7,"VVVVVUMVV",1,7,0.807453416149068,97,103,133,136,141,147,162,165,"ATGATTA","GAGA","CTGAAAA","CTGA",2.49115033669946,30,5,15,59,1.7920910871746,4.59993999962609,7.82975366422236,101,"ENSG00000079974.19"
"11575","ENSG00000135365.17_178371",178363,178371,9,"ENSG00000135365.17",1,8,"VVVVUVVMV",1,7,0.773913043478261,110,116,133,136,146,152,167,170,"ATGATGA","GAGA","GTGATCA","TTGA",2.46983360444523,17,10,15,51,2.47077564839222,4.7340832528401,7.82973542675315,101,"ENSG00000079974.19"
"5169","ENSG00000103546.19_32613",32605,32613,9,"ENSG00000103546.19",1,2,"VMVVUVVVV",1,7,0.773913043478261,114,120,133,136,143,149,183,186,"CTCATGG","CTGA","TTGCTGA","CTGA",2.53154295571153,13,7,34,63,2.05915348148094,4.73402662988946,7.8296788038025,101,"ENSG00000079974.19"
"44298","ENSG00000280709.2_58055",58047,58055,9,"ENSG00000280709.2",1,7,"VVVVVUMVV",1,7,0.807453416149068,110,116,133,136,145,151,164,167,"GAAATGA","CTCA","ATGCTCA","CTGA",2.3659355914576,17,9,13,48,2.62653923097365,4.59986079350608,7.82967445810236,101,"ENSG00000079974.19"
"44936","ENSG00000284500.3_56139",56131,56139,9,"ENSG00000284500.3",1,7,"VVVVVUMVV",1,7,0.807453416149068,110,116,133,136,145,151,164,167,"GAAATGA","CTCA","ATGCTCA","CTGA",2.3659355914576,17,9,13,48,2.62653923097365,4.59986079350608,7.82967445810236,101,"ENSG00000079974.19"
"45352","ENSG00000285472.1_30980",30972,30980,9,"ENSG00000285472.1",1,7,"VVVVVUMVV",1,7,0.807453416149068,110,116,133,136,145,151,164,167,"GAAATGA","CTCA","ATGCTCA","CTGA",2.3659355914576,17,9,13,48,2.62653923097365,4.59986079350608,7.82967445810236,101,"ENSG00000079974.19"
"42204","ENSG00000261115.7_222461",222453,222461,9,"ENSG00000261115.7",1,8,"VVVVVUVMV",1,7,0.806211180124224,96,102,133,136,149,155,169,172,"GAGATGA","CTGG","ATGCTAA","CTGA",2.52322070497043,31,13,14,67,1.5975766624841,4.60476200723841,7.82960672773531,101,"ENSG00000079974.19"
"15314","ENSG00000147724.12_113660",113652,113660,9,"ENSG00000147724.12",1,8,"VVVVUVVMV",1,7,0.773913043478261,87,93,103,106,110,116,133,136,"TTGATGA","TTGA","TTGAAGA","TTGA",2.46718353870939,10,4,17,40,2.48780512932856,4.73392384684779,7.82957602076083,101,"ENSG00000079974.19"
"23510","ENSG00000173077.16_436561",436553,436561,9,"ENSG00000173077.16",1,5,"VVVVMUVVV",1,7,0.808695652173913,81,87,102,105,110,116,133,136,"CTGATGA","GTGA","GTGTAAA","CTCA",2.37547160854974,15,5,17,46,2.542672494596,4.59478747123191,7.82957007992756,101,"ENSG00000079974.19"
"46540","ENSG00000286787.3_41928",41920,41928,9,"ENSG00000286787.3",1,2,"UMVVVVVVV",1,7,0.786749482401656,111,117,133,136,166,172,187,190,"ATGAAGA","CAGA","GTGCTAC","CTGA",2.55362335581625,16,30,15,70,1.70605523840696,4.68255273596215,7.82955066556878,101,"ENSG00000079974.19"
"9267","ENSG00000123572.17_29700",29692,29700,9,"ENSG00000123572.17",1,5,"VVVVMUVVV",1,7,0.808695652173913,112,118,133,136,145,151,206,209,"ATGTTGA","CAGG","CTGAAGG","CTGA",2.47771982849158,15,9,55,88,1.86078114439269,4.59472833358414,7.82951094227979,101,"ENSG00000079974.19"
"9377","ENSG00000124313.18_95100",95092,95100,9,"ENSG00000124313.18",1,6,"UVVVVMVVV",1,7,0.805383022774327,73,79,89,92,112,118,133,136,"CTGATGA","ATGA","CTGATGT","CTGG",2.46256968994734,10,20,15,54,2.01449848400974,4.60790743758133,7.82943952867864,101,"ENSG00000079974.19"
"6716","ENSG00000111670.16_41016",41008,41016,9,"ENSG00000111670.16",1,8,"VVVVVUVMV",1,7,0.806211180124224,116,122,133,136,175,181,193,196,"AGGAGGA","ATGA","GTGGCGA","CTGA",2.47147250375268,11,39,12,71,1.94188548604056,4.60459221109793,7.82943693159483,101,"ENSG00000079974.19"
"11303","ENSG00000134516.20_220019",220011,220019,9,"ENSG00000134516.20",1,3,"UVMVVVVVV",1,7,0.785507246376811,105,111,133,136,155,161,171,174,"ATGGTAA","CAGA","ATGATGA","CTGA",2.56346702535029,22,19,10,60,1.65971980789556,4.68737499422437,7.82940397973161,101,"ENSG00000079974.19"
"47918","ENSG00000289702.1_637",629,637,9,"ENSG00000289702.1",1,3,"UVMVVVVVV",1,7,0.785507246376811,105,111,133,136,155,161,171,174,"ATGGTAA","CAGA","ATGATGA","CTGA",2.56346702535029,22,19,10,60,1.65971980789556,4.68737499422437,7.82940397973161,101,"ENSG00000079974.19"
"35591","ENSG00000236404.12_144055",144047,144055,9,"ENSG00000236404.12",1,5,"UVVVMVVVV",1,7,0.789233954451346,112,118,133,136,143,149,165,168,"TTGATGA","CTGG","ATGTGGA","GTGA",2.40281729120406,15,7,16,47,2.67077226658261,4.67238855198576,7.82932436979114,101,"ENSG00000079974.19"
"46521","ENSG00000286774.1_10099",10091,10099,9,"ENSG00000286774.1",1,6,"UVVVVMVVV",1,7,0.805383022774327,54,60,70,73,116,122,133,136,"CTGATGT","CTGC","TTTCTGA","CTGA",2.47826503136574,10,43,11,73,1.90904832500336,4.60770380019374,7.82923589129105,101,"ENSG00000079974.19"
"26509","ENSG00000184347.15_169451",169443,169451,9,"ENSG00000184347.15",0,NA,"UVVVUVVVV",2,7,0.792546583850932,114,120,133,136,139,145,165,168,"AGGAGGA","CAGA","ATGATCT","CTGA",2.46258893307311,13,3,20,45,2.21892731057708,4.65904671609945,7.82923305150318,101,"ENSG00000079974.19"
"32500","ENSG00000227088.2_569886",569878,569886,9,"ENSG00000227088.2",0,NA,"UVVUVVVVV",2,7,0.78343685300207,62,68,76,79,89,95,133,136,"AGGATGA","ATGA","CTCATAA","CTGA",2.56829719762439,8,10,38,65,1.65953527587042,4.69537914834159,7.82912656034987,101,"ENSG00000079974.19"
"43120","ENSG00000268869.7_6897",6889,6897,9,"ENSG00000268869.7",0,NA,"VVVVUUVVV",2,7,0.812008281573499,111,117,133,136,179,185,194,197,"ATGAGGA","ATGG","TTGAGGG","CTGA",2.47254569732675,16,43,9,77,1.84050280448881,4.58103519666678,7.82906832296077,101,"ENSG00000079974.19"
"30955","ENSG00000214922.9_18234",18226,18234,9,"ENSG00000214922.9",1,2,"VMVVUUVVV",2,6,0.696066252587992,109,115,133,136,141,147,174,177,"ATGATGA","GTGA","CTGAGGT","CTGA",2.75665052176707,18,5,27,59,1.80135659508314,5.04475668504924,7.82902169540121,101,"ENSG00000079974.19"
"16921","ENSG00000152763.17_109651",109643,109651,9,"ENSG00000152763.17",1,1,"MVVVVUVVV",1,7,0.82815734989648,110,116,133,136,163,169,179,182,"GTGAGAA","ATGA","TTGATGG","CTGA",2.43342342785956,17,27,10,63,1.84255032051695,4.51634329322851,7.82897269281443,101,"ENSG00000079974.19"
"11263","ENSG00000134371.14_35214",35206,35214,9,"ENSG00000134371.14",1,1,"MVVVVUVVV",1,7,0.82815734989648,44,50,74,77,116,122,133,136,"ATGATGA","GTGA","GTGGGGA","TTGA",2.52785587890993,24,39,11,83,1.21286192449889,4.51630861264127,7.82893801222719,101,"ENSG00000079974.19"
"9833","ENSG00000127603.32_3947",3939,3947,9,"ENSG00000127603.32",0,NA,"VVVVVUUVV",2,7,0.808281573498965,116,122,133,136,154,160,172,175,"ATAATGT","CTTA","ATAAAGG","CTGA",2.41142148775741,11,18,12,50,2.30639255023117,4.59563395048681,7.82876024448267,101,"ENSG00000079974.19"
"7269","ENSG00000113448.20_1200916",1200908,1200916,9,"ENSG00000113448.20",1,8,"VVVVVVUMV",1,7,0.770186335403727,113,119,133,136,144,150,178,181,"CTGATGT","CTCA","ATGTTGG","CTGA",2.53005009631179,14,8,28,59,2.12502907661822,4.7480074296742,7.82875277128911,101,"ENSG00000079974.19"
"37758","ENSG00000248752.3_689845",689837,689845,9,"ENSG00000248752.3",1,7,"VVUVVVMVV",1,7,0.768944099378882,110,116,133,136,145,151,164,167,"AGGATTA","CTTA","CAGATGA","CTGA",2.4577552796474,17,9,13,48,2.62653923097365,4.75289360715574,7.82867000467127,101,"ENSG00000079974.19"
"40946","ENSG00000258162.4_20192",20184,20192,9,"ENSG00000258162.4",1,8,"VVVUVVVMV",1,7,0.764803312629399,112,118,133,136,157,163,172,175,"ATGATGG","GTAA","TTGATTA","CTGA",2.53964905614294,15,21,9,54,2.14656330552969,4.76938925328732,7.82860250380492,101,"ENSG00000079974.19"
"4085","ENSG00000094804.12_16479",16471,16479,9,"ENSG00000094804.12",1,8,"VVVVVUVMV",1,7,0.806211180124224,115,121,133,136,139,145,155,158,"CTGCTGA","CTTT","TTGCTGG","CTGA",2.33207663523906,12,3,10,34,2.86771789302922,4.6037238653224,7.8285685858193,101,"ENSG00000079974.19"
"31439","ENSG00000223732.2_56584",56576,56584,9,"ENSG00000223732.2",1,2,"UMVVVVVVV",1,7,0.786749482401656,84,90,98,101,109,115,133,136,"GTGAAGA","GTGA","ATAACAA","CTGA",2.45400849636129,8,8,18,43,2.36620600962783,4.6815656630091,7.82856359261573,101,"ENSG00000079974.19"
"19517","ENSG00000163159.15_12442",12434,12442,9,"ENSG00000163159.15",1,8,"VVVVVUVMV",1,7,0.806211180124224,114,120,133,136,137,143,153,156,"AGCATGT","CAGA","GTGAGAA","CTGA",2.38276937948635,13,1,10,33,2.52955007314668,4.60366981743059,7.82851453792749,101,"ENSG00000079974.19"
"21206","ENSG00000166833.23_10330",10322,10330,9,"ENSG00000166833.23",1,8,"UVVVVVVMV",1,7,0.786749482401656,54,60,74,77,86,92,133,136,"ATGATGA","GTGA","GTGATCT","CAGA",2.51916862022267,14,9,41,73,1.93124879356515,4.68142656542908,7.8284244950357,101,"ENSG00000079974.19"
"6217","ENSG00000108684.15_377106",377098,377106,9,"ENSG00000108684.15",1,8,"VVVVUVVMV",1,7,0.773913043478261,109,115,133,136,144,150,178,181,"ATGCTGA","CTCA","TTGAGAA","CTGA",2.56550310180493,18,8,28,63,1.82748960228434,4.7327109035793,7.82836307749234,101,"ENSG00000079974.19"
"44716","ENSG00000283417.1_18903",18895,18903,9,"ENSG00000283417.1",1,8,"VVVVUVVMV",1,7,0.773913043478261,109,115,133,136,144,150,178,181,"ATGCTGA","CTCA","TTGAGAA","CTGA",2.56550310180493,18,8,28,63,1.82748960228434,4.7327109035793,7.82836307749234,101,"ENSG00000079974.19"
"5372","ENSG00000104381.14_11199",11191,11199,9,"ENSG00000104381.14",1,6,"VVVVVMUVV",1,7,0.788819875776397,108,114,133,136,143,149,177,180,"ATGATGC","ATAA","TTGATAA","CTGA",2.54113639747165,19,7,28,63,1.75133110588598,4.67306010559092,7.82833960869651,101,"ENSG00000079974.19"
"41691","ENSG00000259551.1_1853",1845,1853,9,"ENSG00000259551.1",1,2,"VMVVVUVVV",1,7,0.806211180124223,88,94,105,108,115,121,133,136,"GTGTTGA","ATAA","AGGGTAA","CTGA",2.31538615666981,11,7,12,39,2.97765803553128,4.60339143666583,7.82823615716273,101,"ENSG00000079974.19"
"41773","ENSG00000259694.1_1866",1858,1866,9,"ENSG00000259694.1",1,2,"VMVVVUVVV",1,7,0.806211180124223,88,94,105,108,115,121,133,136,"GTGTTGA","ATAA","AGGGTAA","CTGA",2.31538615666981,11,7,12,39,2.97765803553128,4.60339143666583,7.82823615716273,101,"ENSG00000079974.19"
"41813","ENSG00000259774.1_863",855,863,9,"ENSG00000259774.1",1,2,"VMVVVUVVV",1,7,0.806211180124223,88,94,105,108,115,121,133,136,"GTGTTGA","ATAA","AGGGTAA","CTGA",2.31538615666981,11,7,12,39,2.97765803553128,4.60339143666583,7.82823615716273,101,"ENSG00000079974.19"
"45336","ENSG00000285454.1_56236",56228,56236,9,"ENSG00000285454.1",1,2,"VMVVUVVVV",1,7,0.773913043478261,90,96,105,108,115,121,133,136,"GTTAGGA","TTGA","ATGACGT","CTGA",2.40855316392362,9,7,12,37,2.87316593225306,4.7325467562693,7.82819893018235,101,"ENSG00000079974.19"
"24570","ENSG00000177000.13_2419",2411,2419,9,"ENSG00000177000.13",1,1,"MVVVUVVVV",1,7,0.795859213250517,116,122,133,136,151,157,171,174,"GTGATGT","CAGC","CAGATGG","CTGA",2.42667913991425,11,15,14,49,2.40118459119013,4.64476138098796,7.82819823399003,101,"ENSG00000079974.19"
"12728","ENSG00000138814.17_189399",189391,189399,9,"ENSG00000138814.17",1,7,"UVVVVVMVV",1,7,0.787991718426501,114,120,133,136,151,157,170,173,"ATGATAT","CTTA","GATATGA","CTGA",2.4353309057322,13,15,13,50,2.46933660123772,4.67621899319642,7.82818586690242,101,"ENSG00000079974.19"
"15465","ENSG00000148426.13_13850",13842,13850,9,"ENSG00000148426.13",1,1,"MVVVVVUVV",1,7,0.792132505175983,89,95,133,136,151,157,173,176,"ATGCTGA","GTGA","GAGAAGA","CTGA",2.59843119181609,38,15,16,78,1.31536334296101,4.65955948876707,7.82808950947101,101,"ENSG00000079974.19"
"23193","ENSG00000172292.15_39409",39401,39409,9,"ENSG00000172292.15",0,NA,"VVVUVVVVV",1,8,0.880745341614907,50,56,74,77,80,86,133,136,"GTGAAGG","TTGA","GTGGTTG","CTGA",2.37724355950622,18,3,47,77,1.37200338153107,4.3050734445598,7.82805481101943,101,"ENSG00000079974.19"
"5194","ENSG00000103769.10_64597",64589,64597,9,"ENSG00000103769.10",1,2,"UMVVVVVVV",1,7,0.786749482401656,53,59,85,88,112,118,133,136,"ATGATGA","CTGA","GTGAAAA","CCGA",2.64400337837838,26,24,15,74,1.09740443559154,4.68102340619518,7.82802133580181,101,"ENSG00000079974.19"
"29340","ENSG00000197798.9_35091",35083,35091,9,"ENSG00000197798.9",1,8,"VVUVVVVMV",1,7,0.767701863354037,113,119,133,136,143,149,166,169,"TAGATGA","CTTA","GTGTGGG","CTGA",2.45464601521359,14,7,17,47,2.6642800549706,4.7571467057653,7.82795415918145,101,"ENSG00000079974.19"
"26700","ENSG00000184903.10_618436",618428,618436,9,"ENSG00000184903.10",1,8,"VVVVVUVMV",1,7,0.806211180124224,114,120,133,136,143,149,160,163,"TTAATGA","CTCT","TTTATAA","CTGA",2.30967791397597,13,7,11,40,3.01450882069823,4.6030903951345,7.8279351156314,101,"ENSG00000079974.19"
"40692","ENSG00000257335.8_154271",154263,154271,9,"ENSG00000257335.8",1,2,"VMVVVUVVV",1,7,0.806211180124223,80,86,96,99,109,115,133,136,"TTTATGT","CTGT","GTGATTC","CTGA",2.39337688783527,10,10,18,47,2.45635247620392,4.60304959877643,7.82789431927332,101,"ENSG00000079974.19"
"7115","ENSG00000112851.16_8425",8417,8425,9,"ENSG00000112851.16",1,7,"UVVVVVMVV",1,7,0.787991718426501,113,119,133,136,158,164,182,185,"ATGACGA","CTTA","GTCAAGT","CTGA",2.53500409471158,14,22,18,63,1.80346706707773,4.67587359128873,7.82784046499473,101,"ENSG00000079974.19"
"48183","ENSG00000290562.1_11891",11883,11891,9,"ENSG00000290562.1",1,8,"UVVVVUVMV",2,6,0.708902691511387,115,121,133,136,148,154,170,173,"TTGGTGA","CTGT","GTGATGA","CTGA",2.61647145381974,12,12,16,49,2.5257316390656,4.99221866613264,7.82782943217819,101,"ENSG00000079974.19"
"36399","ENSG00000240498.9_124792",124784,124792,9,"ENSG00000240498.9",1,8,"UVVVVUVMV",2,6,0.708902691511387,114,120,133,136,144,150,160,163,"ATGATTA","CTTA","GTGCATA","CTGA",2.54302208094057,13,8,10,40,3.01535129197326,4.99220795789427,7.82781872393982,101,"ENSG00000079974.19"
"12034","ENSG00000136928.7_15221",15213,15221,9,"ENSG00000136928.7",1,1,"MVVVVUVVV",1,7,0.82815734989648,115,121,133,136,148,154,170,173,"AAGGTGT","CTTA","ATGGAGA","CTGA",2.33019348178743,12,12,16,49,2.5257316390656,4.51508871274545,7.82771811233138,101,"ENSG00000079974.19"
"5521","ENSG00000105662.16_56002",55994,56002,9,"ENSG00000105662.16",1,8,"VVVVVVUMV",1,7,0.770186335403727,110,116,133,136,148,154,176,179,"GTGATGT","GTGA","GTGCAGT","CTGA",2.55885713690373,17,12,22,60,1.92841734955212,4.74686623222759,7.82761157384249,101,"ENSG00000079974.19"
"34934","ENSG00000234423.2_224363",224355,224363,9,"ENSG00000234423.2",0,NA,"VVVVUUVVV",2,7,0.812008281573499,88,94,133,136,145,151,183,186,"ATAATGA","GTGA","CTGCTGT","CTGA",2.5912804498603,39,9,32,89,1.04308772777478,4.57957268171087,7.82760580800486,101,"ENSG00000079974.19"
"22413","ENSG00000170516.17_6719",6711,6719,9,"ENSG00000170516.17",1,8,"VVVVUVVMV",1,7,0.773913043478261,113,119,133,136,143,149,157,160,"CTCATGA","AAGA","GTCTTGA","CTGA",2.38852038368726,14,7,8,38,3.00386870971515,4.73183448357422,7.82748665748726,101,"ENSG00000079974.19"
"45579","ENSG00000285713.1_607814",607806,607814,9,"ENSG00000285713.1",1,6,"VVVVVMUVV",1,7,0.788819875776397,57,63,74,77,112,118,133,136,"ATGATGA","CTGA","AGGAGCA","CTAA",2.53152147683398,11,35,15,70,1.81177249978421,4.67214558633601,7.8274250894416,101,"ENSG00000079974.19"
"45664","ENSG00000285783.1_380593",380585,380593,9,"ENSG00000285783.1",1,6,"VVVVVMUVV",1,7,0.788819875776397,57,63,74,77,112,118,133,136,"ATGATGA","CTGA","AGGAGCA","CTAA",2.53152147683398,11,35,15,70,1.81177249978421,4.67214558633601,7.8274250894416,101,"ENSG00000079974.19"
"8134","ENSG00000116991.12_157662",157654,157662,9,"ENSG00000116991.12",1,2,"VMVVVUVVV",1,7,0.806211180124223,37,43,63,66,72,78,133,136,"AAGATGA","TTGA","GGGATTT","CTGA",2.54030366221655,20,6,55,90,1.47489882954727,4.60256414441441,7.8274088649113,101,"ENSG00000079974.19"
"12314","ENSG00000137857.18_30298",30290,30298,9,"ENSG00000137857.18",1,1,"MVVUVUVVV",2,6,0.708902691511387,115,121,133,136,145,151,165,168,"CAGATGT","CTGA","CTGAGGA","CTGA",2.5704282815808,12,9,14,44,2.83078849053812,4.99174425860254,7.82735502464809,101,"ENSG00000079974.19"
"46546","ENSG00000286800.1_24582",24574,24582,9,"ENSG00000286800.1",1,2,"VMUVVVVVV",1,7,0.767701863354037,116,122,133,136,170,176,193,196,"ATCAAGA","CTGA","TTGTTGA","CTGA",2.59941927416125,11,34,17,71,1.69652158262846,4.75649585259253,7.82730330600868,101,"ENSG00000079974.19"
"11302","ENSG00000134516.20_201377",201369,201377,9,"ENSG00000134516.20",1,1,"MVVVVUVVV",1,7,0.82815734989648,116,122,133,136,140,146,172,175,"GTCAGGA","CTGG","GTGGGGA","CTGA",2.40133592984598,11,4,26,50,2.0496749793605,4.51464529458343,7.82727469416935,101,"ENSG00000079974.19"
"32283","ENSG00000226622.7_48353",48345,48353,9,"ENSG00000226622.7",1,6,"UVVVVMVVV",1,7,0.805383022774327,108,114,133,136,166,172,189,192,"CTGATGA","ATGG","GTGAAAA","CTGA",2.56460919033634,19,30,17,75,1.32553830254102,4.60573322619582,7.82726531729313,101,"ENSG00000079974.19"
"17285","ENSG00000153820.13_185780",185772,185780,9,"ENSG00000153820.13",1,1,"MVVVVUVVV",1,7,0.82815734989648,106,112,133,136,143,149,159,162,"ATGATTG","ATTA","GAGATGG","CTGA",2.34689024120014,21,7,10,47,2.412545038255,4.51461999489732,7.82724939448324,101,"ENSG00000079974.19"
"4403","ENSG00000100439.11_14069",14061,14069,9,"ENSG00000100439.11",1,2,"UMVVVVVVV",1,7,0.786749482401656,111,117,133,136,142,148,160,163,"ATAAAGA","CCGG","ATGATGT","CTGA",2.38928286480452,16,6,12,43,2.79214707399092,4.68017487650526,7.82717280611189,101,"ENSG00000079974.19"
"21678","ENSG00000168702.18_175623",175615,175623,9,"ENSG00000168702.18",1,8,"UVVVVVVMV",1,7,0.786749482401656,69,75,94,97,108,114,133,136,"ATAATGA","CTAA","ATCTGGA","CTGA",2.50997632815412,19,11,19,58,1.98719057250271,4.68009152338254,7.82708945298917,101,"ENSG00000079974.19"
"17699","ENSG00000154889.17_19648",19640,19648,9,"ENSG00000154889.17",1,3,"VVMVVUVVV",1,7,0.804968944099379,40,46,59,62,71,77,133,136,"ATGATGA","CTAA","GTCCTGA","TTGA",2.47231189233888,13,9,56,87,1.94674170150141,4.60720524594015,7.82708102233767,101,"ENSG00000079974.19"
"8411","ENSG00000118729.12_27154",27146,27154,9,"ENSG00000118729.12",1,6,"VVUVVMVVV",1,7,0.786335403726708,105,111,133,136,184,190,204,207,"CTGATGT","CTGG","GTGAAGA","CTGA",2.62753946224217,22,48,14,93,1.20977864413372,4.68167709810372,7.82701871301055,101,"ENSG00000079974.19"
"34989","ENSG00000234650.6_1121",1113,1121,9,"ENSG00000234650.6",1,8,"VVVVVUVMV",1,7,0.806211180124224,30,36,54,57,102,108,133,136,"CTGAAGA","CTGA","GTCAAGA","CTGA",2.61997564563505,18,45,25,97,0.942087022642141,4.60214783171895,7.82699255221585,101,"ENSG00000079974.19"
"23466","ENSG00000172987.13_88652",88644,88652,9,"ENSG00000172987.13",1,8,"VVVUVVVMV",1,7,0.764803312629399,98,104,133,136,145,151,168,171,"CTCATGA","CTGA","TTGAACA","CTGA",2.6046340646398,29,9,17,64,1.7067669493666,4.76774851174131,7.82696176225891,101,"ENSG00000079974.19"
"549","ENSG00000018408.15_11631",11623,11631,9,"ENSG00000018408.15",1,1,"MVVUVVVVV",1,7,0.786749482401656,112,118,133,136,142,148,156,159,"ATGCTGT","GAGA","AAGAAGA","CTGA",2.36796737736398,15,6,8,38,2.93326392823231,4.67992827766471,7.82692620727133,101,"ENSG00000079974.19"
"4623","ENSG00000101337.16_52041",52033,52041,9,"ENSG00000101337.16",1,1,"MVVVVUVVV",1,7,0.82815734989648,113,119,133,136,140,146,159,162,"AAGAAGA","GTTA","AAGATAA","CTGA",2.2954812200759,14,4,13,40,2.753905864183,4.51427849950558,7.8269078990915,101,"ENSG00000079974.19"
"14841","ENSG00000145934.17_997563",997555,997563,9,"ENSG00000145934.17",1,1,"MVVVVUVVV",1,7,0.82815734989648,85,91,106,109,114,120,133,136,"ATGTTGT","CTGA","ATGACAG","CAGA",2.29193794481925,15,5,13,42,2.77747826044877,4.51426613981095,7.82689553939687,101,"ENSG00000079974.19"
"3160","ENSG00000081853.15_21121",21113,21121,9,"ENSG00000081853.15",1,8,"UVVVVVVMV",1,7,0.786749482401656,89,95,133,136,144,150,168,171,"ATGAAGA","CTTA","TTGACAA","CTGA",2.56400372993254,38,8,18,73,1.62568581093851,4.6797610026222,7.82675893222882,101,"ENSG00000079974.19"
"30424","ENSG00000204956.6_29367",29359,29367,9,"ENSG00000204956.6",1,8,"UVVVVVVMV",1,7,0.786749482401656,89,95,133,136,144,150,168,171,"ATGAAGA","CTTA","TTGACAA","CTGA",2.56400372993254,38,8,18,73,1.62568581093851,4.6797610026222,7.82675893222882,101,"ENSG00000079974.19"
"39798","ENSG00000254221.3_9782",9774,9782,9,"ENSG00000254221.3",1,8,"UVVVVVVMV",1,7,0.786749482401656,89,95,133,136,144,150,168,171,"ATGAAGA","CTTA","TTGACAA","CTGA",2.56400372993254,38,8,18,73,1.62568581093851,4.6797610026222,7.82675893222882,101,"ENSG00000079974.19"
"39808","ENSG00000254245.3_16052",16044,16052,9,"ENSG00000254245.3",1,8,"UVVVVVVMV",1,7,0.786749482401656,89,95,133,136,144,150,168,171,"ATGAAGA","CTTA","TTGACAA","CTGA",2.56400372993254,38,8,18,73,1.62568581093851,4.6797610026222,7.82675893222882,101,"ENSG00000079974.19"
"42406","ENSG00000262576.3_4860",4852,4860,9,"ENSG00000262576.3",1,8,"UVVVVVVMV",1,7,0.786749482401656,89,95,133,136,144,150,168,171,"ATGAAGA","CTTA","TTGACAA","CTGA",2.56400372993254,38,8,18,73,1.62568581093851,4.6797610026222,7.82675893222882,101,"ENSG00000079974.19"
"26580","ENSG00000184530.9_21043",21035,21043,9,"ENSG00000184530.9",1,8,"UVVVVVVMV",1,7,0.786749482401656,86,92,106,109,111,117,133,136,"TTGATGA","TTGA","ATGATCA","ATGA",2.46703271824607,14,2,16,41,2.2718283059123,4.67967827355486,7.82667620316148,101,"ENSG00000079974.19"
"16387","ENSG00000151445.16_16017",16009,16017,9,"ENSG00000151445.16",1,1,"MVVUVVVVV",1,7,0.786749482401656,49,55,90,93,114,120,133,136,"GTGATTA","CTGA","CTGCTGG","CTGA",2.63287970398062,35,21,13,78,1.16615973208733,4.67967277298953,7.82667070259616,101,"ENSG00000079974.19"
"19030","ENSG00000160219.12_70075",70067,70075,9,"ENSG00000160219.12",1,8,"UVVVVVVMV",1,7,0.786749482401656,69,75,92,95,102,108,133,136,"GTGATGA","ATGA","ATGATTA","CTAA",2.50348363087562,17,7,25,58,2.02801733899417,4.67947705287457,7.82647498248119,101,"ENSG00000079974.19"
"35641","ENSG00000236548.3_104049",104041,104049,9,"ENSG00000236548.3",1,2,"UMVVVVVVV",1,7,0.786749482401656,106,112,133,136,148,154,166,169,"GTGGTGA","GTGC","GTGATGG","CTGA",2.48755424069122,21,12,12,54,2.13379742285876,4.67937309020007,7.82637101980669,101,"ENSG00000079974.19"
"30837","ENSG00000213995.12_20479",20471,20479,9,"ENSG00000213995.12",1,8,"VVVVVUVMV",1,7,0.806211180124224,107,113,133,136,142,148,166,169,"AAAATGA","CCGA","ATGCTGG","CTGA",2.44434362142977,20,6,18,53,2.1103917068555,4.60150396243015,7.82634868292704,101,"ENSG00000079974.19"
"39586","ENSG00000253875.2_11173",11165,11173,9,"ENSG00000253875.2",1,8,"VVVVVUVMV",1,7,0.806211180124224,106,112,133,136,169,175,190,193,"ATGTTGA","CAGA","TTGTTTA","CTGA",2.57247086864312,21,33,15,78,1.25609687203333,4.60147566574687,7.82632038624376,101,"ENSG00000079974.19"
"9325","ENSG00000124177.16_158765",158757,158765,9,"ENSG00000124177.16",1,2,"VMVVVUVVV",1,7,0.806211180124223,55,61,76,79,106,112,133,136,"ATCATGG","CTGT","ATGAGGA","CTGA",2.54226335810936,15,27,21,72,1.45739906588628,4.6014553633205,7.82630008381739,101,"ENSG00000079974.19"
"35138","ENSG00000235088.1_2325",2317,2325,9,"ENSG00000235088.1",1,2,"VMVVVUVVV",1,7,0.806211180124223,55,61,76,79,106,112,133,136,"ATCATGG","CTGT","ATGAGGA","CTGA",2.54226335810936,15,27,21,72,1.45739906588628,4.6014553633205,7.82630008381739,101,"ENSG00000079974.19"
"43005","ENSG00000267586.7_17191",17183,17191,9,"ENSG00000267586.7",1,8,"UVVVVVVMV",1,7,0.786749482401656,89,95,133,136,160,166,174,177,"GTGATAA","CTGA","ATAAAGA","CTGA",2.63808614984074,38,24,8,79,1.12985444380481,4.67927386068576,7.82627179029239,101,"ENSG00000079974.19"
"7796","ENSG00000115761.17_92450",92442,92450,9,"ENSG00000115761.17",1,2,"VMVVVUVVV",1,7,0.806211180124223,87,93,104,107,114,120,133,136,"TTGTTGA","CTTA","GTGAAGA","CTCA",2.32173231542776,11,7,13,40,2.92704015889572,4.60131389877019,7.82615861926709,101,"ENSG00000079974.19"
"31653","ENSG00000224316.1_11868",11860,11868,9,"ENSG00000224316.1",1,2,"VMVUVVVVV",1,7,0.764803312629399,109,115,133,136,150,156,169,172,"ATGAGGT","TTGA","GTGTGGA","CTGA",2.52889627079196,18,14,13,54,2.20835854862061,4.76691675514175,7.82613000565935,101,"ENSG00000079974.19"
"32112","ENSG00000226002.1_11942",11934,11942,9,"ENSG00000226002.1",1,2,"VMVUVVVVV",1,7,0.764803312629399,109,115,133,136,150,156,169,172,"ATGAGGT","TTGA","GTGTGGA","CTGA",2.52889627079196,18,14,13,54,2.20835854862061,4.76691675514175,7.82613000565935,101,"ENSG00000079974.19"
"32942","ENSG00000228309.7_57061",57053,57061,9,"ENSG00000228309.7",1,8,"VVVVVUVMV",1,7,0.806211180124224,112,118,133,136,148,154,166,169,"ATCAGGA","TTGG","AAGATGA","CTGA",2.36547527937299,15,12,12,48,2.6352298265801,4.60126625560001,7.82611097609691,101,"ENSG00000079974.19"
"9448","ENSG00000124749.17_244334",244326,244334,9,"ENSG00000124749.17",1,1,"MVVUVVVVV",1,7,0.786749482401656,115,121,133,136,155,161,180,183,"GTGGTGA","CTGC","TTGAAGT","CTGA",2.52271115135658,12,19,19,59,1.89815474545127,4.67905727195712,7.82605520156375,101,"ENSG00000079974.19"
"10481","ENSG00000131269.19_70298",70290,70298,9,"ENSG00000131269.19",1,8,"VVVVVVUMV",1,7,0.770186335403727,112,118,133,136,150,156,167,170,"ATGATCA","ATAA","TTGAGGT","CTGA",2.46926092063631,15,14,11,49,2.51925178332569,4.74524781355861,7.82599315517352,101,"ENSG00000079974.19"
"17419","ENSG00000154153.15_5503",5495,5503,9,"ENSG00000154153.15",1,2,"VMVVVUVVV",1,7,0.806211180124223,93,99,133,136,155,161,174,177,"ATTATGA","TTGT","GTGAGGA","CTGA",2.57258417447724,34,19,13,75,1.25401625129418,4.60114435361894,7.82598907411584,101,"ENSG00000079974.19"
"721","ENSG00000028116.18_42493",42485,42493,9,"ENSG00000028116.18",1,5,"UVVVMUVVV",2,6,0.711387163561077,115,121,133,136,160,166,178,181,"AAGATGA","CTGA","CAGATAA","CTGA",2.67246210351142,12,24,12,57,2.10489271676695,4.9803266850441,7.8258753392884,101,"ENSG00000079974.19"
"40589","ENSG00000257060.8_87274",87266,87274,9,"ENSG00000257060.8",1,1,"MVVVVUVVV",1,7,0.82815734989648,81,87,100,103,116,122,133,136,"ATGAGGT","CTGA","TTTCTGA","GTGA",2.30599317733779,13,13,11,46,2.67966633841436,4.51323854683324,7.82586794641916,101,"ENSG00000079974.19"
"6340","ENSG00000109452.13_544417",544409,544417,9,"ENSG00000109452.13",1,3,"UVMVVVVVV",1,7,0.785507246376811,94,100,133,136,143,149,158,161,"ATGATGT","TTTA","TTGGGGA","CTGA",2.50797771296391,33,7,9,58,2.01550326179714,4.68383867038914,7.82586765589638,101,"ENSG00000079974.19"
"7905","ENSG00000116016.14_92472",92464,92472,9,"ENSG00000116016.14",0,NA,"VVVVUUVVV",2,7,0.812008281573499,64,70,91,94,112,118,133,136,"GGGATGG","CTGA","GTGACAT","CTGA",2.50674632598371,21,18,15,63,1.59964627520533,4.57782211210752,7.82585523840151,101,"ENSG00000079974.19"
"33746","ENSG00000231024.1_6549",6541,6549,9,"ENSG00000231024.1",1,1,"MVVVVUVVV",1,7,0.82815734989648,115,121,133,136,144,150,160,163,"AGGAAGA","TGGA","ATAACTA","CTGA",2.25314349258754,12,8,10,39,3.03156892303775,4.51313138507201,7.82576078465793,101,"ENSG00000079974.19"
"34483","ENSG00000233143.4_614241",614233,614241,9,"ENSG00000233143.4",0,NA,"VVVUVVVVV",1,8,0.880745341614907,71,77,100,103,110,116,133,136,"ATGAGGG","CTGA","GGGTAGA","CTGT",2.28604462191045,23,7,17,56,1.97062258647576,4.30273001646969,7.82571138292931,101,"ENSG00000079974.19"
"28777","ENSG00000196482.18_36376",36368,36376,9,"ENSG00000196482.18",1,7,"VVVVVUMVV",1,7,0.807453416149068,114,120,133,136,142,148,171,174,"CTGATAT","ATGA","GTGCTAA","CTGA",2.40669114467659,13,6,23,51,2.33859485386565,4.59580062126073,7.82561428585701,101,"ENSG00000079974.19"
"36065","ENSG00000237833.1_586",578,586,9,"ENSG00000237833.1",1,8,"VVVVVUVMV",1,7,0.806211180124224,114,120,133,136,154,160,171,174,"CAGATGA","AAGA","GTAAAGA","CTGA",2.40724600548054,13,18,11,51,2.35463651274193,4.60073580398638,7.82558052448328,101,"ENSG00000079974.19"
"26916","ENSG00000185278.16_12339",12331,12339,9,"ENSG00000185278.16",0,NA,"VVUVVUVVV",2,7,0.805797101449275,114,120,133,136,144,150,158,161,"ATTAGAA","TTGA","GTCAAGA","CTGA",2.30806935486757,13,8,8,38,3.0222337442241,4.60234069416864,7.82552909996574,101,"ENSG00000079974.19"
"17884","ENSG00000155657.29_69374",69366,69374,9,"ENSG00000155657.29",1,1,"MVVVUVVVV",1,7,0.795859213250517,112,118,133,136,153,159,178,181,"ATCATGA","TGGA","GTGCTAA","CTGA",2.49832209126385,15,17,19,60,1.91285851043023,4.64208477971397,7.82552163271604,101,"ENSG00000079974.19"
"1722","ENSG00000065609.15_55500",55492,55500,9,"ENSG00000065609.15",1,1,"MVVVUUVVV",2,6,0.718012422360248,115,121,133,136,140,146,178,181,"CTGTTGA","CTGA","GTGATTA","CTGA",2.68274207738084,12,4,32,57,1.92827126502202,4.95330461189024,7.82535430133123,101,"ENSG00000079974.19"
"6126","ENSG00000108061.13_18647",18639,18647,9,"ENSG00000108061.13",1,6,"UVVVVMVVV",1,7,0.805383022774327,79,85,98,101,104,110,133,136,"ATGGTGA","CTGA","CTGAAAA","CTGC",2.45370767575469,13,3,23,48,2.05702938586998,4.60377013939198,7.82530223048929,101,"ENSG00000079974.19"
"41465","ENSG00000259070.9_122707",122699,122707,9,"ENSG00000259070.9",1,8,"VVVVVUVMV",1,7,0.806211180124224,106,112,133,136,183,189,199,202,"AGGATGA","GTGA","GTTTAGA","CTGA",2.54849520696038,21,47,10,87,1.4114921909116,4.60036505932854,7.82520977982543,101,"ENSG00000079974.19"
"25234","ENSG00000180096.13_3395",3387,3395,9,"ENSG00000180096.13",1,6,"VVVVVMUVV",1,7,0.788819875776397,86,92,102,105,112,118,133,136,"ATGATAA","TTGA","AGGATGA","CTTA",2.38781912871138,10,7,15,41,2.7605648588743,4.66983976257087,7.82511926567646,101,"ENSG00000079974.19"
"23343","ENSG00000172673.12_90101",90093,90101,9,"ENSG00000172673.12",0,NA,"UVVUVVVVV",2,7,0.78343685300207,94,100,107,110,116,122,133,136,"AGGATTA","GTGA","ATGGATA","CTGA",2.39633824230342,7,6,11,33,2.78957949917831,4.69129194530028,7.82503935730856,101,"ENSG00000079974.19"
"15639","ENSG00000148948.8_745918",745910,745918,9,"ENSG00000148948.8",1,2,"VMVVVUVVV",1,7,0.806211180124223,68,74,88,91,98,104,133,136,"CAGATGA","GCGA","TTGAAGA","CTGA",2.44310639261987,14,7,29,59,2.11282036450435,4.60004907882587,7.82489379932276,101,"ENSG00000079974.19"
"40854","ENSG00000257986.3_114479",114471,114479,9,"ENSG00000257986.3",1,1,"MVVVUVVVV",1,7,0.795859213250517,111,117,133,136,147,153,164,167,"ATGCTGA","ATAA","ATTATAT","CTGA",2.3856403933518,16,11,11,47,2.66153838573431,4.64145191868657,7.82488877168864,101,"ENSG00000079974.19"
"40385","ENSG00000255872.3_413359",413351,413359,9,"ENSG00000255872.3",1,6,"VVVUVMVVV",1,7,0.78343685300207,96,102,133,136,140,146,176,179,"ATGATGA","CTGA","CTGATGC","TTGA",2.66520873552124,31,4,30,74,0.99645576627943,4.69112850077192,7.8248759127802,101,"ENSG00000079974.19"
"37426","ENSG00000248148.1_29183",29175,29183,9,"ENSG00000248148.1",1,2,"VMVUVVVVV",1,7,0.764803312629399,76,82,96,99,114,120,133,136,"ATGATGA","ATGA","AAGAAGA","CAGA",2.49378480007587,14,15,13,51,2.43732462113901,4.7656391554112,7.8248524059288,101,"ENSG00000079974.19"
"47804","ENSG00000289368.2_159528",159520,159528,9,"ENSG00000289368.2",1,3,"VVMVVVUVV",1,7,0.768944099378882,111,117,133,136,141,147,165,168,"ATGCTGA","GTGT","GTGATTT","CTGA",2.48825863659504,16,5,18,48,2.40725549352949,4.74891160104077,7.8246879985563,101,"ENSG00000079974.19"
"29234","ENSG00000197549.10_3225",3217,3225,9,"ENSG00000197549.10",1,6,"VVVUVMVVV",1,7,0.78343685300207,43,49,66,69,80,86,133,136,"ATGCTGG","CTGA","GTTATGC","CTGA",2.57527739895859,17,11,47,84,1.59489260011678,4.69085214829351,7.8245995603018,101,"ENSG00000079974.19"
"48276","ENSG00000290847.1_51731",51723,51731,9,"ENSG00000290847.1",1,6,"VVVUVMVVV",1,7,0.78343685300207,43,49,66,69,80,86,133,136,"ATGCTGG","CTGA","GTTATGC","CTGA",2.57527739895859,17,11,47,84,1.59489260011678,4.69085214829351,7.8245995603018,101,"ENSG00000079974.19"
"19036","ENSG00000160293.17_199707",199699,199707,9,"ENSG00000160293.17",1,1,"MVVVVUVVV",1,7,0.82815734989648,115,121,133,136,142,148,172,175,"GTGATGG","GTGG","GCCAGGA","CTGA",2.36244301429783,12,6,24,51,2.29825570695427,4.51196895056828,7.8245983501542,101,"ENSG00000079974.19"
"5208","ENSG00000103942.13_107219",107211,107219,9,"ENSG00000103942.13",1,2,"UMVVVVVVV",1,7,0.786749482401656,114,120,133,136,148,154,185,188,"TTGATGA","TTGT","ATGGTGG","CTGA",2.52626170742656,13,12,31,65,1.86862479990748,4.67759237902113,7.82459030862776,101,"ENSG00000079974.19"
"24320","ENSG00000175779.5_80288",80280,80288,9,"ENSG00000175779.5",1,1,"MVVUVVVVV",1,7,0.786749482401656,89,95,133,136,145,151,167,170,"TTGTTGA","CAGA","TTGAGGA","CTGA",2.54967843745046,38,9,16,72,1.71209206076649,4.67748707760905,7.82448500721568,101,"ENSG00000079974.19"
"13378","ENSG00000141293.16_250927",250919,250927,9,"ENSG00000141293.16",1,6,"VVVVVMUVV",1,7,0.788819875776397,113,119,133,136,149,155,164,167,"CTGGTGA","CAGT","GTGGAGA","CTGA",2.4020716259018,14,13,9,45,2.66270089533493,4.66912793367007,7.82440743677566,101,"ENSG00000079974.19"
"2466","ENSG00000075151.24_112353",112345,112353,9,"ENSG00000075151.24",0,NA,"VVVVVUUVV",2,7,0.808281573498965,54,60,76,79,86,92,133,136,"ATGACTA","CTGA","ATCAGTA","CTGA",2.47651943580843,16,7,41,73,1.85465757286937,4.59119678623139,7.82432308022725,101,"ENSG00000079974.19"
"9375","ENSG00000124299.16_81189",81181,81189,9,"ENSG00000124299.16",1,7,"VVVVVUMVV",1,7,0.807453416149068,115,121,133,136,154,160,178,181,"AGGATGA","TTGC","GTGAGAC","CTGA",2.45535671881642,12,18,18,57,2.00897062613614,4.5945038545614,7.82431751915767,101,"ENSG00000079974.19"
"16366","ENSG00000151413.17_237285",237277,237285,9,"ENSG00000151413.17",1,3,"VVMVVUVVV",1,7,0.804968944099379,112,118,133,136,161,167,175,178,"ATGAAGA","CTTA","ATGATGA","TTGA",2.4606313843727,15,25,8,57,2.01351850170517,4.60443193271412,7.82430770911164,101,"ENSG00000079974.19"
"42774","ENSG00000266602.2_325431",325423,325431,9,"ENSG00000266602.2",1,8,"VVUVVVVMV",1,7,0.767701863354037,84,90,101,104,115,121,133,136,"GTGATCA","CTGG","ATATTGC","CTGA",2.43494358257634,11,11,12,43,2.78034280521069,4.75332500559657,7.82413245901272,101,"ENSG00000079974.19"
"7201","ENSG00000113296.14_22549",22541,22549,9,"ENSG00000113296.14",1,5,"VVVVMUVVV",1,7,0.808695652173913,50,56,75,78,86,92,133,136,"ATAATAA","GTGA","ATGATGT","CTGA",2.51654276890129,19,8,41,77,1.58025864454622,4.58930260930538,7.82408521800103,101,"ENSG00000079974.19"
"17490","ENSG00000154240.17_128937",128929,128937,9,"ENSG00000154240.17",1,8,"VVVVVUVMV",1,7,0.806211180124224,51,57,70,73,76,82,133,136,"ATGATGA","CTGT","GTGGTGG","TTGA",2.5047828019218,13,3,51,76,1.69840733533823,4.59923983703756,7.82408455753446,101,"ENSG00000079974.19"
"12632","ENSG00000138735.16_9778",9770,9778,9,"ENSG00000138735.16",1,8,"VVUVVVVMV",1,7,0.767701863354037,114,120,133,136,145,151,166,169,"ATGACTA","TTGA","AAGAGGA","CTGA",2.43684410262167,13,9,15,46,2.76741358991009,4.75326023518031,7.82406768859646,101,"ENSG00000079974.19"
"12042","ENSG00000136929.13_3914",3906,3914,9,"ENSG00000136929.13",1,1,"MVVVVUVVV",1,7,0.82815734989648,110,116,133,136,144,150,185,188,"AGAATGA","CTCT","ATGATGA","CTGA",2.43765962495653,17,8,35,69,1.79466487139373,4.51143225944265,7.82406165902857,101,"ENSG00000079974.19"
"18167","ENSG00000156395.14_138214",138206,138214,9,"ENSG00000156395.14",1,1,"MVVVUVVVV",1,7,0.795859213250517,114,120,133,136,187,193,204,207,"ATGTTGA","CTTC","GTGAAGG","CTGA",2.48705212308279,13,51,11,84,1.98205796575043,4.64060136324226,7.82403821624433,101,"ENSG00000079974.19"
"45504","ENSG00000285666.1_25464",25456,25464,9,"ENSG00000285666.1",0,NA,"UVVVVVUVV",2,7,0.788819875776397,79,85,98,101,107,113,133,136,"GTGATGA","CTAA","ATGTTGG","CTGG",2.42659928491469,13,6,20,48,2.49767175407711,4.66875008004376,7.82402958314935,101,"ENSG00000079974.19"
"45653","ENSG00000285782.2_4257",4249,4257,9,"ENSG00000285782.2",0,NA,"UVVVVVUVV",2,7,0.788819875776397,79,85,98,101,107,113,133,136,"GTGATGA","CTAA","ATGTTGG","CTGG",2.42659928491469,13,6,20,48,2.49767175407711,4.66875008004376,7.82402958314935,101,"ENSG00000079974.19"
"5281","ENSG00000104237.11_293287",293279,293287,9,"ENSG00000104237.11",1,6,"VVVUVMVVV",1,7,0.78343685300207,116,122,133,136,138,144,154,157,"CTGAAGG","ATGA","ATGAGAA","CTGA",2.40061745454327,11,2,10,32,2.75657841726969,4.69017369522287,7.82392110723115,101,"ENSG00000079974.19"
"13483","ENSG00000141564.16_256402",256394,256402,9,"ENSG00000141564.16",0,NA,"VVVVUUVVV",2,7,0.812008281573499,111,117,133,136,147,153,165,168,"ATGATAG","TTTA","ATGGTGC","CTGA",2.35058032792891,16,11,12,48,2.63288850677677,4.57585600657571,7.82388913286971,101,"ENSG00000079974.19"
"37902","ENSG00000249102.3_15728",15720,15728,9,"ENSG00000249102.3",0,NA,"VVVUVVVVV",1,8,0.880745341614907,112,118,133,136,179,185,195,198,"ATGTAGA","TAGA","CTTGTGA","CTGA",2.29351211168326,15,43,10,77,1.9134376067655,4.30087958783015,7.82386095428977,101,"ENSG00000079974.19"
"37872","ENSG00000248994.2_52253",52245,52253,9,"ENSG00000248994.2",1,2,"VMVVVUVVV",1,7,0.806211180124223,109,115,133,136,158,164,179,182,"ATGATGA","CTCA","GTGGGGA","CTTA",2.50635998001846,18,22,15,64,1.68695862468134,4.59900628953443,7.82385101003133,101,"ENSG00000079974.19"
"14790","ENSG00000145907.16_27568",27560,27568,9,"ENSG00000145907.16",1,1,"MVVVUUVVV",2,6,0.718012422360248,60,66,75,78,89,95,133,136,"ATGATGA","TTGA","TCGATGT","CTGA",2.71581453167811,9,11,38,67,1.70156460344823,4.95174870365891,7.8237983930999,101,"ENSG00000079974.19"
"45076","ENSG00000284977.3_61564",61556,61564,9,"ENSG00000284977.3",1,5,"UVVVMVVVV",1,7,0.789233954451346,109,115,133,136,145,151,171,174,"TTGATGT","CTAA","TTAATGG","CTGA",2.48011242888081,18,9,20,56,2.13334304014406,4.66685647483737,7.82379229264276,101,"ENSG00000079974.19"
"45129","ENSG00000285082.3_116797",116789,116797,9,"ENSG00000285082.3",1,5,"UVVVMVVVV",1,7,0.789233954451346,109,115,133,136,145,151,171,174,"TTGATGT","CTAA","TTAATGG","CTGA",2.48011242888081,18,9,20,56,2.13334304014406,4.66685647483737,7.82379229264276,101,"ENSG00000079974.19"
"15659","ENSG00000149090.13_30553",30545,30553,9,"ENSG00000149090.13",1,1,"MVVUVVVVV",1,7,0.786749482401656,115,121,133,136,156,162,209,212,"ATAATGA","CAGA","GTAAAGA","CTGA",2.61360089687177,12,20,47,88,1.28298939978291,4.67674884473201,7.82374677433864,101,"ENSG00000079974.19"
"15661","ENSG00000149090.13_30629",30621,30629,9,"ENSG00000149090.13",1,1,"MVVUVVVVV",1,7,0.786749482401656,39,45,57,60,80,86,133,136,"ATAATGA","CAGA","GTAAAGA","CTGA",2.61360089687177,12,20,47,88,1.28298939978291,4.67674884473201,7.82374677433864,101,"ENSG00000079974.19"
"47754","ENSG00000289195.1_5923",5915,5923,9,"ENSG00000289195.1",0,NA,"UVUVVVVVV",2,7,0.786335403726708,95,101,111,114,116,122,133,136,"TTGTTGA","ATGA","ATACTGG","CTGA",2.40400119731921,10,2,11,32,2.68688258497362,4.67838930844209,7.82373092334893,101,"ENSG00000079974.19"
"30207","ENSG00000204131.10_155495",155487,155495,9,"ENSG00000204131.10",1,8,"VVVVVUVMV",1,7,0.806211180124224,69,75,88,91,102,108,133,136,"AAGATGT","CTCA","ATTATTA","CTGA",2.44375988717181,13,11,25,58,2.10374511630003,4.59886942436135,7.82371414485825,101,"ENSG00000079974.19"
"8154","ENSG00000117036.12_12303",12295,12303,9,"ENSG00000117036.12",0,NA,"VVVUVVUVV",2,7,0.766873706004141,114,120,133,136,142,148,164,167,"GTGAAGA","TAGA","ATGACAA","CTGA",2.44172117775357,13,6,16,44,2.74664955069004,4.75619768392846,7.82369250794502,101,"ENSG00000079974.19"
"22592","ENSG00000170927.15_14745",14737,14745,9,"ENSG00000170927.15",0,NA,"VVVVUUVVV",2,7,0.812008281573499,103,109,133,136,158,164,172,175,"GTGTTGA","CTAA","ATGAAGC","CTGA",2.53513296856305,24,22,8,63,1.40167217140195,4.57563965712224,7.82367278341624,101,"ENSG00000079974.19"
"2647","ENSG00000077092.20_668178",668170,668178,9,"ENSG00000077092.20",1,2,"VMVUVVVVV",1,7,0.764803312629399,115,121,133,136,141,147,164,167,"GAGATGT","CTGA","AAGATCT","CTGA",2.46242209702645,12,5,17,43,2.64161687617601,4.76444104742143,7.82365429793902,101,"ENSG00000079974.19"
"23712","ENSG00000173611.18_88148",88140,88148,9,"ENSG00000173611.18",1,8,"UVVVVVVMV",1,7,0.786749482401656,71,77,92,95,104,110,133,136,"ATGATGG","CAGA","GTGATGG","ATGA",2.47313372085414,15,9,23,56,2.21875753828843,4.676578919329,7.82357684893563,101,"ENSG00000079974.19"
"32365","ENSG00000226846.2_133652",133644,133652,9,"ENSG00000226846.2",1,1,"MVVVVVUVV",1,7,0.792132505175983,112,118,133,136,139,145,154,157,"GTGCTGA","GAGA","ATGAGAT","CTGA",2.38625639679979,15,3,9,36,2.71154812569429,4.65498102608989,7.82351104679382,101,"ENSG00000079974.19"
"25151","ENSG00000179818.17_139169",139161,139169,9,"ENSG00000179818.17",1,8,"UVVVVVVMV",1,7,0.786749482401656,98,104,133,136,157,163,181,184,"GTGATGG","TTGA","GTGATGT","CTGA",2.66593576706311,29,21,18,77,0.9330616199008,4.67649168341371,7.82348961302034,101,"ENSG00000079974.19"
"27877","ENSG00000187546.14_218474",218466,218474,9,"ENSG00000187546.14",1,5,"UVVVMVVVV",1,7,0.789233954451346,71,77,90,93,102,108,133,136,"TTGATGT","TTGA","ATTATAT","CTGA",2.46694880374128,13,9,25,56,2.21925648892861,4.66639546180096,7.82333127960634,101,"ENSG00000079974.19"
"24142","ENSG00000175267.15_21710",21702,21710,9,"ENSG00000175267.15",1,1,"MVVVVUVVV",1,7,0.82815734989648,64,70,87,90,110,116,133,136,"AAGATGA","CTGA","TTGATTT","CAGA",2.44680452629134,17,20,17,63,1.73060635349498,4.51065913219264,7.82328853177856,101,"ENSG00000079974.19"
"30303","ENSG00000204442.4_471030",471022,471030,9,"ENSG00000204442.4",0,NA,"VVVUVVVVV",1,8,0.880745341614907,101,107,133,136,143,149,197,200,"ATGTTGA","TTCA","ATGTTCT","CTGA",2.40955713356887,26,7,48,90,1.13746668778493,4.30029522789435,7.82327659435398,101,"ENSG00000079974.19"
"20974","ENSG00000166128.13_69933",69925,69933,9,"ENSG00000166128.13",1,8,"VVVVVUVMV",1,7,0.806211180124224,84,90,133,136,140,146,158,161,"ACGATGA","AAGA","TTGAGAA","CTGA",2.48957103075281,43,4,12,68,1.79627365933472,4.59835346608837,7.82319818658526,101,"ENSG00000079974.19"
"8164","ENSG00000117114.21_114432",114424,114432,9,"ENSG00000117114.21",0,NA,"VVVUVVVVV",1,8,0.880745341614907,116,122,133,136,158,164,184,187,"ATAATGA","TTGT","GTGATGT","TTGA",2.32591982926071,11,22,20,62,1.69471216949388,4.30021109114133,7.82319245760095,101,"ENSG00000079974.19"
"25542","ENSG00000182132.14_309602",309594,309602,9,"ENSG00000182132.14",1,8,"VVVVVVUMV",1,7,0.770186335403727,111,117,133,136,146,152,173,176,"AAGAAGA","CTGA","CAGATCA","CTGA",2.51594895000858,16,10,21,56,2.19641383076227,4.74235170770487,7.82309704931978,101,"ENSG00000079974.19"
"28618","ENSG00000196242.10_2449",2441,2449,9,"ENSG00000196242.10",1,8,"VVVVVUVMV",1,7,0.806211180124224,94,100,133,136,183,189,198,201,"GTGAGGA","CTGT","GTGTTGA","CTGA",2.60633333846374,33,47,9,98,1.01729032608985,4.59821147896203,7.82305619945892,101,"ENSG00000079974.19"
"683","ENSG00000024048.11_1450",1442,1450,9,"ENSG00000024048.11",1,1,"MVVVVUVVV",1,7,0.82815734989648,104,110,133,136,148,154,180,183,"GTGAGGA","ATGT","GTGAAGA","CTGA",2.51496490494887,23,12,26,70,1.2752156078645,4.51041207688091,7.82304147646683,101,"ENSG00000079974.19"
"25305","ENSG00000180694.14_121521",121513,121521,9,"ENSG00000180694.14",1,2,"UMVVVVVVV",1,7,0.786749482401656,112,118,133,136,142,148,159,162,"TTGATTT","CTGT","TTGTAGA","CTGA",2.37013921164461,15,6,11,41,2.90323199383234,4.67604001786577,7.8230379474724,101,"ENSG00000079974.19"
"42179","ENSG00000260989.1_4088",4080,4088,9,"ENSG00000260989.1",1,1,"MVVVVUVVV",1,7,0.82815734989648,116,122,133,136,142,148,190,193,"ATGCTGT","TTCA","CTGATGC","CTGA",2.4103963637659,11,6,42,68,1.97228757721232,4.51039916724625,7.82302856683217,101,"ENSG00000079974.19"
"33732","ENSG00000230975.1_5848",5840,5848,9,"ENSG00000230975.1",1,8,"VVVVVUVMV",1,7,0.806211180124224,115,121,133,136,142,148,161,164,"TTGAAGA","GGGA","GTACAGA","CTGA",2.31844709602027,12,6,13,40,2.93620699704671,4.59813024262879,7.82297496312568,101,"ENSG00000079974.19"
"18029","ENSG00000156026.15_117319",117311,117319,9,"ENSG00000156026.15",1,6,"UVVVVMVVV",1,7,0.805383022774327,97,103,133,136,144,150,164,167,"TTGATGA","AAGA","ATGGCTA","CTGA",2.47562091488182,30,8,14,61,1.90152877496688,4.60141705187809,7.8229491429754,101,"ENSG00000079974.19"
"20464","ENSG00000164900.5_14237",14229,14237,9,"ENSG00000164900.5",1,8,"VVUVVVVMV",1,7,0.767701863354037,110,116,133,136,144,150,174,177,"ATGAGGG","CTGT","ATGAGGA","CTGA",2.5429690744114,17,8,24,58,2.05542819890939,4.75213884041302,7.82294629382917,101,"ENSG00000079974.19"
"40198","ENSG00000255245.4_46269",46261,46269,9,"ENSG00000255245.4",1,8,"VVVVVUVMV",1,7,0.806211180124224,54,60,70,73,84,90,133,136,"CAGAGGA","CTGA","GTGAACA","CTGA",2.49401810066948,10,11,43,73,1.76555878705515,4.59808653121291,7.82293125170981,101,"ENSG00000079974.19"
"40630","ENSG00000257239.1_81966",81958,81966,9,"ENSG00000257239.1",1,6,"UVVVVMVVV",1,7,0.805383022774327,113,119,133,136,146,152,205,208,"ATAATAA","CTTA","CTGATGC","CTGA",2.48125372516419,14,10,53,86,1.86331165294429,4.60125078850972,7.82278287960703,101,"ENSG00000079974.19"
"1516","ENSG00000058673.17_33959",33951,33959,9,"ENSG00000058673.17",0,NA,"UVVVVUVVV",2,7,0.824844720496894,114,120,133,136,184,190,199,202,"GTTATGA","CCGA","ATGATGA","ATGA",2.41467688505431,13,48,9,79,1.99558332473248,4.52335730627364,7.82273618826122,101,"ENSG00000079974.19"
"40680","ENSG00000257315.4_33959",33951,33959,9,"ENSG00000257315.4",0,NA,"UVVVVUVVV",2,7,0.824844720496894,114,120,133,136,184,190,199,202,"GTTATGA","CCGA","ATGATGA","ATGA",2.41467688505431,13,48,9,79,1.99558332473248,4.52335730627364,7.82273618826122,101,"ENSG00000079974.19"
"3944","ENSG00000091157.15_185911",185903,185911,9,"ENSG00000091157.15",1,1,"MVVUVVVVV",1,7,0.786749482401656,113,119,133,136,186,192,203,206,"GTTATGA","CTCA","GTATTGA","CTGA",2.51286346057584,14,50,11,84,1.95052286964765,4.67573648503831,7.82273441464494,101,"ENSG00000079974.19"
"659","ENSG00000022840.17_7331",7323,7331,9,"ENSG00000022840.17",1,5,"UVVVMVVVV",1,7,0.789233954451346,95,101,133,136,138,144,156,159,"ATTATGA","AAGA","ATGAAGA","CTGA",2.57346365220277,32,2,12,55,1.50671573160119,4.66578501990492,7.8227208377103,101,"ENSG00000079974.19"
"38115","ENSG00000249614.2_22378",22370,22378,9,"ENSG00000249614.2",1,6,"UVVVVMVVV",1,7,0.805383022774327,112,118,133,136,141,147,164,167,"GTGATGG","AAGA","ATAATTC","CTGA",2.37927782470272,15,5,17,46,2.542672494596,4.60113116482021,7.82266325591752,101,"ENSG00000079974.19"
"14007","ENSG00000144229.13_554054",554046,554054,9,"ENSG00000144229.13",1,6,"VVVVVMUVV",1,7,0.788819875776397,115,121,133,136,143,149,159,162,"TTTATGA","CTGA","GTTATCA","CTGC",2.34141086721362,12,7,10,38,3.05995008775671,4.66733896729521,7.8226184704008,101,"ENSG00000079974.19"
"39681","ENSG00000254093.9_21419",21411,21419,9,"ENSG00000254093.9",1,8,"VVVVVUVMV",1,7,0.806211180124224,109,115,133,136,144,150,158,161,"TTTATGT","CTTA","GAGATCA","CTGA",2.36173524541062,18,8,8,43,2.6455246213703,4.59760656436027,7.82245128485717,101,"ENSG00000079974.19"
"41234","ENSG00000258724.1_21382",21374,21382,9,"ENSG00000258724.1",1,8,"VVVVVUVMV",1,7,0.806211180124224,109,115,133,136,144,150,158,161,"TTTATGT","CTTA","GAGATCA","CTGA",2.36173524541062,18,8,8,43,2.6455246213703,4.59760656436027,7.82245128485717,101,"ENSG00000079974.19"
"16877","ENSG00000152558.15_40713",40705,40713,9,"ENSG00000152558.15",1,3,"VVMVVUVVV",1,7,0.804968944099379,102,108,133,136,139,145,159,162,"AAGATGT","ATGA","GTCAGGA","CTGA",2.49986834622535,25,3,14,51,1.74446628383859,4.60256381466857,7.82243959106608,101,"ENSG00000079974.19"
"7936","ENSG00000116117.19_708208",708200,708208,9,"ENSG00000116117.19",0,NA,"VVUVVUVVV",2,7,0.805797101449275,111,117,133,136,144,150,158,161,"ATGATGA","AGGA","GAGTAGA","GTGA",2.33521273122533,16,8,8,41,2.82885170854667,4.59923414584554,7.82242255164264,101,"ENSG00000079974.19"
"14273","ENSG00000144642.22_915721",915713,915721,9,"ENSG00000144642.22",0,NA,"UVVVUVVVV",2,7,0.792546583850932,115,121,133,136,154,160,177,180,"TTGGTGA","CAGA","TTGGGGA","CTGA",2.4806994372788,12,18,17,56,2.07054159312879,4.65213446041353,7.82232079581725,101,"ENSG00000079974.19"
"44778","ENSG00000283563.1_1141334",1141326,1141334,9,"ENSG00000283563.1",0,NA,"UVVVUVVVV",2,7,0.792546583850932,115,121,133,136,154,160,177,180,"TTGGTGA","CAGA","TTGGGGA","CTGA",2.4806994372788,12,18,17,56,2.07054159312879,4.65213446041353,7.82232079581725,101,"ENSG00000079974.19"
"13633","ENSG00000142794.19_24443",24435,24443,9,"ENSG00000142794.19",1,2,"VMUVVVVVV",1,7,0.767701863354037,65,71,79,82,92,98,133,136,"ATTATGA","CTGG","GTGGCGA","CTGA",2.59854250921999,8,10,35,62,1.68234250164871,4.75148980744549,7.82229726086164,101,"ENSG00000079974.19"
"31216","ENSG00000219481.11_17395",17387,17395,9,"ENSG00000219481.11",1,2,"VMUVVVVVV",1,7,0.767701863354037,65,71,79,82,92,98,133,136,"ATTATGA","CTGG","GTGGCGA","CTGA",2.59854250921999,8,10,35,62,1.68234250164871,4.75148980744549,7.82229726086164,101,"ENSG00000079974.19"
"21720","ENSG00000168769.14_99404",99396,99404,9,"ENSG00000168769.14",1,2,"UMVVVUVVV",2,6,0.708902691511387,62,68,92,95,108,114,133,136,"ATTATGA","CTGA","ATGATTA","CTGA",2.76888476558775,24,13,19,65,1.48743584400887,4.98666690364846,7.82227766969401,101,"ENSG00000079974.19"
"11135","ENSG00000134028.14_13118",13110,13118,9,"ENSG00000134028.14",0,NA,"VVVUVVUVV",2,7,0.766873706004141,88,94,106,109,116,122,133,136,"AGGAGGA","CTAA","ATGTGGT","CTGA",2.39823801300411,12,7,11,39,3.03072645176272,4.75474496794752,7.82223979196409,101,"ENSG00000079974.19"
"45146","ENSG00000285095.2_240705",240697,240705,9,"ENSG00000285095.2",1,1,"MVVVVUVVV",1,7,0.82815734989648,82,88,133,136,142,148,162,165,"ATGGTGG","CTGG","TTTAAGA","CTGA",2.42745577764014,45,6,14,74,1.8553951925176,4.50960842752963,7.82223782711555,101,"ENSG00000079974.19"
"6115","ENSG00000108018.16_476989",476981,476989,9,"ENSG00000108018.16",1,2,"VMVVUVVVV",1,7,0.773913043478261,35,41,50,53,75,81,133,136,"TTGATGA","CAGA","GTGGAGA","CTGA",2.67974272677507,9,22,52,92,1.04134929931855,4.72657520278809,7.82222737670113,101,"ENSG00000079974.19"
"7588","ENSG00000114948.13_88088",88080,88088,9,"ENSG00000114948.13",1,2,"VMVVUVVVV",1,7,0.773913043478261,109,115,133,136,152,158,186,189,"GAGATGA","GTGA","GTGAAGA","CTGA",2.63644659121337,18,16,28,71,1.32952565347308,4.72645906539056,7.8221112393036,101,"ENSG00000079974.19"
"28551","ENSG00000196104.11_124932",124924,124932,9,"ENSG00000196104.11",1,1,"MVVVVUVVV",1,7,0.82815734989648,115,121,133,136,141,147,177,180,"AAAATGC","ATGA","ATGATGG","CTGA",2.39695297496136,12,5,30,56,2.05821752690684,4.50947600666231,7.82210540624823,101,"ENSG00000079974.19"
"39159","ENSG00000253154.4_99353",99345,99353,9,"ENSG00000253154.4",0,NA,"UVUVVVVVV",2,7,0.786335403726708,82,88,96,99,106,112,133,136,"GTGATGA","TTGT","ATACTTA","CTGA",2.476404996446,8,7,21,45,2.1974441328555,4.6767026939572,7.82204430886403,101,"ENSG00000079974.19"
"12435","ENSG00000138182.15_53008",53000,53008,9,"ENSG00000138182.15",1,8,"VVVVUVVMV",1,7,0.773913043478261,103,109,133,136,151,157,167,170,"ATGATGC","GAGA","GAGATGA","CTGA",2.57006032687665,24,15,10,58,1.771795040178,4.72638263817226,7.8220348120853,101,"ENSG00000079974.19"
"31534","ENSG00000224057.2_6310",6302,6310,9,"ENSG00000224057.2",1,1,"MVUVVVVVV",1,7,0.789648033126294,112,118,133,136,144,150,163,166,"ATGATGC","CTGT","GTGCTGC","CTGG",2.3748574973262,15,8,13,45,2.82126418526281,4.6634118751927,7.82200400769788,101,"ENSG00000079974.19"
"40019","ENSG00000254706.3_11324",11316,11324,9,"ENSG00000254706.3",1,8,"VVVVVVUMV",1,7,0.770186335403727,115,121,133,136,143,149,169,172,"ATAATGT","CTCA","AGGAAGA","CTGA",2.46699190094281,12,7,20,48,2.51839261260212,4.74125132138855,7.82199666300346,101,"ENSG00000079974.19"
"44264","ENSG00000280241.4_294628",294620,294628,9,"ENSG00000280241.4",1,2,"VMUVVVVVV",1,7,0.767701863354037,70,76,96,99,112,118,133,136,"ATGATGA","ATGA","GTGAAGT","ATGA",2.5504631301917,20,13,15,57,2.00159881434225,4.75117158723839,7.82197904065454,101,"ENSG00000079974.19"
"32906","ENSG00000228262.11_206276",206268,206276,9,"ENSG00000228262.11",1,3,"VVMVVVUVV",1,7,0.768944099378882,70,76,86,89,104,110,133,136,"GTGATCA","CTGC","GTCATGA","CTGA",2.57283131386207,10,15,23,57,1.83181432281159,4.74600577047301,7.82178216798854,101,"ENSG00000079974.19"
"9423","ENSG00000124570.21_6922",6914,6922,9,"ENSG00000124570.21",1,8,"UVVVVVVMV",1,7,0.786749482401656,60,66,92,95,109,115,133,136,"ATGGTGA","CTGG","GTGTCGA","CTGA",2.59598607575759,26,14,18,67,1.39245108871306,4.67475623177425,7.82175416138088,101,"ENSG00000079974.19"
"4416","ENSG00000100504.17_5768",5760,5768,9,"ENSG00000100504.17",1,2,"UMVVVVVVV",1,7,0.786749482401656,52,58,82,85,93,99,133,136,"ATGATCA","TTGA","TAGATGA","CTGA",2.61461099928192,24,8,34,75,1.26823768735257,4.67474442064134,7.82174235024796,101,"ENSG00000079974.19"
"11756","ENSG00000135976.21_107523",107515,107523,9,"ENSG00000135976.21",0,NA,"UVVVVVUVV",2,7,0.788819875776397,111,117,133,136,146,152,173,176,"ATTATGG","CTGC","GTCAGGA","CTGA",2.47034926671259,16,10,21,56,2.19641383076227,4.66635223554488,7.82163173865047,101,"ENSG00000079974.19"
"2103","ENSG00000070190.13_2497",2489,2497,9,"ENSG00000070190.13",1,8,"VVVVVUVMV",1,7,0.806211180124224,89,95,104,107,116,122,133,136,"GTGCTGG","CTGG","GGGGTGT","CTGA",2.3331305950122,9,9,11,38,2.83244385572892,4.59666195561924,7.82150667611613,101,"ENSG00000079974.19"
"17602","ENSG00000154639.19_41486",41478,41486,9,"ENSG00000154639.19",1,8,"VVVVVUVMV",1,7,0.806211180124224,114,120,133,136,145,151,173,176,"GGGATGA","GGGA","CCGAAGA","CTGA",2.40487052103314,13,9,22,53,2.35395841980873,4.59660714000742,7.82145186050431,101,"ENSG00000079974.19"
"39303","ENSG00000253438.5_644462",644454,644462,9,"ENSG00000253438.5",1,6,"VVUVVMVVV",1,7,0.786335403726708,114,120,133,136,171,177,191,194,"GTGATGG","CTGG","CTAATGG","CTGA",2.52259992496319,13,35,14,71,1.88685638601748,4.67604730477635,7.82138891968318,101,"ENSG00000079974.19"
"28081","ENSG00000188107.15_1973533",1973525,1973533,9,"ENSG00000188107.15",1,2,"UMVVVVVVV",1,7,0.786749482401656,77,83,104,107,116,122,133,136,"ATGTTTA","CTGA","GAATTGA","CTGA",2.45257604331572,21,9,11,50,2.34692391912416,4.67435771864058,7.8213556482472,101,"ENSG00000079974.19"
"37144","ENSG00000245662.4_46466",46458,46466,9,"ENSG00000245662.4",1,2,"VMVVVVUVV",1,7,0.770186335403727,110,116,133,136,139,145,163,166,"CTGATGG","GTGA","ATGCTGC","CTGA",2.53014956332804,17,3,18,47,2.09470646197714,4.74059255437435,7.82133789598926,101,"ENSG00000079974.19"
"1842","ENSG00000066468.24_50048",50040,50048,9,"ENSG00000066468.24",1,8,"VVVVVUVMV",1,7,0.806211180124224,110,116,133,136,167,173,186,189,"ATGAGGA","TTTA","GTGATTT","CTGA",2.50040199151204,17,31,13,70,1.71657721648086,4.59648095664029,7.82132567713718,101,"ENSG00000079974.19"
"42838","ENSG00000267109.1_1400",1392,1400,9,"ENSG00000267109.1",1,5,"VVUVMVVVV",1,7,0.770186335403727,102,108,133,136,139,145,153,156,"ATGACTA","GTGA","ATGATGA","CTGA",2.56551793054847,25,3,8,45,1.85881036801081,4.74056580958349,7.8213111511984,101,"ENSG00000079974.19"
"46544","ENSG00000286792.1_32039",32031,32039,9,"ENSG00000286792.1",1,8,"VVVUVVVMV",1,7,0.764803312629399,114,120,133,136,151,157,168,171,"AGGATGA","TTGG","GAGTTGA","CTGA",2.47667506861177,13,15,11,48,2.53706209726462,4.76205730533577,7.82127055585337,101,"ENSG00000079974.19"
"22921","ENSG00000171724.3_181264",181256,181264,9,"ENSG00000171724.3",1,2,"VMVVVVUVV",1,7,0.770186335403727,110,116,133,136,143,149,172,175,"ATAATGA","TTGA","GAGCTCA","CTGA",2.52721810841999,17,7,23,56,2.11368503261538,4.74045143885383,7.82119678046874,101,"ENSG00000079974.19"
"47057","ENSG00000287564.2_18955",18947,18955,9,"ENSG00000287564.2",0,NA,"UVVVVUVVV",2,7,0.824844720496894,82,88,104,107,116,122,133,136,"TTGGAGA","ATGA","CTTCTGA","CTGA",2.29590769229337,16,9,11,45,2.78027541315198,4.52158167377694,7.82096055576452,101,"ENSG00000079974.19"
"871","ENSG00000038532.17_123027",123019,123027,9,"ENSG00000038532.17",0,NA,"VVVVUUVVV",2,7,0.812008281573499,110,116,133,136,183,189,204,207,"AAGATGA","ATGC","GTGAGAA","CTGA",2.50767630707668,17,47,15,88,1.57380739808893,4.5729123613167,7.8209454876107,101,"ENSG00000079974.19"
"41451","ENSG00000259053.1_261881",261873,261881,9,"ENSG00000259053.1",1,1,"MVUVVVVVV",1,7,0.789648033126294,111,117,133,136,171,177,190,193,"TTGATAA","CTGA","GAGTTTA","CTGA",2.53084826622671,16,35,13,73,1.77690678157134,4.66230713910401,7.82089927160919,101,"ENSG00000079974.19"
"27800","ENSG00000187391.22_371906",371898,371906,9,"ENSG00000187391.22",1,8,"UVVVVVVMV",1,7,0.786749482401656,59,65,77,80,111,117,133,136,"TTTATGA","CTGA","GTCATCC","CTGA",2.53409909115184,12,31,16,68,1.8011315245791,4.67378136639785,7.82077929600447,101,"ENSG00000079974.19"
"23523","ENSG00000173157.18_113762",113754,113762,9,"ENSG00000173157.18",1,2,"VMVVVUVVV",1,7,0.806211180124223,94,100,133,136,168,174,185,188,"ATGATGC","CAGA","ATTTTGA","CTGA",2.60183885916363,33,32,11,85,1.03796930869784,4.59589042578051,7.82073514627741,101,"ENSG00000079974.19"
"47217","ENSG00000287862.1_161204",161196,161204,9,"ENSG00000287862.1",0,NA,"UVVVVUVVV",2,7,0.824844720496894,101,107,133,136,144,150,158,161,"ATAATGG","ATGG","TTGCTGA","CTGA",2.3976321833364,26,8,8,51,2.10085497009797,4.52126738141849,7.82064626340606,101,"ENSG00000079974.19"
"26609","ENSG00000184611.13_230473",230465,230473,9,"ENSG00000184611.13",1,7,"UVVVVVMVV",1,7,0.787991718426501,85,91,102,105,116,122,133,136,"AGTATGA","CTAA","GTTTGGA","CTGA",2.37923463462573,11,11,11,42,2.81308666297025,4.66866272345211,7.82062959715811,101,"ENSG00000079974.19"
"44197","ENSG00000279395.3_999",991,999,9,"ENSG00000279395.3",1,8,"VVVVUVVMV",1,7,0.773913043478261,82,88,106,109,116,122,133,136,"ATGCTGA","CTGA","AAGATGT","CTCA",2.43622444418029,18,7,11,45,2.65814522852365,4.72491038076473,7.82056255467778,101,"ENSG00000079974.19"
"16487","ENSG00000151690.15_96197",96189,96197,9,"ENSG00000151690.15",1,8,"UVVVVVVMV",1,7,0.786749482401656,111,117,133,136,139,145,168,171,"TTGAAGA","ATGA","GTGACAA","CTGA",2.51944422503288,16,3,23,51,1.89793918849085,4.67355850551085,7.82055643511748,101,"ENSG00000079974.19"
"35650","ENSG00000236548.3_292254",292246,292254,9,"ENSG00000236548.3",1,1,"MVVVVVUVV",1,7,0.792132505175983,89,95,133,136,157,163,171,174,"ATGATGA","CCAA","TTGAGGC","CTGA",2.60795271961574,38,21,8,76,1.22152879783411,4.65197006548475,7.82050008618869,101,"ENSG00000079974.19"
"28998","ENSG00000196912.13_54983",54975,54983,9,"ENSG00000196912.13",0,NA,"UVVVVVUVV",2,7,0.788819875776397,111,117,133,136,146,152,173,176,"ATCATGG","CTGC","GTCAGGA","CTGA",2.46964355041054,16,10,21,56,2.19641383076227,4.66517604170814,7.82045554481373,101,"ENSG00000079974.19"
"9302","ENSG00000123977.10_11453",11445,11453,9,"ENSG00000123977.10",1,2,"UMVVVVVVV",1,7,0.786749482401656,112,118,133,136,184,190,233,236,"TTGATGA","TTAA","GTGATGA","CTGA",2.66566579784363,15,48,43,115,0.92210220868045,4.6733018819095,7.82029981151613,101,"ENSG00000079974.19"
"21762","ENSG00000168904.15_133659",133651,133659,9,"ENSG00000168904.15",0,NA,"VVVVUUVVV",2,7,0.812008281573499,42,48,60,63,76,82,133,136,"ATGAAGA","CTGA","GTGGAGA","CTTA",2.48887777313809,12,13,51,85,1.69625576303343,4.57219356265518,7.82022668894918,101,"ENSG00000079974.19"
"3077","ENSG00000080709.16_406094",406086,406094,9,"ENSG00000080709.16",0,NA,"UVVVVVUVV",2,7,0.788819875776397,116,122,133,136,146,152,164,167,"ATGGTGG","AGGA","GTGACCA","CTGA",2.37168716484712,11,10,12,42,2.84848743502195,4.66493380016736,7.82021330327295,101,"ENSG00000079974.19"
"20470","ENSG00000164919.11_9403",9395,9403,9,"ENSG00000164919.11",1,1,"MVVVVUVVV",1,7,0.82815734989648,55,61,75,78,116,122,133,136,"ATTATAA","CTTA","TTGGTGT","CTGA",2.41044099509114,14,38,11,72,1.96070277942771,4.50757735334216,7.82020675292808,101,"ENSG00000079974.19"
"33988","ENSG00000231689.3_303268",303260,303268,9,"ENSG00000231689.3",0,NA,"UVVVVVUVV",2,7,0.788819875776397,116,122,133,136,138,144,159,162,"ATATAGA","CTGA","GTGAAAA","CTGA",2.43952207986038,11,2,15,37,2.39598293789928,4.66486586757546,7.82014537068105,101,"ENSG00000079974.19"
"7034","ENSG00000112541.19_336754",336746,336754,9,"ENSG00000112541.19",1,8,"VVVUVVVMV",1,7,0.764803312629399,115,121,133,136,140,146,161,164,"ATGATTA","CTTG","ATGACTA","CTGA",2.4533386083566,12,4,15,40,2.68813347869659,4.76093105026848,7.82014430078608,101,"ENSG00000079974.19"
"22868","ENSG00000171587.15_712578",712570,712578,9,"ENSG00000171587.15",1,6,"UVVVVMVVV",1,7,0.805383022774327,96,102,133,136,143,149,175,178,"AAGATGA","GTGA","TTAAAGA","CTGA",2.56889303068389,31,7,26,73,1.26842950472979,4.5985957606556,7.82012785175291,101,"ENSG00000079974.19"
"48231","ENSG00000290705.1_3825",3817,3825,9,"ENSG00000290705.1",1,1,"MVVVUVVVV",1,7,0.795859213250517,116,122,133,136,172,178,190,193,"ATGAAGG","CTGC","GTGGGGA","CTGA",2.48963040167606,11,36,12,68,1.94921375138462,4.63668744063959,7.82012429364166,101,"ENSG00000079974.19"
"43039","ENSG00000267686.2_1744",1736,1744,9,"ENSG00000267686.2",1,7,"VVVVUVMVV",1,7,0.775155279503105,72,78,92,95,109,115,133,136,"ATGATGA","CAGA","TTGAGAA","CTTA",2.49826392244649,14,14,18,55,2.2227923270347,4.71947128583617,7.82009240384859,101,"ENSG00000079974.19"
"15569","ENSG00000148735.16_21268",21260,21268,9,"ENSG00000148735.16",0,NA,"VVVVUUVVV",2,7,0.812008281573499,116,122,133,136,178,184,199,202,"TTGATCA","CTTA","ATGGTGG","CTGA",2.47363240633301,11,42,15,77,1.79680466538679,4.57192184356838,7.81995496986237,101,"ENSG00000079974.19"
"48499","ENSG00000291185.1_43101",43093,43101,9,"ENSG00000291185.1",0,NA,"UVVVVUVVV",2,7,0.824844720496894,100,106,133,136,144,150,173,176,"ATGATGC","GTTA","CTGGAGA","CTGA",2.49513664693889,27,8,23,67,1.44798024076838,4.52055613842358,7.81993502041116,101,"ENSG00000079974.19"
"27975","ENSG00000187764.12_137134",137126,137134,9,"ENSG00000187764.12",1,3,"VVMVVVUVV",1,7,0.768944099378882,116,122,133,136,157,163,179,182,"CTGATGA","ATGG","GTGCTGT","CTGA",2.55067337952553,11,21,16,57,1.97169347106796,4.74404566697621,7.81982206449173,101,"ENSG00000079974.19"
"28737","ENSG00000196405.13_5579",5571,5579,9,"ENSG00000196405.13",1,2,"VMUVVVVVV",1,7,0.767701863354037,74,80,90,93,99,105,133,136,"TAGATGG","CTGA","CTGATTA","CTGA",2.53772721203914,10,6,28,53,2.07779421605376,4.748993907412,7.81980136082815,101,"ENSG00000079974.19"
"47985","ENSG00000289907.1_16705",16697,16705,9,"ENSG00000289907.1",1,7,"UVVVVVMVV",1,7,0.787991718426501,101,107,133,136,168,174,186,189,"TTGATGA","GTGA","GGGGTGA","CTGA",2.63166214462847,26,32,12,79,1.12691634074278,4.66783265956647,7.81979953327248,101,"ENSG00000079974.19"
"12280","ENSG00000137776.17_6032",6024,6032,9,"ENSG00000137776.17",1,5,"UVVVMVVVV",1,7,0.789233954451346,113,119,133,136,145,151,159,162,"AGCATGG","CTCA","TTGTTGA","CTGA",2.35845911136071,14,9,8,40,2.92774994011655,4.66270267063032,7.8196384884357,101,"ENSG00000079974.19"
"33899","ENSG00000231424.3_360210",360202,360210,9,"ENSG00000231424.3",1,8,"UVVVVVVMV",1,7,0.786749482401656,114,120,133,136,137,143,151,154,"ATGATGA","TTCA","GTGTGGA","ATGA",2.41160501362707,13,1,8,31,2.6131738857098,4.6726351608059,7.81963309041253,101,"ENSG00000079974.19"
"22522","ENSG00000170743.17_194029",194021,194029,9,"ENSG00000170743.17",0,NA,"VVUVVUVVV",2,7,0.805797101449275,116,122,133,136,145,151,171,174,"CTCATGG","CTTA","CAGATGA","CTGA",2.39141794725502,11,9,20,49,2.44298661979725,4.59644323370767,7.81963163950477,101,"ENSG00000079974.19"
"31112","ENSG00000215765.3_72725",72717,72725,9,"ENSG00000215765.3",1,8,"VVUVVVVMV",1,7,0.767701863354037,112,118,133,136,143,149,173,176,"CTGATGA","GGGA","TTGACAA","CTGA",2.5157955339077,15,7,24,55,2.22332493913863,4.74882379129748,7.81963124471363,101,"ENSG00000079974.19"
"23230","ENSG00000172345.14_4094",4086,4094,9,"ENSG00000172345.14",1,8,"VVVVVUVMV",1,7,0.806211180124224,113,119,133,136,159,165,179,182,"GGGATGA","CAGC","GTGTGGA","CTGA",2.45557685158146,14,23,14,60,2.00832594184434,4.59470957143019,7.81955429192708,101,"ENSG00000079974.19"
"40191","ENSG00000255240.6_18825",18817,18825,9,"ENSG00000255240.6",0,NA,"UVVUVVVVV",2,7,0.78343685300207,114,120,133,136,144,150,163,166,"AGGATGT","CAGC","CTGGAGA","CTGA",2.37436553484836,13,8,13,43,2.91376640783383,4.68571749337238,7.81946490538067,101,"ENSG00000079974.19"
"37732","ENSG00000248738.6_6282",6274,6282,9,"ENSG00000248738.6",1,7,"VVVVUVMVV",1,7,0.775155279503105,93,99,133,136,143,149,158,161,"AAGATGA","GTTA","TTGAAGA","CTGA",2.52969707628143,34,7,9,59,2.01071071865775,4.71883947346682,7.81946059147925,101,"ENSG00000079974.19"
"3097","ENSG00000081052.14_147099",147091,147099,9,"ENSG00000081052.14",0,NA,"VVVVVUUVV",2,7,0.808281573498965,67,73,86,89,103,109,133,136,"TTGATGT","CTTA","GTAGGGA","CTGA",2.46193831766071,13,14,24,60,1.93221300727217,4.58628378125256,7.81941007524842,101,"ENSG00000079974.19"
"6224","ENSG00000108684.15_520925",520917,520925,9,"ENSG00000108684.15",1,1,"MVVVVUVVV",1,7,0.82815734989648,83,89,105,108,111,117,133,136,"TAGATGA","CTGA","ATGTTAA","CTGC",2.35816388081296,16,3,16,44,2.30599388531524,4.50677160601708,7.819401005603,101,"ENSG00000079974.19"
"21824","ENSG00000169083.18_26626",26618,26626,9,"ENSG00000169083.18",1,8,"VVVVVUVMV",1,7,0.806211180124224,115,121,133,136,140,146,159,162,"TTGATGG","TTTA","GTACTGC","CTGA",2.3341134155331,12,4,13,38,2.8168696944754,4.59440644950735,7.81925117000425,101,"ENSG00000079974.19"
"12652","ENSG00000138759.20_349590",349582,349590,9,"ENSG00000138759.20",1,7,"VVVVVUMVV",1,7,0.807453416149068,66,72,92,95,104,110,133,136,"AAGTTGA","CTGA","ATGCTCC","CTGA",2.48369848986248,20,9,23,61,1.79961217025853,4.58940052566877,7.81921419026504,101,"ENSG00000079974.19"
"1555","ENSG00000060709.16_367811",367803,367811,9,"ENSG00000060709.16",1,1,"MVVVVUVVV",1,7,0.82815734989648,116,122,133,136,153,159,168,171,"TAAATGA","CTGG","CTGAAGC","CTGA",2.34309585755774,11,17,9,46,2.40566913756503,4.50657704698749,7.81920644657342,101,"ENSG00000079974.19"
"13997","ENSG00000144229.13_18240",18232,18240,9,"ENSG00000144229.13",0,NA,"VVVUVUVVV",2,7,0.802898550724638,111,117,133,136,146,152,160,163,"AGGAAGA","CTGA","CTGGTGA","CTGT",2.35522776721171,16,10,8,43,2.7286426117718,4.60754026496247,7.81913446786102,101,"ENSG00000079974.19"
"18868","ENSG00000159023.23_156275",156267,156275,9,"ENSG00000159023.23",1,6,"UVVVVMVVV",1,7,0.805383022774327,28,34,47,50,88,94,133,136,"TTGAGGA","CTGA","CTGGGGA","CTGA",2.6037781452059,13,38,39,99,1.03165382548819,4.59754369838188,7.81907578947919,101,"ENSG00000079974.19"
"21266","ENSG00000166948.10_29381",29373,29381,9,"ENSG00000166948.10",1,2,"UMVVVVVVV",1,7,0.786749482401656,110,116,133,136,166,172,183,186,"GTAATGA","CTAA","GGGAAGA","CTGA",2.53445556435927,17,30,11,67,1.79182311381668,4.67204838571962,7.81904631532625,101,"ENSG00000079974.19"
"5818","ENSG00000106780.9_67146",67138,67146,9,"ENSG00000106780.9",1,8,"VVUVVVVMV",1,7,0.767701863354037,90,96,105,108,116,122,133,136,"ATGTTAA","CAGA","TTGTTCA","CTGA",2.41580751200843,9,8,11,37,2.88752415993942,4.74822689333224,7.81903434674839,101,"ENSG00000079974.19"
"34970","ENSG00000234497.5_41518",41510,41518,9,"ENSG00000234497.5",1,1,"MVVVVUVVV",1,7,0.82815734989648,116,122,133,136,166,172,187,190,"TTGATTT","CAGA","TTGCTGA","CTGA",2.42735705996853,11,30,15,65,1.8429426537234,4.5063307633784,7.81896016296432,101,"ENSG00000079974.19"
"37541","ENSG00000248431.2_1298",1290,1298,9,"ENSG00000248431.2",1,2,"VMVUVVVVV",1,7,0.764803312629399,84,90,100,103,115,121,133,136,"AACATGA","GTGA","ATGATAT","CTGA",2.45742680969933,10,12,12,43,2.65560349243988,4.75961222260884,7.81882547312644,101,"ENSG00000079974.19"
"3845","ENSG00000089250.20_5138",5130,5138,9,"ENSG00000089250.20",1,8,"VVVVVUVMV",1,7,0.806211180124224,89,95,109,112,113,119,133,136,"ATGGTGG","ATGA","GAGAAGC","CTGA",2.42323703292546,14,1,14,38,2.22078621623475,4.59392494226779,7.81876966276469,101,"ENSG00000079974.19"
"7022","ENSG00000112531.17_131182",131174,131182,9,"ENSG00000112531.17",1,8,"VVVVVVUMV",1,7,0.770186335403727,114,120,133,136,149,155,167,170,"ATGATGG","CTGC","GTGCTGA","GTGA",2.44522053394337,13,13,12,47,2.65060692815329,4.73801928861061,7.81876463022552,101,"ENSG00000079974.19"
"46990","ENSG00000287462.1_452",444,452,9,"ENSG00000287462.1",0,NA,"UVVVVUVVV",2,7,0.824844720496894,111,117,133,136,145,151,160,163,"AGGAGCA","CAGA","TTGAGCA","CTGA",2.29170634662286,16,9,9,43,2.79948611067674,4.51938210537396,7.81876098736154,101,"ENSG00000079974.19"
"41801","ENSG00000259754.2_31702",31694,31702,9,"ENSG00000259754.2",1,2,"UMVVVVVVV",1,7,0.786749482401656,110,116,133,136,149,155,167,170,"AAGAAGA","CTGG","GTCAAGA","CTGA",2.44189047742461,17,13,12,51,2.40768236343698,4.67173805323359,7.81873598284022,101,"ENSG00000079974.19"
"16652","ENSG00000151962.8_32151",32143,32151,9,"ENSG00000151962.8",1,2,"VMVVVUVVV",1,7,0.806211180124223,18,24,40,43,85,91,133,136,"ATTATGA","CTGA","ATAATTT","CTGA",2.62783746829045,16,42,42,109,0.856611652674936,4.59388202698615,7.81872674748304,101,"ENSG00000079974.19"
"16732","ENSG00000152208.13_159168",159160,159168,9,"ENSG00000152208.13",1,7,"UVVVVVMVV",1,7,0.787991718426501,103,109,133,136,153,159,174,177,"ATGATGC","CTAA","GTGTAAA","CTGA",2.58056226341895,24,17,15,65,1.46322211517575,4.66674263449219,7.81870950819819,101,"ENSG00000079974.19"
"2886","ENSG00000079101.18_48036",48028,48036,9,"ENSG00000079101.18",1,8,"UVVVVUVMV",2,6,0.708902691511387,66,72,87,90,108,114,133,136,"ATGATGA","CTGC","CTCAAGA","CTGA",2.71121101545851,15,18,19,61,1.85750138415157,4.98306037180208,7.81867113784763,101,"ENSG00000079974.19"
"2878","ENSG00000078747.17_2846",2838,2846,9,"ENSG00000078747.17",1,1,"MVVVVVUVV",1,7,0.792132505175983,108,114,133,136,141,147,158,161,"ATGAAGA","CGGG","GAGAAGG","CTGA",2.41466904637539,19,5,11,44,2.50276775571577,4.6501403495546,7.81867037025853,101,"ENSG00000079974.19"
"47932","ENSG00000289720.1_2810",2802,2810,9,"ENSG00000289720.1",1,1,"MVVVVVUVV",1,7,0.792132505175983,108,114,133,136,141,147,158,161,"ATGAAGA","CGGG","GAGAAGG","CTGA",2.41466904637539,19,5,11,44,2.50276775571577,4.6501403495546,7.81867037025853,101,"ENSG00000079974.19"
"33600","ENSG00000230448.5_54101",54093,54101,9,"ENSG00000230448.5",1,2,"VMVVUVVVV",1,7,0.773913043478261,75,81,95,98,111,117,133,136,"AGGATGA","CTGA","GTCATGT","ATGA",2.47126070835933,14,13,16,52,2.41686210039474,4.72298337236424,7.81863554627728,101,"ENSG00000079974.19"
"5677","ENSG00000106113.19_26039",26031,26039,9,"ENSG00000106113.19",0,NA,"UVVVVVUVV",2,7,0.788819875776397,116,122,133,136,141,147,159,162,"ACCATGA","CTGT","ATAGGGA","CTGA",2.35651215171595,11,5,12,37,2.94317471065411,4.66331393052344,7.81859343362903,101,"ENSG00000079974.19"
"46641","ENSG00000286957.1_541",533,541,9,"ENSG00000286957.1",1,2,"VMVVVUVVV",1,7,0.806211180124223,109,115,133,136,149,155,168,171,"ATGATTA","TTAA","ATGTTCT","CTGA",2.41425734546041,18,13,13,53,2.27979116489424,4.59371003365758,7.81855475415447,101,"ENSG00000079974.19"
"48094","ENSG00000290412.1_2564",2556,2564,9,"ENSG00000290412.1",1,2,"VMVUVVVVV",1,7,0.764803312629399,112,118,133,136,150,156,169,172,"AGGTTGA","TTGA","GTGTAGA","CTGA",2.4878145221414,15,14,13,51,2.45187766402274,4.75932695290803,7.81854020342563,101,"ENSG00000079974.19"
"24955","ENSG00000178878.13_26021",26013,26021,9,"ENSG00000178878.13",1,8,"VVVVUVVMV",1,7,0.773913043478261,102,108,133,136,141,147,162,165,"ATGATGA","GTAA","AGGAATA","CTGA",2.54559489480093,25,5,15,54,1.92039566715347,4.72275707478992,7.81840924870297,101,"ENSG00000079974.19"
"42381","ENSG00000261848.5_18907",18899,18907,9,"ENSG00000261848.5",1,2,"VMVVVUVVV",1,7,0.806211180124223,98,104,133,136,144,150,160,163,"CTGATTA","CAGA","ATGGGAA","CTGA",2.44933320866486,29,8,10,56,2.0452007583321,4.59352220402446,7.81836692452136,101,"ENSG00000079974.19"
"36616","ENSG00000242220.9_46288",46280,46288,9,"ENSG00000242220.9",1,3,"VVMVVUVVV",1,7,0.804968944099379,98,104,133,136,149,155,171,174,"TTGAAGA","CTTA","CTGATGG","CTGA",2.53234305549664,29,13,16,67,1.51126223167267,4.59838731707923,7.81826309347675,101,"ENSG00000079974.19"
"42671","ENSG00000265590.10_71780",71772,71780,9,"ENSG00000265590.10",1,3,"VVMVVUVVV",1,7,0.804968944099379,98,104,133,136,149,155,171,174,"TTGAAGA","CTTA","CTGATGG","CTGA",2.53234305549664,29,13,16,67,1.51126223167267,4.59838731707923,7.81826309347675,101,"ENSG00000079974.19"
"32618","ENSG00000227308.2_21773",21765,21773,9,"ENSG00000227308.2",1,7,"VVVVUVMVV",1,7,0.775155279503105,116,122,133,136,163,169,178,181,"TGGATGA","CTGG","GTGAGGC","CTGA",2.52142959222749,11,27,9,56,2.06103094037435,4.71764038880607,7.81826150681849,101,"ENSG00000079974.19"
"14697","ENSG00000145734.20_68568",68560,68568,9,"ENSG00000145734.20",1,8,"VVVVVUVMV",1,7,0.806211180124224,88,94,133,136,178,184,196,199,"ATGATGA","ATCA","CTGTTGG","CTGA",2.61123913337618,39,42,12,102,0.965124373023158,4.59334631554942,7.81819103604632,101,"ENSG00000079974.19"
"39338","ENSG00000253496.3_133419",133411,133419,9,"ENSG00000253496.3",1,8,"VVUVVVVMV",1,7,0.767701863354037,113,119,133,136,149,155,166,169,"ATAATGA","AGGA","GAAATGA","CTGA",2.45142446433786,14,13,11,47,2.6466001213307,4.74735747089578,7.81816492431193,101,"ENSG00000079974.19"
"15011","ENSG00000146592.17_213003",212995,213003,9,"ENSG00000146592.17",1,1,"MVVUVUVVV",2,6,0.708902691511387,115,121,133,136,146,152,168,171,"GAGATGA","CTGA","GGGCGGA","CTGA",2.59052242079765,12,10,16,47,2.65966656413832,4.98245400903066,7.81806477507621,101,"ENSG00000079974.19"
"30297","ENSG00000204442.4_34490",34482,34490,9,"ENSG00000204442.4",1,8,"UVVVVVVMV",1,7,0.786749482401656,114,120,133,136,155,161,197,200,"AGGAAGA","CTGA","GTGAGGG","CTGA",2.59816936952831,13,19,36,77,1.36250261396011,4.67090793603722,7.81790586564384,101,"ENSG00000079974.19"
"32589","ENSG00000227248.1_2445",2437,2445,9,"ENSG00000227248.1",1,8,"UVVVVVVMV",1,7,0.786749482401656,114,120,133,136,155,161,197,200,"AGGAAGA","CTGA","GTGAGGG","CTGA",2.59816936952831,13,19,36,77,1.36250261396011,4.67090793603722,7.81790586564384,101,"ENSG00000079974.19"
"44305","ENSG00000280739.5_193179",193171,193179,9,"ENSG00000280739.5",1,7,"VVVVVUMVV",1,7,0.807453416149068,83,89,101,104,116,122,133,136,"GTGCTGA","CTGA","ATAAAGT","ATGA",2.33875025374452,12,12,11,44,2.76047784817007,4.58803655161672,7.81785021621299,101,"ENSG00000079974.19"
"46121","ENSG00000286206.1_40261",40253,40261,9,"ENSG00000286206.1",1,1,"MVVVVUVVV",1,7,0.82815734989648,96,102,133,136,154,160,180,183,"GTGATGT","TTGA","AAGATAA","CTGA",2.56489614681477,31,18,20,78,0.921283363529684,4.50514775224037,7.8177771518263,101,"ENSG00000079974.19"
"11382","ENSG00000134775.16_207695",207687,207695,9,"ENSG00000134775.16",0,NA,"VVVVVUUVV",2,7,0.808281573498965,69,75,87,90,100,106,133,136,"ATGATCA","CTGA","AGGATAA","ATGA",2.43547600428334,12,10,27,58,2.10191423662393,4.58460523296156,7.81773152695741,101,"ENSG00000079974.19"
"26836","ENSG00000185052.13_253693",253685,253693,9,"ENSG00000185052.13",1,3,"VVMVVVUVV",1,7,0.768944099378882,115,121,133,136,141,147,167,170,"GTGATTA","CCAA","ATGAGGA","CTGA",2.47731891008284,12,5,20,46,2.45213813458746,4.74189938378494,7.81767578130046,101,"ENSG00000079974.19"
"8827","ENSG00000120899.18_29633",29625,29633,9,"ENSG00000120899.18",0,NA,"VVUVVUVVV",2,7,0.805797101449275,96,102,110,113,116,122,133,136,"ATGATGA","AGGA","TTCAGGA","CTGT",2.3472482041983,8,3,11,31,2.72947355086852,4.59444872804763,7.81763713384473,101,"ENSG00000079974.19"
"11139","ENSG00000134030.14_194417",194409,194417,9,"ENSG00000134030.14",1,2,"VMVVVUUVV",2,6,0.692339544513457,78,84,95,98,104,110,133,136,"GTGTTGA","CTGA","TTGCTGA","CTGA",2.68115481174541,11,6,23,49,2.31850031136609,5.04821643075053,7.81757460880436,101,"ENSG00000079974.19"
"44164","ENSG00000279043.1_3400",3392,3400,9,"ENSG00000279043.1",1,2,"VMVVVVUVV",1,7,0.770186335403727,112,118,133,136,176,182,229,232,"ATGAAGA","CTAA","ATGATGA","CTGA",2.70379946277427,15,40,47,111,0.921750406068679,4.73677003947429,7.81751538108919,101,"ENSG00000079974.19"
"1651","ENSG00000064692.20_138738",138730,138738,9,"ENSG00000064692.20",1,8,"VVUVVVVMV",1,7,0.767701863354037,108,114,133,136,146,152,166,169,"ATGAGAA","CTGG","CTGAAGA","CTGA",2.49593320663936,19,10,14,52,2.3466887648328,4.74656086894046,7.81736832235661,101,"ENSG00000079974.19"
"11519","ENSG00000135250.17_266278",266270,266278,9,"ENSG00000135250.17",1,2,"UMVVVVVVV",1,7,0.786749482401656,81,87,102,105,109,115,133,136,"TTGGTGA","CGGA","CAGATAA","CTGA",2.44409751934084,15,4,18,46,2.38742097017111,4.67035110811084,7.81734903771746,101,"ENSG00000079974.19"
"809","ENSG00000035115.22_27610",27602,27610,9,"ENSG00000035115.22",1,1,"MVVUVVVVV",1,7,0.786749482401656,116,122,133,136,148,154,171,174,"GAGATTA","TTGA","GTGAAGT","CTGA",2.43627458241339,11,12,17,49,2.43946780781975,4.67032458931059,7.81732251891721,101,"ENSG00000079974.19"
"48108","ENSG00000290429.1_52156",52148,52156,9,"ENSG00000290429.1",1,1,"MVVVVUVVV",1,7,0.82815734989648,97,103,109,112,114,120,133,136,"ATGAAGA","CTAA","GTGACAA","ATGA",2.35703305350786,6,2,13,30,2.30513208050417,4.50467144263915,7.81730084222507,101,"ENSG00000079974.19"
"48364","ENSG00000291040.1_41315",41307,41315,9,"ENSG00000291040.1",0,NA,"VVVUVUVVV",2,7,0.802898550724638,93,99,108,111,115,121,133,136,"CTGGTGA","AAGA","ATGCAGG","CTGA",2.34359534220258,9,4,12,34,2.79879425326128,4.60569080031962,7.81728500321818,101,"ENSG00000079974.19"
"48366","ENSG00000291040.1_PAR_Y_41315",41307,41315,9,"ENSG00000291040.1_PAR_Y",0,NA,"VVVUVUVVV",2,7,0.802898550724638,93,99,108,111,115,121,133,136,"CTGGTGA","AAGA","ATGCAGG","CTGA",2.34359534220258,9,4,12,34,2.79879425326128,4.60569080031962,7.81728500321818,101,"ENSG00000079974.19"
"47747","ENSG00000289174.1_45571",45563,45571,9,"ENSG00000289174.1",1,1,"MVVVVUVVV",1,7,0.82815734989648,102,108,133,136,159,165,173,176,"CTGATGT","CTTA","ATTATGC","CTGA",2.5040404939372,25,23,8,65,1.32499407211636,4.50464934125775,7.81727874084367,101,"ENSG00000079974.19"
"23020","ENSG00000171953.16_14612",14604,14612,9,"ENSG00000171953.16",1,8,"VVVVVUVMV",1,7,0.806211180124224,66,72,96,99,108,114,133,136,"GGAATGA","CTGA","AAGATGT","CTGA",2.4938592548971,24,9,19,61,1.74385037131574,4.5923946843241,7.81723940482099,101,"ENSG00000079974.19"
"45609","ENSG00000285741.1_56748",56740,56748,9,"ENSG00000285741.1",1,8,"VVVUVVVMV",1,7,0.764803312629399,101,107,133,136,145,151,159,162,"ATGATAA","TTCA","ATGAGGA","CTGA",2.54512022842096,26,9,8,52,2.06460964533119,4.75801945870106,7.81723270921866,101,"ENSG00000079974.19"
"7367","ENSG00000113719.17_38409",38401,38409,9,"ENSG00000113719.17",1,2,"UMVVVVVVV",1,7,0.786749482401656,103,109,133,136,143,149,186,189,"ATGATGA","CAAA","CTGGTGT","CTGA",2.61394574721781,24,7,37,77,1.2546023201491,4.67022682540028,7.81722475500691,101,"ENSG00000079974.19"
"35626","ENSG00000236472.1_1853",1845,1853,9,"ENSG00000236472.1",1,3,"VVMVVUVVV",1,7,0.804968944099379,5,11,28,31,72,78,133,136,"ATGATGA","CAGA","GTGATGA","CTAA",2.64410731047738,17,41,55,122,0.761848843472551,4.59730772833044,7.81718350472796,101,"ENSG00000079974.19"
"6062","ENSG00000107864.15_6635",6627,6635,9,"ENSG00000107864.15",0,NA,"VVUVVVUVV",2,7,0.769772256728778,55,61,72,75,88,94,133,136,"ATGATGA","CTGA","ATCTTGA","GTGA",2.58877292471042,11,13,39,72,1.69386538595065,4.7380878876717,7.81717691458682,101,"ENSG00000079974.19"
"11115","ENSG00000133962.8_21883",21875,21883,9,"ENSG00000133962.8",1,8,"VVVVVUVMV",1,7,0.806211180124224,109,115,133,136,138,144,153,156,"ATGAGAA","CTCA","CTGATTT","CTGA",2.41786951638465,18,2,9,38,2.25003724238988,4.59229183790521,7.81713655840211,101,"ENSG00000079974.19"
"42104","ENSG00000260711.2_974",966,974,9,"ENSG00000260711.2",1,8,"VVVVVUVMV",1,7,0.806211180124224,109,115,133,136,138,144,153,156,"ATGAGAA","CTCA","CTGATTT","CTGA",2.41786951638465,18,2,9,38,2.25003724238988,4.59229183790521,7.81713655840211,101,"ENSG00000079974.19"
"9930","ENSG00000128513.16_19568",19560,19568,9,"ENSG00000128513.16",1,5,"VVVVMVUVV",1,7,0.772670807453416,114,120,133,136,141,147,155,158,"GTGATGA","CTTT","ATGAAGA","CTAA",2.38002747368588,13,5,8,35,3.03887925885067,4.72643227085581,7.81711550066947,101,"ENSG00000079974.19"
"45905","ENSG00000286043.1_6694",6686,6694,9,"ENSG00000286043.1",1,7,"VVVVUVMVV",1,7,0.775155279503105,66,72,101,104,111,117,133,136,"ATGATGA","CTGA","ATGGGAA","CTCA",2.55728161196911,29,7,16,61,1.8170809175443,4.7164062493346,7.81702736734702,101,"ENSG00000079974.19"
"13598","ENSG00000142599.20_449823",449815,449823,9,"ENSG00000142599.20",1,2,"VMVVVUVVV",1,7,0.806211180124223,112,118,133,136,173,179,193,196,"ATGAAGA","ATAA","ATGAGAA","CTGA",2.48616413736751,15,37,14,75,1.79429749190878,4.59218126858972,7.81702598908661,101,"ENSG00000079974.19"
"29824","ENSG00000198771.11_78394",78386,78394,9,"ENSG00000198771.11",1,7,"VVVUVVMVV",1,7,0.766045548654244,73,79,100,103,115,121,133,136,"AGGATAA","ATGA","ATGAAGA","CTGA",2.53156627342213,21,12,12,54,2.13379742285876,4.75272647808491,7.81690867270189,101,"ENSG00000079974.19"
"21907","ENSG00000169306.10_1133945",1133937,1133945,9,"ENSG00000169306.10",0,NA,"VVVUVUVVV",2,7,0.802898550724638,108,114,133,136,161,167,175,178,"ATGCTGT","CTGC","TTGTTGA","CTGA",2.51104001038498,19,25,8,61,1.68086383560744,4.60528264287683,7.81687684577538,101,"ENSG00000079974.19"
"33995","ENSG00000231689.3_479469",479461,479469,9,"ENSG00000231689.3",1,1,"MVVVVUVVV",1,7,0.82815734989648,114,120,133,136,149,155,175,178,"AGGAGGA","CTGT","AAGAAAA","CTGA",2.37158730096541,13,13,20,55,2.20621285680535,4.50419871581035,7.81682811539627,101,"ENSG00000079974.19"
"4450","ENSG00000100605.17_131799",131791,131799,9,"ENSG00000100605.17",1,3,"VVMVUVVVV",1,7,0.772670807453416,76,82,92,95,101,107,133,136,"AATATGA","CTGG","GTGTTGA","CTGA",2.51467015327195,10,6,26,51,2.13993326297355,4.7261002378633,7.81678346767696,101,"ENSG00000079974.19"
"18407","ENSG00000157216.16_150709",150701,150709,9,"ENSG00000157216.16",1,8,"VVVUVVVMV",1,7,0.764803312629399,58,64,103,106,116,122,133,136,"ATGTTGA","CAGA","GTGCAGT","CTGA",2.57162627404852,39,10,11,69,1.88604558489257,4.75755518630402,7.81676843682162,101,"ENSG00000079974.19"
"19375","ENSG00000162836.12_19555",19547,19555,9,"ENSG00000162836.12",0,NA,"VVVVUVUVV",2,7,0.775983436853002,113,119,133,136,143,149,157,160,"TTGATAA","CAAA","GAGAAGA","CTGA",2.37705752695803,14,7,8,38,3.00386870971515,4.71272972235883,7.81666346977084,101,"ENSG00000079974.19"
"31820","ENSG00000224905.8_93185",93177,93185,9,"ENSG00000224905.8",1,1,"MVVVVVUVV",1,7,0.792132505175983,85,91,104,107,115,121,133,136,"GTGATGA","CAGA","ACAAAGA","CTGC",2.34513698104547,13,8,12,42,2.95772979160902,4.64799408297804,7.81652410368197,101,"ENSG00000079974.19"
"33346","ENSG00000229425.5_138599",138591,138599,9,"ENSG00000229425.5",1,2,"VMUVVVVVV",1,7,0.767701863354037,112,118,133,136,145,151,201,204,"AAGATGA","GTGA","TTGCTCA","CTGA",2.5680484360893,15,9,50,83,1.86250959280422,4.74570812501656,7.8165155784327,101,"ENSG00000079974.19"
"47158","ENSG00000287722.1_329624",329616,329624,9,"ENSG00000287722.1",1,6,"UVVVVMVVV",1,7,0.805383022774327,116,122,133,136,172,178,207,210,"ATTATGA","GTGA","TTGTTGT","CTGA",2.58592380086833,11,36,29,85,1.14017836968239,4.59491759386782,7.81644968496513,101,"ENSG00000079974.19"
"25292","ENSG00000180440.4_11516",11508,11516,9,"ENSG00000180440.4",1,8,"VVVVVVUMV",1,7,0.770186335403727,113,119,133,136,183,189,200,203,"GTGATGA","CTAT","ATGACTA","CTGA",2.54869024320715,14,47,11,81,1.95136206074911,4.73565758719919,7.8164029288141,101,"ENSG00000079974.19"
"35179","ENSG00000235257.11_61926",61918,61926,9,"ENSG00000235257.11",1,8,"VVVVUVVMV",1,7,0.773913043478261,27,33,66,69,115,121,133,136,"GTGATGA","CTTA","ATGGAGA","CTGA",2.68587449801891,33,46,12,100,0.977151781010857,4.72074544195089,7.81639761586394,101,"ENSG00000079974.19"
"26907","ENSG00000185274.12_226550",226542,226550,9,"ENSG00000185274.12",1,3,"UVMVVVVVV",1,7,0.785507246376811,115,121,133,136,142,148,163,166,"ATTATGT","TTCA","ATGTGGA","CTGA",2.38184167552084,12,6,15,42,2.81847126751759,4.67435394274747,7.81638292825471,101,"ENSG00000079974.19"
"2913","ENSG00000079215.15_78854",78846,78854,9,"ENSG00000079215.15",1,8,"UVVVVVVMV",1,7,0.786749482401656,55,61,76,79,86,92,133,136,"CTGACGA","CTGG","GTGATAT","CTGA",2.51269456485714,15,7,41,72,1.92623803782825,4.66938378421896,7.81638171382559,101,"ENSG00000079974.19"
"41966","ENSG00000260192.3_386164",386156,386164,9,"ENSG00000260192.3",1,8,"VVVVVUVMV",1,7,0.806211180124224,80,86,96,99,104,110,133,136,"GTGCTGG","CAGA","ATGCTGT","CTGA",2.4230688201585,10,5,23,47,2.21223296246347,4.59150627421337,7.81635099471027,101,"ENSG00000079974.19"
"28733","ENSG00000196387.10_21560",21552,21560,9,"ENSG00000196387.10",1,1,"MVUVVVVVV",1,7,0.789648033126294,111,117,133,136,142,148,161,164,"ATGATGT","CTGC","GTAATGT","TTGA",2.3821876704518,16,6,13,44,2.74952189876665,4.65769325877799,7.81628539128316,101,"ENSG00000079974.19"
"29030","ENSG00000197037.11_10946",10938,10946,9,"ENSG00000197037.11",1,1,"MVUVVVVVV",1,7,0.789648033126294,109,115,133,136,146,152,166,169,"GTGATGG","CTTC","GTTATGT","CTGA",2.42914643157618,18,10,14,51,2.43639510405185,4.65767616197326,7.81626829447844,101,"ENSG00000079974.19"
"8413","ENSG00000118733.17_24523",24515,24523,9,"ENSG00000118733.17",1,1,"MVVVVUVVV",1,7,0.82815734989648,112,118,133,136,149,155,181,184,"TTGATCA","ATGC","ATGATCA","CTGA",2.42616756430074,15,13,26,63,1.83995945004285,4.50360246967861,7.81623186926453,101,"ENSG00000079974.19"
"30123","ENSG00000203727.4_221040",221032,221040,9,"ENSG00000203727.4",0,NA,"VVVVVUUVV",2,7,0.808281573498965,111,117,133,136,160,166,179,182,"ATTATGA","GGGA","GTTCTGA","CTGA",2.46427258143864,16,24,13,62,1.90368759772106,4.58304286849467,7.81616916249053,101,"ENSG00000079974.19"
"32740","ENSG00000227681.5_69027",69019,69027,9,"ENSG00000227681.5",0,NA,"VVVVVUUVV",2,7,0.808281573498965,111,117,133,136,160,166,179,182,"ATTATGA","GGGA","GTTCTGA","CTGA",2.46427258143864,16,24,13,62,1.90368759772106,4.58304286849467,7.81616916249053,101,"ENSG00000079974.19"
"15069","ENSG00000147003.7_2206",2198,2206,9,"ENSG00000147003.7",1,8,"UVVVVVVMV",1,7,0.786749482401656,83,89,105,108,113,119,133,136,"CTGAATA","CTGA","ATGCACA","CTGA",2.40405178908619,16,5,14,44,2.64940741534191,4.6691048356458,7.81610276525243,101,"ENSG00000079974.19"
"45456","ENSG00000285602.1_2802",2794,2802,9,"ENSG00000285602.1",1,8,"UVVVVVVMV",1,7,0.786749482401656,83,89,105,108,113,119,133,136,"CTGAATA","CTGA","ATGCACA","CTGA",2.40405178908619,16,5,14,44,2.64940741534191,4.6691048356458,7.81610276525243,101,"ENSG00000079974.19"
"45793","ENSG00000285919.1_6312",6304,6312,9,"ENSG00000285919.1",1,8,"UVVVVVVMV",1,7,0.786749482401656,115,121,133,136,140,146,167,170,"ATGATTA","TTTA","TTGACAA","CTGA",2.45604945045652,12,4,21,46,2.30233882410072,4.66900045678605,7.81599838639268,101,"ENSG00000079974.19"
"42174","ENSG00000260971.4_295392",295384,295392,9,"ENSG00000260971.4",1,2,"UMVVVVVVV",1,7,0.786749482401656,85,91,105,108,113,119,133,136,"GGGATGA","TAGA","GTAATAT","CTGA",2.38374455699025,14,5,14,42,2.78412916957926,4.66893988737857,7.81593781698519,101,"ENSG00000079974.19"
"44998","ENSG00000284686.1_342200",342192,342200,9,"ENSG00000284686.1",1,2,"UMVVVVVVV",1,7,0.786749482401656,85,91,105,108,113,119,133,136,"GGGATGA","TAGA","GTAATAT","CTGA",2.38374455699025,14,5,14,42,2.78412916957926,4.66893988737857,7.81593781698519,101,"ENSG00000079974.19"
"47410","ENSG00000288092.1_502",494,502,9,"ENSG00000288092.1",1,8,"VVVVUVVMV",1,7,0.773913043478261,65,71,83,86,112,118,133,136,"GTGACCA","CTGA","CTGATAA","CTGA",2.5439284556257,12,26,15,62,1.92155865737067,4.72027042371884,7.81592259763188,101,"ENSG00000079974.19"
"366","ENSG00000009844.16_35738",35730,35738,9,"ENSG00000009844.16",1,1,"MVVVVUVVV",1,7,0.82815734989648,113,119,133,136,152,158,170,173,"ATCATCA","GAGA","CTGAAGC","CTGA",2.34026592635404,14,16,12,51,2.41107232663391,4.50321129224854,7.81584069183447,101,"ENSG00000079974.19"
"13094","ENSG00000140090.18_15746",15738,15746,9,"ENSG00000140090.18",1,6,"UVVVVMUVV",2,6,0.691511387163561,84,90,133,136,143,149,161,164,"GTGATGA","CTGT","ATGATTA","CTGA",2.73609722152464,43,7,12,71,1.95851596762584,5.04979102778086,7.81583657643511,101,"ENSG00000079974.19"
"9917","ENSG00000128512.24_100966",100958,100966,9,"ENSG00000128512.24",1,2,"UMVVVVVVV",1,7,0.786749482401656,115,121,133,136,152,158,175,178,"ATGATGA","CTTA","ATTAAGA","CAGA",2.47332214405314,12,16,17,54,2.18649321036899,4.66882687601414,7.81582480562077,101,"ENSG00000079974.19"
"20307","ENSG00000164627.18_112174",112166,112174,9,"ENSG00000164627.18",1,8,"VVVVUVVMV",1,7,0.773913043478261,71,77,88,91,107,113,133,136,"CTGATCA","CTGA","ATCAGGC","CTGA",2.53508256403899,11,16,20,56,1.97985214693382,4.7201006434651,7.81575281737814,101,"ENSG00000079974.19"
"18419","ENSG00000157388.20_157825",157817,157825,9,"ENSG00000157388.20",1,7,"VVVVUVMVV",1,7,0.775155279503105,111,117,133,136,176,182,208,211,"TTGATGG","CTGA","GTGATAT","CTGA",2.66678537879799,16,40,26,91,1.08169243693482,4.71506540723036,7.81568652524278,101,"ENSG00000079974.19"
"1448","ENSG00000056291.19_7661",7653,7661,9,"ENSG00000056291.19",0,NA,"VVVVVUUVV",2,7,0.808281573498965,112,118,133,136,146,152,166,169,"ATGATGA","CTCC","GTTATGG","CTAA",2.34736708621056,15,10,14,48,2.68088650240767,4.58250010261952,7.81562639661538,101,"ENSG00000079974.19"
"25713","ENSG00000182621.18_645157",645149,645157,9,"ENSG00000182621.18",1,2,"UMVVVVVVV",1,7,0.786749482401656,114,120,133,136,141,147,163,166,"ATGATGA","TTCA","ATGAGGT","CTGG",2.3964626391097,13,5,16,43,2.69799301074586,4.66860265120263,7.81560058080925,101,"ENSG00000079974.19"
"18691","ENSG00000158163.15_21794",21786,21794,9,"ENSG00000158163.15",1,7,"VVVVVUMVV",1,7,0.807453416149068,110,116,133,136,174,180,221,224,"GTGATGA","GAGA","GTTATGA","CTGA",2.6340027537778,17,38,41,105,0.782909022582741,4.58573184527534,7.81554550987162,101,"ENSG00000079974.19"
"31950","ENSG00000225434.5_16029",16021,16029,9,"ENSG00000225434.5",0,NA,"VVVVVUUVV",2,7,0.808281573498965,112,118,133,136,139,145,154,157,"AAGATGT","GTGA","TTGATGA","CTGT",2.34269907756907,15,3,9,36,2.71154812569429,4.58238549403869,7.81551178803455,101,"ENSG00000079974.19"
"36346","ENSG00000240086.7_18615",18607,18615,9,"ENSG00000240086.7",0,NA,"VVVVVUUVV",2,7,0.808281573498965,112,118,133,136,139,145,154,157,"AAGATGT","GTGA","TTGATGA","CTGT",2.34269907756907,15,3,9,36,2.71154812569429,4.58238549403869,7.81551178803455,101,"ENSG00000079974.19"
"37929","ENSG00000249225.1_28475",28467,28475,9,"ENSG00000249225.1",1,1,"MVVVVVUVV",1,7,0.792132505175983,52,58,69,72,84,90,133,136,"CTGAGGA","ATGA","GTGGTGT","CTGA",2.52537337445401,11,12,43,75,1.75181981283763,4.64691057729942,7.81544059800335,101,"ENSG00000079974.19"
"29319","ENSG00000197694.19_34921",34913,34921,9,"ENSG00000197694.19",1,1,"MVVVUVVVV",1,7,0.795859213250517,109,115,133,136,139,145,159,162,"ATGATAT","CAGG","GTGATTA","CTGA",2.44210827524814,18,3,14,44,2.24728178200999,4.6320009042494,7.81543775725148,101,"ENSG00000079974.19"
"43160","ENSG00000269534.5_5009",5001,5009,9,"ENSG00000269534.5",0,NA,"VVVVVUUVV",2,7,0.808281573498965,108,114,133,136,149,155,166,169,"CTAGTGA","TTGA","CTGATGT","CTGA",2.41082915860214,19,13,11,52,2.25704930139589,4.58231092301921,7.81543721701507,101,"ENSG00000079974.19"
"3839","ENSG00000089250.20_14221",14213,14221,9,"ENSG00000089250.20",1,3,"VVMVVUVVV",1,7,0.804968944099379,111,117,133,136,155,161,180,183,"ATGATGG","TTCA","ATCAAGA","CTGA",2.49693571937062,16,19,19,63,1.73590039505192,4.59553463104735,7.81541040744486,101,"ENSG00000079974.19"
"37591","ENSG00000248515.2_120772",120764,120772,9,"ENSG00000248515.2",0,NA,"UVVVVVUVV",2,7,0.788819875776397,83,89,133,136,164,170,186,189,"ATGATTA","CTCA","GTGAAGA","CTGA",2.67122762926111,44,28,16,97,0.832306489722015,4.66012267119902,7.81540217430461,101,"ENSG00000079974.19"
"16301","ENSG00000151320.11_326480",326472,326480,9,"ENSG00000151320.11",0,NA,"UVVVVUVVV",2,7,0.824844720496894,86,92,106,109,115,121,133,136,"GTGATAA","CTGG","ATGGTTA","ATGA",2.27004843015252,14,6,12,41,2.92993519723474,4.51589784956288,7.81527673155046,101,"ENSG00000079974.19"
"45974","ENSG00000286084.3_97543",97535,97543,9,"ENSG00000286084.3",1,8,"UVVVVVVMV",1,7,0.786749482401656,113,119,133,136,185,191,199,202,"ATGAGAA","CTGA","TTAATAA","CTGA",2.50918086841252,14,49,8,80,1.94511100165685,4.66824586443508,7.8152437940417,101,"ENSG00000079974.19"
"38757","ENSG00000251002.10_14193",14185,14193,9,"ENSG00000251002.10",1,8,"VVVVUVVMV",1,7,0.773913043478261,113,119,133,136,139,145,161,164,"CTGGTGA","CTTA","ATCAGGA","CTGA",2.46561442010401,14,3,16,42,2.44071563955259,4.71953627672817,7.81518845064121,101,"ENSG00000079974.19"
"24445","ENSG00000176406.25_359537",359529,359537,9,"ENSG00000176406.25",1,7,"VVVVVUMVV",1,7,0.807453416149068,52,58,68,71,79,85,133,136,"TTGAAGA","TTGA","TAGATGT","CTGA",2.46471840644208,10,8,48,75,1.90975985970777,4.58530397566374,7.81511764026001,101,"ENSG00000079974.19"
"17898","ENSG00000155792.10_130855",130847,130855,9,"ENSG00000155792.10",1,8,"UVVVVVVMV",1,7,0.786749482401656,111,117,133,136,145,151,168,171,"ATGATGG","TTAA","ATTAGCA","CTGA",2.42786712010803,16,9,17,51,2.48656575888317,4.66808663990084,7.81508456950747,101,"ENSG00000079974.19"
"24794","ENSG00000178031.18_437449",437441,437449,9,"ENSG00000178031.18",1,6,"UVVVVMVVV",1,7,0.805383022774327,43,49,68,71,105,111,133,136,"ATGATTC","CTGA","GTGATTT","CTGA",2.60483254734975,19,34,22,84,1.00859029179238,4.59353515186434,7.81506724296165,101,"ENSG00000079974.19"
"24513","ENSG00000176728.10_255019",255011,255019,9,"ENSG00000176728.10",1,2,"VMVVVVUVV",1,7,0.770186335403727,95,101,133,136,151,157,170,173,"GTGATGG","CTGA","ATGGCTA","CTGA",2.61608407322283,32,15,13,69,1.49634593727093,4.73422660635579,7.8149719479707,101,"ENSG00000079974.19"
"39023","ENSG00000251510.1_6269",6261,6269,9,"ENSG00000251510.1",1,2,"VMVVVVUVV",1,7,0.770186335403727,95,101,133,136,151,157,170,173,"GTGATGG","CTGA","ATGGCTA","CTGA",2.61608407322283,32,15,13,69,1.49634593727093,4.73422660635579,7.8149719479707,101,"ENSG00000079974.19"
"12009","ENSG00000136861.19_116070",116062,116070,9,"ENSG00000136861.19",1,8,"UVVVVVVMV",1,7,0.786749482401656,114,120,133,136,146,152,160,163,"AGCAAGA","CTGA","ATGAGTC","CTGA",2.36465922962483,13,10,8,40,2.90710278039866,4.66787441114104,7.81487234074767,101,"ENSG00000079974.19"
"33183","ENSG00000228971.4_271435",271427,271435,9,"ENSG00000228971.4",1,2,"VMVVVVUVV",1,7,0.770186335403727,116,122,133,136,185,191,206,209,"ATCATGA","TTAA","GTGAAGA","CTGA",2.57150214318686,11,49,15,84,1.79297604781112,4.73408091726422,7.81482625887912,101,"ENSG00000079974.19"
"32726","ENSG00000227674.3_166245",166237,166245,9,"ENSG00000227674.3",1,5,"UVVVMVVVV",1,7,0.789233954451346,112,118,133,136,143,149,166,169,"ATGAAGA","TTCA","AAGAAAA","CTGA",2.40337853966092,15,7,17,48,2.60892697261066,4.65786264258753,7.81479846039291,101,"ENSG00000079974.19"
"3435","ENSG00000083857.15_20342",20334,20342,9,"ENSG00000083857.15",1,5,"VVVVMUVVV",1,7,0.808695652173913,113,119,133,136,139,145,155,158,"GTGTTTA","ATGA","ATGGAAA","CTGA",2.33289968384385,14,3,10,36,2.76731708750663,4.5799954116164,7.81477802031205,101,"ENSG00000079974.19"
"31630","ENSG00000224222.2_9765",9757,9765,9,"ENSG00000224222.2",1,1,"MVUVVVVVV",1,7,0.789648033126294,95,101,110,113,116,122,133,136,"TTGTTGA","CGTA","GTGTTGG","CTGA",2.37675218673166,9,3,11,32,2.7794809799021,4.65612388952828,7.81471602203346,101,"ENSG00000079974.19"
"13123","ENSG00000140367.12_57487",57479,57487,9,"ENSG00000140367.12",1,6,"UVVVVMVVV",1,7,0.805383022774327,111,117,133,136,144,150,159,162,"TTGATTA","CTGA","TTGCTCA","GTGA",2.32978636669864,16,8,9,42,2.84056922269602,4.59311958350507,7.81465167460238,101,"ENSG00000079974.19"
"9403","ENSG00000124486.15_108391",108383,108391,9,"ENSG00000124486.15",1,1,"MVUVVVVVV",1,7,0.789648033126294,76,82,94,97,98,104,133,136,"ATGATGC","CTGG","GTGACAG","CTGA",2.57228914753085,12,1,29,51,1.475288543972,4.65597071521108,7.81456284771626,101,"ENSG00000079974.19"
"5411","ENSG00000104447.13_206713",206705,206713,9,"ENSG00000104447.13",1,6,"VVUVVMVVV",1,7,0.786335403726708,115,121,133,136,148,154,209,212,"AAGATGA","GTGT","ATGATAA","CTGA",2.53642317816554,12,12,55,88,1.76672797240665,4.6690539567109,7.81439557161773,101,"ENSG00000079974.19"
"5996","ENSG00000107643.17_131739",131731,131739,9,"ENSG00000107643.17",0,NA,"VVUUVVVVV",2,7,0.764389233954451,115,121,133,136,144,150,204,207,"ATGAAGA","TTGA","ATGTATA","CTGA",2.5559229997969,12,8,54,83,1.98770992090816,4.75679914655521,7.81435608237301,101,"ENSG00000079974.19"
"24605","ENSG00000177125.6_11947",11939,11947,9,"ENSG00000177125.6",0,NA,"VVUVUVVVV",2,7,0.773498964803312,92,98,108,111,115,121,133,136,"AGGATCA","TTGA","GTGCCTA","CTGA",2.40518879258334,10,4,12,35,2.84677672509838,4.72034216891349,7.81433802812674,101,"ENSG00000079974.19"
"27203","ENSG00000185737.13_595078",595070,595078,9,"ENSG00000185737.13",1,2,"VMVVVUVVV",1,7,0.806211180124223,88,94,104,107,110,116,133,136,"GTAAAGA","GTGA","GTCAAGA","CTGA",2.39928031634641,10,3,17,39,2.36260191426199,4.58945100580951,7.81429572630641,101,"ENSG00000079974.19"
"17258","ENSG00000153707.19_781368",781360,781368,9,"ENSG00000153707.19",1,2,"VMVUVVVVV",1,7,0.764803312629399,111,117,133,136,144,150,167,170,"CTGATAA","TTGA","TTGGTTA","CTGA",2.47457578499212,16,8,17,50,2.52291018641901,4.75502052159161,7.81423377210921,101,"ENSG00000079974.19"
"13505","ENSG00000141627.14_277949",277941,277949,9,"ENSG00000141627.14",0,NA,"UVVUVVVVV",2,7,0.78343685300207,96,102,133,136,166,172,182,185,"ATGATGA","ATGG","GTGGTGT","CTGA",2.64580620200927,31,30,10,80,1.08315161504757,4.68046490711067,7.81421231911895,101,"ENSG00000079974.19"
"36827","ENSG00000243176.8_93712",93704,93712,9,"ENSG00000243176.8",1,8,"VVVUVVVMV",1,7,0.764803312629399,116,122,133,136,145,151,160,163,"GTGGTCA","TGGA","GTGATGA","CTGA",2.40538896980435,11,9,9,38,2.98383488654197,4.75494033797608,7.81415358849368,101,"ENSG00000079974.19"
"453","ENSG00000011677.13_59370",59362,59370,9,"ENSG00000011677.13",1,3,"VVMVVUVVV",1,7,0.804968944099379,112,118,133,136,157,163,171,174,"AAGATGC","TAGA","ATGATAA","CTGA",2.437328332191,15,21,8,53,2.12816768379384,4.59425580793346,7.81413158433097,101,"ENSG00000079974.19"
"16822","ENSG00000152377.14_400273",400265,400273,9,"ENSG00000152377.14",1,1,"MVVVVVUVV",1,7,0.792132505175983,107,113,133,136,139,145,186,189,"ATTATGA","CAGA","ATGACAA","CTGA",2.60613276139331,20,3,41,73,1.2080095006715,4.64555697749007,7.814086998194,101,"ENSG00000079974.19"
"27988","ENSG00000187823.4_109338",109330,109338,9,"ENSG00000187823.4",1,8,"VVVVVVUMV",1,7,0.770186335403727,83,89,133,136,154,160,179,182,"ATGATGA","TTTA","ATGATGT","CTGA",2.69773344214051,44,18,19,90,0.948443035337979,4.73333316240202,7.81407850401692,101,"ENSG00000079974.19"
"30067","ENSG00000203472.3_17235",17227,17235,9,"ENSG00000203472.3",1,6,"VVVUVMVVV",1,7,0.78343685300207,95,101,133,136,147,153,169,172,"ATGGTGT","CTGA","GTGAATC","CTGA",2.56559287321902,32,11,16,68,1.61701144980611,4.68024098448323,7.81398839649151,101,"ENSG00000079974.19"
"29998","ENSG00000198947.18_368040",368032,368040,9,"ENSG00000198947.18",1,5,"VVUVMVVVV",1,7,0.770186335403727,105,111,133,136,139,145,156,159,"ATGAGGA","TTAA","ATGATTA","CTGA",2.53546799462404,22,3,11,45,2.02970278583208,4.73320568749809,7.813951029113,101,"ENSG00000079974.19"
"28749","ENSG00000196437.12_4488",4480,4488,9,"ENSG00000196437.12",1,8,"VVVVUVVMV",1,7,0.773913043478261,98,104,133,136,169,175,185,188,"ATGAGGA","CAGA","ATGATGG","CTGA",2.66778816679872,29,33,10,81,1.08777123083993,4.71825641904118,7.81390859295423,101,"ENSG00000079974.19"
"22496","ENSG00000170624.14_828949",828941,828949,9,"ENSG00000170624.14",1,2,"UMVVVVVVV",1,7,0.786749482401656,114,120,133,136,138,144,153,156,"TAGAAGA","CTGA","GTCCTGT","CTGA",2.39096057286998,13,2,9,33,2.72772849389642,4.66686641159073,7.81386434119736,101,"ENSG00000079974.19"
"29366","ENSG00000197847.12_22237",22229,22237,9,"ENSG00000197847.12",1,2,"VMVVUVVVV",1,7,0.773913043478261,98,104,133,136,152,158,181,184,"ATGAGGA","CTGA","GGGGTGA","CTGA",2.69498273856072,29,16,23,77,0.905956322826651,4.71812697830786,7.81377915222091,101,"ENSG00000079974.19"
"6316","ENSG00000109339.24_408218",408210,408218,9,"ENSG00000109339.24",1,3,"UVMVVVVVV",1,7,0.785507246376811,115,121,133,136,142,148,156,159,"ATGAGAA","TTGC","ATGAATA","CTGA",2.33865573987347,12,6,8,35,3.09576072844806,4.67169974856779,7.81372873407504,101,"ENSG00000079974.19"
"30286","ENSG00000204442.4_208764",208756,208764,9,"ENSG00000204442.4",1,1,"MVVVUVVVV",1,7,0.795859213250517,105,111,133,136,143,149,174,177,"GTGATGA","TTCA","TTAAAGA","CTGA",2.53665133477431,22,7,25,63,1.61005102529766,4.63026498094827,7.81370183395034,101,"ENSG00000079974.19"
"3995","ENSG00000091656.19_110350",110342,110350,9,"ENSG00000091656.19",1,6,"UVVVVMVVV",1,7,0.805383022774327,102,108,133,136,146,152,161,164,"ATGTTGA","CTGA","AGGAAGA","CAGA",2.44495380913099,25,10,9,53,2.06875483584945,4.59211172418068,7.81364381527798,101,"ENSG00000079974.19"
"19074","ENSG00000160799.12_29569",29561,29569,9,"ENSG00000160799.12",1,1,"MVVVVUVVV",1,7,0.82815734989648,77,83,96,99,113,119,133,136,"AAGAGGA","CTAA","AGCATGT","CTGA",2.3269973232141,13,14,14,50,2.49054055325194,4.50096401033649,7.81359340992241,101,"ENSG00000079974.19"
"32465","ENSG00000227036.10_256554",256546,256554,9,"ENSG00000227036.10",1,5,"UVVVMVVVV",1,7,0.789233954451346,111,117,133,136,140,146,160,163,"AAGATGA","TTGG","GAGATTG","CTGA",2.41007964909204,16,4,14,43,2.55940020810682,4.65664946718011,7.81358528498549,101,"ENSG00000079974.19"
"47727","ENSG00000289130.2_43188",43180,43188,9,"ENSG00000289130.2",1,8,"VVVVUVVMV",1,7,0.773913043478261,115,121,133,136,148,154,169,172,"GTGAAGA","TAGA","CTGAAAA","CTGA",2.44298806964546,12,12,15,48,2.58494111848045,4.71788206236255,7.81353423627559,101,"ENSG00000079974.19"
"46529","ENSG00000286780.1_84518",84510,84518,9,"ENSG00000286780.1",0,NA,"UVVVVUVVV",2,7,0.824844720496894,115,121,133,136,186,192,214,217,"CTGTTGA","CAGA","ATGGTGG","CTGA",2.49718601913235,12,50,22,93,1.40863840538673,4.5141362999006,7.81351518188818,101,"ENSG00000079974.19"
"32539","ENSG00000227124.11_60201",60193,60201,9,"ENSG00000227124.11",1,8,"UVVVVVVMV",1,7,0.786749482401656,115,121,133,136,139,145,153,156,"TTGATGT","GTTA","TTTGTGA","CTGA",2.35921383942778,12,3,8,32,2.93775089458213,4.6664607893585,7.81345871896513,101,"ENSG00000079974.19"
"36948","ENSG00000243797.6_9431",9423,9431,9,"ENSG00000243797.6",1,7,"VVVVVUMVV",1,7,0.807453416149068,114,120,133,136,144,150,163,166,"AATATTA","ATGA","GTGTTTA","CTGA",2.31310863308949,13,8,13,43,2.91376640783383,4.58362265710761,7.81343632170389,101,"ENSG00000079974.19"
"24133","ENSG00000175198.17_55792",55784,55792,9,"ENSG00000175198.17",0,NA,"UVVUVVVVV",2,7,0.78343685300207,110,116,133,136,168,174,193,196,"TTGATGG","CTCA","GTGAGGA","CTGA",2.60292335109445,17,32,19,77,1.36552920803529,4.67958788716623,7.81333529917451,101,"ENSG00000079974.19"
"19013","ENSG00000160190.14_83186",83178,83186,9,"ENSG00000160190.14",0,NA,"VVVVVUUVV",2,7,0.808281573498965,92,98,106,109,114,120,133,136,"GCGAGGA","CTGA","GTGATGT","CTGG",2.34110952430907,8,5,13,35,2.71335586697867,4.58018817392644,7.8133144679223,101,"ENSG00000079974.19"
"12702","ENSG00000138785.16_94725",94717,94725,9,"ENSG00000138785.16",1,6,"VVVUVMVVV",1,7,0.78343685300207,115,121,133,136,151,157,169,172,"GTGAATA","GTGA","CTGATTA","CTGA",2.43065220738,12,15,12,48,2.51388137770918,4.67955735672729,7.81330476873557,101,"ENSG00000079974.19"
"38859","ENSG00000251175.5_25911",25903,25911,9,"ENSG00000251175.5",1,6,"VVVUVMVVV",1,7,0.78343685300207,115,121,133,136,151,157,169,172,"GTGAATA","GTGA","CTGATTA","CTGA",2.43065220738,12,15,12,48,2.51388137770918,4.67955735672729,7.81330476873557,101,"ENSG00000079974.19"
"27660","ENSG00000187079.20_256203",256195,256203,9,"ENSG00000187079.20",1,1,"MVVVVUVVV",1,7,0.82815734989648,95,101,112,115,116,122,133,136,"GTGATGT","CTGG","CTGCAGA","CTGG",2.31894206147161,11,1,11,32,2.54284999452133,4.50061593441634,7.81324533400227,101,"ENSG00000079974.19"
"7420","ENSG00000114120.14_16859",16851,16859,9,"ENSG00000114120.14",0,NA,"UVVVUVVVV",2,7,0.792546583850932,101,107,133,136,140,146,156,159,"GGGATGA","TTGT","ATGTTGA","CTGA",2.48995576272039,26,4,10,49,1.97253000279632,4.64305877189972,7.81324510730345,101,"ENSG00000079974.19"
"27021","ENSG00000185420.19_698192",698184,698192,9,"ENSG00000185420.19",1,6,"VVVUVMVVV",1,7,0.78343685300207,54,60,91,94,100,106,133,136,"ATGATCA","TTGA","GTGAGCA","CTGA",2.62474613441705,31,6,27,73,1.21946680129001,4.67944359101759,7.81319100302587,101,"ENSG00000079974.19"
"15901","ENSG00000150275.20_1399074",1399066,1399074,9,"ENSG00000150275.20",1,1,"MVVVVUVVV",1,7,0.82815734989648,80,86,97,100,109,115,133,136,"GTGATGC","TTGA","CTGATTT","CTGG",2.31569544205214,11,9,18,47,2.5642180314518,4.50054691128318,7.81317631086911,101,"ENSG00000079974.19"
"21091","ENSG00000166435.17_20262",20254,20262,9,"ENSG00000166435.17",1,1,"MVVVVVUVV",1,7,0.792132505175983,84,90,104,107,116,122,133,136,"ATCAAGA","CTGT","GGCAGGA","CTGA",2.34988861083208,14,9,11,43,2.91263987276715,4.64464098624526,7.8131710069492,101,"ENSG00000079974.19"
"46948","ENSG00000287394.1_63458",63450,63458,9,"ENSG00000287394.1",1,1,"MVVVVUVVV",1,7,0.82815734989648,94,100,133,136,142,148,160,163,"GTGAGGA","ATAA","ATAAAGA","CTGA",2.40648048185243,33,6,12,60,1.95874767459899,4.50048772173714,7.81311712132306,101,"ENSG00000079974.19"
"23853","ENSG00000174469.23_1421840",1421832,1421840,9,"ENSG00000174469.23",1,3,"UVMVVVVVV",1,7,0.785507246376811,65,71,81,84,90,96,133,136,"GTTATAA","CTGA","GTGTTTA","CTGA",2.51170064515821,10,6,37,62,1.93964929070082,4.67108006460556,7.81310905011281,101,"ENSG00000079974.19"
"29211","ENSG00000197442.11_17614",17606,17614,9,"ENSG00000197442.11",1,8,"VVUVVVVMV",1,7,0.767701863354037,93,99,106,109,115,121,133,136,"ATGAGGA","CTGA","TAGAAGA","ATGA",2.43732105902404,7,6,12,34,2.7203245076012,4.74228289194037,7.81309034535652,101,"ENSG00000079974.19"
"26812","ENSG00000185046.20_342921",342913,342921,9,"ENSG00000185046.20",1,5,"VVVVMVUVV",1,7,0.772670807453416,49,55,67,70,76,82,133,136,"ATGATGA","GTGA","ATAATGA","CTTA",2.53548739435395,12,6,51,78,1.9858803901234,4.72228242145409,7.81296565126776,101,"ENSG00000079974.19"
"12140","ENSG00000137473.19_118095",118087,118095,9,"ENSG00000137473.19",0,NA,"VVVUVUVVV",2,7,0.802898550724638,113,119,133,136,139,145,158,161,"ACAATGT","GTGA","GTGATAG","CTGA",2.3664999729296,14,3,13,39,2.62870264911643,4.60134228382844,7.81293648672699,101,"ENSG00000079974.19"
"2184","ENSG00000071051.14_83661",83653,83661,9,"ENSG00000071051.14",0,NA,"VVUVVUVVV",2,7,0.805797101449275,74,80,94,97,114,120,133,136,"GTAATGA","CTGA","CTGAAAA","CTGC",2.40713039981962,14,17,13,53,2.31130807312388,4.58971101798034,7.81289942377744,101,"ENSG00000079974.19"
"28918","ENSG00000196696.14_31924",31916,31924,9,"ENSG00000196696.14",1,2,"UMVVVVVVV",1,7,0.786749482401656,18,24,36,39,77,83,133,136,"ATAATGT","CTGA","TTGTTGA","CTGA",2.64740798270041,12,38,50,109,1.0137243610759,4.665777728103,7.81277565770962,101,"ENSG00000079974.19"
"40178","ENSG00000255185.7_31752",31744,31752,9,"ENSG00000255185.7",1,2,"UMVVVVVVV",1,7,0.786749482401656,18,24,36,39,77,83,133,136,"ATAATGT","CTGA","TTGTTGA","CTGA",2.64740798270041,12,38,50,109,1.0137243610759,4.665777728103,7.81277565770962,101,"ENSG00000079974.19"
"37815","ENSG00000248905.10_262081",262073,262081,9,"ENSG00000248905.10",1,8,"VVVVVVUMV",1,7,0.770186335403727,53,59,70,73,89,95,133,136,"ATGATGA","CTGA","GTAAGGA","CAGA",2.61513634169884,11,16,38,74,1.49367980749623,4.73198052137213,7.81272586298703,101,"ENSG00000079974.19"
"11894","ENSG00000136367.15_9001",8993,9001,9,"ENSG00000136367.15",1,2,"VMVUVVVVV",1,7,0.764803312629399,115,121,133,136,139,145,155,158,"ATCTTGA","CTGT","GGGATGG","CTGA",2.42194558311842,12,3,10,34,2.86771789302922,4.75350544512133,7.81271869563893,101,"ENSG00000079974.19"
"2877","ENSG00000078725.13_95563",95555,95563,9,"ENSG00000078725.13",1,1,"MVVUVVVVV",1,7,0.786749482401656,112,118,133,136,146,152,174,177,"ATGAAGT","TTGA","GTGAACG","CTGA",2.46709632467435,15,10,22,56,2.21529153588901,4.66565009176284,7.81264802136947,101,"ENSG00000079974.19"
"27380","ENSG00000186094.18_1238812",1238804,1238812,9,"ENSG00000186094.18",1,1,"MVVVUVVVV",1,7,0.795859213250517,91,97,133,136,185,191,205,208,"ATGAAGA","CTGG","CTGAGGA","CTGA",2.64569526580509,36,49,14,108,0.878615435663694,4.62914596859107,7.81258282159314,101,"ENSG00000079974.19"
"25739","ENSG00000182667.15_450895",450887,450895,9,"ENSG00000182667.15",0,NA,"UVVVVVUVV",2,7,0.788819875776397,116,122,133,136,137,143,157,160,"CTGCTGT","CTGT","GTGATCA","CTGA",2.44883104965411,11,1,14,35,2.30351139681666,4.65726293196102,7.81254243506661,101,"ENSG00000079974.19"
"42415","ENSG00000262655.4_53381",53373,53381,9,"ENSG00000262655.4",1,8,"VVVVUVVMV",1,7,0.773913043478261,40,46,55,58,73,79,133,136,"TTGATGA","CTGG","GGGATTA","CTGA",2.62147679892607,9,15,54,87,1.39102382930962,4.71688395553752,7.81253612945056,101,"ENSG00000079974.19"
"29459","ENSG00000198010.13_516327",516319,516327,9,"ENSG00000198010.13",1,8,"VVVVVUUMV",2,6,0.692339544513457,105,111,133,136,184,190,201,204,"GTGATGA","CTGA","GTGCGGA","CTGA",2.82726639836732,22,48,11,90,1.32418471937701,5.04315684378978,7.81251502184361,101,"ENSG00000079974.19"
"16489","ENSG00000151692.15_130069",130061,130069,9,"ENSG00000151692.15",1,8,"VVVVVUVMV",1,7,0.806211180124224,71,77,92,95,106,112,133,136,"ATGGTGG","GTGG","ATGAGGA","CTGA",2.42185967778559,15,11,21,56,2.20488210257733,4.58765332195365,7.81249804245055,101,"ENSG00000079974.19"
"42006","ENSG00000260289.2_61092",61084,61092,9,"ENSG00000260289.2",1,2,"VMVVVUVVV",1,7,0.806211180124223,116,122,133,136,143,149,159,162,"GTGGTGA","CTTG","AGAAAGA","CTGA",2.29452949269542,11,7,10,37,3.05362272147605,4.58762150152805,7.81246622202494,101,"ENSG00000079974.19"
"37340","ENSG00000247381.3_8260",8252,8260,9,"ENSG00000247381.3",0,NA,"VVVUVVUVV",2,7,0.766873706004141,116,122,133,136,144,150,168,171,"ATGTTGG","CTGG","TTGAAAA","CTGA",2.45673883186585,11,8,18,46,2.60161669597259,4.74496889376957,7.81246371778613,101,"ENSG00000079974.19"
"29390","ENSG00000197934.8_111467",111459,111467,9,"ENSG00000197934.8",1,8,"UVVVVVVMV",1,7,0.786749482401656,114,120,133,136,153,159,183,186,"ATGCTGA","CTGT","ATGAATT","CTGA",2.5386182499631,13,17,24,63,1.73754534906853,4.6654167538723,7.81241468347892,101,"ENSG00000079974.19"
"15870","ENSG00000149972.12_659187",659179,659187,9,"ENSG00000149972.12",1,8,"UVVVVUVMV",2,6,0.708902691511387,115,121,133,136,177,183,194,197,"AAGATGA","CTGA","ATCATGG","CTGA",2.68724250891682,12,41,11,73,1.99194454587277,4.97672365132956,7.81233441737511,101,"ENSG00000079974.19"
"15716","ENSG00000149256.16_608848",608840,608848,9,"ENSG00000149256.16",1,8,"VVUVVVVMV",1,7,0.767701863354037,109,115,133,136,147,153,183,186,"AGGAAGA","CTGA","AAGATGA","CTGA",2.6007031533121,18,11,30,68,1.6280456552049,4.74151666932139,7.81232412273754,101,"ENSG00000079974.19"
"2600","ENSG00000076382.17_19026",19018,19026,9,"ENSG00000076382.17",1,7,"VVUVVVMVV",1,7,0.768944099378882,114,120,133,136,146,152,169,172,"CAGATGA","CTGG","GTGGGAA","CTGA",2.45301743006532,13,10,17,49,2.59264543972174,4.73652374337264,7.81230014088817,101,"ENSG00000079974.19"
"21428","ENSG00000167524.17_34198",34190,34198,9,"ENSG00000167524.17",1,7,"VVUVVVMVV",1,7,0.768944099378882,114,120,133,136,146,152,169,172,"CAGATGA","CTGG","GTGGGAA","CTGA",2.45301743006532,13,10,17,49,2.59264543972174,4.73652374337264,7.81230014088817,101,"ENSG00000079974.19"
"3398","ENSG00000083168.11_44565",44557,44565,9,"ENSG00000083168.11",1,2,"VMVVUVVVV",1,7,0.773913043478261,105,111,133,136,145,151,165,168,"ATAATGA","CTGT","ATAATTT","CTGA",2.50612967016948,22,9,14,54,2.15904595693058,4.71664427284844,7.81229644676148,101,"ENSG00000079974.19"
"5096","ENSG00000103056.12_10872",10864,10872,9,"ENSG00000103056.12",0,NA,"UVVUVVVVV",2,7,0.78343685300207,116,122,133,136,152,158,168,171,"TTGATGA","TTGA","AGGATGA","CTGT",2.43698928195263,11,16,10,46,2.46753467376429,4.67853247169546,7.81227988370374,101,"ENSG00000079974.19"
"16498","ENSG00000151693.11_6500",6492,6500,9,"ENSG00000151693.11",1,8,"VVUVVVVMV",1,7,0.767701863354037,99,105,133,136,150,156,165,168,"AAGATGT","CTGA","GGGATCA","CTGA",2.58996988784833,28,14,9,60,1.69937519793952,4.74146027923209,7.81226773264824,101,"ENSG00000079974.19"
"40135","ENSG00000255082.1_7639",7631,7639,9,"ENSG00000255082.1",1,6,"UVVVVMVVV",1,7,0.805383022774327,90,96,133,136,184,190,206,209,"GTGATGA","TTGA","GGGAGAA","CTGA",2.63978701112651,37,48,16,110,0.76425434404477,4.59070860455537,7.81224069565268,101,"ENSG00000079974.19"
"15644","ENSG00000148948.8_828167",828159,828167,9,"ENSG00000148948.8",1,1,"MVVVVVUVV",1,7,0.792132505175983,105,111,133,136,140,146,159,162,"ATCATGT","ATGA","AAGATGG","CTGA",2.47185218389153,22,4,13,48,2.09575265771992,4.6436918042492,7.81222182495313,101,"ENSG00000079974.19"
"6140","ENSG00000108100.18_270908",270900,270908,9,"ENSG00000108100.18",0,NA,"VVVVVUUVV",2,7,0.808281573498965,103,109,133,136,156,162,177,180,"ATTAGGA","CTGA","CTGTTGG","CTGA",2.55043845009441,24,20,15,68,1.31312421745452,4.57901180452098,7.81213809851684,101,"ENSG00000079974.19"
"44107","ENSG00000278254.4_72719",72711,72719,9,"ENSG00000278254.4",0,NA,"VVUVVUVVV",2,7,0.805797101449275,100,106,133,136,157,163,178,181,"ATAATGA","CTGT","AAGAAGA","CTGA",2.5796093998992,27,21,15,72,1.15814405668675,4.5888850140037,7.8120734198008,101,"ENSG00000079974.19"
"35944","ENSG00000237505.8_397689",397681,397689,9,"ENSG00000237505.8",1,8,"VVVUVVVMV",1,7,0.764803312629399,61,67,75,78,92,98,133,136,"ATAATTA","CTGA","GTGATGG","CTGA",2.64066553100383,8,14,35,66,1.40694474415752,4.7528454043791,7.8120586548967,101,"ENSG00000079974.19"
"17948","ENSG00000155893.13_11290",11282,11290,9,"ENSG00000155893.13",1,8,"VVVVVUVMV",1,7,0.806211180124224,71,77,100,103,111,117,133,136,"ATGATGA","ATGA","TGGCTGA","CTGG",2.44959440432297,23,8,16,56,2.01817622917652,4.58720139783242,7.81204611832931,101,"ENSG00000079974.19"
"8124","ENSG00000116984.15_111891",111883,111891,9,"ENSG00000116984.15",1,6,"UVVVVMVVV",1,7,0.805383022774327,82,88,98,101,108,114,133,136,"CTGATGA","CTGT","CTGTTGG","CTGG",2.37915408175467,10,7,19,45,2.50060394914553,4.59040779021083,7.81193988130813,101,"ENSG00000079974.19"
"8823","ENSG00000120833.14_7368",7360,7368,9,"ENSG00000120833.14",1,8,"UVVVVVVMV",1,7,0.786749482401656,84,90,105,108,115,121,133,136,"GTGGGGA","ATGA","GTGAAAT","CTGA",2.36697254905203,15,7,12,43,2.87991769593812,4.66493367240458,7.81193160201121,101,"ENSG00000079974.19"
"12302","ENSG00000137822.13_39926",39918,39926,9,"ENSG00000137822.13",0,NA,"VVVVVUUVV",2,7,0.808281573498965,111,117,133,136,147,153,170,173,"TTGGTGA","CCTA","ATAATGA","CTGA",2.39159153635535,16,11,17,53,2.37076607058593,4.57867741157206,7.81180370556792,101,"ENSG00000079974.19"
"44463","ENSG00000282278.1_708949",708941,708949,9,"ENSG00000282278.1",1,2,"VMVVVUVVV",1,7,0.806211180124223,85,91,101,104,111,117,133,136,"TTGCTGT","CTCA","CTGATCC","CTGA",2.3478873738681,10,7,16,42,2.69523991124441,4.5869556009246,7.8118003214215,101,"ENSG00000079974.19"
"45676","ENSG00000285783.1_704275",704267,704275,9,"ENSG00000285783.1",1,7,"VVVVVUMVV",1,7,0.807453416149068,115,121,133,136,150,156,188,191,"TTGAGGA","CAGA","CTGACAA","CTGA",2.49212411398444,12,14,32,67,1.7133163548651,4.58186927869034,7.81168294328661,101,"ENSG00000079974.19"
"17492","ENSG00000154240.17_216097",216089,216097,9,"ENSG00000154240.17",1,7,"VVVVVUMVV",1,7,0.807453416149068,58,64,76,79,87,93,133,136,"GTGTTCA","CCGA","GTGATTA","CTGA",2.44794611241758,12,8,40,69,2.00724430952782,4.58172126474458,7.81153492934086,101,"ENSG00000079974.19"
"37972","ENSG00000249290.5_6442",6434,6442,9,"ENSG00000249290.5",1,2,"VMVVVVUVV",1,7,0.770186335403727,88,94,110,113,115,121,133,136,"ATCATGG","CTGT","ATGAGGG","CTGA",2.48356403378503,16,2,12,39,2.36599057600752,4.7307710336436,7.8115163752585,101,"ENSG00000079974.19"
"28015","ENSG00000187957.8_131978",131970,131978,9,"ENSG00000187957.8",1,8,"VVVVVUVMV",1,7,0.806211180124224,116,122,133,136,139,145,158,161,"ATTATGA","ATGA","TTGAGTA","TTGA",2.34737033786439,11,3,13,36,2.69737098893804,4.58662664367515,7.81147136417205,101,"ENSG00000079974.19"
"46350","ENSG00000286481.2_842902",842894,842902,9,"ENSG00000286481.2",1,1,"MVVVVUVVV",1,7,0.82815734989648,113,119,133,136,162,168,177,180,"AGGATGA","TAGA","AGCTTGA","CTGA",2.3892484288932,14,26,9,58,2.06683197752049,4.49878870920213,7.81141810878805,101,"ENSG00000079974.19"
"34284","ENSG00000232455.2_1266",1258,1266,9,"ENSG00000232455.2",1,8,"VVVVVUVMV",1,7,0.806211180124224,106,112,133,136,185,191,199,202,"ATGATCA","CTGT","CTCATGG","CTGA",2.54326918265302,21,49,8,87,1.39104546989927,4.58654333856319,7.81138805906008,101,"ENSG00000079974.19"
"29556","ENSG00000198216.14_42991",42983,42991,9,"ENSG00000198216.14",1,3,"UVMVVVVVV",1,7,0.785507246376811,114,120,133,136,171,177,215,218,"GTGATGG","GTGA","GTGGTGA","CTGA",2.64469405444937,13,35,38,95,1.0458107301526,4.66927610662043,7.81130509212768,101,"ENSG00000079974.19"
"36020","ENSG00000237734.1_3482",3474,3482,9,"ENSG00000237734.1",1,8,"UVVVVVVMV",1,7,0.786749482401656,92,98,106,109,116,122,133,136,"TTGATCA","CAAA","GTTAGGA","CTGA",2.37128424308841,8,7,11,35,2.84853916022757,4.66427519520425,7.81127312481087,101,"ENSG00000079974.19"
"36206","ENSG00000238280.2_98301",98293,98301,9,"ENSG00000238280.2",1,8,"VVUVVVVMV",1,7,0.767701863354037,107,113,133,136,142,148,161,164,"ATGTAGA","TTGA","TTGATTA","CTGA",2.48498033209391,20,6,13,48,2.39513328501186,4.74041720807615,7.8112246614923,101,"ENSG00000079974.19"
"29534","ENSG00000198162.12_72713",72705,72713,9,"ENSG00000198162.12",1,5,"UVVVMVVVV",1,7,0.789233954451346,115,121,133,136,141,147,173,176,"ATGTTAA","CAGA","GTGATAT","CTGA",2.4673277822787,12,5,26,52,2.1682450082525,4.65427422252763,7.81121004033301,101,"ENSG00000079974.19"
"29579","ENSG00000198346.11_11718",11710,11718,9,"ENSG00000198346.11",0,NA,"VVVVUVUVV",2,7,0.775983436853002,95,101,133,136,141,147,161,164,"ATGATGA","GAGA","AAGGTGG","CTGA",2.55040189595102,32,5,14,60,1.82618072569112,4.70721500800781,7.81114875541982,101,"ENSG00000079974.19"
"38657","ENSG00000250731.1_101",93,101,9,"ENSG00000250731.1",0,NA,"VVVVUVUVV",2,7,0.775983436853002,65,71,103,106,111,117,131,134,"ATGATGA","GAGA","AAGGTGG","CTGA",2.55040189595102,32,5,14,60,1.82618072569112,4.70721500800781,7.81114875541982,101,"ENSG00000079974.19"
"28257","ENSG00000188580.15_559779",559771,559779,9,"ENSG00000188580.15",1,1,"MVVVVVUVV",1,7,0.792132505175983,44,50,67,70,80,86,133,136,"ATAATGA","ATGC","TTGAAGA","CTGA",2.53682048300985,17,10,47,83,1.65800479048853,4.64253533597188,7.81106535667582,101,"ENSG00000079974.19"
"28899","ENSG00000196660.12_135961",135953,135961,9,"ENSG00000196660.12",1,6,"VVVVUMVVV",1,7,0.792546583850932,98,104,133,136,144,150,160,163,"ATGAAGA","GTGC","GTGCTCA","CTGA",2.47773351885789,29,8,10,56,2.0452007583321,4.64085605434617,7.8110423897499,101,"ENSG00000079974.19"
"40886","ENSG00000258028.3_54160",54152,54160,9,"ENSG00000258028.3",1,1,"MVVVVUVVV",1,7,0.82815734989648,99,105,133,136,145,151,171,174,"GTGATGC","GTTA","GTGGAGA","CTGA",2.46725101827918,28,9,20,66,1.54495550714242,4.49832390725091,7.81095330683683,101,"ENSG00000079974.19"
"24443","ENSG00000176406.25_18163",18155,18163,9,"ENSG00000176406.25",1,2,"UMVVVVVVV",1,7,0.786749482401656,110,116,133,136,142,148,161,164,"CTGATGA","CTCA","ATGAGAA","CTCA",2.39870905907912,17,6,13,45,2.6639508472496,4.66383614361093,7.81083407321756,101,"ENSG00000079974.19"
"43165","ENSG00000269651.1_1573",1565,1573,9,"ENSG00000269651.1",0,NA,"VVVVVUUVV",2,7,0.808281573498965,82,88,133,136,164,170,181,184,"ATGATGA","GGGA","GTGGTAT","CTGA",2.58770200504008,45,28,11,93,1.05943946188294,4.57769654053754,7.8108228345334,101,"ENSG00000079974.19"
"19823","ENSG00000163754.18_14273",14265,14273,9,"ENSG00000163754.18",1,8,"VVUVVVVMV",1,7,0.767701863354037,116,122,133,136,146,152,169,172,"ATGGTGA","ATAA","TTGTGGA","CTGA",2.45799210948218,11,10,17,47,2.57340273289247,4.74000419902675,7.8108116524429,101,"ENSG00000079974.19"
"32353","ENSG00000226829.2_54204",54196,54204,9,"ENSG00000226829.2",1,2,"UMVVVUVVV",2,6,0.708902691511387,109,115,133,136,139,145,153,156,"ATGTTGT","CTGA","GTGAGTA","CTGA",2.62401444095825,18,3,8,38,2.40720706188081,4.97515916706728,7.81076993311283,101,"ENSG00000079974.19"
"24437","ENSG00000176371.14_3073",3065,3073,9,"ENSG00000176371.14",1,8,"VVVVUVVMV",1,7,0.773913043478261,107,113,133,136,143,149,158,161,"AGGATGA","GTGC","AGGATGG","CTGA",2.45480757377025,20,7,9,45,2.49500504206971,4.71509721680117,7.81074939071421,101,"ENSG00000079974.19"
"33715","ENSG00000230894.2_10029",10021,10029,9,"ENSG00000230894.2",0,NA,"UVVVVVUVV",2,7,0.788819875776397,49,55,80,83,90,96,133,136,"GTGATGA","CTGA","TTGAAGA","CTTA",2.61201543311635,25,7,37,78,1.2083506789628,4.65544672493462,7.81072622804021,101,"ENSG00000079974.19"
"46634","ENSG00000286946.1_2869",2861,2869,9,"ENSG00000286946.1",0,NA,"VVVUUVVVV",2,7,0.770600414078675,106,112,133,136,147,153,172,175,"GTGAGGT","TTGA","ATGATGA","CTGA",2.56393293942955,21,11,19,60,1.82015317224391,4.72825985877689,7.81066151509159,101,"ENSG00000079974.19"
"41975","ENSG00000260192.3_665891",665883,665891,9,"ENSG00000260192.3",1,2,"UMVVVUVVV",2,6,0.708902691511387,104,110,133,136,144,150,180,183,"TTGATGA","TTGA","ATGATGA","CTGA",2.77705926264761,23,8,30,70,1.3862516297864,4.97499501185929,7.81060577790484,101,"ENSG00000079974.19"
"18262","ENSG00000156687.11_534570",534562,534570,9,"ENSG00000156687.11",1,8,"UVVVVVVMV",1,7,0.786749482401656,77,83,100,103,115,121,133,136,"AAAATGA","ATGG","GTGAAGA","CTGA",2.42612458496527,17,12,12,50,2.47967032432243,4.66345855602272,7.81045648562934,101,"ENSG00000079974.19"
"28719","ENSG00000196376.11_158194",158186,158194,9,"ENSG00000196376.11",1,2,"VMVVVUVVV",1,7,0.806211180124223,109,115,133,136,146,152,167,170,"ATTCTGA","GTAA","GTGATGG","CTGA",2.39401370881608,18,10,15,52,2.38194285506313,4.58550856179258,7.81035328228947,101,"ENSG00000079974.19"
"21858","ENSG00000169155.10_27966",27958,27966,9,"ENSG00000169155.10",0,NA,"VVVUVUVVV",2,7,0.802898550724638,112,118,133,136,157,163,180,183,"ATAATGG","TTGA","CTGATTT","CTGA",2.48242091841064,15,21,17,62,1.84544992312149,4.59873067813145,7.81032488103,101,"ENSG00000079974.19"
"5302","ENSG00000104313.20_259115",259107,259115,9,"ENSG00000104313.20",1,8,"VVVVUVVMV",1,7,0.773913043478261,71,77,101,104,115,121,133,136,"GTGATCA","CTCA","ATGAGTA","CTGA",2.52706570313244,24,11,12,56,2.01117289422962,4.7145693954448,7.81022156935785,101,"ENSG00000079974.19"
"11700","ENSG00000135862.6_116242",116234,116242,9,"ENSG00000135862.6",0,NA,"VVUVUVVVV",2,7,0.773498964803312,115,121,133,136,169,175,186,189,"ATTATGT","CAGA","GTGAGAA","CTGA",2.5274412214059,12,33,11,65,2.01507542576278,4.7161708921172,7.81016675133045,101,"ENSG00000079974.19"
"38600","ENSG00000250546.6_406897",406889,406897,9,"ENSG00000250546.6",1,1,"MVVVUVVVV",1,7,0.795859213250517,113,119,133,136,143,149,164,167,"AAGGTGA","TAGA","ATGAAAA","CTGA",2.3579847198772,14,7,15,45,2.78701068822528,4.62672720518499,7.81016405818706,101,"ENSG00000079974.19"
"3015","ENSG00000080224.18_97692",97684,97692,9,"ENSG00000080224.18",0,NA,"UVVVVUVVV",2,7,0.824844720496894,89,95,133,136,146,152,173,176,"ATGCTGT","CTGT","GTGAATA","CTGA",2.50215643970542,38,10,21,78,1.36152405888108,4.51064174756263,7.81002062955021,101,"ENSG00000079974.19"
"34242","ENSG00000232284.9_356554",356546,356554,9,"ENSG00000232284.9",1,8,"VVVVUVVMV",1,7,0.773913043478261,107,113,133,136,140,146,156,159,"GTGAGGA","TTGA","AGGAAGC","CTGA",2.47750623617371,20,4,10,43,2.34048638914867,4.71429865757669,7.80995083148974,101,"ENSG00000079974.19"
"6411","ENSG00000109738.11_46551",46543,46551,9,"ENSG00000109738.11",1,8,"VVVVVUVMV",1,7,0.806211180124224,82,88,96,99,106,112,133,136,"TTGATGT","CTGA","GTGATTG","CTTA",2.42144073924464,8,7,21,45,2.1974441328555,4.5850955986216,7.8099403191185,101,"ENSG00000079974.19"
"14928","ENSG00000146151.14_18638",18630,18638,9,"ENSG00000146151.14",1,8,"VVVVUUVMV",2,6,0.696066252587992,78,84,97,100,113,119,133,136,"ATGATTA","ATGA","GTGAGGG","CTGA",2.63105230453087,13,13,14,49,2.56232867890814,5.02566934394516,7.80993435429712,101,"ENSG00000079974.19"
"24145","ENSG00000175274.19_27051",27043,27051,9,"ENSG00000175274.19",1,5,"VVVVMUVVV",1,7,0.808695652173913,71,77,90,93,113,119,133,136,"GTGAGGA","CTGA","GTGTTGG","CTCA",2.42328074889715,13,20,14,56,2.14499639046004,4.57505034577692,7.80983295447258,101,"ENSG00000079974.19"
"24539","ENSG00000176771.18_709052",709044,709052,9,"ENSG00000176771.18",0,NA,"VVVVVUUVV",2,7,0.808281573498965,114,120,133,136,167,173,185,188,"ATCATCA","CTGC","GTGTTGC","CTGA",2.44659869451018,13,31,12,65,1.99611778197946,4.57669393634517,7.80982023034103,101,"ENSG00000079974.19"
"48471","ENSG00000291144.1_116461",116453,116461,9,"ENSG00000291144.1",1,6,"UVVVVMVVV",1,7,0.805383022774327,112,118,133,136,138,144,152,155,"AAGATGA","CCTA","GGCATTA","CTGA",2.36570354974488,15,2,8,34,2.58157395972986,4.58823273950727,7.80976483060458,101,"ENSG00000079974.19"
"10822","ENSG00000132932.19_54085",54077,54085,9,"ENSG00000132932.19",1,1,"MVVVVUVVV",1,7,0.82815734989648,114,120,133,136,161,167,218,221,"ATGAAGA","CAGT","GAGATGA","CTGA",2.53002174654114,13,25,51,98,1.121521853525,4.49708337428315,7.80971277386907,101,"ENSG00000079974.19"
"37718","ENSG00000248694.1_306",298,306,9,"ENSG00000248694.1",1,1,"MVVVVUVVV",1,7,0.82815734989648,91,97,133,136,146,152,160,163,"ATGATGC","TCGA","GATTTGA","CTGA",2.41554549837481,36,10,8,63,1.88442442723627,4.49701527076708,7.809644670353,101,"ENSG00000079974.19"
"5594","ENSG00000105939.14_8585",8577,8585,9,"ENSG00000105939.14",1,6,"VVVUVMVVV",1,7,0.78343685300207,109,115,133,136,168,174,192,195,"AGGATGT","CAGA","TTGATGA","CTGA",2.60487749236282,18,32,18,77,1.33766829421099,4.67587956082411,7.80962697283239,101,"ENSG00000079974.19"
"33566","ENSG00000230379.5_35395",35387,35395,9,"ENSG00000230379.5",1,1,"MVVVVVUVV",1,7,0.792132505175983,106,112,133,136,149,155,166,169,"ATAATGA","TTAA","GAGATAA","CTGA",2.47114558956196,21,13,11,54,2.08981463524942,4.64102964141562,7.80955966211955,101,"ENSG00000079974.19"
"35569","ENSG00000236333.4_20824",20816,20824,9,"ENSG00000236333.4",1,8,"VVVUVVVMV",1,7,0.764803312629399,86,92,133,136,140,146,163,166,"GTGATGG","ATGA","TTGATGG","CTGA",2.61973253159986,41,4,17,71,1.53636120847335,4.7503111881181,7.8095244386357,101,"ENSG00000079974.19"
"18734","ENSG00000158321.19_261920",261912,261920,9,"ENSG00000158321.19",1,8,"VVUVVVVMV",1,7,0.767701863354037,101,107,133,136,155,161,177,180,"ATGATGA","TTTA","GTGAGGG","CTGA",2.66099357727565,26,19,16,70,1.21487370418814,4.73870772150645,7.8095151749226,101,"ENSG00000079974.19"
"8897","ENSG00000121316.11_54837",54829,54837,9,"ENSG00000121316.11",1,2,"UMVVVVVVV",1,7,0.786749482401656,111,117,133,136,146,152,165,168,"ATGATAA","ATGG","GAGACCA","CTGA",2.39877122375296,16,10,13,48,2.65706975281283,4.66221947779147,7.8092174073981,101,"ENSG00000079974.19"
"33221","ENSG00000229066.2_4101",4093,4101,9,"ENSG00000229066.2",1,2,"VMVVVUVVV",1,7,0.806211180124223,96,102,133,136,145,151,161,164,"CTGCTGA","CTTA","ATCATAA","CTGA",2.45322892018984,31,9,10,59,1.98260087126759,4.58436508479997,7.80920980529686,101,"ENSG00000079974.19"
"37288","ENSG00000246662.6_266169",266161,266169,9,"ENSG00000246662.6",1,2,"VMVVVUVVV",1,7,0.806211180124223,68,74,87,90,108,114,133,136,"AAAATGA","CTTA","ATGAGGT","CTGA",2.45902783395894,13,18,19,59,1.94364187998557,4.58429019326129,7.80913491375819,101,"ENSG00000079974.19"
"22223","ENSG00000169946.14_95945",95937,95945,9,"ENSG00000169946.14",1,1,"MVUVVUVVV",2,6,0.711801242236025,68,74,87,90,99,105,133,136,"GTGATGA","CAGA","GTGTTAT","CTGA",2.65902452930802,13,9,28,59,2.1206966291811,4.96188170614197,7.80908667508607,101,"ENSG00000079974.19"
"25341","ENSG00000180999.11_1061",1053,1061,9,"ENSG00000180999.11",1,8,"VVVVUVVMV",1,7,0.773913043478261,77,83,101,104,115,121,133,136,"GTGATCA","CTGG","GTATTGT","CTGA",2.45901452852228,18,11,12,50,2.46027132556381,4.71342537892809,7.80907755284114,101,"ENSG00000079974.19"
"2725","ENSG00000077782.23_61466",61458,61466,9,"ENSG00000077782.23",1,6,"UVVVVMVVV",1,7,0.805383022774327,99,105,133,136,146,152,168,171,"GTGATGA","TTCA","ATCAGAA","CTGA",2.49231011855809,28,10,16,63,1.7346959603388,4.58752418768152,7.80905627877883,101,"ENSG00000079974.19"
"891","ENSG00000039139.11_288390",288382,288390,9,"ENSG00000039139.11",0,NA,"UVVVVUVVV",2,7,0.824844720496894,98,104,133,136,141,147,186,189,"ATGTTGA","CTTG","TTGATGA","CTGA",2.55355628368895,29,5,39,82,1.01499680353172,4.50967634036452,7.8090552223521,101,"ENSG00000079974.19"
"26099","ENSG00000183337.18_10295",10287,10295,9,"ENSG00000183337.18",0,NA,"VVVUVVUVV",2,7,0.766873706004141,116,122,133,136,144,150,160,163,"GAGATCA","GTGA","GTGGTCA","CTGA",2.3916619777361,11,8,10,38,3.02123989921163,4.74141327102974,7.8089080950463,101,"ENSG00000079974.19"
"7989","ENSG00000116205.14_52898",52890,52898,9,"ENSG00000116205.14",1,2,"UMVVVVVVV",1,7,0.786749482401656,73,79,107,110,114,120,133,136,"ATTTTGA","TTGA","GTGATCA","CTGA",2.52186473767098,28,4,13,54,1.83494670005243,4.66184457113141,7.80884250073803,101,"ENSG00000079974.19"
"35554","ENSG00000236303.4_154910",154902,154910,9,"ENSG00000236303.4",1,8,"VVVVVUVMV",1,7,0.806211180124224,82,88,133,136,138,144,162,165,"ATGAGGA","CTGG","ATGGTTA","CTGA",2.57616075246323,45,2,18,74,1.16152603848714,4.58398276372718,7.80882748422407,101,"ENSG00000079974.19"
"29597","ENSG00000198382.9_16378",16370,16378,9,"ENSG00000198382.9",1,8,"UVVVVVVMV",1,7,0.786749482401656,113,119,133,136,144,150,165,168,"GAGATGA","CTGA","AAGATGG","CAGA",2.38133443817217,14,8,15,46,2.77174603734722,4.66182723962375,7.80882516923038,101,"ENSG00000079974.19"
"1798","ENSG00000066032.19_715835",715827,715835,9,"ENSG00000066032.19",1,8,"VVVVVVUMV",1,7,0.770186335403727,63,69,85,88,91,97,133,136,"ATGATGA","CAGA","GTGAAGA","CAGA",2.59934379696387,16,3,36,64,1.58285665170943,4.72795382453381,7.80869916614871,101,"ENSG00000079974.19"
"38159","ENSG00000249738.10_165752",165744,165752,9,"ENSG00000249738.10",1,2,"VMVVVUVVV",1,7,0.806211180124223,99,105,133,136,147,153,165,168,"GTGATGC","CCTA","TTGCTGA","CTGA",2.46964262687777,28,11,12,60,1.87110593007854,4.58384752731591,7.80869224781281,101,"ENSG00000079974.19"
"37660","ENSG00000248636.7_266065",266057,266065,9,"ENSG00000248636.7",1,6,"UVVVVMVVV",1,7,0.805383022774327,88,94,105,108,114,120,133,136,"ATGAGGC","GTGA","GTGATGT","CTTA",2.31389545573219,11,6,13,39,2.9225369314352,4.58712665907912,7.80865875017643,101,"ENSG00000079974.19"
"33007","ENSG00000228495.3_250485",250477,250485,9,"ENSG00000228495.3",1,2,"VMVVVUVVV",1,7,0.806211180124223,86,92,105,108,114,120,133,136,"ATGAACA","ATGC","GTTATGG","CTGA",2.31187251766624,13,6,13,41,2.9227224780417,4.58380148228749,7.80864620278439,101,"ENSG00000079974.19"
"37568","ENSG00000248491.6_124914",124906,124914,9,"ENSG00000248491.6",1,1,"MVVUVVVVV",1,7,0.786749482401656,93,99,133,136,151,157,172,175,"GTGATGA","ATGA","GTGATGA","TTGA",2.58945129496828,34,15,15,73,1.38306147361629,4.66151752668454,7.80851545629116,101,"ENSG00000079974.19"
"46736","ENSG00000287101.1_6724",6716,6724,9,"ENSG00000287101.1",1,1,"MVVUVVVVV",1,7,0.786749482401656,93,99,133,136,151,157,172,175,"GTGATGA","ATGA","GTGATGA","TTGA",2.58945129496828,34,15,15,73,1.38306147361629,4.66151752668454,7.80851545629116,101,"ENSG00000079974.19"
"39610","ENSG00000253901.1_52262",52254,52262,9,"ENSG00000253901.1",1,8,"VVVVVUVMV",1,7,0.806211180124224,108,114,133,136,148,154,172,175,"TTGATGT","CTCC","CTGATGT","CTGA",2.45338190846678,19,12,18,58,1.97872865743702,4.58365201180389,7.80849673230079,101,"ENSG00000079974.19"
"39284","ENSG00000253434.8_348599",348591,348599,9,"ENSG00000253434.8",1,1,"MVVVVUUVV",2,6,0.714285714285714,77,83,96,99,107,113,133,136,"ATAATGA","ATGA","GTAATAA","CTGA",2.59587973782161,13,8,20,50,2.49942558983265,4.95132262716084,7.8084654843037,101,"ENSG00000079974.19"
"10913","ENSG00000133107.15_11312",11304,11312,9,"ENSG00000133107.15",0,NA,"UVVVVVUVV",2,7,0.788819875776397,111,117,133,136,150,156,172,175,"ATTTTGA","CTAA","GTGTAGA","CTGA",2.459014849297,16,14,16,55,2.21925416276112,4.65317162285194,7.80845112595753,101,"ENSG00000079974.19"
"27184","ENSG00000185736.16_481932",481924,481932,9,"ENSG00000185736.16",1,8,"VVVUVVVMV",1,7,0.764803312629399,110,116,133,136,148,154,171,174,"CTGATGG","TTGA","CTGGTCA","CTGA",2.5167628975634,17,12,17,55,2.21849575262139,4.74922876742769,7.80844201794529,101,"ENSG00000079974.19"
"15395","ENSG00000148123.15_248758",248750,248758,9,"ENSG00000148123.15",1,8,"VVVVUVVMV",1,7,0.773913043478261,111,117,133,136,154,160,171,174,"ATGATGG","ATGC","TTGGAGA","CTGA",2.49818728382619,16,18,11,54,2.1965185983165,4.71277512262278,7.80842729653582,101,"ENSG00000079974.19"
"16276","ENSG00000151276.24_468519",468511,468519,9,"ENSG00000151276.24",1,1,"MVVVVUVVV",1,7,0.82815734989648,113,119,133,136,154,160,176,179,"ATGAAGT","CAGG","GTGATCC","CTGA",2.38313685675838,14,18,16,57,2.09517862186455,4.4956894167301,7.80831881631602,101,"ENSG00000079974.19"
"34150","ENSG00000231971.6_72709",72701,72709,9,"ENSG00000231971.6",1,2,"VMVVVUVVV",1,7,0.806211180124223,101,107,133,136,137,143,151,154,"CTAATGA","CTGG","TTGTTGA","CTGA",2.53283728167417,26,1,8,44,1.44814489624082,4.58343169351715,7.80827641401404,101,"ENSG00000079974.19"
"12176","ENSG00000137522.18_48259",48251,48259,9,"ENSG00000137522.18",1,7,"UVVVVVMVV",1,7,0.787991718426501,105,111,133,136,141,147,160,163,"AAGATGA","CCAA","CTGTGGA","CTGA",2.46538103934337,22,5,13,49,2.18880896416358,4.65617063994651,7.80813751365251,101,"ENSG00000079974.19"
"19512","ENSG00000163145.13_37394",37386,37394,9,"ENSG00000163145.13",0,NA,"UVVVVVUVV",2,7,0.788819875776397,80,86,104,107,114,120,133,136,"AAAATGG","ATGA","CTGAAGA","CTGA",2.40344329997233,18,7,13,47,2.58824341368252,4.65279968670784,7.80807918981343,101,"ENSG00000079974.19"
"5104","ENSG00000103091.15_35633",35625,35633,9,"ENSG00000103091.15",1,2,"UMVVVVVVV",1,7,0.786749482401656,112,118,133,136,147,153,173,176,"ATGGTAA","CAGA","ATGAAAA","CTGA",2.45747040372866,15,11,20,55,2.26101335825311,4.66103734577772,7.80803527538434,101,"ENSG00000079974.19"
"44330","ENSG00000280953.2_20549",20541,20549,9,"ENSG00000280953.2",1,2,"VMUVVVVVV",1,7,0.767701863354037,99,105,133,136,141,147,158,161,"ATGATGA","CTCT","ATGGTTT","CTGA",2.54302622788621,28,5,11,53,1.99537299314042,4.73722029476212,7.80802774817827,101,"ENSG00000079974.19"
"7653","ENSG00000115252.19_336265",336257,336265,9,"ENSG00000115252.19",1,8,"VVVVVUVMV",1,7,0.806211180124224,89,95,104,107,111,117,133,136,"ATAATAA","TTGA","ATTAACA","CTGA",2.37604461665017,9,4,16,38,2.4923773304413,4.58316869369394,7.80801341419083,101,"ENSG00000079974.19"
"9460","ENSG00000124782.21_16497",16489,16497,9,"ENSG00000124782.21",1,5,"VVVVMUVVV",1,7,0.808695652173913,115,121,133,136,141,147,156,159,"CTGTTGC","CTGG","GGGGTGG","CTGA",2.2845920357225,12,5,9,35,3.06188807165969,4.57312541078575,7.80790801948141,101,"ENSG00000079974.19"
"21329","ENSG00000167165.19_26894",26886,26894,9,"ENSG00000167165.19",0,NA,"VVUVVUVVV",2,7,0.805797101449275,73,79,102,105,111,117,133,136,"ATGGTGA","CTGA","ATGGTTA","GTGA",2.44842895953848,23,6,16,54,2.01542541993535,4.58457128754797,7.80775969334507,101,"ENSG00000079974.19"
"36451","ENSG00000241119.2_46603",46595,46603,9,"ENSG00000241119.2",0,NA,"VVUVVUVVV",2,7,0.805797101449275,73,79,102,105,111,117,133,136,"ATGGTGA","CTGA","ATGGTTA","GTGA",2.44842895953848,23,6,16,54,2.01542541993535,4.58457128754797,7.80775969334507,101,"ENSG00000079974.19"
"36632","ENSG00000242366.4_100868",100860,100868,9,"ENSG00000242366.4",0,NA,"VVUVVUVVV",2,7,0.805797101449275,73,79,102,105,111,117,133,136,"ATGGTGA","CTGA","ATGGTTA","GTGA",2.44842895953848,23,6,16,54,2.01542541993535,4.58457128754797,7.80775969334507,101,"ENSG00000079974.19"
"36656","ENSG00000242515.6_82053",82045,82053,9,"ENSG00000242515.6",0,NA,"VVUVVUVVV",2,7,0.805797101449275,73,79,102,105,111,117,133,136,"ATGGTGA","CTGA","ATGGTTA","GTGA",2.44842895953848,23,6,16,54,2.01542541993535,4.58457128754797,7.80775969334507,101,"ENSG00000079974.19"
"36988","ENSG00000244122.3_36600",36592,36600,9,"ENSG00000244122.3",0,NA,"VVUVVUVVV",2,7,0.805797101449275,73,79,102,105,111,117,133,136,"ATGGTGA","CTGA","ATGGTTA","GTGA",2.44842895953848,23,6,16,54,2.01542541993535,4.58457128754797,7.80775969334507,101,"ENSG00000079974.19"
"47595","ENSG00000288705.1_5594",5586,5594,9,"ENSG00000288705.1",0,NA,"VVUVVUVVV",2,7,0.805797101449275,73,79,102,105,111,117,133,136,"ATGGTGA","CTGA","ATGGTTA","GTGA",2.44842895953848,23,6,16,54,2.01542541993535,4.58457128754797,7.80775969334507,101,"ENSG00000079974.19"
"27556","ENSG00000186487.21_216797",216789,216797,9,"ENSG00000186487.21",1,2,"VMVVVVUVV",1,7,0.770186335403727,116,122,133,136,148,154,162,165,"ACACTGA","CTGT","GTGATGA","CTGA",2.42310518705898,11,12,8,40,2.75392514849667,4.72698993222247,7.80773527383738,101,"ENSG00000079974.19"
"5695","ENSG00000106328.10_6976",6968,6976,9,"ENSG00000106328.10",1,8,"VVVVVUVMV",1,7,0.806211180124224,116,122,133,136,143,149,166,169,"CTGATGG","GAGA","GTCCTTA","CTGA",2.34754958616064,11,7,17,44,2.6811065779692,4.58285928809336,7.80770400859025,101,"ENSG00000079974.19"
"33320","ENSG00000229337.2_60513",60505,60513,9,"ENSG00000229337.2",1,1,"MVVVVUVVV",1,7,0.82815734989648,82,88,133,136,146,152,162,165,"ATGATCA","GTGC","GGGAGGG","CTGA",2.4122661129375,45,10,10,74,1.89841784136042,4.49504798190261,7.80767738148853,101,"ENSG00000079974.19"
"35628","ENSG00000236501.6_12507",12499,12507,9,"ENSG00000236501.6",1,1,"MVVVVUVVV",1,7,0.82815734989648,82,88,133,136,146,152,162,165,"ATGATCA","GTGC","GGGAGGG","CTGA",2.4122661129375,45,10,10,74,1.89841784136042,4.49504798190261,7.80767738148853,101,"ENSG00000079974.19"
"22771","ENSG00000171385.11_69666",69658,69666,9,"ENSG00000171385.11",0,NA,"UVVVUVVVV",2,7,0.792546583850932,116,122,133,136,144,150,163,166,"AGGAGGA","GAGA","GAGATGT","CTGA",2.34677323862397,11,8,13,41,2.90473314802163,4.63747201804535,7.80765835344908,101,"ENSG00000079974.19"
"16683","ENSG00000152061.24_740408",740400,740408,9,"ENSG00000152061.24",1,8,"VVVVVUVMV",1,7,0.806211180124224,115,121,133,136,143,149,157,160,"AAAATGA","ATCA","TGGATGT","CTGA",2.28725008389974,12,7,8,36,3.08286607336289,4.58279999150696,7.80764471200386,101,"ENSG00000079974.19"
"37414","ENSG00000248138.5_10200",10192,10200,9,"ENSG00000248138.5",0,NA,"VVVVVUUVV",2,7,0.808281573498965,86,92,108,111,114,120,133,136,"ATGATGT","TTGA","ATAATAA","CTGG",2.37234258628529,16,3,13,41,2.4820668126669,4.57442101364222,7.80754730763808,101,"ENSG00000079974.19"
"29043","ENSG00000197077.14_61504",61496,61504,9,"ENSG00000197077.14",1,2,"UMVVVUVVV",2,6,0.708902691511387,111,117,133,136,142,148,158,161,"ACGATGA","CTGT","GTGTATA","CTGA",2.55623850783565,16,6,10,41,2.84584719355427,4.97185931144799,7.80747007749354,101,"ENSG00000079974.19"
"48513","ENSG00000291214.1_39792",39784,39792,9,"ENSG00000291214.1",0,NA,"VVVVUUVVV",2,7,0.812008281573499,76,82,97,100,111,117,133,136,"ATGCTGC","CAAA","GTGACTA","CTGA",2.3600976860303,15,11,16,51,2.50357547917216,4.55939001317686,7.80742313947086,101,"ENSG00000079974.19"
"10391","ENSG00000130779.22_38449",38441,38449,9,"ENSG00000130779.22",1,1,"MVVVVVUVV",1,7,0.792132505175983,84,90,133,136,157,163,175,178,"TTGATGA","ATGA","GTGTTCG","CTGA",2.60374454069788,43,21,12,85,1.1969576083131,4.63881363657474,7.80734365727867,101,"ENSG00000079974.19"
"4964","ENSG00000102466.16_92666",92658,92666,9,"ENSG00000102466.16",1,8,"VVVUVVVMV",1,7,0.764803312629399,109,115,133,136,147,153,163,166,"ATGAAGA","AGGA","AAGAAGA","CTGA",2.47337259895801,18,11,10,48,2.50326153916375,4.74810304972096,7.80731630023856,101,"ENSG00000079974.19"
"36888","ENSG00000243319.7_84728",84720,84728,9,"ENSG00000243319.7",1,8,"VVVUVVVMV",1,7,0.764803312629399,109,115,133,136,147,153,163,166,"ATGAAGA","AGGA","AAGAAGA","CTGA",2.47337259895801,18,11,10,48,2.50326153916375,4.74810304972096,7.80731630023856,101,"ENSG00000079974.19"
"605","ENSG00000021645.20_1081135",1081127,1081135,9,"ENSG00000021645.20",0,NA,"UVVVVVUVV",2,7,0.788819875776397,116,122,133,136,142,148,160,163,"ATGAGGA","ATAA","ATGATGA","CTGT",2.34471842711446,11,6,12,38,2.97649584985615,4.65198800765481,7.8072675107604,101,"ENSG00000079974.19"
"27639","ENSG00000186952.15_406884",406876,406884,9,"ENSG00000186952.15",1,2,"UMVVVVVVV",1,7,0.786749482401656,112,118,133,136,154,160,173,176,"AAGATCA","CAGA","ATGAAAA","CTGA",2.46593899935322,15,18,13,55,2.20140392127478,4.66024931257406,7.80724724218069,101,"ENSG00000079974.19"
"37182","ENSG00000245832.7_178739",178731,178739,9,"ENSG00000245832.7",0,NA,"VVVUUVVVV",2,7,0.770600414078675,116,122,133,136,143,149,167,170,"AAGATGG","CTAA","TTGATTC","CTGA",2.44236942167106,11,7,18,45,2.61688134685066,4.72483603949777,7.80723769581247,101,"ENSG00000079974.19"
"24892","ENSG00000178568.15_160799",160791,160799,9,"ENSG00000178568.15",1,2,"VMVVVUVVV",1,7,0.806211180124223,112,118,133,136,139,145,154,157,"AAGATGT","GTGA","TTGATGA","CTGT",2.34269907756907,15,3,9,36,2.71154812569429,4.58238549403869,7.80723021453558,101,"ENSG00000079974.19"
"44145","ENSG00000278811.4_160470",160462,160470,9,"ENSG00000278811.4",1,8,"UVVVVVVMV",1,7,0.786749482401656,105,111,133,136,145,151,180,183,"ATGCTGA","CTGG","CTGAGGG","CTGA",2.58064449476234,22,9,29,69,1.43656580272054,4.66021560861737,7.807213538224,101,"ENSG00000079974.19"
"36450","ENSG00000241119.2_16949",16941,16949,9,"ENSG00000241119.2",1,1,"MVVUVVVVV",1,7,0.786749482401656,79,85,96,99,112,118,133,136,"TTGATTA","GTGA","AAGAAAA","CTGA",2.42291734213366,11,13,15,48,2.48788991463968,4.66016804888269,7.80716597848932,101,"ENSG00000079974.19"
"36636","ENSG00000242366.4_71214",71206,71214,9,"ENSG00000242366.4",1,1,"MVVUVVVVV",1,7,0.786749482401656,79,85,96,99,112,118,133,136,"TTGATTA","GTGA","AAGAAAA","CTGA",2.42291734213366,11,13,15,48,2.48788991463968,4.66016804888269,7.80716597848932,101,"ENSG00000079974.19"
"36655","ENSG00000242515.6_52399",52391,52399,9,"ENSG00000242515.6",1,1,"MVVUVVVVV",1,7,0.786749482401656,79,85,96,99,112,118,133,136,"TTGATTA","GTGA","AAGAAAA","CTGA",2.42291734213366,11,13,15,48,2.48788991463968,4.66016804888269,7.80716597848932,101,"ENSG00000079974.19"
"36991","ENSG00000244122.3_6946",6938,6946,9,"ENSG00000244122.3",1,1,"MVVUVVVVV",1,7,0.786749482401656,79,85,96,99,112,118,133,136,"TTGATTA","GTGA","AAGAAAA","CTGA",2.42291734213366,11,13,15,48,2.48788991463968,4.66016804888269,7.80716597848932,101,"ENSG00000079974.19"
"36418","ENSG00000240571.1_7624",7616,7624,9,"ENSG00000240571.1",0,NA,"UVUVVVVVV",2,7,0.786335403726708,113,119,133,136,150,156,169,172,"GGGGTGA","GAGA","GTGATGA","CTGA",2.42106090623159,14,14,13,50,2.50658604070126,4.6617480205613,7.80708963546813,101,"ENSG00000079974.19"
"29051","ENSG00000197085.11_111595",111587,111595,9,"ENSG00000197085.11",1,1,"MVVVVVUVV",1,7,0.792132505175983,92,98,108,111,115,121,133,136,"GTGGTGA","CTGA","CGGATAA","CTAA",2.35611282894826,10,4,12,35,2.84677672509838,4.63854889618837,7.8070789168923,101,"ENSG00000079974.19"
"23456","ENSG00000172987.13_374278",374270,374278,9,"ENSG00000172987.13",1,2,"UMVVVUVVV",2,6,0.708902691511387,115,121,133,136,143,149,161,164,"TTGATGA","ATAA","ATGAACA","CTGA",2.53415850832633,12,7,12,40,2.99132810114279,4.97142953916292,7.80704030520847,101,"ENSG00000079974.19"
"11218","ENSG00000134258.18_8988",8980,8988,9,"ENSG00000134258.18",0,NA,"VVVVVUUVV",2,7,0.808281573498965,97,103,133,136,150,156,170,173,"GAGATAA","CTGA","TAGATGA","CTGA",2.51367325335215,30,14,14,67,1.53771315576389,4.57388371119456,7.80701000519042,101,"ENSG00000079974.19"
"6499","ENSG00000110328.6_4154",4146,4154,9,"ENSG00000110328.6",1,1,"MVVVVUVVV",1,7,0.82815734989648,38,44,63,66,116,122,133,136,"CTTATGA","CTGG","CTTAGGA","CTGA",2.46202455160111,19,50,11,89,1.5634820508706,4.49424476538618,7.8068741649721,101,"ENSG00000079974.19"
"312","ENSG00000008086.13_207398",207390,207398,9,"ENSG00000008086.13",1,1,"MVVVVUVVV",1,7,0.82815734989648,104,110,133,136,143,149,168,171,"AGGATTA","CTGT","CTGTTCA","CTGA",2.4192955707207,23,7,19,58,1.84826147546047,4.49422465339961,7.80685405298553,101,"ENSG00000079974.19"
"10346","ENSG00000130612.17_2864",2856,2864,9,"ENSG00000130612.17",1,8,"VVVVVUVMV",1,7,0.806211180124224,107,113,133,136,142,148,169,172,"AAGATGG","CTGG","AAGAAGA","CTGA",2.4590118463235,20,6,21,56,1.9344773629613,4.58197241794616,7.80681713844306,101,"ENSG00000079974.19"
"43118","ENSG00000268797.1_92786",92778,92786,9,"ENSG00000268797.1",1,8,"VVVVVUVMV",1,7,0.806211180124224,107,113,133,136,142,148,169,172,"AAGATGG","CTGG","AAGAAGA","CTGA",2.4590118463235,20,6,21,56,1.9344773629613,4.58197241794616,7.80681713844306,101,"ENSG00000079974.19"
"48210","ENSG00000290611.1_3257",3249,3257,9,"ENSG00000290611.1",1,8,"VVVVVUVMV",1,7,0.806211180124224,107,113,133,136,142,148,169,172,"AAGATGG","CTGG","AAGAAGA","CTGA",2.4590118463235,20,6,21,56,1.9344773629613,4.58197241794616,7.80681713844306,101,"ENSG00000079974.19"
"21391","ENSG00000167346.9_220832",220824,220832,9,"ENSG00000167346.9",1,1,"MVVVVVUVV",1,7,0.792132505175983,113,119,133,136,140,146,157,160,"GAGATGA","AAGA","GGGGTCA","CTGA",2.35582765876403,14,4,11,38,2.84726313322388,4.63819521457935,7.80672523528328,101,"ENSG00000079974.19"
"47015","ENSG00000287514.2_50637",50629,50637,9,"ENSG00000287514.2",1,1,"MVVVUVVVV",1,7,0.795859213250517,112,118,133,136,167,173,187,190,"CTGATGC","ATTA","GTGAAGA","CTGA",2.50046459890294,15,31,14,69,1.82328989070634,4.62326347084815,7.80670032385022,101,"ENSG00000079974.19"
"26551","ENSG00000184408.10_15617",15609,15617,9,"ENSG00000184408.10",1,7,"UVVVVVMVV",1,7,0.787991718426501,108,114,133,136,147,153,203,206,"AAGATGA","ATGA","CTGGTTA","CTGA",2.58067137269925,19,11,50,89,1.41440582051734,4.65472040962809,7.80668728333409,101,"ENSG00000079974.19"
"19419","ENSG00000162946.23_221568",221560,221568,9,"ENSG00000162946.23",1,2,"VMVVVVUVV",1,7,0.770186335403727,116,122,133,136,145,151,167,170,"TTGCTGA","GTGA","GCGAATA","CTGA",2.43205767954235,11,9,16,45,2.68993440327286,4.72591306672213,7.80665840833704,101,"ENSG00000079974.19"
"9522","ENSG00000125246.16_252222",252214,252222,9,"ENSG00000125246.16",1,2,"UMVVVVVVV",1,7,0.786749482401656,114,120,133,136,142,148,157,160,"CTGAGAA","TTGA","TTGATCT","CTGA",2.33721055057986,13,6,9,37,3.05690452077254,4.65957704782624,7.80657497743287,101,"ENSG00000079974.19"
"5736","ENSG00000106536.21_273719",273711,273719,9,"ENSG00000106536.21",1,1,"MVVVVUVVV",1,7,0.82815734989648,116,122,133,136,141,147,164,167,"ATGTTAA","ATAA","AAGAAGA","CTGA",2.30316248274889,11,5,17,42,2.62129231770413,4.49392721734084,7.80655661692676,101,"ENSG00000079974.19"
"18458","ENSG00000157445.15_287386",287378,287386,9,"ENSG00000157445.15",0,NA,"UVVVVUVVV",2,7,0.824844720496894,115,121,133,136,169,175,201,204,"GTGCTGA","CAGC","TTGATGA","CTGA",2.51438107968041,12,33,26,80,1.26570710765909,4.50706190971546,7.80644079170304,101,"ENSG00000079974.19"
"9976","ENSG00000128641.19_177831",177823,177831,9,"ENSG00000128641.19",0,NA,"UVVVUVVVV",2,7,0.792546583850932,45,51,71,74,82,88,133,136,"ATGATGA","CTTA","ATGAGGA","CTCA",2.55904849540449,20,8,45,82,1.48436984266324,4.63617328633995,7.80635962174368,101,"ENSG00000079974.19"
"20698","ENSG00000165379.14_133949",133941,133949,9,"ENSG00000165379.14",1,2,"VMVVVUVVV",1,7,0.806211180124223,111,117,133,136,141,147,162,165,"GTGATTT","CTAA","TTTATCA","CTGA",2.36002442891896,16,5,15,45,2.59247467372287,4.58149271662899,7.80633743712588,101,"ENSG00000079974.19"
"4304","ENSG00000100142.16_18940",18932,18940,9,"ENSG00000100142.16",1,8,"VVVUVVVMV",1,7,0.764803312629399,116,122,133,136,149,155,165,168,"CTGCTGA","CTTA","TTAAGGA","CTGA",2.44604986613579,11,13,10,43,2.68131653712662,4.74707891117464,7.80629216169223,101,"ENSG00000079974.19"
"42595","ENSG00000264869.2_10974",10966,10974,9,"ENSG00000264869.2",1,6,"VVVUVMVVV",1,7,0.78343685300207,116,122,133,136,168,174,186,189,"ATGATGG","GGGA","TTGAAAA","CTGA",2.50827643665236,11,32,12,64,1.96806363111805,4.67247663553345,7.80622404754173,101,"ENSG00000079974.19"
"27950","ENSG00000187715.13_22234",22226,22234,9,"ENSG00000187715.13",1,8,"UVVVVUVMV",2,6,0.708902691511387,116,122,133,136,143,149,160,163,"GTGAGTA","CTGA","GTGAATA","CTGA",2.52929825335215,11,7,11,38,3.0203974279366,4.9705964459044,7.80620721194995,101,"ENSG00000079974.19"
"7593","ENSG00000115020.17_45630",45622,45630,9,"ENSG00000115020.17",1,1,"MVVVVVUVV",1,7,0.792132505175983,93,99,133,136,145,151,164,167,"GTGATTA","CTGT","AGGATGG","CTGA",2.50032539200281,34,9,13,65,1.88181191823906,4.63766196623112,7.80619198693505,101,"ENSG00000079974.19"
"14589","ENSG00000145416.14_476472",476464,476472,9,"ENSG00000145416.14",0,NA,"UVVVVUVVV",2,7,0.824844720496894,78,84,94,97,110,116,133,136,"ATGATTA","TTGA","CTGAGAA","TTGA",2.35724468092076,10,13,17,49,2.31227343150302,4.50680949274369,7.80618837473127,101,"ENSG00000079974.19"
"2382","ENSG00000073921.18_41777",41769,41777,9,"ENSG00000073921.18",1,1,"MVVVVUVVV",1,7,0.82815734989648,114,120,133,136,141,147,170,173,"ATAATGA","CTAA","ATGAAAA","CTAA",2.3531532103935,13,5,23,50,2.28653783798894,4.49355647681974,7.80618587640566,101,"ENSG00000079974.19"
"7","ENSG00000000971.17_65238",65230,65238,9,"ENSG00000000971.17",1,8,"VVVUVVVMV",1,7,0.764803312629399,90,96,133,136,138,144,152,155,"ATGATGA","AAGA","CTCAAGA","CTGA",2.6217241568853,37,2,8,56,1.5096501380846,4.74695279599664,7.80616604651424,101,"ENSG00000079974.19"
"47910","ENSG00000289697.1_65140",65132,65140,9,"ENSG00000289697.1",1,8,"VVVUVVVMV",1,7,0.764803312629399,90,96,133,136,138,144,152,155,"ATGATGA","AAGA","CTCAAGA","CTGA",2.6217241568853,37,2,8,56,1.5096501380846,4.74695279599664,7.80616604651424,101,"ENSG00000079974.19"
"3145","ENSG00000081800.9_82762",82754,82762,9,"ENSG00000081800.9",1,8,"VVVUVVVMV",1,7,0.764803312629399,90,96,105,108,114,120,133,136,"ATGTTGA","TTAA","TGGACGA","CTGA",2.42537029106304,9,6,13,37,2.81804482815698,4.74679502547764,7.80600827599524,101,"ENSG00000079974.19"
"37703","ENSG00000248690.8_129857",129849,129857,9,"ENSG00000248690.8",0,NA,"UVVVVUVVV",2,7,0.824844720496894,107,113,133,136,145,151,167,170,"CTGCTGG","ATGA","GTAATGG","CTGA",2.37399573755458,20,9,16,54,2.19955243072952,4.50654767027335,7.80592655226092,101,"ENSG00000079974.19"
"29266","ENSG00000197584.13_179662",179654,179662,9,"ENSG00000197584.13",1,7,"UVVVVVMVV",1,7,0.787991718426501,99,105,133,136,150,156,164,167,"ATGTTGA","CTGA","GTGATGG","TTGA",2.54021201376419,28,14,8,59,1.68090186783065,4.65391215656465,7.80587903027065,101,"ENSG00000079974.19"
"31514","ENSG00000223941.5_33393",33385,33393,9,"ENSG00000223941.5",1,7,"UVVVVVMVV",1,7,0.787991718426501,99,105,133,136,150,156,164,167,"ATGTTGA","CTGA","GTGATGG","TTGA",2.54021201376419,28,14,8,59,1.68090186783065,4.65391215656465,7.80587903027065,101,"ENSG00000079974.19"
"43898","ENSG00000275163.1_33471",33463,33471,9,"ENSG00000275163.1",1,7,"UVVVVVMVV",1,7,0.787991718426501,99,105,133,136,150,156,164,167,"ATGTTGA","CTGA","GTGATGG","TTGA",2.54021201376419,28,14,8,59,1.68090186783065,4.65391215656465,7.80587903027065,101,"ENSG00000079974.19"
"8918","ENSG00000121481.11_21377",21369,21377,9,"ENSG00000121481.11",0,NA,"VVVVUUVVV",2,7,0.812008281573499,84,90,106,109,115,121,133,136,"GAGATGA","CTGA","GAAATGT","CAGA",2.31587835709109,16,6,12,43,2.79214707399092,4.55783403031621,7.8058671566102,101,"ENSG00000079974.19"
"42753","ENSG00000266405.3_2222",2214,2222,9,"ENSG00000266405.3",1,8,"UVVVVVVMV",1,7,0.786749482401656,92,98,133,136,145,151,172,175,"CTGATGA","CTAC","GTGGTGA","CTGA",2.5823874308735,35,9,21,74,1.41952595018448,4.65886053900195,7.80585846860857,101,"ENSG00000079974.19"
"12453","ENSG00000138271.6_6389",6381,6389,9,"ENSG00000138271.6",1,1,"MVVVVVUVV",1,7,0.792132505175983,80,86,99,102,110,116,133,136,"ATAAAGA","TTGA","AAGAGTA","CTGA",2.3799954954577,13,8,17,47,2.68264508947955,4.63732043146605,7.80585045216999,101,"ENSG00000079974.19"
"28788","ENSG00000196482.18_582694",582686,582694,9,"ENSG00000196482.18",0,NA,"VVUVVVUVV",2,7,0.769772256728778,116,122,133,136,148,154,174,177,"TTGATGT","ATGG","ATGAAGA","CTGA",2.4974472308292,11,12,20,52,2.25734349334729,4.72674792471881,7.80583695163393,101,"ENSG00000079974.19"
"5204","ENSG00000103888.17_6400",6392,6400,9,"ENSG00000103888.17",1,7,"VVVVUVMVV",1,7,0.775155279503105,57,63,104,107,114,120,133,136,"ATGAAGA","CTGA","ATGAGGA","CAGA",2.53505899900682,41,7,13,70,1.92009607736837,4.70512235102013,7.80574346903255,101,"ENSG00000079974.19"
"12449","ENSG00000138193.17_324610",324602,324610,9,"ENSG00000138193.17",1,1,"MVVVVUVVV",1,7,0.82815734989648,105,111,133,136,171,177,188,191,"ATCATGA","CTCA","ATCCTGT","CTGA",2.4944352648254,22,35,11,77,1.3427051669614,4.49306839978268,7.8056977993686,101,"ENSG00000079974.19"
"10053","ENSG00000128923.11_33126",33118,33126,9,"ENSG00000128923.11",1,6,"UVVVVMVVV",1,7,0.805383022774327,116,122,133,136,157,163,182,185,"ATGATAA","ATAA","TTTATGA","CTGA",2.48221325855998,11,21,19,60,1.7884337201108,4.58413052762767,7.80566261872498,101,"ENSG00000079974.19"
"15384","ENSG00000148120.18_270953",270945,270953,9,"ENSG00000148120.18",1,2,"VMVVVUVVV",1,7,0.806211180124223,23,29,44,47,97,103,133,136,"CTGATGT","CAGA","CTGGTGA","CTGA",2.59289998468577,15,50,30,104,1.03700898768049,4.5807522213964,7.80559694189329,101,"ENSG00000079974.19"
"44225","ENSG00000279847.3_15473",15465,15473,9,"ENSG00000279847.3",1,1,"MVVVVVUVV",1,7,0.792132505175983,111,117,133,136,143,149,157,160,"AAGATGG","AAGA","AGGATGG","CTGA",2.35454109741439,16,7,8,40,2.85115871942076,4.63702484221251,7.80555486291644,101,"ENSG00000079974.19"
"3114","ENSG00000081189.16_137697",137689,137697,9,"ENSG00000081189.16",1,7,"VVVVVUMVV",1,7,0.807453416149068,84,90,133,136,141,147,155,158,"TTGAGGA","TTTA","GTGATGG","CTGA",2.45860618194101,43,5,8,65,1.91205007825368,4.57568948946509,7.80550315406137,101,"ENSG00000079974.19"
"24040","ENSG00000174937.5_3748",3740,3748,9,"ENSG00000174937.5",1,8,"VVUVVVVMV",1,7,0.767701863354037,82,88,106,109,116,122,133,136,"ATGTTGA","CTGA","AGGATGT","ATGA",2.4420882203279,18,7,11,45,2.65814522852365,4.73468334101074,7.80549079442689,101,"ENSG00000079974.19"
"33569","ENSG00000230416.3_897",889,897,9,"ENSG00000230416.3",1,8,"VVUVVVVMV",1,7,0.767701863354037,82,88,106,109,116,122,133,136,"ATGTTGA","CTGA","AGGATGT","ATGA",2.4420882203279,18,7,11,45,2.65814522852365,4.73468334101074,7.80549079442689,101,"ENSG00000079974.19"
"45014","ENSG00000284732.1_3748",3740,3748,9,"ENSG00000284732.1",1,8,"VVUVVVVMV",1,7,0.767701863354037,82,88,106,109,116,122,133,136,"ATGTTGA","CTGA","AGGATGT","ATGA",2.4420882203279,18,7,11,45,2.65814522852365,4.73468334101074,7.80549079442689,101,"ENSG00000079974.19"
"30473","ENSG00000205111.10_45474",45466,45474,9,"ENSG00000205111.10",0,NA,"UVVVVUVVV",2,7,0.824844720496894,89,95,110,113,115,121,133,136,"TTGATGA","CTGC","TTTATGG","CTGT",2.33567968465195,15,2,12,38,2.45259901227958,4.50594922748982,7.80532810947739,101,"ENSG00000079974.19"
"7748","ENSG00000115526.11_24617",24609,24617,9,"ENSG00000115526.11",1,3,"VVMVUVVVV",1,7,0.772670807453416,85,91,102,105,115,121,133,136,"ATGACGC","CTGT","GTTTGGA","CTGA",2.40133795184565,11,10,12,42,2.84848743502195,4.71435177849823,7.8050350083119,101,"ENSG00000079974.19"
"12657","ENSG00000138759.20_450611",450603,450611,9,"ENSG00000138759.20",1,2,"VMVVUVVVV",1,7,0.773913043478261,114,120,133,136,162,168,178,181,"GTGTTGA","CTGT","CTGTTGG","CTGA",2.51059374301084,13,26,10,58,2.09990454275303,4.70929904070633,7.80495121461937,101,"ENSG00000079974.19"
"28263","ENSG00000188580.15_649795",649787,649795,9,"ENSG00000188580.15",1,7,"VVVVUVMVV",1,7,0.775155279503105,99,105,133,136,151,157,176,179,"ATGTTGA","CTGT","ATGATGC","CTGA",2.64151991221109,28,15,19,71,1.20709716085519,4.70430747723229,7.80492859524471,101,"ENSG00000079974.19"
"16941","ENSG00000152818.20_423581",423573,423581,9,"ENSG00000152818.20",0,NA,"VVVVVUUVV",2,7,0.808281573498965,90,96,133,136,149,155,173,176,"CTGATGA","CAAA","TTCATGA","CTGA",2.54288387068001,37,13,18,77,1.33451427433171,4.57176835304961,7.80489464704547,101,"ENSG00000079974.19"
"19471","ENSG00000163092.22_342753",342745,342753,9,"ENSG00000163092.22",1,1,"MVVVVVUVV",1,7,0.792132505175983,95,101,133,136,142,148,161,164,"ATAAGGA","CTGA","ATAAAAA","CTGA",2.49287280178909,32,6,13,60,1.92629520911586,4.63636180526077,7.80489182596471,101,"ENSG00000079974.19"
"9171","ENSG00000123066.9_175154",175146,175154,9,"ENSG00000123066.9",1,8,"VVUVVVVMV",1,7,0.767701863354037,116,122,133,136,142,148,158,161,"ATGGTGA","TTGA","GTGGAGA","ATGA",2.38115348156408,11,6,10,36,3.06115136982541,4.73387697839648,7.80468443181263,101,"ENSG00000079974.19"
"39090","ENSG00000251600.8_421255",421247,421255,9,"ENSG00000251600.8",0,NA,"VVVVVUUVV",2,7,0.808281573498965,113,119,133,136,143,149,160,163,"ATGATGG","AAGA","GTGATTT","CTGC",2.29682320239719,14,7,11,41,2.97383677531519,4.57149786449077,7.80462415848663,101,"ENSG00000079974.19"
"34384","ENSG00000232900.2_10835",10827,10835,9,"ENSG00000232900.2",1,6,"VVVVVMUVV",1,7,0.788819875776397,107,113,133,136,145,151,165,168,"AGAATGA","GTGT","CTGATGA","CTGA",2.44271609334607,20,9,14,52,2.3125843284526,4.64933957102327,7.80461907412886,101,"ENSG00000079974.19"
"3777","ENSG00000089048.15_34908",34900,34908,9,"ENSG00000089048.15",1,2,"UMVVVVVVV",1,7,0.786749482401656,111,117,133,136,145,151,161,164,"GTGGTGA","CTAT","CTGGTGG","CTGA",2.37498479154872,16,9,10,44,2.79714621987804,4.65759454088404,7.80459247049066,101,"ENSG00000079974.19"
"12095","ENSG00000137251.16_23085",23077,23085,9,"ENSG00000137251.16",1,5,"UVVVMVVVV",1,7,0.789233954451346,92,98,109,112,116,122,133,136,"AGGAAGA","CTGC","AAGACCA","CTGA",2.34907633093277,11,4,11,35,2.92998831380578,4.64762429667273,7.80456011447812,101,"ENSG00000079974.19"
"8066","ENSG00000116698.22_50072",50064,50072,9,"ENSG00000116698.22",1,2,"VMVUVVVVV",1,7,0.764803312629399,114,120,133,136,184,190,234,237,"ATGATTA","CTGA","ATCAAGA","CTGA",2.69623830561331,13,48,44,114,1.00614203441113,4.74526601795829,7.80447926847589,101,"ENSG00000079974.19"
"29954","ENSG00000198929.13_216399",216391,216399,9,"ENSG00000198929.13",0,NA,"VVVVUUVVV",2,7,0.812008281573499,81,87,100,103,114,120,133,136,"TAGAAGA","GTGA","CTCAGGA","CTGA",2.32075298652894,13,11,13,46,2.75395732407148,4.55641097523277,7.80444410152677,101,"ENSG00000079974.19"
"25571","ENSG00000182175.15_13605",13597,13605,9,"ENSG00000182175.15",1,7,"UVVVVVMVV",1,7,0.787991718426501,115,121,133,136,138,144,152,155,"ATGTAGA","CTGC","GCGAGAA","CTGA",2.36889032938783,12,2,8,31,2.81723734531405,4.65245988530822,7.80442675901423,101,"ENSG00000079974.19"
"25168","ENSG00000179889.20_32139",32131,32139,9,"ENSG00000179889.20",1,2,"UMVVVVVVV",1,7,0.786749482401656,18,24,36,39,77,83,133,136,"ATAATGT","CTGA","TTGCTGA","CTGA",2.64234041513285,12,38,50,109,1.0137243610759,4.65733178215705,7.80432971176368,101,"ENSG00000079974.19"
"1725","ENSG00000065615.14_86253",86245,86253,9,"ENSG00000065615.14",1,5,"UVVVMVVVV",1,7,0.789233954451346,82,88,102,105,110,116,133,136,"AAGACTA","CTGA","TTGAATA","CTGA",2.39855924202254,14,5,17,45,2.59899857656282,4.64734838084495,7.80428419865033,101,"ENSG00000079974.19"
"42047","ENSG00000260456.7_209860",209852,209860,9,"ENSG00000260456.7",1,1,"MVVVVVUVV",1,7,0.792132505175983,112,118,133,136,156,162,172,175,"ATATTGA","CGGA","TAGATGA","CTGA",2.45326914906866,15,20,10,54,2.1875514406369,4.63566977527365,7.80419979597759,101,"ENSG00000079974.19"
"46607","ENSG00000286904.1_3143",3135,3143,9,"ENSG00000286904.1",1,2,"UMVVVVVVV",1,7,0.786749482401656,78,84,105,108,111,117,133,136,"ATGATGA","CAGA","GTAAGGA","ATGA",2.51370793789051,21,3,16,49,1.87040524816123,4.65711454185782,7.80411247146445,101,"ENSG00000079974.19"
"18575","ENSG00000157680.16_273266",273258,273266,9,"ENSG00000157680.16",1,8,"VVVVVUVMV",1,7,0.806211180124224,109,115,133,136,167,173,186,189,"AGGATGA","CTAG","TTGTTGA","CTGA",2.50335220726482,18,31,13,71,1.62793906562356,4.57923844518058,7.80408316567748,101,"ENSG00000079974.19"
"27760","ENSG00000187323.12_349228",349220,349228,9,"ENSG00000187323.12",1,1,"MVVVVUVVV",1,7,0.82815734989648,116,122,133,136,145,151,167,170,"ATAATGA","TTGT","GTAATGA","TTGA",2.29129145088234,11,9,16,45,2.68993440327286,4.49130268562211,7.80393208520803,101,"ENSG00000079974.19"
"14970","ENSG00000146416.19_77338",77330,77338,9,"ENSG00000146416.19",0,NA,"UVVVUVVVV",2,7,0.792546583850932,116,122,133,136,147,153,169,172,"AAGATGA","GTTA","ATTCAGA","CTGA",2.3945619411463,11,11,16,47,2.57119737585519,4.63373591254096,7.80392224794469,101,"ENSG00000079974.19"
"23232","ENSG00000172348.16_223796",223788,223796,9,"ENSG00000172348.16",1,2,"UMVVVVVVV",1,7,0.786749482401656,111,117,133,136,147,153,166,169,"TTAATGA","GTGC","GTGAATA","CTGA",2.40512133142345,16,11,13,49,2.59331243076106,4.65686366006269,7.80386158966931,101,"ENSG00000079974.19"
"43131","ENSG00000269067.2_22628",22620,22628,9,"ENSG00000269067.2",0,NA,"UVVUVVVVV",2,7,0.78343685300207,110,116,133,136,145,151,167,170,"CTGTTGA","CTGT","GTTAGGT","CTGA",2.43236681945708,17,9,16,51,2.46457668551793,4.67008887047462,7.8038362824829,101,"ENSG00000079974.19"
"46884","ENSG00000287308.1_26753",26745,26753,9,"ENSG00000287308.1",1,2,"VMVVVUVVV",1,7,0.806211180124223,11,17,62,65,71,77,133,136,"TTGATGG","CTGA","GTGTTAG","CTGA",2.59964010852772,45,6,56,116,0.984673191577389,4.57890181210722,7.80374653260411,101,"ENSG00000079974.19"
"16622","ENSG00000151914.22_257724",257716,257724,9,"ENSG00000151914.22",1,8,"VVVVVVUMV",1,7,0.770186335403727,112,118,133,136,151,157,187,190,"GTGATGC","CTTA","TTGATGG","CTGA",2.59531333434995,15,15,30,69,1.58990899556981,4.72299947280903,7.80374481442393,101,"ENSG00000079974.19"
"34069","ENSG00000231873.2_13527",13519,13527,9,"ENSG00000231873.2",1,3,"VVMVVUVVV",1,7,0.804968944099379,92,98,110,113,116,122,133,136,"CTGATGA","CTGC","ATGTTAG","CTGT",2.32752848255006,12,3,11,35,2.81845516435072,4.58382792867112,7.80370370506863,101,"ENSG00000079974.19"
"35694","ENSG00000236780.7_258809",258801,258809,9,"ENSG00000236780.7",1,8,"UVVVVVVMV",1,7,0.786749482401656,108,114,133,136,147,153,201,204,"TTGATGC","ATGA","TTGAGGA","CTGA",2.58159553919108,19,11,48,87,1.41579903671916,4.65660899116492,7.80360692077155,101,"ENSG00000079974.19"
"39173","ENSG00000253197.5_40472",40464,40472,9,"ENSG00000253197.5",1,2,"VMVUVVVVV",1,7,0.764803312629399,100,106,133,136,142,148,160,163,"ATTATGT","CTGC","CTGAGGA","CTGA",2.53991775457236,27,6,12,54,2.0446040326899,4.74434726579308,7.80356051631068,101,"ENSG00000079974.19"
"36326","ENSG00000239920.2_84592",84584,84592,9,"ENSG00000239920.2",1,1,"MVVUVVVVV",1,7,0.786749482401656,94,100,133,136,140,146,160,163,"ATGATGC","CACA","TTGCTGA","CTGA",2.535020750379,33,4,14,60,1.72600080871489,4.65653478614373,7.80353271575035,101,"ENSG00000079974.19"
"6332","ENSG00000109452.13_13087",13079,13087,9,"ENSG00000109452.13",1,1,"MVVVVUVVV",1,7,0.82815734989648,111,117,133,136,140,146,161,164,"CTGTTGT","GTGA","GTTTTGG","CTGA",2.31931592402537,16,4,15,44,2.50144838041652,4.49088863514641,7.80351803473233,101,"ENSG00000079974.19"
"16643","ENSG00000151952.16_390712",390704,390712,9,"ENSG00000151952.16",1,5,"VVVVMUVVV",1,7,0.808695652173913,66,72,105,108,114,120,133,136,"GTGATGT","CTGA","GTGCTCA","CTCA",2.45323822710577,33,6,13,61,1.91981386522994,4.56868384481711,7.80346645351276,101,"ENSG00000079974.19"
"21043","ENSG00000166278.16_39740",39732,39740,9,"ENSG00000166278.16",1,7,"VVVVUVMVV",1,7,0.775155279503105,64,70,83,86,91,97,133,136,"ATGGTGG","CTGA","GTCTGGA","CTGA",2.52600749346736,13,5,36,63,1.9711621242673,4.70280302017909,7.80342413819151,101,"ENSG00000079974.19"
"37011","ENSG00000244255.5_9827",9819,9827,9,"ENSG00000244255.5",1,7,"VVVVUVMVV",1,7,0.775155279503105,64,70,83,86,91,97,133,136,"ATGGTGG","CTGA","GTCTGGA","CTGA",2.52600749346736,13,5,36,63,1.9711621242673,4.70280302017909,7.80342413819151,101,"ENSG00000079974.19"
"23559","ENSG00000173226.17_46821",46813,46821,9,"ENSG00000173226.17",1,8,"VVVUVVVMV",1,7,0.764803312629399,113,119,133,136,150,156,165,168,"CTAATGT","CTGA","AACATGA","CTGA",2.45810286291938,14,14,9,46,2.5894393111255,4.744197932647,7.8034111831646,101,"ENSG00000079974.19"
"2311","ENSG00000072832.15_23018",23010,23018,9,"ENSG00000072832.15",1,8,"VVVVUVVMV",1,7,0.773913043478261,112,118,133,136,146,152,160,163,"ATGATTC","TTGA","TGCATGA","CTGA",2.40383964659543,15,10,8,42,2.8052555133981,4.70771328934191,7.80336546325495,101,"ENSG00000079974.19"
"20161","ENSG00000164331.10_11254",11246,11254,9,"ENSG00000164331.10",1,2,"VMVVVVUVV",1,7,0.770186335403727,56,62,107,110,114,120,133,136,"ATGATTA","TTGA","TTGCTCA","CTGA",2.56999202648061,45,4,13,71,1.7571067055992,4.72259672053414,7.80334206214905,101,"ENSG00000079974.19"
"29821","ENSG00000198771.11_39019",39011,39019,9,"ENSG00000198771.11",1,8,"UVVVVVVMV",1,7,0.786749482401656,112,118,133,136,141,147,155,158,"ATGATGT","CTGC","TTGCTAA","ATGA",2.35881049863712,15,5,8,37,2.89994278903026,4.65633652831944,7.80333445792606,101,"ENSG00000079974.19"
"33114","ENSG00000228714.4_27299",27291,27299,9,"ENSG00000228714.4",1,1,"MVVVVVUVV",1,7,0.792132505175983,112,118,133,136,144,150,177,180,"GAGATGG","TTGA","TTGCTGA","CTGA",2.46593165435831,15,8,27,59,2.09965884507121,4.63480080186498,7.80333082256891,101,"ENSG00000079974.19"
"11093","ENSG00000133835.18_164379",164371,164379,9,"ENSG00000133835.18",1,8,"UVVVVVVMV",1,7,0.786749482401656,115,121,133,136,140,146,154,157,"AGCATGA","CCAA","GTGATCT","CTGA",2.33985145409475,12,4,8,33,3.02631915951842,4.65633221337085,7.80333014297747,101,"ENSG00000079974.19"
"44240","ENSG00000280029.4_12561",12553,12561,9,"ENSG00000280029.4",1,1,"MVVVVUVVV",1,7,0.82815734989648,100,106,133,136,178,184,194,197,"GTGATCA","ATGA","CTGTTGG","CTGA",2.52827551353734,27,42,10,88,1.10758273017902,4.49068820510698,7.8033176046929,101,"ENSG00000079974.19"
"21383","ENSG00000167323.13_86038",86030,86038,9,"ENSG00000167323.13",1,6,"VVVVVMUVV",1,7,0.788819875776397,116,122,133,136,145,151,198,201,"GTGATGT","CCAA","CTGATGC","CTGA",2.49926406448213,11,9,47,76,1.93015309234876,4.6479783805574,7.80325788366299,101,"ENSG00000079974.19"
"11179","ENSG00000134152.11_25172",25164,25172,9,"ENSG00000134152.11",1,1,"MVVVVUVVV",1,7,0.82815734989648,115,121,133,136,148,154,175,178,"ATGATGA","AGGA","TAGAAGA","ATGA",2.36039974859984,12,12,21,54,2.22639266570909,4.49059774742701,7.80322714701293,101,"ENSG00000079974.19"
"16894","ENSG00000152582.14_49509",49501,49509,9,"ENSG00000152582.14",1,1,"MVVUVVVVV",1,7,0.786749482401656,113,119,133,136,143,149,186,189,"AGGATGA","ATAA","TTCATGA","CTGA",2.49364359768528,14,7,37,67,2.00044549359626,4.65618403620786,7.80318196581448,101,"ENSG00000079974.19"
"23610","ENSG00000173406.16_286478",286470,286478,9,"ENSG00000173406.16",0,NA,"VVUUVVVVV",2,7,0.764389233954451,113,119,133,136,141,147,156,159,"ATGACGT","TTGC","GTGAGAA","CTGA",2.40141919139839,14,5,9,37,2.97283552479713,4.74557420019659,7.8031311360144,101,"ENSG00000079974.19"
"5714","ENSG00000106459.15_21686",21678,21686,9,"ENSG00000106459.15",0,NA,"VVVVVUUVV",2,7,0.808281573498965,112,118,133,136,147,153,177,180,"TTGATGT","CTGA","GTGTTGT","TTGA",2.4332348994763,15,11,24,59,2.05836841662053,4.5699836032823,7.80310989727816,101,"ENSG00000079974.19"
"17324","ENSG00000153930.13_102713",102705,102713,9,"ENSG00000153930.13",1,8,"VVVVVUVMV",1,7,0.806211180124224,114,120,133,136,142,148,164,167,"ATGATGA","CTCT","TTGTTCA","GTGA",2.33492415259663,13,6,16,44,2.74664955069004,4.57820264200023,7.80304736249713,101,"ENSG00000079974.19"
"33397","ENSG00000229618.3_710107",710099,710107,9,"ENSG00000229618.3",0,NA,"UVVVVVUVV",2,7,0.788819875776397,111,117,133,136,150,156,172,175,"ATCTTGA","CTGC","GTGCAGA","CTGA",2.45574469433852,16,14,16,55,2.21925416276112,4.64772136458782,7.80300086769341,101,"ENSG00000079974.19"
"42681","ENSG00000265702.2_21029",21021,21029,9,"ENSG00000265702.2",1,1,"MVUVVVVVV",1,7,0.789648033126294,111,117,133,136,161,167,221,224,"GTGATGT","CTGC","GTGGTGA","CTGA",2.64221830627085,16,25,54,104,0.962801106232516,4.64439745367621,7.80298958618139,101,"ENSG00000079974.19"
"18323","ENSG00000157077.16_132893",132885,132893,9,"ENSG00000157077.16",0,NA,"VVVUVVUVV",2,7,0.766873706004141,39,45,53,56,83,89,133,136,"AGGATGA","CTGA","TTGAGGT","CTGA",2.71709806357169,8,27,44,88,0.827844748149413,4.73545795965683,7.80295278367339,101,"ENSG00000079974.19"
"12763","ENSG00000138944.8_51392",51384,51392,9,"ENSG00000138944.8",1,6,"VVUVVMVVV",1,7,0.786335403726708,104,110,133,136,141,147,170,173,"GTGAGGA","CAGA","TTAATGA","CTGA",2.56008834894982,23,5,23,60,1.56313725366494,4.6575982283326,7.80293984323943,101,"ENSG00000079974.19"
"38892","ENSG00000251226.2_64989",64981,64989,9,"ENSG00000251226.2",1,8,"VVVVUVVMV",1,7,0.773913043478261,84,90,97,100,110,116,133,136,"ATCATGT","GTGA","CTGTGGA","CTGA",2.49132384187617,7,10,17,43,2.21995989717304,4.70719637742022,7.80284855133326,101,"ENSG00000079974.19"
"31750","ENSG00000224612.2_13414",13406,13414,9,"ENSG00000224612.2",1,6,"UVVVVMVVV",1,7,0.805383022774327,113,119,133,136,144,150,160,163,"ATGTTTT","CTGT","GCGGTGA","CTGA",2.30256329945861,14,8,10,41,2.97467924659022,4.58127531074524,7.80280740184254,101,"ENSG00000079974.19"
"12529","ENSG00000138472.11_23228",23220,23228,9,"ENSG00000138472.11",1,1,"MVVUVVVVV",1,7,0.786749482401656,115,121,133,136,186,192,204,207,"GTGATGG","CTAA","ATGTTTT","CTGA",2.49962304085129,12,50,12,83,1.95906037523486,4.65580349522753,7.80280142483416,101,"ENSG00000079974.19"
"16957","ENSG00000152822.14_401349",401341,401349,9,"ENSG00000152822.14",1,8,"VVVVVUVMV",1,7,0.806211180124224,113,119,133,136,139,145,153,156,"TTGATCA","CAGG","TTAATAA","CTGA",2.32500437044355,14,3,8,34,2.81163651498766,4.5779164128195,7.80276113331639,101,"ENSG00000079974.19"
"7388","ENSG00000113805.9_97063",97055,97063,9,"ENSG00000113805.9",0,NA,"VVVVUUVVV",2,7,0.812008281573499,96,102,110,113,116,122,133,136,"CTGAGGA","CTGA","CTTGTGA","TTGA",2.32333567862524,8,3,11,31,2.72947355086852,4.5545945187592,7.8026276450532,101,"ENSG00000079974.19"
"1594","ENSG00000063169.12_25606",25598,25606,9,"ENSG00000063169.12",1,5,"VVVVMVUVV",1,7,0.772670807453416,85,91,101,104,111,117,133,136,"ATCATGC","CTCA","GTGAGTC","CTGA",2.42287747953481,10,7,16,42,2.69523991124441,4.71193911036912,7.80262234018279,101,"ENSG00000079974.19"
"43109","ENSG00000268746.1_26278",26270,26278,9,"ENSG00000268746.1",1,5,"VVVVMVUVV",1,7,0.772670807453416,85,91,101,104,111,117,133,136,"ATCATGC","CTCA","GTGAGTC","CTGA",2.42287747953481,10,7,16,42,2.69523991124441,4.71193911036912,7.80262234018279,101,"ENSG00000079974.19"
"44489","ENSG00000282728.1_62047",62039,62047,9,"ENSG00000282728.1",1,1,"MVVVVVUVV",1,7,0.792132505175983,96,102,133,136,149,155,173,176,"GTGATGT","CAGA","AAGAGGA","CTGA",2.57611001634763,31,13,18,71,1.36229767853666,4.63409111354689,7.80262113425082,101,"ENSG00000079974.19"
"19808","ENSG00000163719.20_43854",43846,43854,9,"ENSG00000163719.20",1,6,"VVVUVMVVV",1,7,0.78343685300207,37,43,54,57,99,105,133,136,"ATGATCA","TTGA","GTGAACA","CTGA",2.62812451279543,11,42,28,90,1.15428351139577,4.66877839917466,7.80252581118294,101,"ENSG00000079974.19"
"26930","ENSG00000185306.13_70222",70214,70222,9,"ENSG00000185306.13",1,8,"UVVVVVVMV",1,7,0.786749482401656,74,80,94,97,115,121,133,136,"ATGGTGA","GGGA","TTGATTC","CTGA",2.44904722905733,14,18,12,53,2.29488475621427,4.65546657081578,7.8024645004224,101,"ENSG00000079974.19"
"28415","ENSG00000189108.13_1055621",1055613,1055621,9,"ENSG00000189108.13",1,8,"VVVVVUVMV",1,7,0.806211180124224,104,110,133,136,172,178,189,192,"ATGATTA","TTTA","GTGATGG","CTGA",2.55528931532139,23,36,11,79,1.27518181805842,4.57761098005025,7.80245570054714,101,"ENSG00000079974.19"
"6016","ENSG00000107736.22_313056",313048,313056,9,"ENSG00000107736.22",1,2,"VMVVVUVVV",1,7,0.806211180124223,58,64,76,79,106,112,133,136,"AGGAGGA","CTTA","ATGAGGA","CTGA",2.51435444232454,12,27,21,69,1.54806264437625,4.57760639830163,7.80245111879852,101,"ENSG00000079974.19"
"38754","ENSG00000250994.3_14168",14160,14168,9,"ENSG00000250994.3",0,NA,"VVVVUVUVV",2,7,0.775983436853002,106,112,133,136,150,156,170,173,"TTGAAGG","CTGA","CTGCTGA","CTGA",2.53349857664651,21,14,14,58,1.90393847875485,4.6984822474329,7.80241599484491,101,"ENSG00000079974.19"
"21784","ENSG00000168952.16_30069",30061,30069,9,"ENSG00000168952.16",0,NA,"VVVVUUVVV",2,7,0.812008281573499,102,108,133,136,146,152,185,188,"GTGATGA","GTGT","CTGTTGT","CTGA",2.56073760815658,25,10,33,77,1.14592700552965,4.55437776497671,7.80241089127071,101,"ENSG00000079974.19"
"28325","ENSG00000188677.15_107280",107272,107280,9,"ENSG00000188677.15",1,6,"VVVVVMUVV",1,7,0.788819875776397,114,120,133,136,149,155,179,182,"ATGATTT","CAGA","CTGAGCA","CTGA",2.48773395062065,13,13,24,59,2.00356791517277,4.64711522982761,7.8023947329332,101,"ENSG00000079974.19"
"44182","ENSG00000279175.1_3712",3704,3712,9,"ENSG00000279175.1",1,6,"VVVVVMUVV",1,7,0.788819875776397,114,120,133,136,149,155,179,182,"ATGATTT","CAGA","CTGAGCA","CTGA",2.48773395062065,13,13,24,59,2.00356791517277,4.64711522982761,7.8023947329332,101,"ENSG00000079974.19"
"36271","ENSG00000239445.6_20081",20073,20081,9,"ENSG00000239445.6",1,2,"UMVVVVVVV",1,7,0.786749482401656,85,91,97,100,109,115,133,136,"ATGATGA","CTTA","AAGAAGA","TTGA",2.47947561895661,6,9,18,42,2.09149668368378,4.65533353584863,7.80233146545525,101,"ENSG00000079974.19"
"21560","ENSG00000168356.13_141479",141471,141479,9,"ENSG00000168356.13",1,8,"VVVUVVVMV",1,7,0.764803312629399,86,92,109,112,116,122,133,136,"ATGAAAA","CTGT","GTGATAT","CTGA",2.4554516103171,17,4,11,41,2.60270341598938,4.74309520452585,7.80230845504345,101,"ENSG00000079974.19"
"31422","ENSG00000223725.6_213093",213085,213093,9,"ENSG00000223725.6",0,NA,"UVVUVVVVV",2,7,0.78343685300207,111,117,133,136,155,161,191,194,"ATGTTGA","ATTA","GTGATGA","CTGA",2.6080368632986,16,19,30,74,1.28726196679639,4.66854359719677,7.80229100920505,101,"ENSG00000079974.19"
"19025","ENSG00000160208.13_35456",35448,35456,9,"ENSG00000160208.13",1,8,"UVVVVVVMV",1,7,0.786749482401656,111,117,133,136,141,147,157,160,"ATAATGA","ATGA","GTGCTGT","CTGT",2.37278610847798,16,5,10,40,2.8024502429619,4.65525607487044,7.80225400447706,101,"ENSG00000079974.19"
"35720","ENSG00000236859.8_20146",20138,20146,9,"ENSG00000236859.8",1,2,"VMVVVVUVV",1,7,0.770186335403727,116,122,133,136,148,154,170,173,"GAGATGG","ATGA","GTGAGAA","CTGA",2.45773517565182,11,12,16,48,2.50101977283424,4.72148023596159,7.80222557757649,101,"ENSG00000079974.19"
"17716","ENSG00000154928.19_72719",72711,72719,9,"ENSG00000154928.19",1,2,"VMVUVVVVV",1,7,0.764803312629399,110,116,133,136,156,162,170,173,"CTGAGGA","CTAA","TTGAAGA","CTGA",2.54377739721895,17,20,8,54,2.01324261761609,4.74293964976894,7.80215290028653,101,"ENSG00000079974.19"
"47584","ENSG00000288700.2_382258",382250,382258,9,"ENSG00000288700.2",1,2,"VMVUVVVVV",1,7,0.764803312629399,110,116,133,136,156,162,170,173,"CTGAGGA","CTAA","TTGAAGA","CTGA",2.54377739721895,17,20,8,54,2.01324261761609,4.74293964976894,7.80215290028653,101,"ENSG00000079974.19"
"44267","ENSG00000280296.1_1435",1427,1435,9,"ENSG00000280296.1",1,3,"UVMVVVVVV",1,7,0.785507246376811,72,78,93,96,107,113,133,136,"ATGTTTA","CTAA","TTGATCA","CTGA",2.4568920379712,15,11,20,55,2.26101335825311,4.66007340284862,7.80210238835586,101,"ENSG00000079974.19"
"25205","ENSG00000179915.25_650385",650377,650385,9,"ENSG00000179915.25",1,8,"VVUVVVVMV",1,7,0.767701863354037,92,98,108,111,116,122,133,136,"ATGATCT","GTGC","GTGAGGG","CTGA",2.39354078916631,10,5,11,35,2.96818958154212,4.73128204399604,7.80208949741219,101,"ENSG00000079974.19"
"26544","ENSG00000184384.14_363710",363702,363710,9,"ENSG00000184384.14",1,8,"VVVVUVVMV",1,7,0.773913043478261,64,70,83,86,101,107,133,136,"ATGATCA","CTGC","CTCAAGA","CTGA",2.55595342900827,13,15,26,63,1.7857745083367,4.70636600876462,7.80201818267766,101,"ENSG00000079974.19"
"28640","ENSG00000196277.16_678459",678451,678459,9,"ENSG00000196277.16",0,NA,"UVVVVVUVV",2,7,0.788819875776397,111,117,133,136,151,157,168,171,"AGGATTA","CAGA","TTGGTGG","CTGA",2.4313276082338,16,15,11,51,2.3779718998855,4.64670565536105,7.80198515846664,101,"ENSG00000079974.19"
"23145","ENSG00000172264.19_1916236",1916228,1916236,9,"ENSG00000172264.19",1,8,"VVVVUVVMV",1,7,0.773913043478261,112,118,133,136,146,152,168,171,"GTGAAGG","CTGG","GTGAATA","CTGA",2.43872190659549,15,10,16,50,2.56698142449996,4.70628186711747,7.80193404103052,101,"ENSG00000079974.19"
"35957","ENSG00000237505.8_742651",742643,742651,9,"ENSG00000237505.8",1,6,"VVVUVMVVV",1,7,0.78343685300207,114,120,133,136,155,161,171,174,"ATGTTGA","ATAA","GTTATTA","CTGA",2.45306908262682,13,19,10,51,2.31881434135174,4.66815205638263,7.80189946839091,101,"ENSG00000079974.19"
"7746","ENSG00000115525.18_58975",58967,58975,9,"ENSG00000115525.18",1,2,"VMVVVUVVV",1,7,0.806211180124223,105,111,133,136,150,156,169,172,"ATGATGA","CTCA","TTGGGGA","CTGT",2.46431123484471,22,14,13,58,1.87892866473053,4.57691755759049,7.80176227808738,101,"ENSG00000079974.19"
"21687","ENSG00000168702.18_365185",365177,365185,9,"ENSG00000168702.18",1,5,"UVVVMVVVV",1,7,0.789233954451346,110,116,133,136,141,147,160,163,"ATAATTT","CTGA","ATGCTAT","CTGA",2.39474426128669,17,5,13,44,2.61427522123416,4.64480924078636,7.80174505859174,101,"ENSG00000079974.19"
"9806","ENSG00000127337.7_11098",11090,11098,9,"ENSG00000127337.7",1,1,"MVVVUVVVV",1,7,0.795859213250517,112,118,133,136,139,145,158,161,"ATGATGA","TTTA","ATGATAG","TTGA",2.3865908263104,15,3,13,40,2.5626010950941,4.61830165095752,7.80173850395959,101,"ENSG00000079974.19"
"39544","ENSG00000253773.5_329892",329884,329892,9,"ENSG00000253773.5",1,8,"VVVUVVVMV",1,7,0.764803312629399,116,122,133,136,138,144,152,155,"CAGAAGA","CTGA","TAGTTGA","CTGA",2.41743774914646,11,2,8,30,2.85352026603319,4.74244298175241,7.80165623227,101,"ENSG00000079974.19"
"21992","ENSG00000169519.21_156649",156641,156649,9,"ENSG00000169519.21",1,1,"MVVVVUVVV",1,7,0.82815734989648,58,64,79,82,114,120,133,136,"ATGAAGA","ATGA","ATGCTGA","ATGA",2.41379794966184,15,32,13,69,1.86382541945171,4.48895293763266,7.80158233721858,101,"ENSG00000079974.19"
"33740","ENSG00000230990.2_54741",54733,54741,9,"ENSG00000230990.2",1,2,"VMUVVVVVV",1,7,0.767701863354037,116,122,133,136,149,155,166,169,"ATGAAGA","CTCT","GTAGTGA","CTGA",2.43887793924824,11,13,11,44,2.6634266443293,4.73065322649606,7.80146067991221,101,"ENSG00000079974.19"
"37473","ENSG00000248268.1_20042",20034,20042,9,"ENSG00000248268.1",1,2,"UMVVVVVVV",1,7,0.786749482401656,115,121,133,136,144,150,166,169,"AGGAGGA","CGGA","GTCATAG","CTGA",2.37995660972974,12,8,16,45,2.75134207376402,4.65442986799057,7.8014277975972,101,"ENSG00000079974.19"
"9880","ENSG00000127955.17_4704",4696,4704,9,"ENSG00000127955.17",1,8,"UVVVVVVMV",1,7,0.786749482401656,105,111,133,136,146,152,164,167,"ATGAATA","ATGA","ATGTAGA","CTGA",2.46355942129831,22,10,12,53,2.19345772130626,4.65429679915708,7.80129472876371,101,"ENSG00000079974.19"
"1278","ENSG00000051341.15_56530",56522,56530,9,"ENSG00000051341.15",1,1,"MVVVVVUVV",1,7,0.792132505175983,116,122,133,136,144,150,173,176,"GTGGTTA","CAGA","CTGTTGA","CTGA",2.43155738326289,11,8,23,51,2.32060552384558,4.63274701973288,7.80127704043681,101,"ENSG00000079974.19"
"31727","ENSG00000224577.4_44537",44529,44537,9,"ENSG00000224577.4",1,6,"VVVVVMUVV",1,7,0.788819875776397,89,95,104,107,111,117,133,136,"AGGATGC","TTGA","AAGAATA","CTGA",2.41371967482408,9,4,16,38,2.4923773304413,4.64596045731713,7.80123996042271,101,"ENSG00000079974.19"
"14449","ENSG00000145012.14_399756",399748,399756,9,"ENSG00000145012.14",0,NA,"UVVUVVVVV",2,7,0.78343685300207,86,92,106,109,115,121,133,136,"ATGAAGC","GTGT","GTGCTAA","CTGA",2.36097459532017,14,6,12,41,2.92993519723474,4.66744145817564,7.80118887018392,101,"ENSG00000079974.19"
"529","ENSG00000017427.17_28302",28294,28302,9,"ENSG00000017427.17",0,NA,"UVVVVUVVV",2,7,0.824844720496894,112,118,133,136,148,154,179,182,"GTGATTT","CTCA","CTGAGTA","CTGA",2.40882275791128,15,12,25,61,1.94835757471924,4.50179399019862,7.80117287218619,101,"ENSG00000079974.19"
"35374","ENSG00000235885.8_183402",183394,183402,9,"ENSG00000235885.8",1,2,"UMVVVVVVV",1,7,0.786749482401656,113,119,133,136,141,147,171,174,"AGGATGA","CCAA","GTAATAA","CTGA",2.46103051291715,14,5,24,52,2.20946136002723,4.6540828615354,7.80108079114202,101,"ENSG00000079974.19"
"45493","ENSG00000285639.1_2499",2491,2499,9,"ENSG00000285639.1",1,8,"VVVVVUVMV",1,7,0.806211180124224,109,115,133,136,184,190,205,208,"TTAATGG","CTGA","GTGCAGA","CTGA",2.52295246905339,18,48,15,90,1.48483097393587,4.57612852523961,7.80097324573651,101,"ENSG00000079974.19"
"6839","ENSG00000112077.18_19725",19717,19725,9,"ENSG00000112077.18",1,1,"MVVVVVUVV",1,7,0.792132505175983,88,94,133,136,147,153,207,210,"GTGATGA","TTGA","ATGAAAC","CTGA",2.65372282193732,39,11,54,113,0.838192129301842,4.63241940222099,7.80094942292493,101,"ENSG00000079974.19"
"10061","ENSG00000129048.7_10363",10355,10363,9,"ENSG00000129048.7",1,1,"MVVVVVUVV",1,7,0.792132505175983,115,121,133,136,141,147,157,160,"GGGATGA","CAAA","GGTTTGA","CTGA",2.32427304699465,12,5,10,36,3.03415759690402,4.63232781088375,7.80085783158768,101,"ENSG00000079974.19"
"46448","ENSG00000286680.1_98482",98474,98482,9,"ENSG00000286680.1",0,NA,"VVVVVUUVV",2,7,0.808281573498965,30,36,48,51,86,92,133,136,"ATAATGG","CTGA","CTGTTGG","CTGA",2.5850185488947,12,35,41,97,1.0368903885679,4.5675868452998,7.80071313929566,101,"ENSG00000079974.19"
"47054","ENSG00000287557.1_93546",93538,93546,9,"ENSG00000287557.1",0,NA,"VVVVVUUVV",2,7,0.808281573498965,30,36,48,51,86,92,133,136,"ATAATGG","CTGA","CTGTTGG","CTGA",2.5850185488947,12,35,41,97,1.0368903885679,4.5675868452998,7.80071313929566,101,"ENSG00000079974.19"
"47648","ENSG00000288828.1_7409",7401,7409,9,"ENSG00000288828.1",1,2,"VMVVVVUVV",1,7,0.770186335403727,109,115,133,136,170,176,184,187,"ATGATTT","CTAA","CTGATGA","CTGA",2.58132221974083,18,34,8,69,1.67059861342082,4.71985335292326,7.80059869453817,101,"ENSG00000079974.19"
"27112","ENSG00000185565.12_551392",551384,551392,9,"ENSG00000185565.12",1,8,"UVVVVVVMV",1,7,0.786749482401656,89,95,109,112,116,122,133,136,"CTGCAGA","TTGA","TGGATGA","CTGA",2.36507084736218,14,4,11,38,2.84726313322388,4.6536005289096,7.80059845851623,101,"ENSG00000079974.19"
"47833","ENSG00000289455.1_4624",4616,4624,9,"ENSG00000289455.1",1,8,"VVVVUVVMV",1,7,0.773913043478261,114,120,133,136,150,156,164,167,"ATGAAGA","CAGG","CTCATCA","CTGA",2.43184528863768,13,14,8,44,2.60726602728544,4.70489198788416,7.80054416179721,101,"ENSG00000079974.19"
"21898","ENSG00000169291.10_17063",17055,17063,9,"ENSG00000169291.10",1,7,"VVVUVVMVV",1,7,0.766045548654244,114,120,133,136,150,156,173,176,"AGGATCA","CTAA","CTGAGGA","CTGA",2.49436593123638,13,14,17,53,2.31619590735991,4.73632552890061,7.80050772351759,101,"ENSG00000079974.19"
"33841","ENSG00000231304.2_223417",223409,223417,9,"ENSG00000231304.2",1,8,"VVVVVUVMV",1,7,0.806211180124224,116,122,133,136,141,147,161,164,"ATGGTGA","TTGA","ATAATCA","ATGA",2.32203185994246,11,5,14,39,2.82242244801047,4.57565871190671,7.80050343240361,101,"ENSG00000079974.19"
"46592","ENSG00000286863.2_433113",433105,433113,9,"ENSG00000286863.2",0,NA,"UVVVVUVVV",2,7,0.824844720496894,110,116,133,136,164,170,180,183,"CTGTTGG","CTGT","ATGTTGA","CTGA",2.42642098079909,17,28,10,64,1.828308879702,4.50111218792398,7.80049106991156,101,"ENSG00000079974.19"
"25304","ENSG00000180658.4_924",916,924,9,"ENSG00000180658.4",1,1,"MVVVVUVVV",1,7,0.82815734989648,114,120,133,136,143,149,161,164,"GTGCTGG","CTTT","AGGATTA","CTGA",2.24599623364834,13,7,12,41,2.97784358213778,4.48778795161501,7.80041735120093,101,"ENSG00000079974.19"
"36956","ENSG00000243896.4_6088",6080,6088,9,"ENSG00000243896.4",1,1,"MVVVVUVVV",1,7,0.82815734989648,114,120,133,136,143,149,161,164,"GTGCTGG","CTTT","AGGATTA","CTGA",2.24599623364834,13,7,12,41,2.97784358213778,4.48778795161501,7.80041735120093,101,"ENSG00000079974.19"
"44972","ENSG00000284644.1_97003",96995,97003,9,"ENSG00000284644.1",1,1,"MVVVVUVVV",1,7,0.82815734989648,114,120,133,136,143,149,161,164,"GTGCTGG","CTTT","AGGATTA","CTGA",2.24599623364834,13,7,12,41,2.97784358213778,4.48778795161501,7.80041735120093,101,"ENSG00000079974.19"
"13134","ENSG00000140386.13_238050",238042,238050,9,"ENSG00000140386.13",1,8,"VVVVVUVMV",1,7,0.806211180124224,72,78,92,95,105,111,133,136,"ATGAGTA","CTGC","GTGAGTT","CTGA",2.4047969244974,14,10,22,55,2.26973954092419,4.57542975939339,7.80027447989028,101,"ENSG00000079974.19"
"47157","ENSG00000287722.1_305921",305913,305921,9,"ENSG00000287722.1",0,NA,"VVVVVUUVV",2,7,0.808281573498965,103,109,133,136,144,150,175,178,"TTAATGA","ATGA","TGGATGA","CTGA",2.5186109552776,24,8,25,66,1.47769275106896,4.5671081132299,7.80023440722576,101,"ENSG00000079974.19"
"44099","ENSG00000278090.3_4020",4012,4020,9,"ENSG00000278090.3",1,8,"VVVVVUVMV",1,7,0.806211180124224,111,117,133,136,146,152,163,166,"CTGAGGA","CAGA","GTGCTGA","TTGA",2.33625935010649,16,10,11,46,2.72599856804707,4.57526522552258,7.80010994601947,101,"ENSG00000079974.19"
"29479","ENSG00000198042.11_10321",10313,10321,9,"ENSG00000198042.11",1,5,"VVVUMVVVV",1,7,0.767287784679089,116,122,133,136,187,193,231,234,"AAGATGA","CTGA","CTGCTCA","CTGA",2.68766480621412,11,51,38,109,1.00577994650742,4.73088633031705,7.80003746903341,101,"ENSG00000079974.19"
"39309","ENSG00000253438.5_737465",737457,737465,9,"ENSG00000253438.5",1,8,"VVVUVVVMV",1,7,0.764803312629399,61,67,82,85,91,97,133,136,"CTGATGA","CTGA","GTGAGGT","CTAA",2.55378730299889,15,6,36,66,1.93737894915079,4.74065690895251,7.7998701594701,101,"ENSG00000079974.19"
"44148","ENSG00000278811.4_4932",4924,4932,9,"ENSG00000278811.4",1,6,"UVVVVMVVV",1,7,0.805383022774327,111,117,133,136,146,152,180,183,"AAGATGT","CTTA","CTGCTGC","CTGA",2.46040231182424,16,10,28,63,1.91060759268583,4.57832241787853,7.79985450897584,101,"ENSG00000079974.19"
"22776","ENSG00000171408.14_237094",237086,237094,9,"ENSG00000171408.14",1,2,"VMUVVVVVV",1,7,0.767701863354037,65,71,85,88,94,100,133,136,"GTGATGA","TTGA","GTGATGG","TTGA",2.53388088178288,14,6,33,62,2.02360310963173,4.7290355803794,7.79984303379555,101,"ENSG00000079974.19"
"12313","ENSG00000137845.15_7685",7677,7685,9,"ENSG00000137845.15",1,2,"UMVVVVVVV",1,7,0.786749482401656,66,72,81,84,93,99,133,136,"ATTATGT","CTGT","GTGAAGC","CTGA",2.5141422920009,9,9,34,61,1.85037630374043,4.65283122926995,7.79982915887657,101,"ENSG00000079974.19"
"43063","ENSG00000267920.1_318",310,318,9,"ENSG00000267920.1",1,8,"UVVVVVVMV",1,7,0.786749482401656,110,116,133,136,181,187,203,206,"TTGATGC","CAGA","AAGATGA","CTGA",2.56426602256557,17,45,16,87,1.51616381085152,4.65281765698882,7.79981558659545,101,"ENSG00000079974.19"
"20013","ENSG00000164151.12_55317",55309,55317,9,"ENSG00000164151.12",0,NA,"VVVUUVVVV",2,7,0.770600414078675,86,92,133,136,140,146,195,198,"ATGATGA","GTGG","GTGATGG","CTGA",2.70412921134526,41,4,49,103,0.841893307136964,4.71735534569301,7.79975700200771,101,"ENSG00000079974.19"
"38097","ENSG00000249534.2_19401",19393,19401,9,"ENSG00000249534.2",1,8,"UVVVVVVMV",1,7,0.786749482401656,70,76,94,97,110,116,133,136,"ATGATGG","CTGA","TTGAGTA","CAGA",2.48292361114896,18,13,17,57,2.05810914154574,4.65273330396803,7.79973123357465,101,"ENSG00000079974.19"
"34253","ENSG00000232295.7_40992",40984,40992,9,"ENSG00000232295.7",1,8,"VVVVVVUMV",1,7,0.770186335403727,64,70,99,102,109,115,133,136,"AAAATGA","CTGA","GTGATCC","CTGA",2.577193382956,29,7,18,63,1.6946213042947,4.71897763100034,7.79972297261524,101,"ENSG00000079974.19"
"10380","ENSG00000130707.18_18625",18617,18625,9,"ENSG00000130707.18",1,8,"VVUVVVVMV",1,7,0.767701863354037,116,122,133,136,175,181,192,195,"CTGAGGA","CTCA","TTGAAGA","CTGA",2.54190005053559,11,39,11,70,1.96959691407582,4.72889931274495,7.79970676616109,101,"ENSG00000079974.19"
"31010","ENSG00000215244.4_23874",23866,23874,9,"ENSG00000215244.4",1,1,"MVUVVVVVV",1,7,0.789648033126294,111,117,133,136,143,149,163,166,"ATGATGT","ATGA","TTGATCT","CTGG",2.37765962109232,16,7,14,46,2.71336174087338,4.6411064703722,7.79969860287738,101,"ENSG00000079974.19"
"12820","ENSG00000139173.10_167989",167981,167989,9,"ENSG00000139173.10",1,7,"VVVVUVMVV",1,7,0.775155279503105,112,118,133,136,163,169,218,221,"CTAATGA","CTGA","GGGATGA","CTGA",2.66939575425814,15,27,49,100,1.00022694776091,4.69904966070379,7.79967077871622,101,"ENSG00000079974.19"
"10929","ENSG00000133119.13_36002",35994,36002,9,"ENSG00000133119.13",1,1,"MVVVVUVVV",1,7,0.82815734989648,85,91,133,136,141,147,188,191,"TTGATGA","ACGA","ATGTAGA","CTGA",2.54986437376624,42,5,41,97,0.948991195346061,4.48702175511358,7.7996511546995,101,"ENSG00000079974.19"
"4985","ENSG00000102572.15_6240",6232,6240,9,"ENSG00000102572.15",1,5,"UVVVMVVVV",1,7,0.789233954451346,90,96,106,109,116,122,133,136,"TTTATGA","CTGA","CTAAAGA","CTCA",2.33800232474258,10,7,11,37,2.98392688917998,4.64265226353262,7.799588081338,101,"ENSG00000079974.19"
"36223","ENSG00000238755.3_519043",519035,519043,9,"ENSG00000238755.3",1,8,"VVVUVVVMV",1,7,0.764803312629399,82,88,100,103,113,119,133,136,"ATAATTA","TTGA","ATATTGA","CTGA",2.42784830592519,12,10,14,45,2.77574796086026,4.74035083342371,7.79956408394131,101,"ENSG00000079974.19"
"22909","ENSG00000171723.16_331758",331750,331758,9,"ENSG00000171723.16",1,8,"VVVVUVVMV",1,7,0.773913043478261,113,119,133,136,163,169,182,185,"ATGCTGA","GTAA","ATGATGG","CTGA",2.52673367295806,14,27,13,63,1.97060328656144,4.70387360990379,7.79952578381684,101,"ENSG00000079974.19"
"6854","ENSG00000112137.19_498726",498718,498726,9,"ENSG00000112137.19",1,8,"VVVVVUVMV",1,7,0.806211180124224,109,115,133,136,145,151,167,170,"CTGAGCA","CTGA","AGGAAAA","CTGA",2.38842678908619,18,9,16,52,2.37574389218883,4.57464728819086,7.79949200868776,101,"ENSG00000079974.19"
"20112","ENSG00000164307.13_46511",46503,46511,9,"ENSG00000164307.13",1,8,"UVVVVVVMV",1,7,0.786749482401656,109,115,133,136,142,148,165,168,"TTGATGA","CAGA","TTGGTGA","CTTA",2.43915392368627,18,6,17,50,2.34853916945051,4.65239133183974,7.79938926144636,101,"ENSG00000079974.19"
"41292","ENSG00000258779.8_60646",60638,60646,9,"ENSG00000258779.8",1,1,"MVVVVUVVV",1,7,0.82815734989648,116,122,133,136,142,148,158,161,"AGAATGA","GTAA","ATACTTA","CTGA",2.23288031889828,11,6,10,36,3.06115136982541,4.48675504062016,7.79938444020608,101,"ENSG00000079974.19"
"2610","ENSG00000076641.4_39174",39166,39174,9,"ENSG00000076641.4",1,8,"VVVVVVUMV",1,7,0.770186335403727,113,119,133,136,144,150,164,167,"GTGATGC","CAGG","GTGCGTA","CTGA",2.40698935251454,14,8,14,45,2.8279150943933,4.7186276944559,7.7993730360708,101,"ENSG00000079974.19"
"27962","ENSG00000187720.15_37701",37693,37701,9,"ENSG00000187720.15",1,1,"MVVUVVVVV",1,7,0.786749482401656,106,112,133,136,148,154,162,165,"CTAATGG","CTGA","TTTAAGA","CTGA",2.4679262669515,21,12,8,50,2.15657040928284,4.65235304723987,7.79935097684649,101,"ENSG00000079974.19"
"530","ENSG00000017427.17_40433",40425,40433,9,"ENSG00000017427.17",1,1,"MVVVVUVVV",1,7,0.82815734989648,90,96,133,136,140,146,160,163,"ATGATGC","GTCA","ATGACTG","CTGA",2.43499760066483,37,4,14,64,1.71336631460596,4.48667091309288,7.7993003126788,101,"ENSG00000079974.19"
"25427","ENSG00000181381.15_13665",13657,13665,9,"ENSG00000181381.15",0,NA,"UVVUVVVVV",2,7,0.78343685300207,79,85,91,94,101,107,133,136,"AAAATGA","CTGA","TTGTTTA","CTGA",2.54045351809113,6,7,26,48,1.72561786634966,4.66549366340597,7.79924107541425,101,"ENSG00000079974.19"
"32371","ENSG00000226851.1_7333",7325,7333,9,"ENSG00000226851.1",0,NA,"UVVVUVVVV",2,7,0.792546583850932,84,90,133,136,146,152,163,166,"ATGATCA","TTTA","CTAATGA","CTGA",2.49475626109567,43,10,11,73,1.88445812988569,4.62904163429754,7.79922796970127,101,"ENSG00000079974.19"
"12305","ENSG00000137831.15_41878",41870,41878,9,"ENSG00000137831.15",1,6,"VVVVVMUVV",1,7,0.788819875776397,79,85,99,102,114,120,133,136,"ATGAAGA","CTGT","TTGAGGA","CTGG",2.38871969668152,14,12,13,48,2.65071350396686,4.64387787046091,7.7991573735665,101,"ENSG00000079974.19"
"26553","ENSG00000184408.10_179486",179478,179486,9,"ENSG00000184408.10",1,8,"VVVVUVVMV",1,7,0.773913043478261,98,104,133,136,160,166,185,188,"ACAATGA","CTGA","GTGATGA","CTGA",2.70501058574453,29,24,19,81,0.780610038718918,4.70350348592061,7.79915565983366,101,"ENSG00000079974.19"
"44546","ENSG00000282987.1_141730",141722,141730,9,"ENSG00000282987.1",0,NA,"VVVUVVUVV",2,7,0.766873706004141,91,97,133,136,153,159,170,173,"ATGAAGG","TTGA","GTGATGA","CTGA",2.62599067465242,36,17,11,73,1.42000212399532,4.73165165541953,7.79914647943609,101,"ENSG00000079974.19"
"9716","ENSG00000126746.18_15030",15022,15030,9,"ENSG00000126746.18",1,8,"UVVVVVVMV",1,7,0.786749482401656,113,119,133,136,141,147,156,159,"CTCCTGA","CAGA","ATGATCC","CTGA",2.34531813589979,14,5,9,37,2.97283552479713,4.65207244103227,7.79907037063889,101,"ENSG00000079974.19"
"3612","ENSG00000086848.15_10235",10227,10235,9,"ENSG00000086848.15",1,8,"VVVVUVVMV",1,7,0.773913043478261,114,120,133,136,138,144,152,155,"ATTATTT","CTGA","ATGCAGT","CTGA",2.4083909906731,13,2,8,32,2.75757226228217,4.70337805002571,7.79903022393875,101,"ENSG00000079974.19"
"41084","ENSG00000258529.5_18079",18071,18079,9,"ENSG00000258529.5",1,8,"VVVVUVVMV",1,7,0.773913043478261,114,120,133,136,138,144,152,155,"ATTATTT","CTGA","ATGCAGT","CTGA",2.4083909906731,13,2,8,32,2.75757226228217,4.70337805002571,7.79903022393875,101,"ENSG00000079974.19"
"18773","ENSG00000158467.17_121396",121388,121396,9,"ENSG00000158467.17",1,8,"VVVUVVVMV",1,7,0.764803312629399,96,102,133,136,140,146,157,160,"ATGATAA","CTTA","ATAAGGA","CTGA",2.56554271598988,31,4,11,55,1.85564178792783,4.73981497363175,7.79902822414935,101,"ENSG00000079974.19"
"12223","ENSG00000137691.13_3717",3709,3717,9,"ENSG00000137691.13",1,2,"VMVVVUVVV",1,7,0.806211180124223,106,112,133,136,152,158,173,176,"ATGATGT","TGGA","ATGAGTT","CTGA",2.48717785334209,21,16,15,61,1.71551442617394,4.5741750287803,7.79901974927719,101,"ENSG00000079974.19"
"30205","ENSG00000204131.10_154246",154238,154246,9,"ENSG00000204131.10",1,1,"MVVVVUVVV",1,7,0.82815734989648,116,122,133,136,146,152,197,200,"TTGATGA","ATGA","GAGAAGA","CAGA",2.4097592607751,11,10,45,75,1.88035635202919,4.48635452263246,7.79898392221838,101,"ENSG00000079974.19"
"7396","ENSG00000113946.4_47531",47523,47531,9,"ENSG00000113946.4",1,1,"MVVVVUVVV",1,7,0.82815734989648,112,118,133,136,151,157,168,171,"ATGACAA","AAGA","ATTAGGA","CTGA",2.32431152504032,15,15,11,50,2.44984611702836,4.48631407099096,7.79894347057689,101,"ENSG00000079974.19"
"4563","ENSG00000101096.20_119633",119625,119633,9,"ENSG00000101096.20",0,NA,"UVVVVUVVV",2,7,0.824844720496894,116,122,133,136,148,154,168,171,"GGGAGGA","ATAA","AGGATGA","CTGA",2.30727786974845,11,12,14,46,2.61612816994928,4.49949515873473,7.79887404072231,101,"ENSG00000079974.19"
"47288","ENSG00000287941.1_22860",22852,22860,9,"ENSG00000287941.1",1,2,"VMVVVUVVV",1,7,0.806211180124223,110,116,133,136,146,152,164,167,"GAAATGA","GTGA","ATGTAGG","CTGA",2.35241097876606,17,10,12,48,2.6131047904488,4.57396116222231,7.7988058827192,101,"ENSG00000079974.19"
"13159","ENSG00000140443.15_273007",272999,273007,9,"ENSG00000140443.15",1,5,"VVVVMUVVV",1,7,0.808695652173913,54,60,79,82,114,120,133,136,"TTGATGA","CTGA","CTGCAGA","CAGA",2.50872904564132,19,32,13,73,1.53119918675872,4.56401487275854,7.79879748145419,101,"ENSG00000079974.19"
"42757","ENSG00000266450.1_6819",6811,6819,9,"ENSG00000266450.1",1,2,"VMVVVUVVV",1,7,0.806211180124223,112,118,133,136,151,157,168,171,"ATAATGA","CTTA","GTGAAAA","ATGA",2.37687702388382,15,15,11,50,2.44984611702836,4.57392323573012,7.79876795622702,101,"ENSG00000079974.19"
"42771","ENSG00000266602.2_152974",152966,152974,9,"ENSG00000266602.2",1,2,"VMVVVUVVV",1,7,0.806211180124223,112,118,133,136,151,157,168,171,"ATAATGA","CTTA","GTGAAAA","ATGA",2.37687702388382,15,15,11,50,2.44984611702836,4.57392323573012,7.79876795622702,101,"ENSG00000079974.19"
"16028","ENSG00000150667.8_114561",114553,114561,9,"ENSG00000150667.8",1,8,"VVVVUVVMV",1,7,0.773913043478261,115,121,133,136,137,143,151,154,"AGGAAGA","TGGA","ATGAAGA","CTGA",2.41995092501998,12,1,8,30,2.67934450310494,4.7030876674762,7.79873984138924,101,"ENSG00000079974.19"
"46975","ENSG00000287439.1_22398",22390,22398,9,"ENSG00000287439.1",1,7,"VVVVVUMVV",1,7,0.807453416149068,110,116,133,136,154,160,179,182,"AGGAGGA","ATGA","GTGGAGA","CTGA",2.48583061186078,17,18,19,63,1.70302232165112,4.56880660018076,7.79862026477703,101,"ENSG00000079974.19"
"29786","ENSG00000198729.5_81812",81804,81812,9,"ENSG00000198729.5",1,1,"MVUVVVVVV",1,7,0.789648033126294,111,117,133,136,156,162,171,174,"ATGATGA","CTGC","GTGTGGT","GTGA",2.46679137260137,16,20,9,54,2.11461663836021,4.63997311392567,7.79856524643085,101,"ENSG00000079974.19"
"21359","ENSG00000167291.16_31442",31434,31442,9,"ENSG00000167291.16",1,3,"UVMVVVVVV",1,7,0.785507246376811,79,85,97,100,116,122,133,136,"ATGAGGA","CTGA","GTGACCT","CAGA",2.42245016134064,12,16,11,48,2.47640955718845,4.65651932486485,7.7985483103721,101,"ENSG00000079974.19"
"23882","ENSG00000174469.23_508815",508807,508815,9,"ENSG00000174469.23",1,1,"MVVVVUVVV",1,7,0.82815734989648,102,108,133,136,146,152,206,209,"GTGTTGA","TTGA","GTATTGA","CTGA",2.53083758666676,25,10,54,98,1.07095025562483,4.48580020835081,7.79842960793673,101,"ENSG00000079974.19"
"22887","ENSG00000171681.13_68675",68667,68675,9,"ENSG00000171681.13",0,NA,"UVVVVUVVV",2,7,0.824844720496894,108,114,133,136,181,187,196,199,"TTGTTAA","ATGA","ATGATGA","CTGA",2.46270946230615,19,45,9,82,1.57808332427885,4.49903660157996,7.79841548356754,101,"ENSG00000079974.19"
"18784","ENSG00000158470.5_74881",74873,74881,9,"ENSG00000158470.5",1,6,"VVVUVMVVV",1,7,0.78343685300207,111,117,133,136,142,148,159,162,"ATGATGT","CTGG","CTGATAT","CTCA",2.37497078858692,16,6,11,42,2.82489093175048,4.66450738058248,7.79825479259076,101,"ENSG00000079974.19"
"20137","ENSG00000164327.13_49243",49235,49243,9,"ENSG00000164327.13",1,8,"VVVVVUVMV",1,7,0.806211180124224,110,116,133,136,141,147,159,162,"GTAATTA","TTGA","GAGAAGG","CTGA",2.34548632591413,17,5,12,43,2.65690039645844,4.57336897563815,7.79821369613505,101,"ENSG00000079974.19"
"47406","ENSG00000288088.1_236808",236800,236808,9,"ENSG00000288088.1",1,8,"UVVVVVVMV",1,7,0.786749482401656,116,122,133,136,148,154,162,165,"TTCATGG","CTAA","TAGATGA","CTGA",2.37762501733377,11,12,8,40,2.75392514849667,4.65118964934712,7.79818757895374,101,"ENSG00000079974.19"
"35724","ENSG00000236885.2_29717",29709,29717,9,"ENSG00000236885.2",1,7,"VVVVVUMVV",1,7,0.807453416149068,46,52,65,68,78,84,133,136,"ACCATTA","CTGA","CTGATAA","CTGA",2.45641963417193,13,10,49,81,1.89690164784212,4.56825813558041,7.79807180017668,101,"ENSG00000079974.19"
"10345","ENSG00000130595.19_14700",14692,14700,9,"ENSG00000130595.19",1,8,"VVVVVUVMV",1,7,0.806211180124224,86,92,104,107,115,121,133,136,"AGGATGC","CAGA","CTGAAGA","CTGT",2.29854599609439,12,8,12,41,2.9690210902687,4.57316526605783,7.79800998655473,101,"ENSG00000079974.19"
"27857","ENSG00000187416.13_576788",576780,576788,9,"ENSG00000187416.13",1,1,"MVVVVUVVV",1,7,0.82815734989648,109,115,133,136,151,157,176,179,"ATATTGA","ATGA","ATTATGC","CTGA",2.42189652957808,18,15,19,61,1.79543557031843,4.48535310854307,7.79798250812899,101,"ENSG00000079974.19"
"7145","ENSG00000112964.14_223735",223727,223735,9,"ENSG00000112964.14",1,2,"VMVVVUVVV",1,7,0.806211180124223,51,57,77,80,90,96,133,136,"ATAATTA","CTGA","ATAATTA","CTGA",2.53002363911194,20,10,37,76,1.42516547512233,4.57299743396715,7.79784215446405,101,"ENSG00000079974.19"
"4846","ENSG00000102053.13_334125",334117,334125,9,"ENSG00000102053.13",1,2,"UMVVVVVVV",1,7,0.786749482401656,103,109,133,136,156,162,173,176,"GTGATGG","CAGA","AAGAAGA","CTGA",2.56819693389327,24,20,11,64,1.48178857633667,4.65077536723961,7.79777329684624,101,"ENSG00000079974.19"
"43886","ENSG00000274979.1_3038",3030,3038,9,"ENSG00000274979.1",1,8,"UVVVVVVMV",1,7,0.786749482401656,116,122,133,136,143,149,157,160,"TTTCTGA","CTGA","ATGATGA","CTTA",2.32743622838233,11,7,8,35,3.08659389029706,4.65070885321148,7.79770678281811,101,"ENSG00000079974.19"
"37009","ENSG00000244247.2_28302",28294,28302,9,"ENSG00000244247.2",1,2,"UMVVVVVVV",1,7,0.786749482401656,74,80,96,99,108,114,133,136,"ATGGGGA","ATGA","ATGCTTA","CTGA",2.43582101554958,16,9,19,53,2.36391633219922,4.65068077563244,7.79767870523907,101,"ENSG00000079974.19"
"64","ENSG00000003402.21_11717",11709,11717,9,"ENSG00000003402.21",1,8,"VVVVVUVMV",1,7,0.806211180124224,103,109,133,136,142,148,163,166,"TTGCTGA","GTCA","GTGATGG","CTGA",2.44083078697394,24,6,15,54,2.01899807907114,4.57280083139101,7.79764555188791,101,"ENSG00000079974.19"
"13519","ENSG00000141655.18_1065",1057,1065,9,"ENSG00000141655.18",1,8,"VVVVVVUMV",1,7,0.770186335403727,113,119,133,136,142,148,156,159,"GAGAAGA","TTGA","ATAATGT","CTGA",2.37913123140536,14,6,8,37,3.00670818158549,4.71689576440531,7.79764110602021,101,"ENSG00000079974.19"
"4329","ENSG00000100218.12_42393",42385,42393,9,"ENSG00000100218.12",1,8,"VVUVVVVMV",1,7,0.767701863354037,100,106,133,136,148,154,210,213,"ATGATGA","CTGC","GTGTGGG","CTGA",2.70572115059365,27,12,56,104,0.86911741578717,4.7268146049362,7.79762205835235,101,"ENSG00000079974.19"
"15985","ENSG00000150510.17_19150",19142,19150,9,"ENSG00000150510.17",1,8,"VVVVVUVMV",1,7,0.806211180124224,111,117,133,136,149,155,191,194,"CTGAGGT","CTGA","GAGATGT","CTGA",2.50722256527876,16,13,36,74,1.57617362432956,4.57274768154699,7.79759240204388,101,"ENSG00000079974.19"
"29606","ENSG00000198393.8_23830",23822,23830,9,"ENSG00000198393.8",1,8,"VVVVUVVMV",1,7,0.773913043478261,103,109,133,136,144,150,162,165,"AAGATGA","ATGC","GTGTTGG","CTGA",2.49669657734695,24,8,12,53,2.16286979423576,4.70187841080386,7.7975305847169,101,"ENSG00000079974.19"
"2236","ENSG00000072110.16_97131",97123,97131,9,"ENSG00000072110.16",0,NA,"VVUVVUVVV",2,7,0.805797101449275,113,119,133,136,145,151,169,172,"CTGCTGT","ATGG","GTGAAGA","CTGA",2.36190440147903,14,9,18,50,2.55130451144728,4.5743334636602,7.7975218694573,101,"ENSG00000079974.19"
"22609","ENSG00000170959.15_17323",17315,17323,9,"ENSG00000170959.15",1,7,"VVVVVUMVV",1,7,0.807453416149068,87,93,133,136,139,145,165,168,"ATTATGA","CTTA","TTGCTAA","CTGA",2.55781381118528,40,3,20,72,1.21871399150818,4.56770151651919,7.79751518111546,101,"ENSG00000079974.19"
"44479","ENSG00000282508.2_2140",2132,2140,9,"ENSG00000282508.2",0,NA,"UVVUVVVVV",2,7,0.78343685300207,59,65,103,106,111,117,133,136,"ATGAGGA","CTGA","GTGTTGA","GTGA",2.54431309570358,38,5,16,68,1.69295505902664,4.66376059092929,7.79750800293757,101,"ENSG00000079974.19"
"45415","ENSG00000285557.1_160373",160365,160373,9,"ENSG00000285557.1",1,2,"VMUVVVVVV",1,7,0.767701863354037,115,121,133,136,144,150,172,175,"CAGATTA","CTGT","GTGATGA","CTGA",2.47673962601452,12,8,22,51,2.39486190421808,4.72661485274539,7.79742230616154,101,"ENSG00000079974.19"
"23060","ENSG00000172159.16_250969",250961,250969,9,"ENSG00000172159.16",1,1,"MVVVVUVVV",1,7,0.82815734989648,109,115,133,136,146,152,189,192,"ATGGTGA","AGGA","ATTATGG","CTGA",2.45069043593755,18,10,37,74,1.60114698454989,4.48477080603339,7.79740020561931,101,"ENSG00000079974.19"
"39492","ENSG00000253661.3_13943",13935,13943,9,"ENSG00000253661.3",0,NA,"VVVVVUUVV",2,7,0.808281573498965,88,94,133,136,151,157,171,174,"ATGATGC","TTTA","GTGCTGT","CTGA",2.52440200820128,39,15,14,77,1.42727614394108,4.56415571632074,7.7972820103166,101,"ENSG00000079974.19"
"3721","ENSG00000088538.13_123186",123178,123186,9,"ENSG00000088538.13",0,NA,"UVVVVUVVV",2,7,0.824844720496894,32,38,67,70,78,84,133,136,"ATGATGA","CTGA","ATAAATA","TTGA",2.54147562741313,29,8,49,95,1.04834897333974,4.49787995569015,7.79725883767772,101,"ENSG00000079974.19"
"26487","ENSG00000184305.16_25260",25252,25260,9,"ENSG00000184305.16",0,NA,"VVVUVUVVV",2,7,0.802898550724638,83,89,96,99,112,118,133,136,"ATTATGT","GTGA","GTAACGT","CTGA",2.43164104466471,7,13,15,44,2.13169130866914,4.58565790160846,7.79725210450701,101,"ENSG00000079974.19"
"36731","ENSG00000242808.12_332979",332971,332979,9,"ENSG00000242808.12",0,NA,"UVVVVVUVV",2,7,0.788819875776397,110,116,133,136,145,151,167,170,"CTGTTGA","CTGT","ATTAGGT","CTGA",2.41547492756519,17,9,16,51,2.46457668551793,4.64193571732147,7.79721522042706,101,"ENSG00000079974.19"
"37451","ENSG00000248215.6_32065",32057,32065,9,"ENSG00000248215.6",1,7,"VVVVUVMVV",1,7,0.775155279503105,77,83,105,108,113,119,133,136,"AAGCTGA","CTCA","GTGCTGA","CTGA",2.49683344855959,22,5,14,50,2.14060724988048,4.69654089340277,7.79716201141519,101,"ENSG00000079974.19"
"35120","ENSG00000234997.3_48075",48067,48075,9,"ENSG00000234997.3",1,2,"VMVVVUVVV",1,7,0.806211180124223,65,71,81,84,106,112,133,136,"AGGGTGA","CTTA","ATGAGGA","CTGA",2.50588584669998,10,22,21,62,1.58311412674348,4.57225494285251,7.7970996633494,101,"ENSG00000079974.19"
"46460","ENSG00000286708.1_1809",1801,1809,9,"ENSG00000286708.1",1,8,"VVVVVUVMV",1,7,0.806211180124224,114,120,133,136,139,145,159,162,"TTCTTGA","CTGC","GTGAGCA","CTGA",2.35144888476748,13,3,14,39,2.61265716166711,4.57224576502925,7.79709048552614,101,"ENSG00000079974.19"
"26334","ENSG00000183873.18_27577",27569,27577,9,"ENSG00000183873.18",1,8,"UVVVVUVMV",2,6,0.708902691511387,112,118,133,136,138,144,152,155,"ATGATGA","CTGA","ATAATAA","TTGA",2.58961751930502,15,2,8,34,2.58157395972986,4.96142268877416,7.79703345481971,101,"ENSG00000079974.19"
"41141","ENSG00000258583.7_137857",137849,137857,9,"ENSG00000258583.7",1,1,"MVVVVVUVV",1,7,0.792132505175983,65,71,87,90,99,105,133,136,"TTGATGA","CAGA","ATGAGGA","GTGA",2.48262038121522,16,9,28,62,1.96297397330369,4.62844412868463,7.79697414938856,101,"ENSG00000079974.19"
"37906","ENSG00000249145.5_3905",3897,3905,9,"ENSG00000249145.5",1,7,"VVUVVVMVV",1,7,0.768944099378882,27,33,46,49,72,78,133,136,"AAGATGA","CTGA","GTGCTCC","CTGA",2.65725940080871,13,23,55,100,1.1694875624105,4.72113755861715,7.79691395613267,101,"ENSG00000079974.19"
"46391","ENSG00000286546.1_89952",89944,89952,9,"ENSG00000286546.1",1,5,"UVVVMVVVV",1,7,0.789233954451346,116,122,133,136,139,145,154,157,"CTGATAA","CCGT","GTGTGGT","CTGA",2.34428623386402,11,3,9,32,2.93087201071515,4.63986172578548,7.79679754359087,101,"ENSG00000079974.19"
"15664","ENSG00000149090.13_7998",7990,7998,9,"ENSG00000149090.13",1,8,"UVVVVVVMV",1,7,0.786749482401656,113,119,133,136,146,152,186,189,"ATGTGGA","CTGG","GTGGTGA","CTGA",2.50099511178727,14,10,34,67,1.9256648027652,4.64974138700342,7.79673931661005,101,"ENSG00000079974.19"
"21597","ENSG00000168434.13_34385",34377,34385,9,"ENSG00000168434.13",1,2,"VMUVVVVVV",1,7,0.767701863354037,106,112,133,136,145,151,177,180,"AAGATGA","CGGA","ATGCTGT","CTGA",2.59599669489253,21,9,26,65,1.5967185534196,4.72584079650912,7.79664824992527,101,"ENSG00000079974.19"
"18543","ENSG00000157637.13_23974",23966,23974,9,"ENSG00000157637.13",1,7,"VVUVVUMVV",2,6,0.691097308488613,73,79,92,95,101,107,133,136,"CTGTTGA","CTGA","GTGATGC","CTGA",2.68696505035381,13,6,26,54,2.21585512713413,5.03223886570655,7.796628099661,101,"ENSG00000079974.19"
"34780","ENSG00000234129.10_70435",70427,70435,9,"ENSG00000234129.10",0,NA,"UVVVVUVVV",2,7,0.824844720496894,84,90,102,105,114,120,133,136,"ATGGTGA","CTGA","ATGATTA","AGGA",2.26599652710605,12,9,13,43,2.88224643401867,4.49722248701474,7.79660136900232,101,"ENSG00000079974.19"
"32136","ENSG00000226067.7_63291",63283,63291,9,"ENSG00000226067.7",0,NA,"VVUVVVUVV",2,7,0.769772256728778,92,98,133,136,139,145,153,156,"CTGATGA","GGGA","TTGACGA","CTGA",2.5770286420158,35,3,8,55,1.6896778975847,4.71746721108918,7.79655623800429,101,"ENSG00000079974.19"
"44044","ENSG00000277147.9_12478",12470,12478,9,"ENSG00000277147.9",0,NA,"VVUVVVUVV",2,7,0.769772256728778,92,98,133,136,139,145,153,156,"CTGATGA","GGGA","TTGACGA","CTGA",2.5770286420158,35,3,8,55,1.6896778975847,4.71746721108918,7.79655623800429,101,"ENSG00000079974.19"
"45173","ENSG00000285215.3_12474",12466,12474,9,"ENSG00000285215.3",0,NA,"VVUVVVUVV",2,7,0.769772256728778,92,98,133,136,139,145,153,156,"CTGATGA","GGGA","TTGACGA","CTGA",2.5770286420158,35,3,8,55,1.6896778975847,4.71746721108918,7.79655623800429,101,"ENSG00000079974.19"
"48483","ENSG00000291158.1_62000",61992,62000,9,"ENSG00000291158.1",0,NA,"VVUVVVUVV",2,7,0.769772256728778,92,98,133,136,139,145,153,156,"CTGATGA","GGGA","TTGACGA","CTGA",2.5770286420158,35,3,8,55,1.6896778975847,4.71746721108918,7.79655623800429,101,"ENSG00000079974.19"
"19337","ENSG00000162779.22_19490",19482,19490,9,"ENSG00000162779.22",1,5,"UVVVMVVVV",1,7,0.789233954451346,114,120,133,136,139,145,153,156,"ACTAAGA","CTGA","ATGTTAC","CTGA",2.35099551297946,13,3,8,33,2.88489831338736,4.6395504333126,7.79648625111798,101,"ENSG00000079974.19"
"10553","ENSG00000131558.15_265821",265813,265821,9,"ENSG00000131558.15",1,8,"UVVVVVVMV",1,7,0.786749482401656,115,121,133,136,149,155,187,190,"GGGAAGA","CTGG","GTGATGA","CTGA",2.52198540341977,12,13,32,66,1.78466658524505,4.64947565201087,7.7964735816175,101,"ENSG00000079974.19"
"27569","ENSG00000186487.21_426510",426502,426510,9,"ENSG00000186487.21",1,1,"MVVVVVUVV",1,7,0.792132505175983,112,118,133,136,147,153,162,165,"ATGATGC","CTGT","TTGAAAA","TTGA",2.36396825987446,15,11,9,44,2.75189476674267,4.62792079147644,7.79645081218037,101,"ENSG00000079974.19"
"35588","ENSG00000236404.12_121812",121804,121812,9,"ENSG00000236404.12",1,1,"MVVVVVUVV",1,7,0.792132505175983,109,115,133,136,140,146,166,169,"ATGATGA","ATGA","GTGAGTT","CTGC",2.47354469389826,18,4,20,51,2.02099529989974,4.62782331480537,7.7963533355093,101,"ENSG00000079974.19"
"4928","ENSG00000102452.18_211235",211227,211235,9,"ENSG00000102452.18",1,2,"UMVVVVVVV",1,7,0.786749482401656,91,97,107,110,116,122,133,136,"ATGTTAA","CTTA","GCAAAGA","CTGA",2.34088383207067,10,6,11,36,2.99145553752933,4.64933693783345,7.79633486744008,101,"ENSG00000079974.19"
"24622","ENSG00000177182.11_3229",3221,3229,9,"ENSG00000177182.11",1,2,"VMVVVVUVV",1,7,0.770186335403727,112,118,133,136,160,166,174,177,"ATGATGG","TTGG","CTGAAGT","CTGA",2.52390143665236,15,24,8,56,2.03632467792316,4.71558356390139,7.7963289055163,101,"ENSG00000079974.19"
"21559","ENSG00000168356.13_122358",122350,122358,9,"ENSG00000168356.13",1,1,"MVVUVVVVV",1,7,0.786749482401656,109,115,133,136,148,154,163,166,"ATGAGAG","CTGA","ATCAGGA","CTGA",2.42468773245723,18,12,9,48,2.4326680566904,4.64931323493465,7.79631116454127,101,"ENSG00000079974.19"
"16523","ENSG00000151746.15_247840",247832,247840,9,"ENSG00000151746.15",1,1,"MVVVVVUVV",1,7,0.792132505175983,91,97,133,136,156,162,170,173,"CTGATGT","ATGA","TTGATTA","CTGA",2.58700314995993,36,20,8,73,1.26426778874931,4.62773886378721,7.79626888449114,101,"ENSG00000079974.19"
"14265","ENSG00000144642.22_710896",710888,710896,9,"ENSG00000144642.22",0,NA,"UVVVUVVVV",2,7,0.792546583850932,105,111,133,136,146,152,160,163,"ATGAAGA","GTTA","ACGTTGA","CTGA",2.44312046791583,22,10,8,49,2.21658621711291,4.62601400080462,7.79620033620834,101,"ENSG00000079974.19"
"44807","ENSG00000283563.1_936509",936501,936509,9,"ENSG00000283563.1",0,NA,"UVVVUVVVV",2,7,0.792546583850932,105,111,133,136,146,152,160,163,"ATGAAGA","GTTA","ACGTTGA","CTGA",2.44312046791583,22,10,8,49,2.21658621711291,4.62601400080462,7.79620033620834,101,"ENSG00000079974.19"
"21953","ENSG00000169375.17_30154",30146,30154,9,"ENSG00000169375.17",1,8,"UVVVVVVMV",1,7,0.786749482401656,86,92,101,104,114,120,133,136,"TTGTTGT","GTGA","CTGAAAA","CTGA",2.38785563964077,9,10,13,41,2.67776738158711,4.64920124479806,7.79619917440469,101,"ENSG00000079974.19"
"2833","ENSG00000078328.23_2436124",2436116,2436124,9,"ENSG00000078328.23",1,8,"VVVVUVVMV",1,7,0.773913043478261,98,104,133,136,149,155,167,170,"TTGATGT","CTGT","TTGATCA","CTGA",2.56368131143671,29,13,12,63,1.71078003863596,4.70049719538684,7.79614936929989,101,"ENSG00000079974.19"
"17090","ENSG00000153107.13_10311",10303,10311,9,"ENSG00000153107.13",1,8,"UVVVVVVMV",1,7,0.786749482401656,116,122,133,136,141,147,200,203,"GAGATGA","CTGG","GTGCAGT","CTGA",2.50337273199746,11,5,53,78,1.90743189651163,4.64914586079034,7.79614379039697,101,"ENSG00000079974.19"
"34641","ENSG00000233673.8_6495",6487,6495,9,"ENSG00000233673.8",1,8,"UVVVVVVMV",1,7,0.786749482401656,116,122,133,136,141,147,200,203,"GAGATGA","CTGG","GTGCAGT","CTGA",2.50337273199746,11,5,53,78,1.90743189651163,4.64914586079034,7.79614379039697,101,"ENSG00000079974.19"
"48349","ENSG00000291013.1_15971",15963,15971,9,"ENSG00000291013.1",1,8,"UVVVVVVMV",1,7,0.786749482401656,116,122,133,136,141,147,200,203,"GAGATGA","CTGG","GTGCAGT","CTGA",2.50337273199746,11,5,53,78,1.90743189651163,4.64914586079034,7.79614379039697,101,"ENSG00000079974.19"
"46681","ENSG00000287042.3_89091",89083,89091,9,"ENSG00000287042.3",0,NA,"UVVVVUVVV",2,7,0.824844720496894,71,77,91,94,104,110,133,136,"GTGATGG","CAGA","GTGAAGG","CTCA",2.36492111342995,14,10,23,56,2.22080677515034,4.4967368828375,7.79611576482507,101,"ENSG00000079974.19"
"26085","ENSG00000183273.7_154950",154942,154950,9,"ENSG00000183273.7",1,2,"VMVUVVVVV",1,7,0.764803312629399,107,113,133,136,159,165,173,176,"AAGAGGA","CTGA","GTGAAAA","CTGA",2.59548538261268,20,23,8,60,1.64358458484264,4.73670511723178,7.79591836774938,101,"ENSG00000079974.19"
"6323","ENSG00000109339.24_63358",63350,63358,9,"ENSG00000109339.24",1,5,"VVUVMVVVV",1,7,0.770186335403727,112,118,133,136,150,156,173,176,"ATGATTG","CAGA","TTTATGA","CTGA",2.49460127357169,15,14,17,55,2.22992779161346,4.71515073718951,7.79589607880442,101,"ENSG00000079974.19"
"2503","ENSG00000075340.23_125075",125067,125075,9,"ENSG00000075340.23",1,8,"VVVVVUVMV",1,7,0.806211180124224,85,91,103,106,113,119,133,136,"ATGGTGC","CCCA","CTGCTTA","CTGA",2.30929186571309,12,7,14,42,2.88891902407969,4.57104953220841,7.79589425270531,101,"ENSG00000079974.19"
"31019","ENSG00000215262.8_103290",103282,103290,9,"ENSG00000215262.8",0,NA,"UVVVVUVVV",2,7,0.824844720496894,52,58,89,92,105,111,133,136,"ATGAAGG","CAGA","TTGATGG","CTGA",2.52782954418528,31,13,22,75,1.13384921956889,4.49651154520102,7.7958904271886,101,"ENSG00000079974.19"
"31224","ENSG00000219491.7_158",150,158,9,"ENSG00000219491.7",0,NA,"UVVVVUVVV",2,7,0.824844720496894,52,58,89,92,105,111,133,136,"ATGAAGG","CAGA","TTGATGG","CTGA",2.52782954418528,31,13,22,75,1.13384921956889,4.49651154520102,7.7958904271886,101,"ENSG00000079974.19"
"34571","ENSG00000233452.9_156567",156559,156567,9,"ENSG00000233452.9",1,8,"VVVVVUVMV",1,7,0.806211180124224,62,68,86,89,110,116,133,136,"ATGATGA","ATGA","ATGACAA","CTGC",2.50226091011448,18,21,17,65,1.60233350718777,4.57101822698774,7.79586294748463,101,"ENSG00000079974.19"
"35604","ENSG00000236451.3_105483",105475,105483,9,"ENSG00000236451.3",1,5,"VVVVMUVVV",1,7,0.808695652173913,93,99,107,110,115,121,133,136,"AGGATCA","CTGA","TTGAGGT","ATGA",2.31853690569287,8,5,12,34,2.78735387808412,4.56106664567581,7.79584925437146,101,"ENSG00000079974.19"
"4178","ENSG00000096872.17_64572",64564,64572,9,"ENSG00000096872.17",1,1,"MVVVVVUVV",1,7,0.792132505175983,110,116,133,136,147,153,161,164,"GTGATGA","CTAA","CTTTTGA","ATGA",2.3897990918645,17,11,8,45,2.57626513899442,4.62706477118943,7.79559479189336,101,"ENSG00000079974.19"
"2455","ENSG00000074966.11_67638",67630,67638,9,"ENSG00000074966.11",1,8,"VVVVVUVMV",1,7,0.806211180124224,108,114,133,136,138,144,154,157,"AGGAAGA","CTAA","GTAATCA","CTGA",2.42216441823785,19,2,10,40,2.13516498906258,4.57073194432873,7.79557666482562,101,"ENSG00000079974.19"
"1861","ENSG00000066697.15_12786",12778,12786,9,"ENSG00000066697.15",1,1,"MVVVUVVVV",1,7,0.795859213250517,79,85,98,101,114,120,133,136,"TTGATGC","CTGA","TTGGAGA","CTGG",2.37566667540865,13,13,13,48,2.61073752318012,4.61212883980944,7.79556569281151,101,"ENSG00000079974.19"
"48479","ENSG00000291153.1_21690",21682,21690,9,"ENSG00000291153.1",1,7,"VVUVVVMVV",1,7,0.768944099378882,109,115,133,136,149,155,170,173,"ATGAGGA","CCAA","TTGTTGA","CTGA",2.50521586358186,18,13,15,55,2.17763458661921,4.71976841929124,7.79554481680677,101,"ENSG00000079974.19"
"2549","ENSG00000075702.19_2531",2523,2531,9,"ENSG00000075702.19",1,2,"VMVVVUVVV",1,7,0.806211180124223,115,121,133,136,144,150,158,161,"ATAATGA","CTCA","TTTGTGA","ATGA",2.28548797760976,12,8,8,37,3.04579407461945,4.57059514800446,7.79543986850135,101,"ENSG00000079974.19"
"19319","ENSG00000162733.19_28192",28184,28192,9,"ENSG00000162733.19",0,NA,"VVVVVUUVV",2,7,0.808281573498965,74,80,97,100,103,109,133,136,"TTGAGGA","CTGG","AAGAGGA","CTGA",2.47186494289219,17,3,24,53,1.76985132305018,4.56223773558287,7.79536402957873,101,"ENSG00000079974.19"
"30607","ENSG00000206052.11_215371",215363,215371,9,"ENSG00000206052.11",1,1,"MVVVVUVVV",1,7,0.82815734989648,113,119,133,136,139,145,155,158,"TTGATGA","CTAC","CTCATGA","CTGC",2.27453959822635,14,3,10,36,2.76731708750663,4.48272860225391,7.79535800183983,101,"ENSG00000079974.19"
"12677","ENSG00000138771.16_203268",203260,203268,9,"ENSG00000138771.16",1,5,"VVVVMUVVV",1,7,0.808695652173913,90,96,133,136,142,148,156,159,"AGGAGGA","ATGA","CTGCTGC","CTGA",2.44106709834727,37,6,8,60,1.96819394324769,4.56049364972404,7.79527625841969,101,"ENSG00000079974.19"
"16599","ENSG00000151835.17_78715",78707,78715,9,"ENSG00000151835.17",1,8,"VVVUVVVMV",1,7,0.764803312629399,64,70,90,93,114,120,133,136,"ATGTTGT","CTGA","CTGGAGA","CTGA",2.59445363014744,20,21,13,63,1.64784539952575,4.7360507334605,7.7952639839781,101,"ENSG00000079974.19"
"17882","ENSG00000155657.29_264249",264241,264249,9,"ENSG00000155657.29",1,2,"VMVVVUVVV",1,7,0.806211180124223,91,97,133,136,142,148,180,183,"ATGATGG","GTAA","ATGAAGA","CTGA",2.58018959668348,36,6,32,83,1.0803157681629,4.57039493651319,7.79523965701009,101,"ENSG00000079974.19"
"32060","ENSG00000225746.13_41550",41542,41550,9,"ENSG00000225746.13",1,6,"VVVVUMVVV",1,7,0.792546583850932,105,111,133,136,143,149,160,163,"ATGGTGA","TGGA","TTAATCA","CTGA",2.42637002275215,22,7,11,49,2.32399225741248,4.62494810227337,7.79513443767709,101,"ENSG00000079974.19"
"41025","ENSG00000258399.8_100051",100043,100051,9,"ENSG00000258399.8",1,6,"VVVVUMVVV",1,7,0.792546583850932,105,111,133,136,143,149,160,163,"ATGGTGA","TGGA","TTAATCA","CTGA",2.42637002275215,22,7,11,49,2.32399225741248,4.62494810227337,7.79513443767709,101,"ENSG00000079974.19"
"34720","ENSG00000233891.8_300433",300425,300433,9,"ENSG00000233891.8",1,8,"VVVVVUVMV",1,7,0.806211180124224,109,115,133,136,147,153,161,164,"AAGATGG","CTTA","GCCATGC","CTGA",2.36929666180231,18,11,8,46,2.48571553760796,4.57025665407251,7.7951013745694,101,"ENSG00000079974.19"
"43496","ENSG00000271955.2_667237",667229,667237,9,"ENSG00000271955.2",1,8,"VVVVVUVMV",1,7,0.806211180124224,109,115,133,136,147,153,161,164,"AAGATGG","CTTA","GCCATGC","CTGA",2.36929666180231,18,11,8,46,2.48571553760796,4.57025665407251,7.7951013745694,101,"ENSG00000079974.19"
"26835","ENSG00000185052.13_227218",227210,227218,9,"ENSG00000185052.13",1,1,"MVVVUVVVV",1,7,0.795859213250517,114,120,133,136,140,146,160,163,"TTGCTGA","GAGA","AGGTTGA","CTGA",2.35629891859116,13,4,14,40,2.73786037673368,4.61162995850202,7.79506681150409,101,"ENSG00000079974.19"
"17950","ENSG00000155893.13_138718",138710,138718,9,"ENSG00000155893.13",1,1,"MVVVUVVVV",1,7,0.795859213250517,47,53,76,79,112,118,133,136,"CTGATGA","CTGA","GTGTTGA","ATGA",2.59906360608769,23,33,15,80,1.11931104943053,4.61160043917045,7.79503729217252,101,"ENSG00000079974.19"
"24652","ENSG00000177311.12_43231",43223,43231,9,"ENSG00000177311.12",1,1,"MVVVUVVVV",1,7,0.795859213250517,47,53,76,79,112,118,133,136,"CTGATGA","CTGA","GTGTTGA","ATGA",2.59906360608769,23,33,15,80,1.11931104943053,4.61160043917045,7.79503729217252,101,"ENSG00000079974.19"
"28239","ENSG00000188559.16_80185",80177,80185,9,"ENSG00000188559.16",1,1,"MVVVVUVVV",1,7,0.82815734989648,113,119,133,136,160,166,177,180,"ATGATGA","CAGC","CTGATTT","TTGA",2.37498531435288,14,24,11,58,2.09634229447488,4.48239443087353,7.79502383045945,101,"ENSG00000079974.19"
"33585","ENSG00000230426.5_455935",455927,455935,9,"ENSG00000230426.5",1,5,"UVVVMUVVV",2,6,0.711387163561077,115,121,133,136,177,183,235,238,"AGGATGA","CTGA","TTGATGA","CTGA",2.81844941492304,12,41,52,114,1.00780095498491,4.94936593028462,7.79491458452893,101,"ENSG00000079974.19"
"3832","ENSG00000089177.19_78265",78257,78265,9,"ENSG00000089177.19",1,8,"VVUVVVVMV",1,7,0.767701863354037,114,120,133,136,138,144,157,160,"GTGCTGA","TGGA","AGGATGA","CTGA",2.45662254282692,13,2,13,37,2.51883054643972,4.72407854132145,7.7948859947376,101,"ENSG00000079974.19"
"11250","ENSG00000134343.14_48862",48854,48862,9,"ENSG00000134343.14",1,2,"UMVVVVVVV",1,7,0.786749482401656,58,64,71,74,88,94,133,136,"ATGATGT","CTGA","GTGAAGA","CTAA",2.59978939630602,7,14,39,69,1.2594436312351,4.64784323498548,7.79484116459211,101,"ENSG00000079974.19"
"40608","ENSG00000257150.4_60404",60396,60404,9,"ENSG00000257150.4",1,8,"VVVVUVVMV",1,7,0.773913043478261,86,92,133,136,142,148,173,176,"GTGATGA","ATTA","ATGACGA","CTGA",2.63082363207161,41,6,25,81,1.25788159269308,4.69917645162595,7.79482862553899,101,"ENSG00000079974.19"
"14541","ENSG00000145349.20_5413",5405,5413,9,"ENSG00000145349.20",1,1,"MVVVVUVVV",1,7,0.82815734989648,98,104,133,136,145,151,166,169,"ATAATGA","TTGC","ATGCTTG","CTGA",2.41537169144607,29,9,15,62,1.82623970420907,4.48217941179572,7.79480881138164,101,"ENSG00000079974.19"
"23991","ENSG00000174720.18_12619",12611,12619,9,"ENSG00000174720.18",1,2,"VMVUVVVVV",1,7,0.764803312629399,114,120,133,136,142,148,183,186,"ATGAAAA","CTGA","TTGACAA","CTGA",2.53648565202464,13,6,35,63,2.03243841564682,4.73558569061944,7.79479894113704,101,"ENSG00000079974.19"
"40988","ENSG00000258234.1_32329",32321,32329,9,"ENSG00000258234.1",1,8,"VVUVVVVMV",1,7,0.767701863354037,51,57,88,91,99,105,133,136,"ATGAGGA","CTAA","GTGATCA","CTGA",2.65537981429728,31,8,28,76,1.1932593776266,4.72394786823545,7.7947553216516,101,"ENSG00000079974.19"
"24958","ENSG00000178878.13_76431",76423,76431,9,"ENSG00000178878.13",1,1,"MVVVUVVVV",1,7,0.795859213250517,115,121,133,136,149,155,187,190,"TTGATAA","GTGA","GTGCTCA","CTGA",2.49906973393973,12,13,32,66,1.78466658524505,4.61128286954414,7.79471972254621,101,"ENSG00000079974.19"
"16382","ENSG00000151422.14_426380",426372,426380,9,"ENSG00000151422.14",1,2,"VMVVVUUVV",2,6,0.692339544513457,116,122,133,136,137,143,152,155,"ATGATGA","CAGT","GAGATCA","CTGA",2.61432206220614,11,1,9,30,2.67246561923797,5.02531984181972,7.79467801987355,101,"ENSG00000079974.19"
"26118","ENSG00000183454.18_150468",150460,150468,9,"ENSG00000183454.18",1,8,"VVUVVVVMV",1,7,0.767701863354037,84,90,108,111,115,121,133,136,"TTGATGA","CTGA","TTCATAA","CTAA",2.46312093753321,18,4,12,43,2.47456081719267,4.72384176685352,7.79464922026966,101,"ENSG00000079974.19"
"4463","ENSG00000100629.17_162703",162695,162703,9,"ENSG00000100629.17",0,NA,"UVVVVUVVV",2,7,0.824844720496894,99,105,133,136,164,170,184,187,"AAGATGC","ATGA","ATGATGG","CTGA",2.54374196578705,28,28,14,79,1.02273385261645,4.49525340613252,7.7946322881201,101,"ENSG00000079974.19"
"20709","ENSG00000165406.16_94283",94275,94283,9,"ENSG00000165406.16",1,2,"VMVVVUVVV",1,7,0.806211180124223,107,113,133,136,185,191,200,203,"ATGATGC","TTCA","ATGAAAA","CTGA",2.51831701598128,20,49,9,87,1.49007847566288,4.56971464555118,7.79455936604807,101,"ENSG00000079974.19"
"17994","ENSG00000155974.14_387093",387085,387093,9,"ENSG00000155974.14",0,NA,"VVVVUVUVV",2,7,0.775983436853002,109,115,133,136,175,181,194,197,"ATGATTA","ATGG","TTGATGA","CTGA",2.57515261573068,18,39,13,79,1.59453347300438,4.6905543944689,7.79448814188091,101,"ENSG00000079974.19"
"44057","ENSG00000277215.2_387448",387440,387448,9,"ENSG00000277215.2",1,2,"VMVVVUVVV",1,7,0.806211180124223,111,117,133,136,151,157,175,178,"TTGATTG","ATGA","ATGATTA","CTGA",2.43761808873427,16,15,18,58,2.02776239781024,4.56963741400968,7.79448213450657,101,"ENSG00000079974.19"
"47791","ENSG00000289342.2_37552",37544,37552,9,"ENSG00000289342.2",1,1,"MVVVVVUVV",1,7,0.792132505175983,111,117,133,136,144,150,162,165,"AAGATCA","AAGA","ATGTAGA","CTGA",2.35725637664917,16,8,12,45,2.7886146674117,4.62591429460154,7.79444431530547,101,"ENSG00000079974.19"
"19937","ENSG00000164035.10_431182",431174,431182,9,"ENSG00000164035.10",1,1,"MVVVVVUVV",1,7,0.792132505175983,115,121,133,136,146,152,173,176,"GGAATGA","CTGT","TTGGTGA","CTGA",2.4216934564328,12,10,21,52,2.35895395165083,4.62589424863404,7.79442426933798,101,"ENSG00000079974.19"
"43046","ENSG00000267732.2_1111",1103,1111,9,"ENSG00000267732.2",1,7,"VVUVVVMVV",1,7,0.768944099378882,88,94,103,106,112,118,133,136,"GTGGTGG","TTGA","GAGAAGA","CTGA",2.42888572081008,9,6,15,39,2.68196591304732,4.71863434627863,7.79441074379416,101,"ENSG00000079974.19"
"21492","ENSG00000168016.15_93291",93283,93291,9,"ENSG00000168016.15",1,8,"VVUVVVVMV",1,7,0.767701863354037,115,121,133,136,142,148,169,172,"TTTATGA","TAGA","ATGATGT","CTGA",2.46722918620309,12,6,21,48,2.44610458047867,4.72357478879148,7.79438224220763,101,"ENSG00000079974.19"
"8952","ENSG00000121898.13_106681",106673,106681,9,"ENSG00000121898.13",0,NA,"VVVVVUUVV",2,7,0.808281573498965,109,115,133,136,142,148,171,174,"TTGCTGA","ATGA","GTCTGGA","CTGA",2.43539007561176,18,6,23,56,2.00885673171291,4.56119764228116,7.79432393627702,101,"ENSG00000079974.19"
"26481","ENSG00000184305.16_1379764",1379756,1379764,9,"ENSG00000184305.16",1,2,"VMVVVUVVV",1,7,0.806211180124223,114,120,133,136,141,147,164,167,"TATATGA","ATGA","ATGGTAA","CTGA",2.34661168006731,13,5,17,44,2.6333919465228,4.56936745340955,7.79421217390645,101,"ENSG00000079974.19"
"31700","ENSG00000224479.6_6672",6664,6672,9,"ENSG00000224479.6",1,3,"UVMVVVVVV",1,7,0.785507246376811,99,105,133,136,182,188,206,209,"ATAATGA","CTGA","AGGATTA","CTGA",2.6838697929581,28,46,18,101,0.716227794077372,4.65217327011617,7.79420225562342,101,"ENSG00000079974.19"
"46879","ENSG00000287299.1_39100",39092,39100,9,"ENSG00000287299.1",1,1,"MVVVVUVVV",1,7,0.82815734989648,116,122,133,136,161,167,184,187,"ATTTTGA","CTGG","TTGCAGA","CTGA",2.41949173340889,11,25,17,62,1.79629682163667,4.48156042775732,7.79418982734324,101,"ENSG00000079974.19"
"26225","ENSG00000183715.14_133009",133001,133009,9,"ENSG00000183715.14",1,8,"VVUVVVVMV",1,7,0.767701863354037,85,91,102,105,111,117,133,136,"ATGAGGT","CTGC","GAGAGGG","CTGA",2.4237859978156,11,6,16,42,2.73454992187137,4.72328081016052,7.79408826357666,101,"ENSG00000079974.19"
"24420","ENSG00000176204.14_741011",741003,741011,9,"ENSG00000176204.14",1,6,"VVVVUMVVV",1,7,0.792546583850932,94,100,133,136,139,145,155,158,"GTTATGA","GTGA","TTGGTGG","CTGA",2.51665303707349,33,3,10,55,1.71779226651276,4.623869795084,7.79405613048773,101,"ENSG00000079974.19"
"44724","ENSG00000283445.1_50955",50947,50955,9,"ENSG00000283445.1",1,1,"MVVVUVVVV",1,7,0.795859213250517,76,82,94,97,106,112,133,136,"AGGAAGT","CTGA","GGGAAAA","CTGA",2.40461296467604,12,9,21,51,2.41151398869837,4.61056677163466,7.79400362463673,101,"ENSG00000079974.19"
"37734","ENSG00000248740.8_118614",118606,118614,9,"ENSG00000248740.8",1,2,"VMUVVVVVV",1,7,0.767701863354037,99,105,133,136,151,157,165,168,"ATGTTGA","TTGA","GAGATGG","CTGA",2.59208470181296,28,15,8,60,1.61192941928892,4.7231235245105,7.79393097792665,101,"ENSG00000079974.19"
"22744","ENSG00000171310.11_283410",283402,283410,9,"ENSG00000171310.11",1,8,"VVVVVUVMV",1,7,0.806211180124224,103,109,133,136,152,158,169,172,"GTGAGGA","CGGA","GTGCTAG","CTGA",2.48759116074159,24,16,11,60,1.69240345212962,4.56908613093505,7.79393085143194,101,"ENSG00000079974.19"
"26250","ENSG00000183722.9_104168",104160,104168,9,"ENSG00000183722.9",1,6,"UVVVVMVVV",1,7,0.805383022774327,60,66,80,83,114,120,133,136,"ATGGTGA","CTGA","ATGATCC","ATGA",2.45461259853462,14,31,13,67,1.92546831714984,4.57238807684515,7.79392016794246,101,"ENSG00000079974.19"
"12420","ENSG00000138138.14_83662",83654,83662,9,"ENSG00000138138.14",1,5,"UVVVMVVVV",1,7,0.789233954451346,115,121,133,136,176,182,193,196,"ATGTTGC","ATGA","GTGTTCA","CTGA",2.48319192430237,12,40,11,72,1.99330434252316,4.63697929280141,7.79391511060679,101,"ENSG00000079974.19"
"16417","ENSG00000151474.23_40255",40247,40255,9,"ENSG00000151474.23",1,8,"VVVVVVUMV",1,7,0.770186335403727,115,121,133,136,148,154,167,170,"TTGATGT","TTTA","CTGAAAA","CTGA",2.42437447096044,12,12,13,46,2.68924888045263,4.71293633838056,7.79368167999547,101,"ENSG00000079974.19"
"40237","ENSG00000255300.6_37226",37218,37226,9,"ENSG00000255300.6",1,7,"VVVVUVMVV",1,7,0.775155279503105,36,42,59,62,90,96,133,136,"ATGATGA","CTGA","ATGAGGA","CAGA",2.68608228764479,17,28,37,91,0.865002408120293,4.69305441477139,7.79367553278381,101,"ENSG00000079974.19"
"12361","ENSG00000137960.6_91577",91569,91577,9,"ENSG00000137960.6",1,7,"VVUVVVMVV",1,7,0.768944099378882,115,121,133,136,146,152,164,167,"AAGATGA","CTGT","ATGATGC","CTAA",2.40039886296218,12,10,12,43,2.86881199349382,4.71786776997708,7.79364416749261,101,"ENSG00000079974.19"
"43396","ENSG00000271850.2_110754",110746,110754,9,"ENSG00000271850.2",1,1,"MVVVVVUVV",1,7,0.792132505175983,89,95,106,109,114,120,133,136,"TTGAGGA","ATGC","TAGAGGA","CTGA",2.34228626769008,11,5,13,38,2.88521413468769,4.62511397982206,7.793644000526,101,"ENSG00000079974.19"
"20032","ENSG00000164175.15_22405",22397,22405,9,"ENSG00000164175.15",1,6,"VVVVVMUVV",1,7,0.788819875776397,112,118,133,136,146,152,161,164,"GTACTGA","CTGT","TTGGGGA","CTGA",2.36014295480203,15,10,9,43,2.81870118800301,4.63824688833746,7.79352639144305,101,"ENSG00000079974.19"
"19785","ENSG00000163689.21_20892",20884,20892,9,"ENSG00000163689.21",1,5,"VVUVMVVVV",1,7,0.770186335403727,60,66,75,78,89,95,133,136,"ATGAAGA","CTGT","TTGATAT","CTGA",2.57241902100584,9,11,38,67,1.70156460344823,4.7127561858718,7.7935015274867,101,"ENSG00000079974.19"
"37188","ENSG00000245832.7_453264",453256,453264,9,"ENSG00000245832.7",1,2,"VMVVVUVVV",1,7,0.806211180124223,83,89,107,110,115,121,133,136,"ATTAGGA","GTGA","ATTTTTA","CTGA",2.35649775564527,18,5,12,44,2.56456802442776,4.56863826551572,7.79348298601262,101,"ENSG00000079974.19"
"46341","ENSG00000286481.2_755743",755735,755743,9,"ENSG00000286481.2",1,8,"UVVVVVVMV",1,7,0.786749482401656,39,45,53,56,90,96,133,136,"ATGATTA","CAGA","ATGATGT","CTGA",2.66904373385131,8,34,37,88,0.791854851033249,4.64636993584382,7.79336786545045,101,"ENSG00000079974.19"
"2217","ENSG00000071794.16_22888",22880,22888,9,"ENSG00000071794.16",1,8,"UVVVVVVMV",1,7,0.786749482401656,103,109,133,136,156,162,174,177,"ATGAGGA","GAGA","ATGAAGA","CTGA",2.56970895883606,24,20,12,65,1.45407682588467,4.64636747119794,7.79336540080457,101,"ENSG00000079974.19"
"6279","ENSG00000109182.12_33063",33055,33063,9,"ENSG00000109182.12",1,8,"UVVVVVVMV",1,7,0.786749482401656,116,122,133,136,145,151,174,177,"AAGTTGA","GTGA","ATGTTGG","CTGA",2.44516320081874,11,9,23,52,2.2843601990788,4.64636205113427,7.7933599807409,101,"ENSG00000079974.19"
"26246","ENSG00000183715.14_838368",838360,838368,9,"ENSG00000183715.14",1,8,"VVVVVUVMV",1,7,0.806211180124224,22,28,45,48,90,96,133,136,"CTGATGA","CTTA","TTGATTT","CTGA",2.62158338527596,17,42,37,105,0.796575369239261,4.56844948443641,7.79329420493331,101,"ENSG00000079974.19"
"12598","ENSG00000138670.19_78256",78248,78256,9,"ENSG00000138670.19",1,2,"VMVVVVUVV",1,7,0.770186335403727,50,56,99,102,105,111,133,136,"GTTATGA","CTGA","GTGCTTA","CTGA",2.66118494773885,43,3,22,77,1.1089614708807,4.71254861395159,7.79329395556649,101,"ENSG00000079974.19"
"9351","ENSG00000124205.18_8389",8381,8389,9,"ENSG00000124205.18",0,NA,"UVVVVUVVV",2,7,0.824844720496894,116,122,133,136,145,151,172,175,"CTGGTGA","CTTG","CTGCTGG","CTGA",2.33834648806058,11,9,21,50,2.38645074574305,4.4938568332034,7.79323571519097,101,"ENSG00000079974.19"
"35927","ENSG00000237484.7_71620",71612,71620,9,"ENSG00000237484.7",1,8,"UVVVVVVMV",1,7,0.786749482401656,96,102,133,136,165,171,184,187,"TTGATTA","CTGA","GTGAATA","CTGA",2.63586141496119,31,29,13,82,1.01252395248513,4.64623334638993,7.79323127599655,101,"ENSG00000079974.19"
"19804","ENSG00000163714.18_16381",16373,16381,9,"ENSG00000163714.18",0,NA,"VVVVVUUVV",2,7,0.808281573498965,72,78,89,92,99,105,133,136,"AACATGA","TTGA","ATGTAGG","CTGA",2.41363473852928,11,7,28,55,2.14934927732014,4.5600618835455,7.79318817754136,101,"ENSG00000079974.19"
"36516","ENSG00000241570.8_20228",20220,20228,9,"ENSG00000241570.8",0,NA,"VVVVVUUVV",2,7,0.808281573498965,72,78,89,92,99,105,133,136,"AACATGA","TTGA","ATGTAGG","CTGA",2.41363473852928,11,7,28,55,2.14934927732014,4.5600618835455,7.79318817754136,101,"ENSG00000079974.19"
"8406","ENSG00000118689.15_43968",43960,43968,9,"ENSG00000118689.15",0,NA,"VVUVVUVVV",2,7,0.805797101449275,70,76,92,95,114,120,133,136,"ATCCTGG","CTGA","TTGAGGG","CTGA",2.43002739419024,16,19,13,57,2.07975136178488,4.56998349742995,7.79317190322705,101,"ENSG00000079974.19"
"10798","ENSG00000132874.15_128077",128069,128077,9,"ENSG00000132874.15",1,1,"MVVVVUVVV",1,7,0.82815734989648,114,120,133,136,147,153,162,165,"AGGGTGG","TTGA","TGCATGA","CTGA",2.26128495358202,13,11,9,42,2.84675428393587,4.480496826954,7.79312622653992,101,"ENSG00000079974.19"
"43959","ENSG00000276023.5_5170",5162,5170,9,"ENSG00000276023.5",0,NA,"UVVVUVVVV",2,7,0.792546583850932,116,122,133,136,139,145,155,158,"AGGAGGA","GTTA","ATGAGAA","CTGA",2.34110631544296,11,3,10,33,2.88390446837489,4.62281997616533,7.79300631156906,101,"ENSG00000079974.19"
"39299","ENSG00000253438.5_496579",496571,496579,9,"ENSG00000253438.5",1,5,"VVVVMUVVV",1,7,0.808695652173913,114,120,133,136,148,154,165,168,"GTTATCC","CTCA","ATGAAGA","CTGA",2.32194335910528,13,12,11,45,2.75327200458812,4.55822359965583,7.79300620835148,101,"ENSG00000079974.19"
"20334","ENSG00000164675.11_69355",69347,69355,9,"ENSG00000164675.11",1,6,"UVVVVMVVV",1,7,0.805383022774327,85,91,133,136,154,160,170,173,"CTGATGC","CGGA","TTAATGA","CTGA",2.5368270917149,42,18,10,79,1.37344927683097,4.57140747206591,7.79293956316322,101,"ENSG00000079974.19"
"29395","ENSG00000197934.8_59584",59576,59584,9,"ENSG00000197934.8",1,3,"UVMVVVVVV",1,7,0.785507246376811,114,120,133,136,146,152,169,172,"ATAATAA","CTGG","ATCCTGA","CTGA",2.40162769346917,13,10,17,49,2.59264543972174,4.65087418237904,7.79290316788629,101,"ENSG00000079974.19"
"34326","ENSG00000232692.1_74667",74659,74667,9,"ENSG00000232692.1",1,3,"UVMVVVVVV",1,7,0.785507246376811,114,120,133,136,146,152,169,172,"ATAATAA","CTGG","ATCCTGA","CTGA",2.40162769346917,13,10,17,49,2.59264543972174,4.65087418237904,7.79290316788629,101,"ENSG00000079974.19"
"6216","ENSG00000108684.15_339615",339607,339615,9,"ENSG00000108684.15",1,6,"UVVVVMVVV",1,7,0.805383022774327,39,45,66,69,75,81,133,136,"GTGAAGA","TTGA","TTGAGCA","CTGA",2.53352723600205,21,6,52,88,1.39515613483308,4.57133442704503,7.79286651814233,101,"ENSG00000079974.19"
"44214","ENSG00000279668.4_243751",243743,243751,9,"ENSG00000279668.4",1,6,"UVVVVMVVV",1,7,0.805383022774327,39,45,66,69,75,81,133,136,"GTGAAGA","TTGA","TTGAGCA","CTGA",2.53352723600205,21,6,52,88,1.39515613483308,4.57133442704503,7.79286651814233,101,"ENSG00000079974.19"
"46487","ENSG00000286746.1_102972",102964,102972,9,"ENSG00000286746.1",1,6,"VVVVUMVVV",1,7,0.792546583850932,95,101,133,136,140,146,158,161,"ATGCTGA","GAGA","ATGAAAA","CTGA",2.50071297140544,32,4,12,57,1.81919954849881,4.62265483946711,7.79284117487084,101,"ENSG00000079974.19"
"35788","ENSG00000237121.1_40222",40214,40222,9,"ENSG00000237121.1",1,8,"VVVVUVVMV",1,7,0.773913043478261,114,120,133,136,143,149,157,160,"GTGTTGT","CGGC","CTGAAGA","CTGA",2.36009739211114,13,7,8,37,3.05461656648853,4.6971497951407,7.79280196905374,101,"ENSG00000079974.19"
"35982","ENSG00000237568.1_1048",1040,1048,9,"ENSG00000237568.1",1,3,"VVMUVVVVV",1,7,0.763561076604555,114,120,133,136,143,149,181,184,"ATAATGC","ATGA","CTGATAA","CTGA",2.53023411469319,13,7,32,61,2.08595446593717,4.73854547430627,7.79278978072449,101,"ENSG00000079974.19"
"44188","ENSG00000279249.4_57683",57675,57683,9,"ENSG00000279249.4",0,NA,"VVVVVUUVV",2,7,0.808281573498965,115,121,133,136,141,147,158,161,"ATGAGGG","ATCA","AAGAAGG","CTGA",2.28634022246809,12,5,11,37,2.99624312688554,4.55962781916821,7.79275411316407,101,"ENSG00000079974.19"
"38856","ENSG00000251173.1_6291",6283,6291,9,"ENSG00000251173.1",1,1,"MVVVVUVVV",1,7,0.82815734989648,115,121,133,136,146,152,162,165,"ATGATGT","CTTC","GGGATGG","TTGA",2.24966401334663,12,10,10,41,2.92251211305717,4.48006805050868,7.7926974500946,101,"ENSG00000079974.19"
"39543","ENSG00000253773.5_296933",296925,296933,9,"ENSG00000253773.5",1,2,"VMVVVVUVV",1,7,0.770186335403727,113,119,133,136,141,147,160,163,"TTTATGC","CTGA","AAGACAA","CTGA",2.40130819775315,14,5,13,41,2.83865348206628,4.71184370010516,7.79258904172006,101,"ENSG00000079974.19"
"6559","ENSG00000110696.10_131628",131620,131628,9,"ENSG00000110696.10",1,1,"MVVVUVVVV",1,7,0.795859213250517,68,74,90,93,116,122,133,136,"ATGGTGT","CTGT","ATGCTAA","CTGA",2.4659777504304,16,23,11,59,1.99674171711833,4.60914834666358,7.79258519966565,101,"ENSG00000079974.19"
"47549","ENSG00000288692.1_108184",108176,108184,9,"ENSG00000288692.1",0,NA,"UVUVVVVVV",2,7,0.786335403726708,107,113,133,136,148,154,166,169,"GTCATGA","TTGC","ATAATGA","CTGA",2.45617031911396,20,12,12,53,2.21443480688653,4.64722590024491,7.79256751515174,101,"ENSG00000079974.19"
"12962","ENSG00000139722.7_27060",27052,27060,9,"ENSG00000139722.7",1,8,"VVVVUVVMV",1,7,0.773913043478261,114,120,133,136,141,147,155,158,"GTGCTGA","AGGA","ATGACCT","CTGA",2.36227741547178,13,5,8,35,3.03887925885067,4.69684884049896,7.792501014412,101,"ENSG00000079974.19"
"9879","ENSG00000127955.17_444499",444491,444499,9,"ENSG00000127955.17",1,8,"UVVVVVVMV",1,7,0.786749482401656,114,120,133,136,140,146,179,182,"AAGTTGA","GTGA","ATGATTA","CTGA",2.50090644406199,13,4,33,59,1.90927847264344,4.64549702493084,7.79249495453746,101,"ENSG00000079974.19"
"5926","ENSG00000107249.24_53758",53750,53758,9,"ENSG00000107249.24",0,NA,"UVVVVUVVV",2,7,0.824844720496894,113,119,133,136,137,143,192,195,"GTAATGT","ATGA","ATGTTGA","CTGA",2.5019714880934,14,1,49,73,1.29263946331832,4.49311234598525,7.79249122797283,101,"ENSG00000079974.19"
"27563","ENSG00000186487.21_333463",333455,333463,9,"ENSG00000186487.21",1,8,"VVVVUVVMV",1,7,0.773913043478261,71,77,92,95,116,122,133,136,"CTGTTGA","CAGA","CTGGAGA","CTGA",2.49803061372695,15,21,11,56,2.13363582382532,4.69679331216791,7.79244548608095,101,"ENSG00000079974.19"
"43276","ENSG00000270725.1_5547",5539,5547,9,"ENSG00000270725.1",1,7,"VVUVVVMVV",1,7,0.768944099378882,90,96,104,107,115,121,133,136,"ATAATGG","ATGA","AAGAAAA","CTGA",2.41679200727172,8,8,12,37,2.75467092831852,4.71665441086583,7.79243080838136,101,"ENSG00000079974.19"
"29716","ENSG00000198626.18_519389",519381,519389,9,"ENSG00000198626.18",1,1,"MVVVVUVVV",1,7,0.82815734989648,113,119,133,136,141,147,155,158,"GTGATTA","TTGA","GGGTAGA","CTTA",2.24112908121858,14,5,8,36,2.97807621886246,4.47973419007991,7.79236358966583,101,"ENSG00000079974.19"
"8041","ENSG00000116667.15_20811",20803,20811,9,"ENSG00000116667.15",1,2,"VMVUVVVVV",1,7,0.764803312629399,116,122,133,136,145,151,164,167,"ATGAAGT","CTAA","GTTATAT","CTGA",2.41058089575983,11,9,13,42,2.8619218755468,4.73311529515309,7.79232854567069,101,"ENSG00000079974.19"
"31244","ENSG00000220586.2_48211",48203,48211,9,"ENSG00000220586.2",1,8,"VVVVVVUMV",1,7,0.770186335403727,79,85,96,99,116,122,133,136,"TTTATCA","CTGA","TTCATGA","CTGA",2.46836853172862,11,17,11,48,2.39054136316769,4.71158289367296,7.79232823528787,101,"ENSG00000079974.19"
"31416","ENSG00000223720.2_1695",1687,1695,9,"ENSG00000223720.2",1,1,"MVVVVUVVV",1,7,0.82815734989648,98,104,133,136,145,151,161,164,"ATGATGA","GGGA","GAGAAGA","CGGA",2.38641701469259,29,9,10,57,2.00912920506089,4.47964399241955,7.79227339200547,101,"ENSG00000079974.19"
"10323","ENSG00000130540.14_5366",5358,5366,9,"ENSG00000130540.14",1,7,"VVVVUVMVV",1,7,0.775155279503105,113,119,133,136,145,151,195,198,"CTGATGA","TTCA","GTTATGT","CTGA",2.52641427608542,14,9,44,76,1.92355158293129,4.69157835587519,7.79219947388761,101,"ENSG00000079974.19"
"46829","ENSG00000287249.1_85001",84993,85001,9,"ENSG00000287249.1",1,1,"MVVVVUVVV",1,7,0.82815734989648,106,112,133,136,154,160,185,188,"ATCATGA","GTCA","ATGATAA","CTGA",2.52937970551139,21,18,25,73,1.05564194712811,4.47954332930101,7.79217272888693,101,"ENSG00000079974.19"
"48000","ENSG00000289956.1_61435",61427,61435,9,"ENSG00000289956.1",1,1,"MVVVVUVVV",1,7,0.82815734989648,106,112,133,136,154,160,185,188,"ATCATGA","GTCA","ATGATAA","CTGA",2.52937970551139,21,18,25,73,1.05564194712811,4.47954332930101,7.79217272888693,101,"ENSG00000079974.19"
"25325","ENSG00000180817.12_22461",22453,22461,9,"ENSG00000180817.12",1,2,"VMVVVUVVV",1,7,0.806211180124223,114,120,133,136,144,150,170,173,"GAGAGGA","CTAA","CTGATAG","CTGA",2.36541237023007,13,8,20,50,2.49942558983265,4.56721034784161,7.7920550683385,101,"ENSG00000079974.19"
"21507","ENSG00000168078.10_14464",14456,14464,9,"ENSG00000168078.10",1,3,"UVMVVVVVV",1,7,0.785507246376811,109,115,133,136,172,178,194,197,"ATGATGA","CTTG","TTCAGGA","CTGA",2.57382327571627,18,36,16,79,1.44127602079421,4.65002446472566,7.79205345023291,101,"ENSG00000079974.19"
"6208","ENSG00000108684.15_1017734",1017726,1017734,9,"ENSG00000108684.15",1,7,"VVVVUVMVV",1,7,0.775155279503105,31,37,79,82,94,100,133,136,"GTGATGA","CTTA","TTTATGA","CTGA",2.68840828180269,42,12,33,96,0.842549828704196,4.6913179268472,7.79193904485962,101,"ENSG00000079974.19"
"47571","ENSG00000288700.2_111376",111368,111376,9,"ENSG00000288700.2",1,8,"VVVVVUVMV",1,7,0.806211180124224,106,112,133,136,146,152,166,169,"GTGATGG","GTGT","GTGGGGG","CTGA",2.41332217490399,21,10,14,54,2.17945409868633,4.56706714951157,7.79191187000846,101,"ENSG00000079974.19"
"7059","ENSG00000112624.13_71449",71441,71449,9,"ENSG00000112624.13",1,8,"VVVVVVUMV",1,7,0.770186335403727,45,51,65,68,76,82,133,136,"CTGATTA","CTGG","CTGATAA","CTGA",2.53380376730235,14,8,51,82,1.95246843525191,4.71112338765023,7.79186872926513,101,"ENSG00000079974.19"
"14125","ENSG00000144451.20_738919",738911,738919,9,"ENSG00000144451.20",1,2,"UMVVVVVVV",1,7,0.786749482401656,79,85,101,104,110,116,133,136,"AAGATGG","CAGA","ATTAACA","CTGA",2.4087473687671,16,6,17,48,2.52115635066347,4.64486803561103,7.79186596521765,101,"ENSG00000079974.19"
"22914","ENSG00000171723.16_529066",529058,529066,9,"ENSG00000171723.16",1,2,"VMVVVUVVV",1,7,0.806211180124223,91,97,105,108,113,119,133,136,"ATTATCT","CAGA","ATGATCT","CTGA",2.34473431063133,8,5,14,36,2.63650733954115,4.56701735260417,7.79186207310107,101,"ENSG00000079974.19"
"4457","ENSG00000100626.17_67738",67730,67738,9,"ENSG00000100626.17",1,8,"VVVVVUVMV",1,7,0.806211180124224,97,103,133,136,144,150,166,169,"GAGATGA","TTGA","AGGCAGA","CTGA",2.4718774930163,30,8,16,63,1.7887041368164,4.56697185589794,7.79181657639483,101,"ENSG00000079974.19"
"15839","ENSG00000149972.12_1043178",1043170,1043178,9,"ENSG00000149972.12",0,NA,"VVVVUUVVV",2,7,0.812008281573499,55,61,74,77,113,119,133,136,"ATGATGA","CTGT","ATGAATT","CTGT",2.44376084246234,13,36,14,72,1.8833453279639,4.54377106942821,7.79180419572221,101,"ENSG00000079974.19"
"33969","ENSG00000231672.8_380436",380428,380436,9,"ENSG00000231672.8",1,5,"VVVVMVUVV",1,7,0.772670807453416,107,113,133,136,150,156,169,172,"GTGAGGA","CTCA","GGGATGG","CTGA",2.51581954165692,20,14,13,56,2.03229088046231,4.70110528954378,7.79178851935744,101,"ENSG00000079974.19"
"44116","ENSG00000278341.1_487",479,487,9,"ENSG00000278341.1",0,NA,"VVUVVUVVV",2,7,0.805797101449275,79,85,109,112,115,121,133,136,"AAGATGA","CTGA","TTGTGGA","TTGA",2.45929246065427,24,3,12,48,1.87878947017835,4.56851813530171,7.79170654109881,101,"ENSG00000079974.19"
"34986","ENSG00000234634.2_4026",4018,4026,9,"ENSG00000234634.2",0,NA,"VVVUUVVVV",2,7,0.770600414078675,109,115,133,136,144,150,166,169,"GTGATGG","GAGA","CTGCAGA","CTGA",2.46378326647115,18,8,16,51,2.41198921695561,4.70930274835749,7.79170440467219,101,"ENSG00000079974.19"
"21356","ENSG00000167281.20_54144",54136,54144,9,"ENSG00000167281.20",0,NA,"VVVVVUUVV",2,7,0.808281573498965,68,74,88,91,111,117,133,136,"ATGACTA","CTCA","ATGGAGA","CTGA",2.43503916486163,14,20,16,59,2.00041452002124,4.55850223810803,7.79162853210389,101,"ENSG00000079974.19"
"39367","ENSG00000253524.1_20649",20641,20649,9,"ENSG00000253524.1",1,3,"VVMVVUVVV",1,7,0.804968944099379,102,108,133,136,151,157,168,171,"AAGATGA","AAGA","GTCATAA","CTGA",2.48633153066698,25,15,11,60,1.71133504988552,4.57171964691635,7.79159542331386,101,"ENSG00000079974.19"
"30374","ENSG00000204764.14_19070",19062,19070,9,"ENSG00000204764.14",0,NA,"VVVVUUVVV",2,7,0.812008281573499,44,50,92,95,102,108,133,136,"GTCATGA","CTCA","TTTATGA","CTGA",2.53496179832785,42,7,25,83,1.27376821953928,4.54337838543123,7.79141151172523,101,"ENSG00000079974.19"
"27407","ENSG00000186094.18_687249",687241,687249,9,"ENSG00000186094.18",1,6,"UVVVVMVVV",1,7,0.805383022774327,92,98,133,136,161,167,176,179,"AAGATGA","TAGA","GTGATCA","CTGA",2.57223071207618,35,25,9,78,1.13118376735877,4.56984712863332,7.79137921973063,101,"ENSG00000079974.19"
"21652","ENSG00000168675.19_284977",284969,284977,9,"ENSG00000168675.19",1,6,"VVUVVMVVV",1,7,0.786335403726708,114,120,133,136,149,155,163,166,"ATGAAGT","CTAA","ATTTTAA","CTGA",2.38524305792199,13,13,8,43,2.68231038213909,4.64598269207143,7.79132430697826,101,"ENSG00000079974.19"
"5534","ENSG00000105738.11_5739",5731,5739,9,"ENSG00000105738.11",1,3,"VVMUVVVVV",1,7,0.763561076604555,63,69,82,85,91,97,133,136,"GTGAGGG","CTGA","GGGAGGA","CTGA",2.5386850550268,13,6,36,64,2.02351231708423,4.73701983764906,7.79126414406727,101,"ENSG00000079974.19"
"17723","ENSG00000154975.14_252270",252262,252270,9,"ENSG00000154975.14",0,NA,"VVVVVUUVV",2,7,0.808281573498965,66,72,88,91,109,115,133,136,"AGGAAGA","GTGA","CTGAAGC","CTGA",2.45786043183593,16,18,18,61,1.84669814928255,4.55810859038052,7.79123488437638,101,"ENSG00000079974.19"
"27237","ENSG00000185774.16_1183830",1183822,1183830,9,"ENSG00000185774.16",1,7,"UVVVVVMVV",1,7,0.787991718426501,112,118,133,136,186,192,209,212,"TTGATGA","ATGG","GTGATTG","CTGA",2.54235498703282,15,50,17,91,1.60797339481546,4.63925166042524,7.79121853413124,101,"ENSG00000079974.19"
"28752","ENSG00000196437.12_6715",6707,6715,9,"ENSG00000196437.12",1,8,"VVVVUVVMV",1,7,0.773913043478261,112,118,133,136,147,153,170,173,"ATGAGGA","TGGA","ATGAAAT","CTGA",2.450885915674,15,11,17,52,2.44247399365069,4.69542835786934,7.79108053178239,101,"ENSG00000079974.19"
"35021","ENSG00000234717.2_32691",32683,32691,9,"ENSG00000234717.2",1,2,"VMVVVVUVV",1,7,0.770186335403727,112,118,133,136,145,151,161,164,"ATGCTTA","CTGT","TTGCTTA","CTGA",2.39532952854938,15,9,10,43,2.87242091295343,4.71032110915399,7.7910664507689,101,"ENSG00000079974.19"
"35912","ENSG00000237463.7_100942",100934,100942,9,"ENSG00000237463.7",1,8,"VVVVVUVMV",1,7,0.806211180124224,106,112,133,136,141,147,161,164,"ATGCTCA","ATGA","TTTAAGA","CTGA",2.4076546500839,21,5,14,49,2.2138187781879,4.56621244468682,7.79105716518371,101,"ENSG00000079974.19"
"4539","ENSG00000100991.12_15203",15195,15203,9,"ENSG00000100991.12",1,8,"VVVUVVVMV",1,7,0.764803312629399,103,109,133,136,173,179,188,191,"TTGATGA","CGGA","GTGTTTA","CTGA",2.65454283586413,24,37,9,79,1.23011646708167,4.73176717654397,7.79098042706157,101,"ENSG00000079974.19"
"31606","ENSG00000224184.7_756166",756158,756166,9,"ENSG00000224184.7",1,8,"VVVVVUVMV",1,7,0.806211180124224,109,115,133,136,150,156,168,171,"ATGGTGG","CAGA","GTTCTGG","CTGA",2.40252913792157,18,14,12,53,2.24737198526487,4.5660582261855,7.7909029466824,101,"ENSG00000079974.19"
"37138","ENSG00000245573.9_49376",49368,49376,9,"ENSG00000245573.9",1,1,"MVVVUVVVV",1,7,0.795859213250517,75,81,93,96,110,116,133,136,"ATGATGG","GTGA","GTGAGAA","TTGA",2.41633571592761,12,14,17,52,2.32085406700248,4.60743970996331,7.79087656296538,101,"ENSG00000079974.19"
"21686","ENSG00000168702.18_358149",358141,358149,9,"ENSG00000168702.18",1,1,"MVVVVUVVV",1,7,0.82815734989648,116,122,133,136,146,152,160,163,"CTGACGG","CTGA","TTGAAGT","CTAA",2.24999759453601,11,10,8,38,2.91299138763703,4.47824383780261,7.79087323738853,101,"ENSG00000079974.19"
"5987","ENSG00000107611.16_230522",230514,230522,9,"ENSG00000107611.16",1,2,"UMVVVVVVV",1,7,0.786749482401656,113,119,133,136,175,181,204,207,"ATGATCA","ATGA","GTCTTGA","CTGA",2.58656654760245,14,39,23,85,1.33167219672857,4.64386229518623,7.79086022479286,101,"ENSG00000079974.19"
"45453","ENSG00000285592.1_65020",65012,65020,9,"ENSG00000285592.1",1,7,"VVVVVUMVV",1,7,0.807453416149068,105,111,133,136,143,149,159,162,"ATCATGC","GTTA","GTGAGGT","CTGA",2.38578191244081,22,7,10,48,2.33883305100123,4.56101145015166,7.79082511474793,101,"ENSG00000079974.19"
"4058","ENSG00000092847.14_58247",58239,58247,9,"ENSG00000092847.14",0,NA,"UVVVVUVVV",2,7,0.824844720496894,89,95,133,136,173,179,188,191,"GTGATGT","CTAA","GTGAACT","CTGA",2.54258679898133,38,37,9,93,1.01512803365108,4.49142667338166,7.79080555536923,101,"ENSG00000079974.19"
"35035","ENSG00000234767.2_7539",7531,7539,9,"ENSG00000234767.2",1,8,"VVUVVVVMV",1,7,0.767701863354037,89,95,105,108,113,119,133,136,"ATGAAGA","AGGA","AAGAAGG","CTGA",2.41467327463369,10,5,14,38,2.78195025170839,4.71994302064991,7.79075047406606,101,"ENSG00000079974.19"
"1127","ENSG00000048052.24_251067",251059,251067,9,"ENSG00000048052.24",1,6,"VVVUVMVVV",1,7,0.78343685300207,88,94,105,108,116,122,133,136,"ATAATGA","GTGA","TTGAAAA","CTGT",2.34538276646262,11,8,11,39,2.99201626321764,4.65697534324211,7.79072275525039,101,"ENSG00000079974.19"
"30572","ENSG00000205822.11_92522",92514,92522,9,"ENSG00000205822.11",1,6,"UVVVVMVVV",1,7,0.805383022774327,116,122,133,136,139,145,153,156,"TTGAAGA","CACA","ATCAGAA","CTGA",2.29636078881193,11,3,8,31,2.96752828093801,4.56915005158772,7.79068214268503,101,"ENSG00000079974.19"
"40043","ENSG00000254777.5_35843",35835,35843,9,"ENSG00000254777.5",1,1,"MVVVVUVVV",1,7,0.82815734989648,81,87,98,101,106,112,133,136,"TTGTTCA","CAGA","AAGAAGA","CTGA",2.33107625640562,11,5,21,46,2.37068326431302,4.47779791008762,7.79042730967354,101,"ENSG00000079974.19"
"27764","ENSG00000187323.12_414815",414807,414815,9,"ENSG00000187323.12",1,6,"UVVVVMVVV",1,7,0.805383022774327,116,122,133,136,146,152,161,164,"TTGATGA","TAGA","ATGTTAA","ATGA",2.30385841675434,11,10,9,39,2.91644152759617,4.56887440982294,7.79040650092025,101,"ENSG00000079974.19"
"28502","ENSG00000189337.17_787390",787382,787390,9,"ENSG00000189337.17",1,3,"VVMVVVUVV",1,7,0.768944099378882,109,115,133,136,152,158,178,181,"ATGATTC","CAGA","TTGATGA","CTGA",2.57806027288505,18,16,20,63,1.67137904584444,4.71461188293619,7.79038828045172,101,"ENSG00000079974.19"
"18092","ENSG00000156113.24_277049",277041,277049,9,"ENSG00000156113.24",1,8,"VVUVVVVMV",1,7,0.767701863354037,115,121,133,136,144,150,166,169,"TTGCTGG","CTGA","GTTGGGA","CTGA",2.41903902181999,12,8,16,45,2.75134207376402,4.71956722147431,7.79037467489046,101,"ENSG00000079974.19"
"1468","ENSG00000057663.16_134334",134326,134334,9,"ENSG00000057663.16",1,2,"VMUVVVVVV",1,7,0.767701863354037,81,87,96,99,110,116,133,136,"ATGATGG","CTGA","TTGCTGT","CAGA",2.4757445570949,9,11,17,46,2.37308882546753,4.71951313485839,7.79032058827453,101,"ENSG00000079974.19"
"12973","ENSG00000139734.19_315741",315733,315741,9,"ENSG00000139734.19",1,8,"UVVVVVVMV",1,7,0.786749482401656,116,122,133,136,151,157,166,169,"CTGTTGA","TAGA","ATGAGTA","CTGA",2.40556811837803,11,15,9,44,2.5359501775769,4.64326774169094,7.79026567129757,101,"ENSG00000079974.19"
"20851","ENSG00000165868.16_50973",50965,50973,9,"ENSG00000165868.16",1,8,"VVVVVVUMV",1,7,0.770186335403727,93,99,133,136,149,155,173,176,"TAGATGA","CTGA","GTGACCA","CTGA",2.62433183448092,34,13,18,74,1.34235799335714,4.70947588914081,7.79022123075572,101,"ENSG00000079974.19"
"30573","ENSG00000205830.1_2239",2231,2239,9,"ENSG00000205830.1",1,2,"UMVVVVVVV",1,7,0.786749482401656,103,109,133,136,143,149,161,164,"GTGAGGT","ATGA","CTCATGA","CTGA",2.45945267693927,24,7,12,52,2.17635044574741,4.64317540633564,7.79017333594226,101,"ENSG00000079974.19"
"17207","ENSG00000153707.19_1049103",1049095,1049103,9,"ENSG00000153707.19",1,8,"VVVVVUVMV",1,7,0.806211180124224,116,122,133,136,142,148,156,159,"ATGTGGA","AGGA","ATGGATA","CTGA",2.27335149899425,11,6,8,34,3.10547079730643,4.56528686431703,7.79013158481393,101,"ENSG00000079974.19"
"42862","ENSG00000267175.5_26125",26117,26125,9,"ENSG00000267175.5",1,1,"MVVVVUVVV",1,7,0.82815734989648,108,114,133,136,139,145,160,163,"TTGATAG","TTGA","CTGATAG","CTGA",2.37162912140899,19,3,15,46,2.09892589311452,4.47744667562694,7.79007607521286,101,"ENSG00000079974.19"
"46054","ENSG00000286147.1_289829",289821,289829,9,"ENSG00000286147.1",1,6,"VVVVVMUVV",1,7,0.788819875776397,107,113,133,136,165,171,179,182,"GTCATGG","CTGA","GTGTTAA","CTGA",2.55107055494097,20,29,8,66,1.53177714060933,4.63472854338728,7.79000804649287,101,"ENSG00000079974.19"
"16405","ENSG00000151474.23_164596",164588,164596,9,"ENSG00000151474.23",0,NA,"VVVVUUVVV",2,7,0.812008281573499,112,118,133,136,161,167,182,185,"GTGTTGG","TTGA","ATGAAGT","CTGA",2.44761134260336,15,25,15,64,1.85045988121447,4.54196720797589,7.79000033426988,101,"ENSG00000079974.19"
"22427","ENSG00000170558.10_19238",19230,19238,9,"ENSG00000170558.10",1,1,"MVVVVVUVV",1,7,0.792132505175983,114,120,133,136,163,169,180,183,"ATAATGA","CAAA","TTGATTT","CTGA",2.46251148612185,13,27,11,60,2.06896943300712,4.62142816845486,7.78995818915879,101,"ENSG00000079974.19"
"41069","ENSG00000258526.8_367302",367294,367302,9,"ENSG00000258526.8",1,1,"MVUVVVVVV",1,7,0.789648033126294,68,74,90,93,96,102,133,136,"TTGATAC","CTGA","GTTATGA","CTGA",2.53192561607126,16,3,31,59,1.64591080833214,4.63135372886847,7.78994586137364,101,"ENSG00000079974.19"
"10720","ENSG00000132549.20_506786",506778,506786,9,"ENSG00000132549.20",1,8,"UVVVVVVMV",1,7,0.786749482401656,111,117,133,136,147,153,204,207,"CTGTTGA","CTGA","TAAATGA","CTGA",2.53451572602949,16,11,51,87,1.67494510353223,4.64292915259887,7.78992708220549,101,"ENSG00000079974.19"
"32337","ENSG00000226792.8_39174",39166,39174,9,"ENSG00000226792.8",1,8,"UVVVVVVMV",1,7,0.786749482401656,64,70,82,85,91,97,133,136,"TTGATGA","TTTA","ATGTGGG","CTGA",2.48152884878569,12,6,36,63,2.02804359386469,4.64289231310899,7.78989024271562,101,"ENSG00000079974.19"
"11946","ENSG00000136636.13_52913",52905,52913,9,"ENSG00000136636.13",1,1,"MVVVVUVVV",1,7,0.82815734989648,111,117,133,136,145,151,169,172,"TTGAACA","CTGT","ATGGTAA","CTGA",2.3225784628224,16,9,18,52,2.42482102039496,4.47716935980273,7.78979875938866,101,"ENSG00000079974.19"
"35338","ENSG00000235749.3_57230",57222,57230,9,"ENSG00000235749.3",1,2,"VMVVVUVVV",1,7,0.806211180124223,94,100,133,136,147,153,165,168,"CAGATGA","CTCA","TTGCTGT","CTGA",2.46743684791872,33,11,12,65,1.81004992711854,4.56490722831084,7.78975194880773,101,"ENSG00000079974.19"
"3716","ENSG00000088387.22_261157",261149,261157,9,"ENSG00000088387.22",1,2,"VMVVVUVVV",1,7,0.806211180124223,114,120,133,136,141,147,158,161,"ATGAATA","GGGA","GTGCAGC","CTGA",2.2929676976911,13,5,11,38,2.9726827964902,4.56478352860771,7.78962824910461,101,"ENSG00000079974.19"
"116","ENSG00000005108.17_332994",332986,332994,9,"ENSG00000005108.17",1,5,"VVVVMVUVV",1,7,0.772670807453416,89,95,133,136,142,148,165,168,"GTGCTGA","ATGA","GTGTGGA","CTGA",2.56669890517174,38,6,17,70,1.68439894581443,4.69893124507317,7.78961447488683,101,"ENSG00000079974.19"
"1756","ENSG00000065883.18_120677",120669,120677,9,"ENSG00000065883.18",1,8,"VVVVVUVMV",1,7,0.806211180124224,110,116,133,136,177,183,214,217,"GGGATGA","CTGT","ATGAGGA","CTGA",2.60860069050173,17,41,31,98,0.868275943585036,4.56473680339915,7.78958152389604,101,"ENSG00000079974.19"
"12931","ENSG00000139618.18_64260",64252,64260,9,"ENSG00000139618.18",1,7,"VVVUVVMVV",1,7,0.766045548654244,113,119,133,136,151,157,212,215,"GTGAAGA","TTGA","ATGTTGA","CTGA",2.60742926302908,14,15,55,93,1.51846705400605,4.72533220188331,7.78951439650029,101,"ENSG00000079974.19"
"47796","ENSG00000289350.1_38136",38128,38136,9,"ENSG00000289350.1",1,1,"MVUVVVVVV",1,7,0.789648033126294,30,36,62,65,72,78,133,136,"ATGATGA","CTGA","ATGACCA","CAGA",2.60837958494209,26,7,55,97,1.13434502317442,4.63088556403041,7.78947769653559,101,"ENSG00000079974.19"
"8242","ENSG00000117594.10_40960",40952,40960,9,"ENSG00000117594.10",1,2,"VMUVVVVVV",1,7,0.767701863354037,116,122,133,136,142,148,156,159,"ATGAAGA","CAGA","GAGAAGA","GTGA",2.36536925349965,11,6,8,34,3.10547079730643,4.71864978849269,7.78945724190883,101,"ENSG00000079974.19"
"5014","ENSG00000102755.12_175959",175951,175959,9,"ENSG00000102755.12",1,1,"MVUVVVVVV",1,7,0.789648033126294,95,101,133,136,144,150,163,166,"ATCATGA","TTTA","ATGAACA","CTGA",2.48913884277757,32,8,13,62,1.92912761535259,4.63084664180076,7.78943877430593,101,"ENSG00000079974.19"
"10694","ENSG00000132394.11_69648",69640,69648,9,"ENSG00000132394.11",1,2,"UMVVVVVVV",1,7,0.786749482401656,109,115,133,136,139,145,158,161,"GTAATGA","TGGA","CTGAGGT","CTGA",2.44060355762788,18,3,13,43,2.29873972549054,4.64235752741911,7.78935545702573,101,"ENSG00000079974.19"
"7389","ENSG00000113810.16_8859",8851,8859,9,"ENSG00000113810.16",1,2,"VMVVUVVVV",1,7,0.773913043478261,48,54,67,70,78,84,133,136,"AAGATGA","CTTA","GTAATTT","CTGA",2.51840128424409,13,8,49,79,1.98531770531818,4.69366490006969,7.78931707398273,101,"ENSG00000079974.19"
"9221","ENSG00000123124.14_120392",120384,120392,9,"ENSG00000123124.14",1,2,"UMVVVVVVV",1,7,0.786749482401656,112,118,133,136,183,189,200,203,"TTTATGA","CTAA","GTGACAA","CTGA",2.50083062634787,15,47,11,82,1.89694743902184,4.64228790366857,7.78928583327519,101,"ENSG00000079974.19"
"13835","ENSG00000143641.10_159478",159470,159478,9,"ENSG00000143641.10",1,1,"MVVVVUVVV",1,7,0.82815734989648,113,119,133,136,142,148,173,176,"ATGAGGA","GTGA","GAGAGGA","CTGG",2.35281569276023,14,6,25,54,2.22083812712456,4.47656901971485,7.78919841930077,101,"ENSG00000079974.19"
"10722","ENSG00000132549.20_558749",558741,558749,9,"ENSG00000132549.20",1,1,"MVVVVUVVV",1,7,0.82815734989648,102,108,133,136,153,159,179,182,"CTGATAA","TTGA","TTCATGA","CTGA",2.51849470391104,25,17,20,71,1.11630097225678,4.47656641624925,7.78919581583518,101,"ENSG00000079974.19"
"6775","ENSG00000111859.17_91470",91462,91470,9,"ENSG00000111859.17",1,8,"VVVVVUVMV",1,7,0.806211180124224,106,112,133,136,143,149,159,162,"ATCATCA","GGGA","GAGATGA","CTGA",2.37672144084851,21,7,10,47,2.412545038255,4.56433866097793,7.78918338147483,101,"ENSG00000079974.19"
"22499","ENSG00000170624.14_853803",853795,853803,9,"ENSG00000170624.14",1,2,"VMVVVUVVV",1,7,0.806211180124223,81,87,95,98,114,120,133,136,"GTGATGA","CTGG","ACGAAGA","CTGG",2.41705927713469,8,16,13,46,2.14300512690477,4.56418341028402,7.78902813078091,101,"ENSG00000079974.19"
"5376","ENSG00000104381.14_17088",17080,17088,9,"ENSG00000104381.14",1,8,"VVUVVVVMV",1,7,0.767701863354037,115,121,133,136,148,154,189,192,"AAGATGG","CTTA","GTGAGGA","CTGA",2.5580635536942,12,12,35,68,1.81903742849402,4.71819861328051,7.78900606669665,101,"ENSG00000079974.19"
"414","ENSG00000011105.14_92627",92619,92627,9,"ENSG00000011105.14",1,8,"VVVUVVVMV",1,7,0.764803312629399,115,121,133,136,160,166,177,180,"ATGGGGA","CTGA","GTGGGGG","CTGA",2.51789890852391,12,24,11,56,2.13262501577844,4.72965443481779,7.78886768533539,101,"ENSG00000079974.19"
"31836","ENSG00000224957.7_248302",248294,248302,9,"ENSG00000224957.7",1,8,"VVVVVUVMV",1,7,0.806211180124224,92,98,133,136,144,150,159,162,"ATCATTA","CAGA","AGGAAGA","CTGA",2.43933426962349,35,8,9,61,1.99385260403745,4.56402026704852,7.78886498754541,101,"ENSG00000079974.19"
"10979","ENSG00000133392.18_38876",38868,38876,9,"ENSG00000133392.18",1,1,"MVVVVVUVV",1,7,0.792132505175983,113,119,133,136,144,150,165,168,"AAGATGG","GGGA","GGGATGG","CTGA",2.35641421583945,14,8,15,46,2.77174603734722,4.62029353573589,7.78882355643982,101,"ENSG00000079974.19"
"26321","ENSG00000183840.7_175557",175549,175557,9,"ENSG00000183840.7",0,NA,"VVUVVUVVV",2,7,0.805797101449275,78,84,93,96,107,113,133,136,"GTGAGGA","CTGA","GGGAAGA","CAGA",2.41103412727553,9,11,20,49,2.18895933557075,4.56563004601857,7.78881845181567,101,"ENSG00000079974.19"
"7892","ENSG00000115970.19_207127",207119,207127,9,"ENSG00000115970.19",1,2,"VMVVUVVVV",1,7,0.773913043478261,111,117,133,136,142,148,159,162,"ATGATTA","CTGG","ATGGTGA","TTGA",2.3921182982803,16,6,11,42,2.82489093175048,4.69308656340478,7.78873873731783,101,"ENSG00000079974.19"
"2141","ENSG00000070729.14_53574",53566,53574,9,"ENSG00000070729.14",1,1,"MVVVVUVVV",1,7,0.82815734989648,115,121,133,136,156,162,174,177,"TTGAAGG","CAAA","GTGAAGA","CTGA",2.35014702656702,12,20,12,53,2.23639039834639,4.47600931053163,7.78863871011755,101,"ENSG00000079974.19"
"5765","ENSG00000106571.15_279272",279264,279272,9,"ENSG00000106571.15",1,2,"VMVVVUVVV",1,7,0.806211180124223,99,105,133,136,162,168,179,182,"GTGATGA","TTTA","TTGAGAA","CTGA",2.56300659726459,28,26,11,74,1.16810755270904,4.5637045502849,7.7885492707818,101,"ENSG00000079974.19"
"38429","ENSG00000250149.2_333606",333598,333606,9,"ENSG00000250149.2",1,8,"VVVVUVVMV",1,7,0.773913043478261,109,115,133,136,139,145,167,170,"TTGATCA","GTGA","TTGAAGA","CTGA",2.54946199061065,18,3,22,52,1.77510987092316,4.69288078541521,7.78853295932826,101,"ENSG00000079974.19"
"12439","ENSG00000138185.20_74103",74095,74103,9,"ENSG00000138185.20",1,6,"UVVVVMVVV",1,7,0.805383022774327,81,87,101,104,109,115,133,136,"CTAATGA","GTGA","TTGATGA","CTTA",2.35986625672019,14,5,18,46,2.53553703001725,4.5669946853713,7.78852677646861,101,"ENSG00000079974.19"
"38220","ENSG00000249797.2_386790",386782,386790,9,"ENSG00000249797.2",1,2,"VMVVUVVVV",1,7,0.773913043478261,112,118,133,136,146,152,163,166,"GTGAAGG","CGGA","ATTATGT","CTGA",2.39577443002004,15,10,11,45,2.79949049047824,4.69283000598629,7.78848217989934,101,"ENSG00000079974.19"
"20496","ENSG00000164970.15_41673",41665,41673,9,"ENSG00000164970.15",1,5,"VVVVMUVVV",1,7,0.808695652173913,93,99,133,136,145,151,168,171,"AGGATCA","ATGA","GTGAATA","CTGA",2.48314096252549,34,9,17,69,1.66031904029571,4.55364803094975,7.7884306396454,101,"ENSG00000079974.19"
"7488","ENSG00000114439.19_207626",207618,207626,9,"ENSG00000114439.19",1,8,"VVVVVUVMV",1,7,0.806211180124224,113,119,133,136,149,155,163,166,"TAGGTGA","ATGA","TTGAAGC","CTGA",2.34109916552383,14,13,8,44,2.64689792610785,4.56355642406669,7.78840114456358,101,"ENSG00000079974.19"
"16505","ENSG00000151702.18_72999",72991,72999,9,"ENSG00000151702.18",1,1,"MVVVVVUVV",1,7,0.792132505175983,81,87,101,104,110,116,133,136,"ATAATGA","GTGA","GTGATTT","CAGA",2.37449111588347,14,6,17,46,2.64943788715123,4.61984466492692,7.78837468563086,101,"ENSG00000079974.19"
"6847","ENSG00000112137.19_271070",271062,271070,9,"ENSG00000112137.19",1,1,"MVVVVUVVV",1,7,0.82815734989648,108,114,133,136,181,187,195,198,"TTAATGA","ATGA","GAGAAGC","CTGA",2.45146568500733,19,45,8,81,1.55960521023926,4.47567744423869,7.78830684382461,101,"ENSG00000079974.19"
"37553","ENSG00000248457.1_65293",65285,65293,9,"ENSG00000248457.1",1,1,"MVVVVUVVV",1,7,0.82815734989648,70,76,94,97,114,120,133,136,"ATGATGA","CAGA","ACACTGA","CTGG",2.38327840121097,18,17,13,57,2.0135894084873,4.47552802080678,7.7881574203927,101,"ENSG00000079974.19"
"23589","ENSG00000173389.16_6330",6322,6330,9,"ENSG00000173389.16",0,NA,"VVUVVUVVV",2,7,0.805797101449275,102,108,133,136,138,144,155,158,"ATGAGGA","AAGA","TTGAACA","CTGA",2.48604811166223,25,2,11,47,1.68553977451565,4.56479846306597,7.78798686886307,101,"ENSG00000079974.19"
"5237","ENSG00000104059.5_223479",223471,223479,9,"ENSG00000104059.5",1,1,"MVVVVVUVV",1,7,0.792132505175983,98,104,133,136,148,154,177,180,"ATAATGA","ATGA","ATTAAGA","CTGA",2.59419054863242,29,12,23,73,1.18315155898368,4.61943880413328,7.78796882483722,101,"ENSG00000079974.19"
"11094","ENSG00000133835.18_177042",177034,177042,9,"ENSG00000133835.18",1,3,"VVMVVUVVV",1,7,0.804968944099379,80,86,100,103,106,112,133,136,"ATGATGT","CAGA","GTGTTGG","GTGA",2.42165370485291,14,3,21,47,2.127851760886,4.56805244830967,7.78792822470719,101,"ENSG00000079974.19"
"19717","ENSG00000163629.13_17693",17685,17693,9,"ENSG00000163629.13",1,6,"VVVVUMVVV",1,7,0.792546583850932,112,118,133,136,167,173,189,192,"ATGCTCA","CTGG","GTGAGGA","CTGA",2.51406934074453,15,31,16,71,1.71046791852366,4.61773254753846,7.78791888294219,101,"ENSG00000079974.19"
"18355","ENSG00000157152.17_172690",172682,172690,9,"ENSG00000157152.17",1,8,"VVUVVVVMV",1,7,0.767701863354037,87,93,133,136,150,156,164,167,"ATGCTGA","GTGA","TTGAAGG","CTGA",2.58956294857285,40,14,8,71,1.60437756861332,4.71703263977475,7.78784009319089,101,"ENSG00000079974.19"
"16048","ENSG00000150672.19_1395889",1395881,1395889,9,"ENSG00000150672.19",1,2,"VMVVVUVVV",1,7,0.806211180124223,67,73,83,86,111,117,133,136,"ATTAGGA","ATGA","GTGATTC","CTGA",2.46751596252549,10,25,16,60,1.80170804747375,4.56295361607759,7.78779833657449,101,"ENSG00000079974.19"
"4797","ENSG00000101935.13_130683",130675,130683,9,"ENSG00000101935.13",0,NA,"UVVVVVUVV",2,7,0.788819875776397,41,47,65,68,113,119,133,136,"ATGATGA","CTGA","ATGGGCA","CTGC",2.54844353281853,18,45,14,86,1.54034761424466,4.63249279159205,7.78777229469764,101,"ENSG00000079974.19"
"4793","ENSG00000101901.13_9987",9979,9987,9,"ENSG00000101901.13",1,8,"VVVVVUVMV",1,7,0.806211180124224,109,115,133,136,143,149,157,160,"GGGAAGA","ATGG","ATGATGG","CTGA",2.33813386179679,18,7,8,42,2.66391025144351,4.56286733252219,7.78771205301909,101,"ENSG00000079974.19"
"3440","ENSG00000083937.10_26186",26178,26186,9,"ENSG00000083937.10",1,8,"VVVVVUVMV",1,7,0.806211180124224,112,118,133,136,154,160,169,172,"CTGATGA","AGGA","TTGATGA","TTGA",2.39548531414699,15,18,9,51,2.28134498769568,4.56281177050224,7.78765649099913,101,"ENSG00000079974.19"
"23015","ENSG00000171943.12_196578",196570,196578,9,"ENSG00000171943.12",1,8,"VVUVVVVMV",1,7,0.767701863354037,114,120,133,136,148,154,166,169,"ATGATGA","GTGG","TTGATGC","ATGA",2.42155199126804,13,12,12,46,2.7236491260237,4.71683226695266,7.78763972036881,101,"ENSG00000079974.19"
"28715","ENSG00000196369.12_196876",196868,196876,9,"ENSG00000196369.12",1,8,"VVUVVVVMV",1,7,0.767701863354037,114,120,133,136,148,154,166,169,"ATGATGA","GTGG","TTGATGC","ATGA",2.42155199126804,13,12,12,46,2.7236491260237,4.71683226695266,7.78763972036881,101,"ENSG00000079974.19"
"42716","ENSG00000266028.8_196763",196755,196763,9,"ENSG00000266028.8",1,8,"VVUVVVVMV",1,7,0.767701863354037,114,120,133,136,148,154,166,169,"ATGATGA","GTGG","TTGATGC","ATGA",2.42155199126804,13,12,12,46,2.7236491260237,4.71683226695266,7.78763972036881,101,"ENSG00000079974.19"
"43296","ENSG00000270872.2_86771",86763,86771,9,"ENSG00000270872.2",1,8,"VVUVVVVMV",1,7,0.767701863354037,114,120,133,136,148,154,166,169,"ATGATGA","GTGG","TTGATGC","ATGA",2.42155199126804,13,12,12,46,2.7236491260237,4.71683226695266,7.78763972036881,101,"ENSG00000079974.19"
"38377","ENSG00000250062.5_73329",73321,73329,9,"ENSG00000250062.5",0,NA,"UVVVVUVVV",2,7,0.824844720496894,110,116,133,136,145,151,180,183,"CTGCTGA","CTGT","ATTAGGT","CTGA",2.41476921126314,17,9,29,64,1.85451459008323,4.48824399962605,7.78762288161363,101,"ENSG00000079974.19"
"8657","ENSG00000120156.22_5942",5934,5942,9,"ENSG00000120156.22",1,3,"UVMVVVVVV",1,7,0.785507246376811,113,119,133,136,140,146,185,188,"CGGATGA","GTGA","ATGATTT","CTGA",2.51332860069286,14,4,39,66,1.82654610940077,4.64551752850496,7.7875465140122,101,"ENSG00000079974.19"
"46069","ENSG00000286153.2_43576",43568,43576,9,"ENSG00000286153.2",1,7,"VVUVVVMVV",1,7,0.768944099378882,116,122,133,136,142,148,158,161,"ATAATGA","AGGA","AAAATCA","CTGA",2.367809599473,11,6,10,36,3.06115136982541,4.71163717491135,7.78741357242687,101,"ENSG00000079974.19"
"6122","ENSG00000108021.22_64212",64204,64212,9,"ENSG00000108021.22",1,2,"VMVVVUVVV",1,7,0.806211180124223,78,84,99,102,114,120,133,136,"ACTATGA","CTGA","TTGGTGA","CAGA",2.34815176493789,15,12,13,49,2.5956537505644,4.56249971253758,7.78734443303447,101,"ENSG00000079974.19"
"40306","ENSG00000255501.3_359910",359902,359910,9,"ENSG00000255501.3",1,1,"MVVVVUVVV",1,7,0.82815734989648,115,121,133,136,145,151,162,165,"AGGATGT","TGGA","TTGATGA","CTTA",2.240714140852,12,9,11,41,2.96068183600898,4.47469402708891,7.78732342667483,101,"ENSG00000079974.19"
"18587","ENSG00000157764.14_59361",59353,59361,9,"ENSG00000157764.14",1,2,"UMVVVVVVV",1,7,0.786749482401656,109,115,133,136,166,172,180,183,"ATTATGA","CTAA","TTCATCA","CTGA",2.52953521970269,18,30,8,65,1.69754847580032,4.64027915178789,7.78727708139452,101,"ENSG00000079974.19"
"9591","ENSG00000125744.12_923",915,923,9,"ENSG00000125744.12",1,6,"VVVVVMUVV",1,7,0.788819875776397,114,120,133,136,149,155,164,167,"ATCATCT","CTGA","GGGCTGG","CTGA",2.37460154446966,13,13,9,44,2.69709426529491,4.6319428071065,7.78722231021209,101,"ENSG00000079974.19"
"44739","ENSG00000283503.4_41405",41397,41405,9,"ENSG00000283503.4",0,NA,"UVVVVUVVV",2,7,0.824844720496894,112,118,133,136,143,149,163,166,"TTGATCT","CACA","ATGAGGC","CTGA",2.27466805912035,15,7,14,45,2.78685366330455,4.48782684769338,7.78720572968096,101,"ENSG00000079974.19"
"45636","ENSG00000285754.1_60271",60263,60271,9,"ENSG00000285754.1",1,2,"UMVVVVVVV",1,7,0.786749482401656,93,99,133,136,180,186,195,198,"ATGAAGA","CTGC","CTGATAA","CTGA",2.63197826736109,34,44,9,96,1.01404524381561,4.64014175655571,7.78713968616234,101,"ENSG00000079974.19"
"4944","ENSG00000102466.16_224997",224989,224997,9,"ENSG00000102466.16",1,8,"VVVVUVVMV",1,7,0.773913043478261,35,41,57,60,99,105,133,136,"ATGCAGA","CTGA","CTGATGA","CTGA",2.66161886789754,16,39,28,92,1.02152505761618,4.69141271089994,7.78706488481298,101,"ENSG00000079974.19"
"8286","ENSG00000117859.19_86800",86792,86800,9,"ENSG00000117859.19",1,2,"VMVVVVUVV",1,7,0.770186335403727,83,89,133,136,174,180,189,192,"ATGATGA","GTTA","CTGATGG","CTGA",2.6722687565538,44,38,9,100,1.01007515482758,4.7063000496299,7.7870453912448,101,"ENSG00000079974.19"
"36821","ENSG00000243176.8_145128",145120,145128,9,"ENSG00000243176.8",0,NA,"UVVUVVVVV",2,7,0.78343685300207,113,119,133,136,145,151,170,173,"ATCATGA","CTTG","GTGGACA","CTGA",2.41843813581278,14,9,19,51,2.49023352917344,4.65328860864799,7.78703602065627,101,"ENSG00000079974.19"
"12843","ENSG00000139187.10_59483",59475,59483,9,"ENSG00000139187.10",1,1,"MVVVUVVVV",1,7,0.795859213250517,99,105,133,136,143,149,160,163,"GTGAAGT","CAGA","TAGATGA","CTGA",2.45253605203399,28,7,11,55,2.06377865485223,4.60350475043638,7.78694160343845,101,"ENSG00000079974.19"
"42521","ENSG00000263809.1_6219",6211,6219,9,"ENSG00000263809.1",1,1,"MVVVVVUVV",1,7,0.792132505175983,115,121,133,136,153,159,195,198,"AGGATGA","GTGA","GTGCTCC","CTGA",2.55018439614957,12,17,36,74,1.47240540862466,4.61840867907212,7.78693869977605,101,"ENSG00000079974.19"
"682","ENSG00000023892.12_22428",22420,22428,9,"ENSG00000023892.12",1,5,"UVVVMUVVV",2,6,0.711387163561077,86,92,102,105,109,115,133,136,"ATGAAGA","ATGA","ATGATAC","CTGA",2.60220287244176,10,4,18,41,2.41730122278696,4.94133009309967,7.78687874734398,101,"ENSG00000079974.19"
"16648","ENSG00000151952.16_639993",639985,639993,9,"ENSG00000151952.16",1,8,"VVVVVUVMV",1,7,0.806211180124224,74,80,98,101,108,114,133,136,"ATGATGT","CTGC","GTGACGG","CTCA",2.40094973608886,18,7,19,53,2.24178614757089,4.56202943037416,7.78687415087105,101,"ENSG00000079974.19"
"25995","ENSG00000183117.20_585573",585565,585573,9,"ENSG00000183117.20",1,2,"VMVVVVUVV",1,7,0.770186335403727,83,89,102,105,112,118,133,136,"TTGTTGA","CTAA","AAGAATA","CTGA",2.4004457606247,13,7,15,44,2.82140405818526,4.70609394892081,7.78683929053572,101,"ENSG00000079974.19"
"34139","ENSG00000231937.1_36810",36802,36810,9,"ENSG00000231937.1",1,1,"MVVVVVUVV",1,7,0.792132505175983,50,56,99,102,108,114,133,136,"ATGATGA","CTGA","ATAAGAA","CTCA",2.53701134169884,43,6,19,77,1.559575048646,4.61824599832624,7.78677601903017,101,"ENSG00000079974.19"
"24276","ENSG00000175658.4_120",112,120,9,"ENSG00000175658.4",1,8,"VVVVVUVMV",1,7,0.806211180124224,32,38,49,52,88,94,122,125,"ATGAGGA","GTGA","CAGATGG","CTGA",2.56227515221969,11,36,28,84,1.1657402724292,4.56189365514011,7.786738375637,101,"ENSG00000079974.19"
"31668","ENSG00000224363.2_47132",47124,47132,9,"ENSG00000224363.2",1,8,"VVVVVUVMV",1,7,0.806211180124224,43,49,60,63,99,105,133,136,"ATGAGGA","GTGA","CAGATGG","CTGA",2.56227515221969,11,36,28,84,1.1657402724292,4.56189365514011,7.786738375637,101,"ENSG00000079974.19"
"48185","ENSG00000290565.1_24619",24611,24619,9,"ENSG00000290565.1",1,8,"VVVVVUVMV",1,7,0.806211180124224,43,49,60,63,99,105,133,136,"ATGAGGA","GTGA","CAGATGG","CTGA",2.56227515221969,11,36,28,84,1.1657402724292,4.56189365514011,7.786738375637,101,"ENSG00000079974.19"
"48283","ENSG00000290869.1_24668",24660,24668,9,"ENSG00000290869.1",1,8,"VVVVVUVMV",1,7,0.806211180124224,43,49,60,63,99,105,133,136,"ATGAGGA","GTGA","CAGATGG","CTGA",2.56227515221969,11,36,28,84,1.1657402724292,4.56189365514011,7.786738375637,101,"ENSG00000079974.19"
"16327","ENSG00000151322.20_660242",660234,660242,9,"ENSG00000151322.20",1,8,"VVVVUVVMV",1,7,0.773913043478261,112,118,133,136,156,162,170,173,"CTGCTGG","CTGA","CTGAGAA","CTGA",2.48943511701539,15,20,8,52,2.16792893968913,4.69104076328127,7.78669293719431,101,"ENSG00000079974.19"
"40168","ENSG00000255145.3_79890",79882,79890,9,"ENSG00000255145.3",1,8,"VVVVUVVMV",1,7,0.773913043478261,81,87,97,100,107,113,133,136,"GGGATGA","TTGA","GTGATGA","GTGA",2.4486140804897,10,7,20,46,2.43982189688189,4.69097894170331,7.78663111561635,101,"ENSG00000079974.19"
"14226","ENSG00000144619.15_841932",841924,841932,9,"ENSG00000144619.15",1,1,"MVUVVVVVV",1,7,0.789648033126294,56,62,77,80,93,99,133,136,"ATGATGA","CTGT","AAGATGA","TTGA",2.52674226138126,15,13,34,71,1.66720452258293,4.62803823294784,7.78663036545301,101,"ENSG00000079974.19"
"7481","ENSG00000114439.19_123475",123467,123475,9,"ENSG00000114439.19",1,8,"UVVVVVVMV",1,7,0.786749482401656,115,121,133,136,154,160,174,177,"ATAATGA","GAGA","GTGCCAA","CTGA",2.44710952674695,12,18,14,53,2.24443902319388,4.63962563371006,7.78662356331669,101,"ENSG00000079974.19"
"4125","ENSG00000095587.9_47343",47335,47343,9,"ENSG00000095587.9",1,8,"VVVVVUVMV",1,7,0.806211180124224,113,119,133,136,141,147,156,159,"GAGAGGA","CAGG","ATGAAGG","CTGA",2.29109333122861,14,5,9,37,2.97283552479713,4.5616977665803,7.7865424870772,101,"ENSG00000079974.19"
"25446","ENSG00000181617.6_5753",5745,5753,9,"ENSG00000181617.6",0,NA,"VVVVVUUVV",2,7,0.808281573498965,112,118,133,136,139,145,156,159,"AAGATGG","GTGA","TTGATGA","CTGG",2.33363975959347,15,3,11,38,2.65595836413498,4.55338919035619,7.78651548435205,101,"ENSG00000079974.19"
"17905","ENSG00000155816.21_146490",146482,146490,9,"ENSG00000155816.21",1,2,"UMVVVVVVV",1,7,0.786749482401656,103,109,133,136,145,151,180,183,"ATGATGA","CAAA","CAGATAA","CTGA",2.58607412559618,24,9,29,71,1.3175617905636,4.63951399030121,7.78651191990783,101,"ENSG00000079974.19"
"22551","ENSG00000170819.5_43218",43210,43218,9,"ENSG00000170819.5",1,8,"UVVVVUVMV",2,6,0.708902691511387,79,85,99,102,111,117,133,136,"GTGAAGA","GTGA","GTGTGGA","CTGA",2.56929565852345,14,9,16,48,2.67484456445411,4.95087057198594,7.78648133803149,101,"ENSG00000079974.19"
"12240","ENSG00000137710.17_264511",264503,264511,9,"ENSG00000137710.17",1,1,"MVUVVVVVV",1,7,0.789648033126294,68,74,86,89,109,115,133,136,"CTGATGA","CTGA","AAGATAA","CAGA",2.4895981138097,12,20,18,59,1.91420652429283,4.62788182075604,7.78647395326121,101,"ENSG00000079974.19"
"47842","ENSG00000289465.1_55983",55975,55983,9,"ENSG00000289465.1",1,1,"MVUVVVVVV",1,7,0.789648033126294,68,74,86,89,109,115,133,136,"CTGATGA","CTGA","AAGATAA","CAGA",2.4895981138097,12,20,18,59,1.91420652429283,4.62788182075604,7.78647395326121,101,"ENSG00000079974.19"
"15800","ENSG00000149571.12_527692",527684,527692,9,"ENSG00000149571.12",0,NA,"VVVVVUUVV",2,7,0.808281573498965,11,17,31,34,72,78,133,136,"AGGGTGA","CTGA","GTGGAGA","CTGA",2.58562234164298,14,38,55,116,0.975746988762796,4.55330731659567,7.78643361059153,101,"ENSG00000079974.19"
"24738","ENSG00000177694.16_568812",568804,568812,9,"ENSG00000177694.16",1,2,"VMVVVUVVV",1,7,0.806211180124223,68,74,87,90,108,114,133,136,"GTGTTGA","CAGT","GTGAGGC","CTGA",2.44539241449208,13,18,19,59,1.94364187998557,4.56156449414987,7.78640921464676,101,"ENSG00000079974.19"
"2024","ENSG00000069188.17_104015",104007,104015,9,"ENSG00000069188.17",1,8,"VVVVUVVMV",1,7,0.773913043478261,79,85,95,98,114,120,133,136,"GTGATGA","CTGA","ATTGCGA","TTGA",2.46502580956423,10,16,13,48,2.32891002623397,4.69060385583221,7.78625602974525,101,"ENSG00000079974.19"
"19063","ENSG00000160712.13_51659",51651,51659,9,"ENSG00000160712.13",0,NA,"UVVVVVUVV",2,7,0.788819875776397,110,116,133,136,147,153,162,165,"GTGGGGA","CTGT","GTGTTGG","CTGA",2.38955356248098,17,11,9,46,2.59283179279446,4.63079721900025,7.78607672210584,101,"ENSG00000079974.19"
"23637","ENSG00000173452.14_13520",13512,13520,9,"ENSG00000173452.14",0,NA,"VVUVVUVVV",2,7,0.805797101449275,81,87,97,100,109,115,133,136,"ATGAAGT","CTGA","CTGAGGG","TTGA",2.36116958257153,10,9,18,46,2.51006585300547,4.56279910087059,7.78598750666769,101,"ENSG00000079974.19"
"34615","ENSG00000233611.4_68695",68687,68695,9,"ENSG00000233611.4",1,2,"VMUVVVVVV",1,7,0.767701863354037,108,114,133,136,143,149,165,168,"ATGATAA","CAGA","ACAATCA","CTGA",2.47872653106277,19,7,16,51,2.33583072055726,4.71516856524394,7.78597601866008,101,"ENSG00000079974.19"
"44537","ENSG00000282943.1_46654",46646,46654,9,"ENSG00000282943.1",1,8,"VVVVVUVMV",1,7,0.806211180124224,116,122,133,136,144,150,162,165,"GTCAGGT","CTGT","CAGATGA","CTGA",2.29370936127554,11,8,12,40,2.95261791259771,4.56100341360866,7.78584813410556,101,"ENSG00000079974.19"
"9971","ENSG00000128596.17_15430",15422,15430,9,"ENSG00000128596.17",1,1,"MVVVVUVVV",1,7,0.82815734989648,87,93,100,103,116,122,133,136,"AAGATGT","CTGA","CTGATCC","CTGC",2.3352039612074,7,13,11,40,2.32479607118211,4.47320561980786,7.78583501939378,101,"ENSG00000079974.19"
"4648","ENSG00000101463.6_133989",133981,133989,9,"ENSG00000101463.6",1,7,"VVVVUVMVV",1,7,0.775155279503105,7,13,24,27,75,81,133,136,"ATAATGA","CTGA","ATGCAGC","CTGA",2.66444411728242,11,48,52,120,0.977772115855196,4.6851832244345,7.78580434244692,101,"ENSG00000079974.19"
"32427","ENSG00000226990.1_1578",1570,1578,9,"ENSG00000226990.1",1,2,"VMVVVUVVV",1,7,0.806211180124223,111,117,133,136,144,150,160,163,"ATATTCA","ATGA","ATGAAGC","CTGA",2.31098015934405,16,8,10,43,2.8368911233464,4.56085637974335,7.78570110024024,101,"ENSG00000079974.19"
"47349","ENSG00000288024.1_9558",9550,9558,9,"ENSG00000288024.1",1,8,"UVVVVVVMV",1,7,0.786749482401656,113,119,133,136,175,181,198,201,"TTGATAA","CTAA","ATGCTGA","CTGA",2.5326304770984,14,39,17,79,1.67057011429247,4.63869332373712,7.78569125334375,101,"ENSG00000079974.19"
"24428","ENSG00000176225.15_98824",98816,98824,9,"ENSG00000176225.15",0,NA,"VVVVUUVVV",2,7,0.812008281573499,114,120,133,136,145,151,204,207,"ATGATTC","CTGT","ATTTTGA","CTGA",2.43047080293951,13,9,53,84,1.94739526294558,4.53763348730224,7.78566661359623,101,"ENSG00000079974.19"
"4096","ENSG00000095002.15_162325",162317,162325,9,"ENSG00000095002.15",1,8,"UVVVVVVMV",1,7,0.786749482401656,109,115,133,136,140,146,156,159,"ATGTTGA","AGGA","GTTACTA","CTGA",2.40395997664975,18,4,10,41,2.52826093675602,4.63866519527192,7.78566312487855,101,"ENSG00000079974.19"
"38895","ENSG00000251247.13_14348",14340,14348,9,"ENSG00000251247.13",0,NA,"VVVVUVUVV",2,7,0.775983436853002,103,109,133,136,141,147,166,169,"AAGATGA","CTCA","CAGATGT","CTGA",2.55032304878084,24,5,19,57,1.72474177297312,4.68172385787801,7.78565760529002,101,"ENSG00000079974.19"
"48524","ENSG00000291239.1_13851",13843,13851,9,"ENSG00000291239.1",0,NA,"VVVVUVUVV",2,7,0.775983436853002,103,109,133,136,141,147,166,169,"AAGATGA","CTCA","CAGATGT","CTGA",2.55032304878084,24,5,19,57,1.72474177297312,4.68172385787801,7.78565760529002,101,"ENSG00000079974.19"
"23063","ENSG00000172159.16_42490",42482,42490,9,"ENSG00000172159.16",1,1,"MVVVUVVVV",1,7,0.795859213250517,112,118,133,136,154,160,170,173,"ATTATGC","CTCA","CTTATGG","CTGA",2.41893792556659,15,18,10,52,2.28250467559856,4.60218937817729,7.78562623117936,101,"ENSG00000079974.19"
"15648","ENSG00000148950.11_74397",74389,74397,9,"ENSG00000148950.11",1,2,"VMVVVUVVV",1,7,0.806211180124223,108,114,133,136,177,183,191,194,"ATGAAGA","CTGA","TTGTTGA","CTTA",2.50196898935431,19,41,8,77,1.56301800814124,4.56070281762583,7.78554753812272,101,"ENSG00000079974.19"
"18143","ENSG00000156265.16_60492",60484,60492,9,"ENSG00000156265.16",1,6,"UVVVVMVVV",1,7,0.805383022774327,45,51,69,72,83,89,133,136,"ATGATGA","CGGA","ATGTGGA","ATGA",2.51173439833093,18,11,44,82,1.51054487555469,4.56386021610688,7.78539230720419,101,"ENSG00000079974.19"
"5657","ENSG00000106070.20_113841",113833,113841,9,"ENSG00000106070.20",1,8,"VVVVVUVMV",1,7,0.806211180124224,70,76,99,102,109,115,133,136,"TTTATGA","ATGA","GGGAAGG","CTGA",2.44990971169103,23,7,18,57,1.90905161948311,4.56044575768916,7.78529047818606,101,"ENSG00000079974.19"
"35198","ENSG00000235303.1_24893",24885,24893,9,"ENSG00000235303.1",1,1,"MVVVVVUVV",1,7,0.792132505175983,112,118,133,136,145,151,171,174,"ATTATGG","CAGA","GTTTTAA","CTGA",2.41353151732991,15,9,20,53,2.37662620236675,4.61670907947488,7.78523910017881,101,"ENSG00000079974.19"
"8989","ENSG00000121964.15_272974",272966,272974,9,"ENSG00000121964.15",0,NA,"VVUVVUVVV",2,7,0.805797101449275,29,35,53,56,103,109,133,136,"GTGATGA","CTGA","TTGATTA","CTGG",2.58993531728623,18,47,24,98,0.981930312693709,4.56204144031715,7.78522984611425,101,"ENSG00000079974.19"
"16193","ENSG00000151090.20_24837",24829,24837,9,"ENSG00000151090.20",1,7,"UVVVVVMVV",1,7,0.787991718426501,107,113,133,136,143,149,191,194,"ATGTTGA","TTGG","GTGATGG","CTGA",2.55434379679655,20,7,42,78,1.50407509962406,4.63325843623361,7.78522530993961,101,"ENSG00000079974.19"
"36258","ENSG00000239407.5_1922",1914,1922,9,"ENSG00000239407.5",0,NA,"UVVUVVVVV",2,7,0.78343685300207,106,112,133,136,143,149,157,160,"TTGATTA","TTGA","GTAGTGT","CTGA",2.43149013582849,21,7,8,45,2.39597203630609,4.65147656879066,7.78522398079895,101,"ENSG00000079974.19"
"7431","ENSG00000114127.11_126186",126178,126186,9,"ENSG00000114127.11",1,2,"VMVVVUVVV",1,7,0.806211180124223,112,118,133,136,176,182,195,198,"ATGATCT","CTAA","TTGCAGA","CTGA",2.4608229492989,15,40,13,77,1.83599842865002,4.56037118932734,7.78521590982424,101,"ENSG00000079974.19"
"4407","ENSG00000100479.14_24827",24819,24827,9,"ENSG00000100479.14",0,NA,"UVVVVVUVV",2,7,0.788819875776397,73,79,93,96,116,122,133,136,"AAAATGA","CTGT","CTGAAAA","CTGA",2.44379447638359,14,20,11,54,2.22777040045062,4.62993339408531,7.7852128971909,101,"ENSG00000079974.19"
"41660","ENSG00000259462.3_14500",14492,14500,9,"ENSG00000259462.3",1,6,"VVUVVMVVV",1,7,0.786335403726708,115,121,133,136,145,151,162,165,"CTGAAGT","GTGA","GGGAGGG","CTGA",2.33974205984714,12,9,11,41,2.96068183600898,4.63974055874749,7.78508217365432,101,"ENSG00000079974.19"
"22425","ENSG00000170558.10_114365",114357,114365,9,"ENSG00000170558.10",0,NA,"UVVVVVUVV",2,7,0.788819875776397,102,108,133,136,150,156,177,180,"TTGATGA","TTTA","ATGATGC","CTGA",2.5896369568938,25,14,21,69,1.25486522709621,4.62977790159705,7.78505740470264,101,"ENSG00000079974.19"
"15467","ENSG00000148429.15_21148",21140,21148,9,"ENSG00000148429.15",0,NA,"VVVVVUUVV",2,7,0.808281573498965,115,121,133,136,146,152,163,166,"AAGATGT","CCGC","GAGATTT","CTGA",2.29586492556439,12,10,11,42,2.90155585125339,4.55183050542067,7.78495679941653,101,"ENSG00000079974.19"
"40947","ENSG00000258162.4_41138",41130,41138,9,"ENSG00000258162.4",1,6,"UVVVVMVVV",1,7,0.805383022774327,114,120,133,136,142,148,187,190,"AAGTAGA","CTGA","ATTATGA","CTGA",2.43740493095424,13,6,39,67,2.00431643708498,4.56342066086165,7.78495275195896,101,"ENSG00000079974.19"
"30720","ENSG00000211455.8_33881",33873,33881,9,"ENSG00000211455.8",1,2,"UMVVVVVVV",1,7,0.786749482401656,81,87,99,102,112,118,133,136,"AAGATAA","CTTA","GTCTAGA","CTGA",2.37482914382562,12,10,15,46,2.71957890381417,4.63794329899624,7.78494122860286,101,"ENSG00000079974.19"
"8681","ENSG00000120253.14_9913",9905,9913,9,"ENSG00000120253.14",0,NA,"VVVVUUVVV",2,7,0.812008281573499,55,61,70,73,82,88,133,136,"TTGATGA","ATGA","GGGATGA","CTGG",2.45298440556274,9,9,45,72,1.79417203288898,4.53685035082682,7.78488347712081,101,"ENSG00000079974.19"
"30777","ENSG00000213390.11_5953",5945,5953,9,"ENSG00000213390.11",1,3,"VVMVVUVVV",1,7,0.804968944099379,97,103,133,136,145,151,164,167,"ATGAAGA","TGGA","TGGAGGA","CTGA",2.45200826685369,30,9,13,61,1.91324181497907,4.56499089850092,7.78486667489844,101,"ENSG00000079974.19"
"43190","ENSG00000269891.2_5917",5909,5917,9,"ENSG00000269891.2",1,3,"VVMVVUVVV",1,7,0.804968944099379,97,103,133,136,145,151,164,167,"ATGAAGA","TGGA","TGGAGGA","CTGA",2.45200826685369,30,9,13,61,1.91324181497907,4.56499089850092,7.78486667489844,101,"ENSG00000079974.19"
"31431","ENSG00000223727.6_162963",162955,162963,9,"ENSG00000223727.6",1,1,"MVVVVUVVV",1,7,0.82815734989648,112,118,133,136,149,155,206,209,"CTGGAGA","CTGA","TTGTTGT","CTGA",2.44246951830094,15,13,51,88,1.60559221740757,4.47218058485346,7.78480998443938,101,"ENSG00000079974.19"
"4","ENSG00000000460.17_3172",3164,3172,9,"ENSG00000000460.17",1,7,"VVVVUVMVV",1,7,0.775155279503105,105,111,133,136,142,148,159,162,"AGGATGA","CCCA","ATGATCC","CTGA",2.46422073380137,22,6,11,48,2.30844722933211,4.68414636366864,7.78476748168106,101,"ENSG00000079974.19"
"5051","ENSG00000102858.13_35114",35106,35114,9,"ENSG00000102858.13",0,NA,"VVVVUUVVV",2,7,0.812008281573499,107,113,133,136,148,154,167,170,"TTGCTGA","TTGG","GTGGGGA","CTGA",2.39571051416671,20,12,13,54,2.17542137024228,4.53670619950509,7.78473932579909,101,"ENSG00000079974.19"
"25844","ENSG00000182974.3_1035",1027,1035,9,"ENSG00000182974.3",1,1,"MVVUVVVVV",1,7,0.786749482401656,92,98,133,136,144,150,165,168,"ATGAGGA","GTGA","ATTATAC","CTGA",2.51075488194942,35,8,15,67,1.81234371105618,4.63767739767974,7.78467532728636,101,"ENSG00000079974.19"
"43825","ENSG00000274102.3_11321",11313,11321,9,"ENSG00000274102.3",1,1,"MVVUVVVVV",1,7,0.786749482401656,92,98,133,136,144,150,165,168,"ATGAGGA","GTGA","ATTATAC","CTGA",2.51075488194942,35,8,15,67,1.81234371105618,4.63767739767974,7.78467532728636,101,"ENSG00000079974.19"
"43909","ENSG00000275249.1_1035",1027,1035,9,"ENSG00000275249.1",1,1,"MVVUVVVVV",1,7,0.786749482401656,92,98,133,136,144,150,165,168,"ATGAGGA","GTGA","ATTATAC","CTGA",2.51075488194942,35,8,15,67,1.81234371105618,4.63767739767974,7.78467532728636,101,"ENSG00000079974.19"
"44300","ENSG00000280709.2_86149",86141,86149,9,"ENSG00000280709.2",1,1,"MVVUVVVVV",1,7,0.786749482401656,92,98,133,136,144,150,165,168,"ATGAGGA","GTGA","ATTATAC","CTGA",2.51075488194942,35,8,15,67,1.81234371105618,4.63767739767974,7.78467532728636,101,"ENSG00000079974.19"
"45354","ENSG00000285472.1_66329",66321,66329,9,"ENSG00000285472.1",1,1,"MVVUVVVVV",1,7,0.786749482401656,92,98,133,136,144,150,165,168,"ATGAGGA","GTGA","ATTATAC","CTGA",2.51075488194942,35,8,15,67,1.81234371105618,4.63767739767974,7.78467532728636,101,"ENSG00000079974.19"
"20520","ENSG00000165006.14_67509",67501,67509,9,"ENSG00000165006.14",1,6,"VVVVVMUVV",1,7,0.788819875776397,106,112,133,136,145,151,177,180,"TTGATGA","AAGA","CTGGGGA","CTGA",2.53812091488182,21,9,26,65,1.5967185534196,4.62938116315794,7.78466066626353,101,"ENSG00000079974.19"
"12073","ENSG00000137075.18_48581",48573,48581,9,"ENSG00000137075.18",0,NA,"VVVUVUVVV",2,7,0.802898550724638,114,120,133,136,147,153,167,170,"TTTGTGA","CTTA","GTGTTTA","CTGA",2.33808957698284,13,11,14,47,2.70484561953851,4.57302736652269,7.78462156942124,101,"ENSG00000079974.19"
"44220","ENSG00000279737.1_269",261,269,9,"ENSG00000279737.1",1,3,"UVMVVVVVV",1,7,0.785507246376811,88,94,133,136,171,177,189,192,"GTGATAA","CTGA","AAGAAGA","CTGA",2.63850844713803,39,35,12,95,0.980092186893257,4.6425371252867,7.78456611079395,101,"ENSG00000079974.19"
"23654","ENSG00000173482.17_340805",340797,340805,9,"ENSG00000173482.17",1,6,"VVVVVMUVV",1,7,0.788819875776397,64,70,87,90,92,98,133,136,"AAGATGA","CTGC","CTGATTT","CTGA",2.57750757842939,17,2,35,63,1.33323891003696,4.62915569155822,7.78443519466381,101,"ENSG00000079974.19"
"32423","ENSG00000226985.7_42187",42179,42187,9,"ENSG00000226985.7",1,8,"VVVVVVUMV",1,7,0.770186335403727,76,82,92,95,102,108,133,136,"ATGATTA","GAGA","GTTAAGA","CTGA",2.49326182318595,10,7,25,51,2.19282464786701,4.70364253394333,7.78438787555824,101,"ENSG00000079974.19"
"41132","ENSG00000258561.2_128251",128243,128251,9,"ENSG00000258561.2",1,1,"MVVVVVUVV",1,7,0.792132505175983,59,65,80,83,114,120,133,136,"ATGATGA","CAGA","GAGATCA","CTGG",2.4888527255353,15,31,13,68,1.87105363607789,4.61585128491163,7.78438130561557,101,"ENSG00000079974.19"
"28264","ENSG00000188580.15_654153",654145,654153,9,"ENSG00000188580.15",0,NA,"UVVVUVVVV",2,7,0.792546583850932,103,109,133,136,148,154,163,166,"ATAATGA","TTTA","CTGATAG","CTGA",2.47113026212564,24,12,9,54,1.98257265187057,4.6141935998437,7.78437993524743,101,"ENSG00000079974.19"
"33278","ENSG00000229192.6_42797",42789,42797,9,"ENSG00000229192.6",0,NA,"VVVVUUVVV",2,7,0.812008281573499,92,98,133,136,145,151,173,176,"ATGATGT","TGGA","TTGGGGA","CTGA",2.5167386641529,35,9,22,75,1.36682319236291,4.53627023834556,7.78430336463956,101,"ENSG00000079974.19"
"34190","ENSG00000232072.1_13347",13339,13347,9,"ENSG00000232072.1",0,NA,"VVVVUUVVV",2,7,0.812008281573499,92,98,133,136,145,151,173,176,"ATGATGT","TGGA","TTGGGGA","CTGA",2.5167386641529,35,9,22,75,1.36682319236291,4.53627023834556,7.78430336463956,101,"ENSG00000079974.19"
"25156","ENSG00000179833.4_17782",17774,17782,9,"ENSG00000179833.4",1,8,"UVVVVVVMV",1,7,0.786749482401656,87,93,133,136,155,161,170,173,"ATGATGA","CTTG","TTGTTTA","CTGA",2.5839584108514,40,19,9,77,1.32282147775535,4.63730272085784,7.78430065046447,101,"ENSG00000079974.19"
"26834","ENSG00000185052.13_132790",132782,132790,9,"ENSG00000185052.13",1,8,"VVUVVVVMV",1,7,0.767701863354037,113,119,133,136,152,158,176,179,"ATATTGA","CAGA","CTGAAGA","CTGA",2.51478660754716,14,16,18,57,2.08858715958356,4.71345780247449,7.78426525589064,101,"ENSG00000079974.19"
"31908","ENSG00000225233.2_21509",21501,21509,9,"ENSG00000225233.2",1,6,"UVVVVMVVV",1,7,0.805383022774327,85,91,133,136,143,149,162,165,"ATGATCA","GAGA","GCAATGA","CTGA",2.44962066085212,42,7,13,71,1.91979253474538,4.56264923510655,7.78418132620386,101,"ENSG00000079974.19"
"40494","ENSG00000256615.1_18867",18859,18867,9,"ENSG00000256615.1",1,8,"UVVVVVVMV",1,7,0.786749482401656,82,88,98,101,112,118,133,136,"CTGATGC","GGGA","GGGATCA","CTGA",2.39567355942792,10,11,15,45,2.57752100538807,4.63716951706022,7.78416744666685,101,"ENSG00000079974.19"
"3590","ENSG00000086289.13_29386",29378,29386,9,"ENSG00000086289.13",1,8,"UVVVVVVMV",1,7,0.786749482401656,45,51,62,65,115,121,133,136,"ATGATGA","CTGG","GGGAAGA","CTGG",2.4922422030917,11,50,12,82,1.93370337732507,4.6371628494841,7.78416077909073,101,"ENSG00000079974.19"
"48026","ENSG00000290149.1_266183",266175,266183,9,"ENSG00000290149.1",1,8,"UVVVVVVMV",1,7,0.786749482401656,45,51,62,65,115,121,133,136,"ATGATGA","CTGG","GGGAAGA","CTGG",2.4922422030917,11,50,12,82,1.93370337732507,4.6371628494841,7.78416077909073,101,"ENSG00000079974.19"
"2737","ENSG00000077943.8_153650",153642,153650,9,"ENSG00000077943.8",1,2,"UMVVVVVVV",1,7,0.786749482401656,111,117,133,136,144,150,178,181,"CTGATGC","CTGT","GTGGAAA","CTGA",2.48242737754516,16,8,28,61,1.99902634374007,4.63713554851029,7.78413347811691,101,"ENSG00000079974.19"
"43838","ENSG00000274317.2_22076",22068,22076,9,"ENSG00000274317.2",1,2,"UMVVVVVVV",1,7,0.786749482401656,94,100,133,136,140,146,159,162,"TTTATGA","CAGA","GTGGTGG","CTGA",2.51619505993038,33,4,13,59,1.77376930524239,4.6371007595279,7.78409868913453,101,"ENSG00000079974.19"
"44570","ENSG00000283052.2_199509",199501,199509,9,"ENSG00000283052.2",0,NA,"UVVVVVUVV",2,7,0.788819875776397,75,81,95,98,110,116,133,136,"GAGATGT","CTTA","GGGATGG","CTGA",2.41309100748886,14,12,17,52,2.42764947298967,4.62873071406218,7.78401021716777,101,"ENSG00000079974.19"
"14236","ENSG00000144642.22_1074756",1074748,1074756,9,"ENSG00000144642.22",1,8,"UVVVVVVMV",1,7,0.786749482401656,115,121,133,136,142,148,175,178,"GTCATAA","CTGT","GTGATGG","CTGA",2.45403183309457,12,6,27,54,2.18761328221936,4.63695637571246,7.78395430531909,101,"ENSG00000079974.19"
"44786","ENSG00000283563.1_1300369",1300361,1300369,9,"ENSG00000283563.1",1,8,"UVVVVVVMV",1,7,0.786749482401656,115,121,133,136,142,148,175,178,"GTCATAA","CTGT","GTGATGG","CTGA",2.45403183309457,12,6,27,54,2.18761328221936,4.63695637571246,7.78395430531909,101,"ENSG00000079974.19"
"20857","ENSG00000165895.19_228993",228985,228993,9,"ENSG00000165895.19",1,1,"MVVVVUVVV",1,7,0.82815734989648,87,93,106,109,112,118,133,136,"GTGAATA","CTAA","ATAAAGG","CTGA",2.30078389648462,13,3,15,40,2.54671263256553,4.47131798561575,7.78394738520167,101,"ENSG00000079974.19"
"7817","ENSG00000115825.11_5750",5742,5750,9,"ENSG00000115825.11",1,6,"UVVVVMVVV",1,7,0.805383022774327,88,94,101,104,111,117,133,136,"ATAATGA","GTGA","ATGAGGT","CTTA",2.37518489001474,7,7,16,39,2.41506977045634,4.56240892597199,7.7839410170693,101,"ENSG00000079974.19"
"7465","ENSG00000114353.17_15441",15433,15441,9,"ENSG00000114353.17",1,7,"VVVVUVMVV",1,7,0.775155279503105,46,52,61,64,71,77,133,136,"GTGAGGA","ATGA","CTGCTGT","CTGA",2.53434354125101,9,7,56,81,1.8367695565771,4.68309829122929,7.78371940924171,101,"ENSG00000079974.19"
"15813","ENSG00000149646.12_73083",73075,73083,9,"ENSG00000149646.12",1,1,"MVUVVVVVV",1,7,0.789648033126294,53,59,78,81,88,94,133,136,"ATGACTA","CTGA","TTGTTGC","CTGA",2.53479646283545,19,7,39,74,1.60174742369831,4.625097627317,7.78368975982218,101,"ENSG00000079974.19"
"19178","ENSG00000162409.12_40052",40044,40052,9,"ENSG00000162409.12",1,1,"MVVVVVUVV",1,7,0.792132505175983,109,115,133,136,148,154,172,175,"TTGATGA","ATGA","CTGATGG","ATGA",2.45883623953958,18,12,18,57,2.06825326117393,4.61512371452611,7.78365373523004,101,"ENSG00000079974.19"
"22970","ENSG00000171843.17_61671",61663,61671,9,"ENSG00000171843.17",1,2,"UMVVVVVVV",1,7,0.786749482401656,74,80,94,97,99,105,133,136,"GTGATGA","CTGA","TTGATTG","CTCA",2.53235206439048,14,2,28,53,1.66381217058698,4.63653981663088,7.78353774623751,101,"ENSG00000079974.19"
"16315","ENSG00000151322.20_345618",345610,345618,9,"ENSG00000151322.20",1,7,"VVVVUVMVV",1,7,0.775155279503105,110,116,133,136,150,156,169,172,"ATGAAAA","CTGC","GTGAAGG","CTGA",2.46517977559126,17,14,13,53,2.29707918207127,4.68290275483659,7.78352387284901,101,"ENSG00000079974.19"
"20267","ENSG00000164588.8_104853",104845,104853,9,"ENSG00000164588.8",1,6,"UVVVVMVVV",1,7,0.805383022774327,111,117,133,136,143,149,162,165,"ATCAAGA","CTCA","AGAATGT","CTGA",2.32271940861986,16,7,13,45,2.76303691370971,4.56195824279386,7.78349033389117,101,"ENSG00000079974.19"
"25761","ENSG00000182674.6_26010",26002,26010,9,"ENSG00000182674.6",1,1,"MVUVVVVVV",1,7,0.789648033126294,69,75,88,91,99,105,133,136,"ATGATAA","CTAA","ATGATGA","CAGA",2.45138695269261,13,8,28,58,2.15675520512419,4.6248337224354,7.78342585494057,101,"ENSG00000079974.19"
"28144","ENSG00000188191.16_72101",72093,72101,9,"ENSG00000188191.16",0,NA,"UVVVUVVVV",2,7,0.792546583850932,112,118,133,136,147,153,202,205,"AGGATGA","CCAA","AAGATGA","CTGA",2.50579402643067,15,11,49,84,1.74765661059886,4.61323753003416,7.78342386543789,101,"ENSG00000079974.19"
"6374","ENSG00000109667.12_124719",124711,124719,9,"ENSG00000109667.12",1,2,"VMVVVVUVV",1,7,0.770186335403727,92,98,133,136,139,145,169,172,"CTGATGA","GAGA","ATGATGA","CTGA",2.66810691130512,35,3,24,71,1.02332532156357,4.70267618256609,7.78342152418099,101,"ENSG00000079974.19"
"36766","ENSG00000242880.2_33998",33990,33998,9,"ENSG00000242880.2",1,8,"VVUVVVVMV",1,7,0.767701863354037,113,119,133,136,152,158,176,179,"ATAAGGA","CAGA","TTGAAGA","CTGA",2.51424241921628,14,16,18,57,2.08858715958356,4.71255082192301,7.78335827533916,101,"ENSG00000079974.19"
"37496","ENSG00000248309.9_543981",543973,543981,9,"ENSG00000248309.9",1,1,"MVVVVUVVV",1,7,0.82815734989648,104,110,133,136,148,154,162,165,"TAGATGA","AAGA","TTGATTT","CTGA",2.37950193731216,23,12,8,52,2.01929617961172,4.47066060708986,7.78329000667578,101,"ENSG00000079974.19"
"2222","ENSG00000071909.19_243156",243148,243156,9,"ENSG00000071909.19",1,6,"VVVVUMVVV",1,7,0.792546583850932,116,122,133,136,159,165,190,193,"GAGATGA","CTTA","GTGCAGA","CTGA",2.55470484477357,11,23,25,68,1.42095045272592,4.61307902113742,7.78326535654115,101,"ENSG00000079974.19"
"8258","ENSG00000117625.14_24931",24923,24931,9,"ENSG00000117625.14",1,6,"VVVVVMUVV",1,7,0.788819875776397,115,121,133,136,150,156,167,170,"ATACTGA","CAGA","ATGCCAA","CTGA",2.38485791827214,12,14,11,46,2.61284691321392,4.62797492542372,7.78325442852931,101,"ENSG00000079974.19"
"23405","ENSG00000172915.20_67570",67562,67570,9,"ENSG00000172915.20",1,1,"MVVVVUVVV",1,7,0.82815734989648,27,33,43,46,83,89,133,136,"GTGGTGA","CAGA","GGGAGGA","CTGA",2.54106232089283,10,37,44,100,0.941909975218371,4.47058136195931,7.78321076154523,101,"ENSG00000079974.19"
"48169","ENSG00000290551.1_548597",548589,548597,9,"ENSG00000290551.1",1,1,"MVVVVUVVV",1,7,0.82815734989648,111,117,133,136,141,147,202,205,"GTGAGGA","GTGG","CTGAGGC","CTGA",2.41683442935438,16,5,55,85,1.77006361482234,4.47057328596288,7.78320268554881,101,"ENSG00000079974.19"
"24289","ENSG00000175728.4_515",507,515,9,"ENSG00000175728.4",0,NA,"VVVUVUVVV",2,7,0.802898550724638,110,116,133,136,143,149,188,191,"ATGAGGT","CTGG","ATGACCA","CTGA",2.47593205031366,17,7,39,72,1.77989725610442,4.57152773121554,7.78312193411409,101,"ENSG00000079974.19"
"5552","ENSG00000105821.15_19749",19741,19749,9,"ENSG00000105821.15",1,2,"VMVVVUVVV",1,7,0.806211180124223,107,113,133,136,167,173,182,185,"GTAATGA","TGGA","GTGATCA","CTGA",2.50521504411437,20,31,9,69,1.5314412694715,4.55821872422516,7.78306344472205,101,"ENSG00000079974.19"
"13374","ENSG00000141258.13_8397",8389,8397,9,"ENSG00000141258.13",1,7,"VVVVVUMVV",1,7,0.807453416149068,83,89,108,111,114,120,133,136,"GTGGTGA","CTGA","CTGAGGC","TTGA",2.40111765520309,19,3,13,44,2.2055338075699,4.55324621056429,7.78305987516057,101,"ENSG00000079974.19"
"15343","ENSG00000147905.18_221252",221244,221252,9,"ENSG00000147905.18",1,6,"VVVVVMUVV",1,7,0.788819875776397,32,38,54,57,98,104,133,136,"GAGATGA","TTGA","GTGATGC","CTGA",2.627705195719,16,41,29,95,0.992953806459994,4.62774711114667,7.78302661425226,101,"ENSG00000079974.19"
"19907","ENSG00000163947.12_69273",69265,69273,9,"ENSG00000163947.12",1,8,"VVVVVUVMV",1,7,0.806211180124224,46,52,65,68,72,78,133,136,"TAGAAGA","CTGA","CTGAATA","CTGA",2.45979503232944,13,4,55,81,1.83407548575621,4.55817725865478,7.78302197915167,101,"ENSG00000079974.19"
"25103","ENSG00000179399.15_917554",917546,917554,9,"ENSG00000179399.15",1,2,"VMVVVUVVV",1,7,0.806211180124223,103,109,133,136,155,161,182,185,"ATGATAA","ATGA","GTAATTA","CTGA",2.58473848012072,24,19,21,73,1.0010826384482,4.55816812647991,7.7830128469768,101,"ENSG00000079974.19"
"19427","ENSG00000162959.14_71195",71187,71195,9,"ENSG00000162959.14",1,8,"UVVVVVVMV",1,7,0.786749482401656,103,109,133,136,147,153,163,166,"AGGATGA","ATCA","ATGCTGC","CTGA",2.47360746721814,24,11,10,54,2.05316613434392,4.63597064561621,7.78296857522284,101,"ENSG00000079974.19"
"19429","ENSG00000162961.14_99770",99762,99770,9,"ENSG00000162961.14",1,8,"UVVVVVVMV",1,7,0.786749482401656,103,109,133,136,147,153,163,166,"AGGATGA","ATCA","ATGCTGC","CTGA",2.47360746721814,24,11,10,54,2.05316613434392,4.63597064561621,7.78296857522284,101,"ENSG00000079974.19"
"26030","ENSG00000183185.10_45121",45113,45121,9,"ENSG00000183185.10",1,1,"MVUVVVVVV",1,7,0.789648033126294,104,110,133,136,181,187,206,209,"ATGATGA","GTAA","GTGAGTA","CTGA",2.64694624615229,23,45,19,96,0.850969300249055,4.62431940198274,7.78291153448791,101,"ENSG00000079974.19"
"27192","ENSG00000185737.13_198968",198960,198968,9,"ENSG00000185737.13",1,1,"MVVVVVUVV",1,7,0.792132505175983,111,117,133,136,142,148,163,166,"GAGATGG","TTGA","GTCTGGA","CTGA",2.37218165435831,16,6,15,46,2.64291398431127,4.614364586675,7.78289460737893,101,"ENSG00000079974.19"
"7508","ENSG00000114487.10_63806",63798,63806,9,"ENSG00000114487.10",1,2,"UMVVVVVVV",1,7,0.786749482401656,76,82,94,97,105,111,133,136,"ATGCAGA","CTTA","GTTATGT","CTGA",2.42225399457616,12,8,22,51,2.39486190421808,4.63580546701478,7.7828033966214,101,"ENSG00000079974.19"
"7612","ENSG00000115170.16_53100",53092,53100,9,"ENSG00000115170.16",1,1,"MVVVVUVVV",1,7,0.82815734989648,114,120,133,136,145,151,170,173,"ACAATGA","TTCA","AAGTTGA","CTGA",2.30375363025963,13,9,19,50,2.52224550927215,4.47015076108409,7.78278016067001,101,"ENSG00000079974.19"
"44456","ENSG00000282278.1_377501",377493,377501,9,"ENSG00000282278.1",1,2,"UMVVVUVVV",2,6,0.708902691511387,112,118,133,136,138,144,154,157,"ATGATAA","CAGA","ATTAAGA","CTGA",2.58767923376548,15,2,10,36,2.53725453224883,4.94711235600467,7.78272312205022,101,"ENSG00000079974.19"
"15408","ENSG00000148180.22_53330",53322,53330,9,"ENSG00000148180.22",1,6,"UVVVVMVVV",1,7,0.805383022774327,108,114,133,136,151,157,171,174,"ATGGTGC","CTGC","CTGGTGG","CTGA",2.43638696769868,19,15,14,57,2.00200844381346,4.56114705711784,7.78267914821515,101,"ENSG00000079974.19"
"29595","ENSG00000198382.9_139275",139267,139275,9,"ENSG00000198382.9",1,2,"UMVVVVVVV",1,7,0.786749482401656,84,90,108,111,116,122,133,136,"ATGATGC","CTGA","ATTTTTA","CTGT",2.39200399077119,18,5,11,43,2.5959736736364,4.63566673636109,7.78266466596771,101,"ENSG00000079974.19"
"20687","ENSG00000165323.16_61216",61208,61216,9,"ENSG00000165323.16",1,2,"UMVVVVVVV",1,7,0.786749482401656,108,114,133,136,147,153,172,175,"GAGATGA","CTGC","GTGACTC","CTGA",2.483321274094,19,11,19,58,1.98719057250271,4.63566643328234,7.78266436288897,101,"ENSG00000079974.19"
"20576","ENSG00000165091.18_72618",72610,72618,9,"ENSG00000165091.18",1,8,"VVVVVUVMV",1,7,0.806211180124224,86,92,106,109,114,120,133,136,"CTCATGA","CTGA","ATGGACA","CTAA",2.30887513606837,14,5,13,41,2.83865348206628,4.55778859729719,7.78263331779408,101,"ENSG00000079974.19"
"14030","ENSG00000144278.15_67586",67578,67586,9,"ENSG00000144278.15",1,3,"VVMVVVUVV",1,7,0.768944099378882,58,64,79,82,116,122,133,136,"TTGATGA","ATGA","ACATTGA","CTGA",2.53617697313031,15,34,11,69,1.91934991567498,4.7067991008026,7.78257549831812,101,"ENSG00000079974.19"
"37843","ENSG00000248973.3_223595",223587,223595,9,"ENSG00000248973.3",1,2,"UMVVVVVVV",1,7,0.786749482401656,88,94,112,115,116,122,133,136,"TTGCAGA","CTGA","GTGAGTA","CTGA",2.47793116643461,18,1,11,39,2.02263518564614,4.63554407380255,7.78254200340917,101,"ENSG00000079974.19"
"2977","ENSG00000079841.20_491818",491810,491818,9,"ENSG00000079841.20",0,NA,"UVVVUVVVV",2,7,0.792546583850932,86,92,101,104,111,117,133,136,"TTGATGA","CTAA","TTGTGGA","CAGA",2.37453152678328,9,7,16,41,2.61895097253261,4.61229028777196,7.78247662317569,101,"ENSG00000079974.19"
"22465","ENSG00000170615.15_56190",56182,56190,9,"ENSG00000170615.15",1,1,"MVVVVUVVV",1,7,0.82815734989648,115,121,133,136,151,157,170,173,"ATCATAA","CATA","TTGAGTA","CTGA",2.31075016648655,12,15,13,49,2.47430530169348,4.46982660290095,7.78245600248688,101,"ENSG00000079974.19"
"4668","ENSG00000101542.10_27158",27150,27158,9,"ENSG00000101542.10",1,6,"VVVVVMUVV",1,7,0.788819875776397,104,110,133,136,150,156,172,175,"TTTATGG","CTGA","GTGAAGG","CTGA",2.52815325249385,23,14,16,62,1.65431346150143,4.62716711953177,7.78244662263736,101,"ENSG00000079974.19"
"4157","ENSG00000095951.17_16444",16436,16444,9,"ENSG00000095951.17",0,NA,"UVVVVUVVV",2,7,0.824844720496894,114,120,133,136,180,186,202,205,"ATGTTGA","CTTT","TTGCTAA","CTGA",2.42622598483566,13,44,16,82,1.75739182360748,4.48305793062797,7.78243681261554,101,"ENSG00000079974.19"
"5600","ENSG00000105967.16_208572",208564,208572,9,"ENSG00000105967.16",0,NA,"UVVUVVVVV",2,7,0.78343685300207,114,120,133,136,147,153,167,170,"ATGAGAA","TTGC","ATGATTA","CTGA",2.38341925338698,13,11,14,47,2.70484561953851,4.64857682719626,7.78232423920454,101,"ENSG00000079974.19"
"44634","ENSG00000283217.1_49361",49353,49361,9,"ENSG00000283217.1",1,2,"UMVVVVVVV",1,7,0.786749482401656,116,122,133,136,143,149,175,178,"ATTATAA","CAGA","CTGAGAA","CTGA",2.44946940475863,11,7,26,53,2.21130148005632,4.63527437794513,7.78227230755175,101,"ENSG00000079974.19"
"44672","ENSG00000283341.4_26908",26900,26908,9,"ENSG00000283341.4",1,2,"UMVVVVVVV",1,7,0.786749482401656,116,122,133,136,143,149,175,178,"ATTATAA","CAGA","CTGAGAA","CTGA",2.44946940475863,11,7,26,53,2.21130148005632,4.63527437794513,7.78227230755175,101,"ENSG00000079974.19"
"41727","ENSG00000259616.2_40137",40129,40137,9,"ENSG00000259616.2",1,6,"VVVUVMVVV",1,7,0.78343685300207,115,121,133,136,148,154,163,166,"GTGAGGA","ATGT","ATGGAGG","CTGA",2.37180612116509,12,12,9,42,2.78204584031701,4.64852166202107,7.78226907402935,101,"ENSG00000079974.19"
"32288","ENSG00000226647.2_31612",31604,31612,9,"ENSG00000226647.2",0,NA,"UVVVUVVVV",2,7,0.792546583850932,110,116,133,136,140,146,167,170,"ATGAAGA","TGGA","GTGAAAC","CTGA",2.45918732090775,17,4,21,51,2.05353556867877,4.61202942701594,7.78221576241967,101,"ENSG00000079974.19"
"28031","ENSG00000188001.10_21778",21770,21778,9,"ENSG00000188001.10",1,7,"VVVVVUMVV",1,7,0.807453416149068,110,116,133,136,144,150,159,162,"ATGTTGC","TTGG","GTGTATA","CTGA",2.31851236285732,17,8,9,43,2.7526408765568,4.55234749056807,7.78216115516435,101,"ENSG00000079974.19"
"42262","ENSG00000261397.1_3477",3469,3477,9,"ENSG00000261397.1",1,8,"VVVVVUVMV",1,7,0.806211180124224,113,119,133,136,148,154,163,166,"GTGTTTG","CTAA","ATGAAGA","CTGA",2.32382070578863,14,12,9,44,2.73707024608165,4.55730207116814,7.78214679166503,101,"ENSG00000079974.19"
"41769","ENSG00000259692.6_323722",323714,323722,9,"ENSG00000259692.6",1,8,"VVVVUVVMV",1,7,0.773913043478261,111,117,133,136,149,155,169,172,"GAGATGA","CACA","AGGATGA","CTGA",2.45132392944021,16,13,14,52,2.40368896102204,4.68646212265586,7.7821142965689,101,"ENSG00000079974.19"
"36222","ENSG00000238755.3_504451",504443,504451,9,"ENSG00000238755.3",1,2,"VMVVVUVVV",1,7,0.806211180124223,112,118,133,136,142,148,201,204,"ATGAAGA","TAGA","TGGATAA","CTGA",2.4501811307376,15,6,53,83,1.89447611953356,4.55725424777939,7.78209896827629,101,"ENSG00000079974.19"
"34258","ENSG00000232310.10_112257",112249,112257,9,"ENSG00000232310.10",1,8,"VVVVVUVMV",1,7,0.806211180124224,116,122,133,136,140,146,161,164,"ATGATGA","AAGA","GGGCAGA","CTGT",2.33317444646059,11,4,15,39,2.67446341308508,4.55723993070558,7.78208465120247,101,"ENSG00000079974.19"
"13232","ENSG00000140718.21_24220",24212,24220,9,"ENSG00000140718.21",1,1,"MVVVUVVVV",1,7,0.795859213250517,65,71,87,90,109,115,133,136,"CTGATGA","CTGT","TTGATGA","CTGT",2.4896753172759,16,19,18,62,1.79667861812702,4.59862851665826,7.78206536966033,101,"ENSG00000079974.19"
"4402","ENSG00000100433.16_98008",98000,98008,9,"ENSG00000100433.16",1,8,"UVVVVVVMV",1,7,0.786749482401656,93,99,133,136,186,192,204,207,"ATGATTT","CTGA","AAGATGA","CTGA",2.63528325211238,34,50,12,105,0.971113755090135,4.63491719229317,7.78191512189979,101,"ENSG00000079974.19"
"32746","ENSG00000227712.3_95388",95380,95388,9,"ENSG00000227712.3",0,NA,"VVVVVUUVV",2,7,0.808281573498965,113,119,133,136,141,147,157,160,"TTCATGA","CGTA","ATTAACA","CTGA",2.2859752550717,14,5,10,38,2.95516023325629,4.5487488167669,7.78187511076276,101,"ENSG00000079974.19"
"46242","ENSG00000286330.1_42186",42178,42186,9,"ENSG00000286330.1",1,5,"VVVVMUVVV",1,7,0.808695652173913,67,73,95,98,112,118,133,136,"GTGATGA","ATGA","GTGATTG","CTCA",2.46167619844318,22,14,15,60,1.77689466803799,4.54701733108147,7.78179993977712,101,"ENSG00000079974.19"
"31680","ENSG00000224400.5_53358",53350,53358,9,"ENSG00000224400.5",1,8,"VVUVVVVMV",1,7,0.767701863354037,113,119,133,136,145,151,172,175,"ATGATGT","CGGC","GTGACAG","CTGA",2.47032771550087,14,9,21,53,2.37494295172615,4.71094859709965,7.7817560505158,101,"ENSG00000079974.19"
"20318","ENSG00000164631.19_9414",9406,9414,9,"ENSG00000164631.19",0,NA,"UVVVVVUVV",2,7,0.788819875776397,111,117,133,136,139,145,181,184,"TTGATCT","CTGA","TTGATAA","CTGA",2.53844425318049,16,3,36,64,1.58285665170943,4.62645458489485,7.78173408800044,101,"ENSG00000079974.19"
"20396","ENSG00000164796.18_233273",233265,233273,9,"ENSG00000164796.18",1,1,"MVVVVUVVV",1,7,0.82815734989648,83,89,101,104,115,121,133,136,"ATGTTAA","TTGA","CTGAGGA","TTGA",2.26110305367248,12,11,12,44,2.80200557223349,4.46900648251251,7.78163588209843,101,"ENSG00000079974.19"
"3878","ENSG00000090054.16_16936",16928,16936,9,"ENSG00000090054.16",0,NA,"VVUVVVUVV",2,7,0.769772256728778,114,120,133,136,144,150,160,163,"TTGTTGA","ATGG","CTGTGGA","CTGA",2.36921637338389,13,8,10,40,3.01535129197326,4.70253177863313,7.78162080554824,101,"ENSG00000079974.19"
"15204","ENSG00000147316.15_184811",184803,184811,9,"ENSG00000147316.15",1,5,"VVVVMVUVV",1,7,0.772670807453416,116,122,133,136,141,147,155,158,"ATGTTGA","CTGG","GTGATTT","CTGG",2.35035358944277,11,5,8,33,3.09466359973071,4.69092188233729,7.78160511215096,101,"ENSG00000079974.19"
"30031","ENSG00000198959.12_24886",24878,24886,9,"ENSG00000198959.12",1,5,"VVVVMVUVV",1,7,0.772670807453416,85,91,100,103,116,122,133,136,"GAGATGG","CTGG","GTGGGGA","CTGA",2.43450459604217,9,13,11,42,2.53360360566319,4.69090856148608,7.78159179129974,101,"ENSG00000079974.19"
"11443","ENSG00000134986.14_186256",186248,186256,9,"ENSG00000134986.14",1,1,"MVVVVUVVV",1,7,0.82815734989648,113,119,133,136,140,146,155,158,"TTGCAGA","CAGA","ACAAAGA","CTGA",2.24592240548342,14,4,9,36,2.90285289478319,4.46891723283483,7.78154663242075,101,"ENSG00000079974.19"
"6942","ENSG00000112319.21_65654",65646,65654,9,"ENSG00000112319.21",1,6,"UVVVVMVVV",1,7,0.805383022774327,113,119,133,136,148,154,165,168,"ATGATGA","CAAA","GAGAAAA","ATGA",2.32799014876221,14,12,11,46,2.71964231920111,4.55989416107062,7.78142625216793,101,"ENSG00000079974.19"
"24907","ENSG00000178568.15_669540",669532,669540,9,"ENSG00000178568.15",1,1,"MVVVVUVVV",1,7,0.82815734989648,82,88,98,101,108,114,133,136,"AGGATGT","CAGA","GAGATGA","CTAA",2.30616248271031,10,7,19,45,2.50060394914553,4.46875512513689,7.78138452472282,101,"ENSG00000079974.19"
"87","ENSG00000004864.14_164964",164956,164964,9,"ENSG00000004864.14",1,3,"VVMVVUVVV",1,7,0.804968944099379,107,113,133,136,141,147,167,170,"ATGATGC","GTGC","GAGAAGC","CTGA",2.44613483301608,20,5,20,54,1.9383106243771,4.56146904445442,7.78134482085193,101,"ENSG00000079974.19"
"6353","ENSG00000109466.14_101836",101828,101836,9,"ENSG00000109466.14",1,8,"UVVVVVVMV",1,7,0.786749482401656,86,92,133,136,140,146,159,162,"ATGGTGA","GAGA","GTGAAAA","CTGA",2.51689914699529,41,4,13,67,1.75785381871154,4.6342953663367,7.78129329594333,101,"ENSG00000079974.19"
"5069","ENSG00000102935.12_207955",207947,207955,9,"ENSG00000102935.12",1,2,"VMVVUVVVV",1,7,0.773913043478261,106,112,133,136,143,149,157,160,"ATGATGA","CTCA","TGGAGGA","GTGA",2.45185346457444,21,7,8,45,2.39597203630609,4.68541545003393,7.78106762394697,101,"ENSG00000079974.19"
"9681","ENSG00000126216.15_34306",34298,34306,9,"ENSG00000126216.15",1,2,"VMVVVUVVV",1,7,0.806211180124223,114,120,133,136,139,145,154,157,"CTCAAGA","CAGT","GTGCTGA","CTGA",2.30441932469445,13,3,9,34,2.86183285417471,4.55615708803443,7.78100180853133,101,"ENSG00000079974.19"
"22417","ENSG00000170522.10_15645",15637,15645,9,"ENSG00000170522.10",1,8,"VVVUVVVMV",1,7,0.764803312629399,115,121,133,136,149,155,164,167,"TTGTTGA","CAGC","TTGAAGA","CTGA",2.42727458804411,12,13,9,43,2.70531919494812,4.72178744547721,7.78100069599481,101,"ENSG00000079974.19"
"6981","ENSG00000112414.15_30439",30431,30439,9,"ENSG00000112414.15",0,NA,"UVVVVUVVV",2,7,0.824844720496894,112,118,133,136,144,150,169,172,"GTGATGA","CTAG","GTGATAC","CAGA",2.31818391078631,15,8,19,51,2.47186958003076,4.48160724631821,7.78098612830579,101,"ENSG00000079974.19"
"28549","ENSG00000196092.14_54555",54547,54555,9,"ENSG00000196092.14",1,6,"VVUVVMVVV",1,7,0.786335403726708,75,81,92,95,102,108,133,136,"AAAATGG","CTGA","CTGGAGA","CTGA",2.44413605781152,11,7,25,52,2.24813016606736,4.63559263786937,7.7809342527762,101,"ENSG00000079974.19"
"25374","ENSG00000181171.5_40475",40467,40475,9,"ENSG00000181171.5",1,8,"VVVVUVVMV",1,7,0.773913043478261,88,94,101,104,112,118,133,136,"GTGATCA","CTGG","ATCATAT","CTGA",2.44212263663039,7,8,15,39,2.46028092755748,4.68527462627336,7.7809268001864,101,"ENSG00000079974.19"
"28658","ENSG00000196284.17_485150",485142,485150,9,"ENSG00000196284.17",1,1,"MVVVVVUVV",1,7,0.792132505175983,102,108,133,136,138,144,183,186,"TTGATGA","CAGA","GTCAAGA","CTGA",2.6590501592075,25,2,39,75,0.721913108146248,4.6122285423824,7.78075856308633,101,"ENSG00000079974.19"
"19210","ENSG00000162542.14_60310",60302,60310,9,"ENSG00000162542.14",1,2,"UMVVVVVVV",1,7,0.786749482401656,113,119,133,136,154,160,169,172,"AGGATGA","TAGA","GTATTTA","CTGA",2.42978896943374,14,18,9,50,2.33605336437419,4.63366162348312,7.78065955308975,101,"ENSG00000079974.19"
"37302","ENSG00000246876.7_152030",152022,152030,9,"ENSG00000246876.7",1,1,"MVVVVUVVV",1,7,0.82815734989648,116,122,133,136,174,180,188,191,"CTGAAGT","TTGA","TTGATTT","CTGA",2.38589931300142,11,38,8,66,1.96595814460225,4.46798839115294,7.78061779073886,101,"ENSG00000079974.19"
"30734","ENSG00000212719.15_70260",70252,70260,9,"ENSG00000212719.15",1,5,"VVVVMUVVV",1,7,0.808695652173913,115,121,133,136,150,156,176,179,"TGGTTGA","CTGG","GTGCTGA","CTGA",2.40656800560558,12,14,20,55,2.13939343160491,4.54579503391053,7.78057764260618,101,"ENSG00000079974.19"
"46145","ENSG00000286218.2_14098",14090,14098,9,"ENSG00000286218.2",1,1,"MVVVUUVVV",2,6,0.718012422360248,106,112,133,136,141,147,180,183,"ATGATGA","ATGA","TTGATAC","CTGA",2.73253359351216,21,5,33,68,1.41718454645001,4.9085187924661,7.7805684819071,101,"ENSG00000079974.19"
"28434","ENSG00000189108.13_529033",529025,529033,9,"ENSG00000189108.13",1,2,"UMVVVVVVV",1,7,0.786749482401656,114,120,133,136,144,150,179,182,"GTGAGGA","CTGA","CTGATGT","CTAA",2.46044291105931,13,8,29,59,2.1311853990133,4.63353453485218,7.7805324644588,101,"ENSG00000079974.19"
"10089","ENSG00000129158.11_51374",51366,51374,9,"ENSG00000129158.11",1,3,"VVMUVVVVV",1,7,0.763561076604555,99,105,133,136,146,152,166,169,"ATGAGGA","TTGA","GTGCTCT","CTGA",2.55860132429289,28,10,14,61,1.84752059848928,4.72621569011046,7.78045999652868,101,"ENSG00000079974.19"
"3762","ENSG00000088876.13_32243",32235,32243,9,"ENSG00000088876.13",1,2,"UMVVVVVVV",1,7,0.786749482401656,106,112,133,136,165,171,181,184,"GTGATAA","ATGA","GTGATAG","CTGA",2.55938663524479,21,29,10,69,1.47105450448044,4.63340801819476,7.78040594780138,101,"ENSG00000079974.19"
"40485","ENSG00000256566.1_16448",16440,16448,9,"ENSG00000256566.1",1,2,"UMVVVVVVV",1,7,0.786749482401656,106,112,133,136,165,171,181,184,"GTGATAA","ATGA","GTGATAG","CTGA",2.55938663524479,21,29,10,69,1.47105450448044,4.63340801819476,7.78040594780138,101,"ENSG00000079974.19"
"43074","ENSG00000268043.9_23858",23850,23858,9,"ENSG00000268043.9",1,2,"VMVUVVVVV",1,7,0.764803312629399,114,120,133,136,143,149,191,194,"ATGAAGA","CATA","ATGCTGA","CTGA",2.53131929330568,13,7,42,71,2.00930397569376,4.72119148276624,7.78040473328383,101,"ENSG00000079974.19"
"43173","ENSG00000269713.9_23427",23419,23427,9,"ENSG00000269713.9",1,2,"VMVUVVVVV",1,7,0.764803312629399,114,120,133,136,143,149,191,194,"ATGAAGA","CATA","ATGCTGA","CTGA",2.53131929330568,13,7,42,71,2.00930397569376,4.72119148276624,7.78040473328383,101,"ENSG00000079974.19"
"43176","ENSG00000269713.9_29712",29704,29712,9,"ENSG00000269713.9",1,2,"VMVUVVVVV",1,7,0.764803312629399,114,120,133,136,143,149,191,194,"ATGAAGA","CATA","ATGCTGA","CTGA",2.53131929330568,13,7,42,71,2.00930397569376,4.72119148276624,7.78040473328383,101,"ENSG00000079974.19"
"43270","ENSG00000270629.7_86063",86055,86063,9,"ENSG00000270629.7",1,2,"VMVUVVVVV",1,7,0.764803312629399,114,120,133,136,143,149,191,194,"ATGAAGA","CATA","ATGCTGA","CTGA",2.53131929330568,13,7,42,71,2.00930397569376,4.72119148276624,7.78040473328383,101,"ENSG00000079974.19"
"43323","ENSG00000271383.8_2921",2913,2921,9,"ENSG00000271383.8",1,2,"VMVUVVVVV",1,7,0.764803312629399,114,120,133,136,143,149,191,194,"ATGAAGA","CATA","ATGCTGA","CTGA",2.53131929330568,13,7,42,71,2.00930397569376,4.72119148276624,7.78040473328383,101,"ENSG00000079974.19"
"43361","ENSG00000271425.9_86269",86261,86269,9,"ENSG00000271425.9",1,2,"VMVUVVVVV",1,7,0.764803312629399,114,120,133,136,143,149,191,194,"ATGAAGA","CATA","ATGCTGA","CTGA",2.53131929330568,13,7,42,71,2.00930397569376,4.72119148276624,7.78040473328383,101,"ENSG00000079974.19"
"46102","ENSG00000286185.1_87343",87335,87343,9,"ENSG00000286185.1",1,2,"VMVUVVVVV",1,7,0.764803312629399,114,120,133,136,143,149,191,194,"ATGAAGA","CATA","ATGCTGA","CTGA",2.53131929330568,13,7,42,71,2.00930397569376,4.72119148276624,7.78040473328383,101,"ENSG00000079974.19"
"38409","ENSG00000250131.2_231600",231592,231600,9,"ENSG00000250131.2",0,NA,"UVUVVVVVV",2,7,0.786335403726708,113,119,133,136,142,148,162,165,"ATTCTGA","GGGA","GTGTAGA","CTGA",2.35630662986604,14,6,14,43,2.83144750097253,4.63503959168653,7.78038120659336,101,"ENSG00000079974.19"
"24397","ENSG00000176177.10_125451",125443,125451,9,"ENSG00000176177.10",1,7,"VVVUVVMVV",1,7,0.766045548654244,114,120,133,136,143,149,205,208,"GTGGTGA","CTGT","ATGGAGA","CTGA",2.53029717527161,13,7,56,85,1.99614556471243,4.71619834996413,7.78038054458111,101,"ENSG00000079974.19"
"26437","ENSG00000184226.15_651518",651510,651518,9,"ENSG00000184226.15",1,2,"VMVUVVVVV",1,7,0.764803312629399,86,92,133,136,149,155,166,169,"ATGATGG","CTCA","TTTAAGA","CTGA",2.58052997147629,41,13,11,74,1.6809236341042,4.72111419431988,7.78032744483747,101,"ENSG00000079974.19"
"6997","ENSG00000112425.16_165820",165812,165820,9,"ENSG00000112425.16",1,6,"UVVVVMVVV",1,7,0.805383022774327,82,88,95,98,116,122,133,136,"GTGATGG","CTGA","TTGAAGG","TTGA",2.43880970063596,7,18,11,45,1.97631335113451,4.5587611721769,7.78029326327421,101,"ENSG00000079974.19"
"14430","ENSG00000144935.17_42178",42170,42178,9,"ENSG00000144935.17",1,6,"UVVVVMVVV",1,7,0.805383022774327,82,88,95,98,116,122,133,136,"GTGATGG","CTGA","TTGAAGG","TTGA",2.43880970063596,7,18,11,45,1.97631335113451,4.5587611721769,7.78029326327421,101,"ENSG00000079974.19"
"46400","ENSG00000286583.1_914",906,914,9,"ENSG00000286583.1",1,1,"MVVVUUVVV",2,6,0.718012422360248,92,98,108,111,114,120,133,136,"AGGATGA","CTCA","ATGCAGT","CTGA",2.54428333316544,10,3,13,35,2.67095563339625,4.90821113029146,7.78026081973245,101,"ENSG00000079974.19"
"3940","ENSG00000091140.15_38057",38049,38057,9,"ENSG00000091140.15",1,2,"UMVVVVVVV",1,7,0.786749482401656,116,122,133,136,149,155,204,207,"TTGCTGA","ATGA","TTGCTGA","CTGA",2.52914007561176,11,13,49,82,1.67202981000593,4.63324091185442,7.78023884146104,101,"ENSG00000079974.19"
"42691","ENSG00000265781.1_2259",2251,2259,9,"ENSG00000265781.1",1,2,"UMVVVVVVV",1,7,0.786749482401656,80,86,107,110,114,120,133,136,"TTGATAA","CTGT","CAGAGGA","CTGA",2.45445949478944,21,4,13,47,2.16946464497368,4.63313198589248,7.78012991549911,101,"ENSG00000079974.19"
"31767","ENSG00000224746.2_134914",134906,134914,9,"ENSG00000224746.2",1,7,"UVVVVVMVV",1,7,0.787991718426501,106,112,133,136,154,160,180,183,"AGGATGA","CTTA","TTGAATA","CTGA",2.58204062268274,21,18,20,68,1.29897592364919,4.62814501871686,7.78011189242286,101,"ENSG00000079974.19"
"1104","ENSG00000047648.23_29070",29062,29070,9,"ENSG00000047648.23",1,5,"UVVVMVVVV",1,7,0.789233954451346,102,108,133,136,144,150,159,162,"ATGGTTA","GTGC","GTGATGA","CTGA",2.45027614793722,25,8,9,51,2.15749300635472,4.62316683148404,7.78010264928942,101,"ENSG00000079974.19"
"6766","ENSG00000111817.19_85337",85329,85337,9,"ENSG00000111817.19",1,1,"MVVVVVUVV",1,7,0.792132505175983,110,116,133,136,144,150,159,162,"TTGTTGT","CAGA","TTTAGGA","CTGA",2.3540105461117,17,8,9,43,2.7526408765568,4.61151112932536,7.78004115002929,101,"ENSG00000079974.19"
"10123","ENSG00000129493.15_12451",12443,12451,9,"ENSG00000129493.15",1,6,"UVVVVMVVV",1,7,0.805383022774327,91,97,133,136,146,152,163,166,"ATGATGA","CAGA","GAGAAGC","CAGA",2.45153974290981,36,10,11,66,1.89006012037765,4.55841460161077,7.77994669270808,101,"ENSG00000079974.19"
"30076","ENSG00000203546.7_49342",49334,49342,9,"ENSG00000203546.7",1,6,"UVVVVMVVV",1,7,0.805383022774327,91,97,133,136,146,152,163,166,"ATGATGA","CAGA","GAGAAGC","CAGA",2.45153974290981,36,10,11,66,1.89006012037765,4.55841460161077,7.77994669270808,101,"ENSG00000079974.19"
"2911","ENSG00000079215.15_55613",55605,55613,9,"ENSG00000079215.15",1,7,"VVVVVUMVV",1,7,0.807453416149068,102,108,133,136,141,147,155,158,"ATGAAGT","GTGA","TACATGA","CTGA",2.4171383958444,25,5,8,47,2.08614250131555,4.55009961840288,7.77991328299916,101,"ENSG00000079974.19"
"4931","ENSG00000102452.18_283766",283758,283766,9,"ENSG00000102452.18",1,1,"MVVVVVUVV",1,7,0.792132505175983,115,121,133,136,140,146,189,192,"ATAATGC","TTGA","CTGAAGC","CTGA",2.48944410691319,12,4,43,68,1.84905509349471,4.61133728489566,7.7798673055996,101,"ENSG00000079974.19"
"3559","ENSG00000085832.18_109736",109728,109736,9,"ENSG00000085832.18",1,8,"VVVVVUVMV",1,7,0.806211180124224,107,113,133,136,152,158,173,176,"TTGATGA","CAGC","AGGAAGT","CTGA",2.46358887736872,20,16,15,60,1.79607218292651,4.55499950801282,7.77984422850972,101,"ENSG00000079974.19"
"22710","ENSG00000171189.18_130397",130389,130397,9,"ENSG00000171189.18",1,1,"MVVVVVUVV",1,7,0.792132505175983,114,120,133,136,153,159,181,184,"GTGATGG","CTAC","ATGATAA","CTGA",2.4920840563098,13,17,22,61,1.83131727081957,4.6113027448879,7.77983276559183,101,"ENSG00000079974.19"
"30126","ENSG00000203727.4_57146",57138,57146,9,"ENSG00000203727.4",1,8,"VVVVUVVMV",1,7,0.773913043478261,97,103,133,136,143,149,164,167,"ATGTTGA","ATGG","ATGTTGA","CTGA",2.53136691268466,30,7,15,61,1.86062436879886,4.68410094667415,7.77975312058719,101,"ENSG00000079974.19"
"10583","ENSG00000131725.14_26688",26680,26688,9,"ENSG00000131725.14",1,8,"VVVVVUVMV",1,7,0.806211180124224,116,122,133,136,138,144,152,155,"ATGGTGG","TTTA","ATGCAGG","CTGA",2.30482201668895,11,2,8,30,2.85352026603319,4.55475009432321,7.77959481482011,101,"ENSG00000079974.19"
"20919","ENSG00000165973.19_905954",905946,905954,9,"ENSG00000165973.19",1,3,"UVMVVVVVV",1,7,0.785507246376811,109,115,133,136,148,154,187,190,"GTGCTGA","TTGA","ATGTAGA","CTGA",2.55631430279715,18,12,33,72,1.5081412305661,4.63755914563677,7.77958813114402,101,"ENSG00000079974.19"
"1653","ENSG00000064692.20_25919",25911,25919,9,"ENSG00000064692.20",1,1,"MVVVVUVVV",1,7,0.82815734989648,100,106,133,136,148,154,176,179,"ATGATGA","ATGA","ATTAGGA","CTAA",2.4887172325083,27,12,22,70,1.27611212297395,4.46689008492399,7.77951948450991,101,"ENSG00000079974.19"
"40828","ENSG00000257831.1_5313",5305,5313,9,"ENSG00000257831.1",1,1,"MVVVVUVVV",1,7,0.82815734989648,86,92,133,136,151,157,170,173,"ATGAGGA","TTAA","TTGTTGG","CTGA",2.45903218381323,41,15,13,78,1.4739634814201,4.46687784337708,7.779507242963,101,"ENSG00000079974.19"
"3408","ENSG00000083307.12_140204",140196,140204,9,"ENSG00000083307.12",0,NA,"UVVVUVVVV",2,7,0.792546583850932,113,119,133,136,149,155,167,170,"CTGATAA","TTGT","GTCATGG","CTGA",2.37284917571701,14,13,12,48,2.61795024237316,4.60923618678831,7.77942252219203,101,"ENSG00000079974.19"
"12536","ENSG00000138592.14_81253",81245,81253,9,"ENSG00000138592.14",1,2,"VMVVVUVVV",1,7,0.806211180124223,85,91,106,109,116,122,133,136,"CTGATGA","ATAA","ATGAACA","ATGA",2.29579495101209,15,7,11,42,2.91266155369768,4.5544903067779,7.77933502727479,101,"ENSG00000079974.19"
"14531","ENSG00000145349.20_113216",113208,113216,9,"ENSG00000145349.20",1,7,"VVVUVVMVV",1,7,0.766045548654244,116,122,133,136,143,149,159,162,"CTGCTGA","GTCA","GTGCTCA","CTGA",2.37102417946664,11,7,10,37,3.05362272147605,4.71511264614675,7.77929484076373,101,"ENSG00000079974.19"
"37140","ENSG00000245573.9_69612",69604,69612,9,"ENSG00000245573.9",1,8,"UVVVVVVMV",1,7,0.786749482401656,112,118,133,136,148,154,166,169,"TTTATTA","TTGA","GTGTAGA","CTGA",2.38407422574056,15,12,12,48,2.6352298265801,4.63226449954595,7.77926242915258,101,"ENSG00000079974.19"
"20201","ENSG00000164418.22_555599",555591,555599,9,"ENSG00000164418.22",1,8,"UVVVVVVMV",1,7,0.786749482401656,114,120,133,136,142,148,161,164,"GTGATAA","CTTT","GTTAAAA","CTGA",2.34091358616317,13,6,13,41,2.9227224780417,4.6322032631157,7.77920119272233,101,"ENSG00000079974.19"
"5781","ENSG00000106686.17_72982",72974,72982,9,"ENSG00000106686.17",1,2,"UMVVVVVVV",1,7,0.786749482401656,110,116,133,136,158,164,173,176,"ATGTTGC","ATGA","TTCATGA","CTGA",2.48572570808616,17,22,9,57,1.95713350035854,4.63215955523323,7.77915748483985,101,"ENSG00000079974.19"
"7819","ENSG00000115828.17_621",613,621,9,"ENSG00000115828.17",0,NA,"UVVVVUVVV",2,7,0.824844720496894,69,75,91,94,105,111,133,136,"GAGAGGA","GTGA","GTTCTGA","CTGA",2.37577054599031,16,11,22,58,2.08056508593416,4.47975884813406,7.77913773012163,101,"ENSG00000079974.19"
"22020","ENSG00000169621.11_11718",11710,11718,9,"ENSG00000169621.11",1,8,"UVVVVVVMV",1,7,0.786749482401656,113,119,133,136,149,155,168,171,"TTGTTGT","ATGA","CTGAAGC","CTGA",2.39245492760207,14,13,13,49,2.57837416635746,4.63201842092615,7.77901635053278,101,"ENSG00000079974.19"
"38314","ENSG00000249937.9_172901",172893,172901,9,"ENSG00000249937.9",1,2,"UMVVVVVVV",1,7,0.786749482401656,74,80,94,97,114,120,133,136,"TTGATGA","TTGT","ATAGTTA","CTGA",2.43251170742656,14,17,13,53,2.31130807312388,4.63201319732524,7.77901112693186,101,"ENSG00000079974.19"
"26446","ENSG00000184261.5_7812",7804,7812,9,"ENSG00000184261.5",1,2,"UMVVVVVVV",1,7,0.786749482401656,78,84,97,100,108,114,133,136,"CTGAGGA","CTGA","GTGAGGG","CTGC",2.39533736781443,13,8,19,49,2.55873418354306,4.63191249224315,7.77891042184978,101,"ENSG00000079974.19"
"39130","ENSG00000251680.6_212442",212434,212442,9,"ENSG00000251680.6",1,1,"MVVVUVVVV",1,7,0.795859213250517,115,121,133,136,142,148,186,189,"ATGAAGA","ATCA","CTGCTGG","CTGA",2.45514827717064,12,6,38,65,2.01416288439047,4.59545451638202,7.77889136938409,101,"ENSG00000079974.19"
"2326","ENSG00000073146.16_59528",59520,59528,9,"ENSG00000073146.16",1,6,"VVVVVMUVV",1,7,0.788819875776397,116,122,133,136,140,146,160,163,"ACGCTGC","CTGG","CTGATGT","CTGA",2.36257547523117,11,4,14,38,2.74374898397205,4.62356303804496,7.77884254115055,101,"ENSG00000079974.19"
"4128","ENSG00000095637.23_106190",106182,106190,9,"ENSG00000095637.23",1,5,"VVUVMVVVV",1,7,0.770186335403727,69,75,84,87,100,106,133,136,"ATGATGA","CTGA","TTTATTA","CTGG",2.55869932432432,9,13,27,58,1.73396199103373,4.69798937163231,7.77873471324721,101,"ENSG00000079974.19"
"3900","ENSG00000090530.10_44082",44074,44082,9,"ENSG00000090530.10",1,2,"UMVVVVVVV",1,7,0.786749482401656,111,117,133,136,138,144,156,159,"ATCATAA","CTAA","ATGACCA","CTGA",2.42410871433352,16,2,12,39,2.36599057600752,4.63167883455775,7.77867676416438,101,"ENSG00000079974.19"
"19188","ENSG00000162434.14_107003",106995,107003,9,"ENSG00000162434.14",1,1,"MVVVUVVVV",1,7,0.795859213250517,39,45,57,60,111,117,133,136,"TTGTTGA","GTGA","GTTAGGA","CTGA",2.49315190935791,12,51,16,88,1.75936064473542,4.59509334344704,7.77853019644911,101,"ENSG00000079974.19"
"944","ENSG00000041515.16_158873",158865,158873,9,"ENSG00000041515.16",1,6,"UVVVVMVVV",1,7,0.805383022774327,54,60,78,81,113,119,133,136,"ATGATGA","CAGA","GTTATAA","TTGA",2.49823375835383,18,32,14,73,1.57294716119881,4.55695972088942,7.77849181198673,101,"ENSG00000079974.19"
"3361","ENSG00000082996.20_46336",46328,46336,9,"ENSG00000082996.20",1,8,"VVVVVUVMV",1,7,0.806211180124224,116,122,133,136,149,155,167,170,"GTGATGT","CTGG","GTGCTGG","CTTA",2.33722150162605,11,13,12,45,2.63304008119191,4.55362918967472,7.77847391017162,101,"ENSG00000079974.19"
"13197","ENSG00000140538.17_63101",63093,63101,9,"ENSG00000140538.17",0,NA,"UVVVVUVVV",2,7,0.824844720496894,110,116,133,136,144,150,166,169,"AGGTTGA","CACA","CTGATAG","CTGA",2.3122778504572,17,8,16,50,2.50092111305376,4.47902669569211,7.77840557767969,101,"ENSG00000079974.19"
"25842","ENSG00000182973.20_68752",68744,68752,9,"ENSG00000182973.20",1,8,"UVVVVVVMV",1,7,0.786749482401656,75,81,96,99,108,114,133,136,"CTGATGT","TTGA","CTGATGA","CTAA",2.41346097036526,15,9,19,52,2.43562425526398,4.63134101442476,7.77833894403139,101,"ENSG00000079974.19"
"30807","ENSG00000213842.2_987",979,987,9,"ENSG00000213842.2",1,8,"UVVVVVVMV",1,7,0.786749482401656,75,81,96,99,108,114,133,136,"CTGATGT","TTGA","CTGATGA","CTAA",2.41346097036526,15,9,19,52,2.43562425526398,4.63134101442476,7.77833894403139,101,"ENSG00000079974.19"
"18999","ENSG00000160145.16_301136",301128,301136,9,"ENSG00000160145.16",1,5,"VVUVMVVVV",1,7,0.770186335403727,109,115,133,136,143,149,185,188,"AGGATGT","CTGA","GTGTCCA","CTGA",2.56197071277346,18,7,36,70,1.71045438240767,4.69756478355769,7.7783101251726,101,"ENSG00000079974.19"
"15193","ENSG00000147257.16_248776",248768,248776,9,"ENSG00000147257.16",1,8,"VVVVVUVMV",1,7,0.806211180124224,52,58,74,77,83,89,133,136,"ATAATGA","CTGA","GGGATTA","ATGA",2.45745811342142,16,6,44,75,1.83077020286839,4.55345607308613,7.77830079358302,101,"ENSG00000079974.19"
"21546","ENSG00000168280.18_131513",131505,131513,9,"ENSG00000168280.18",1,5,"VVVVMUVVV",1,7,0.808695652173913,77,83,97,100,115,121,133,136,"ATGATGG","CTGC","GCGATTA","CAGA",2.35460759958044,14,15,12,50,2.47654932043076,4.54348332940843,7.77826593810408,101,"ENSG00000079974.19"
"40228","ENSG00000255282.6_44330",44322,44330,9,"ENSG00000255282.6",1,1,"MVVVVUVVV",1,7,0.82815734989648,62,68,82,85,96,102,133,136,"AGGATGC","TTGA","GAAATGG","CTGA",2.39344940455381,14,11,31,65,1.9061457171483,4.46561877021009,7.77824816979601,101,"ENSG00000079974.19"
"7697","ENSG00000115368.10_15197",15189,15197,9,"ENSG00000115368.10",1,1,"MVVUVVVVV",1,7,0.786749482401656,110,116,133,136,147,153,171,174,"TTGAGGA","AGGA","CTGAGGA","CTGA",2.44481254631539,17,11,18,55,2.22618480870365,4.63123377936823,7.77823170897486,101,"ENSG00000079974.19"
"38991","ENSG00000251388.1_86501",86493,86501,9,"ENSG00000251388.1",1,2,"VMVVUVVVV",1,7,0.773913043478261,87,93,103,106,114,120,133,136,"GTCCTGA","CTAA","TGGATGA","CTGA",2.38073130154671,10,8,13,40,2.85818679787468,4.68243220204651,7.77808437595956,101,"ENSG00000079974.19"
"14230","ENSG00000144635.9_18607",18599,18607,9,"ENSG00000144635.9",1,1,"MVVVUVVVV",1,7,0.795859213250517,102,108,133,136,146,152,164,167,"ATGAATA","ATGA","GTGGTCA","CTGA",2.45257969156858,25,10,12,56,2.02803344351647,4.59464118016008,7.77807803316215,101,"ENSG00000079974.19"
"2467","ENSG00000075151.24_112433",112425,112433,9,"ENSG00000075151.24",1,7,"UVVVVVMVV",1,7,0.787991718426501,115,121,133,136,148,154,175,178,"CAGATGA","TTCA","CTGAGGA","CTGA",2.44169732554278,12,12,21,54,2.22639266570909,4.62609370899857,7.77806058270457,101,"ENSG00000079974.19"
"30917","ENSG00000214719.13_8767",8759,8767,9,"ENSG00000214719.13",1,8,"UVVVVUVMV",2,6,0.708902691511387,115,121,133,136,141,147,161,164,"AGGATGA","TTGG","TTGAGGA","CTGA",2.54001966320637,12,5,14,40,2.83609251362198,4.94238923374944,7.77799999979499,101,"ENSG00000079974.19"
"9445","ENSG00000124749.17_163165",163157,163165,9,"ENSG00000124749.17",1,2,"VMVVVUVVV",1,7,0.806211180124223,77,83,100,103,112,118,133,136,"ATGAAGG","ATGG","TTGAGGG","CTGA",2.35327964228087,17,9,15,50,2.52343478820882,4.55299143418699,7.77783615468389,101,"ENSG00000079974.19"
"32454","ENSG00000227028.6_72049",72041,72049,9,"ENSG00000227028.6",0,NA,"UVVVVUVVV",2,7,0.824844720496894,97,103,133,136,142,148,180,183,"AAGATGA","AGGA","TTGGTGA","CTGA",2.51940866678307,30,6,32,77,1.11777064805532,4.47845710665228,7.77783598863986,101,"ENSG00000079974.19"
"1994","ENSG00000068781.21_33390",33382,33390,9,"ENSG00000068781.21",1,8,"VVVVVUVMV",1,7,0.806211180124224,73,79,98,101,110,116,133,136,"GTGATGA","CTCA","AGGATGC","CTCA",2.39796638803828,19,9,17,54,2.2251154186358,4.55288950138942,7.77773422188632,101,"ENSG00000079974.19"
"36836","ENSG00000243244.7_33932",33924,33932,9,"ENSG00000243244.7",1,8,"VVVVVUVMV",1,7,0.806211180124224,73,79,98,101,110,116,133,136,"GTGATGA","CTCA","AGGATGC","CTCA",2.39796638803828,19,9,17,54,2.2251154186358,4.55288950138942,7.77773422188632,101,"ENSG00000079974.19"
"26645","ENSG00000184672.12_732852",732844,732852,9,"ENSG00000184672.12",1,2,"VMUVVVVVV",1,7,0.767701863354037,114,120,133,136,176,182,195,198,"ATGATTA","CTGC","CTAATCA","CTGA",2.5358276994502,13,40,13,75,1.92213127610934,4.706912318111,7.77771977152714,101,"ENSG00000079974.19"
"34518","ENSG00000233290.4_338922",338914,338922,9,"ENSG00000233290.4",1,1,"MVVVVUVVV",1,7,0.82815734989648,104,110,133,136,146,152,165,168,"ATGTTGC","ATAA","GTGATTT","CTGA",2.36546400003893,23,10,13,55,2.09037921217745,4.46503480310925,7.77766420269518,101,"ENSG00000079974.19"
"23750","ENSG00000173838.12_88347",88339,88347,9,"ENSG00000173838.12",1,2,"VMVVVVUVV",1,7,0.770186335403727,114,120,133,136,140,146,183,186,"ATGATAG","CTAA","ATGAAGA","CTGA",2.53765274530875,13,4,37,63,1.86992255552115,4.69690188106153,7.77764722267644,101,"ENSG00000079974.19"
"34742","ENSG00000233928.7_202614",202606,202614,9,"ENSG00000233928.7",0,NA,"VVVUVVUVV",2,7,0.766873706004141,108,114,133,136,142,148,167,170,"GTGATTA","CTCA","GGGATTA","CTGA",2.50567308168248,19,6,19,53,2.13608430077845,4.71014287799874,7.77763770201531,101,"ENSG00000079974.19"
"39204","ENSG00000253309.7_4866",4858,4866,9,"ENSG00000253309.7",1,6,"UVVVVMVVV",1,7,0.805383022774327,107,113,133,136,149,155,169,172,"ATGATTA","CTTT","ATAATTA","CTGA",2.42524817436817,20,13,14,56,2.05587729183541,4.55604961357247,7.77758170466977,101,"ENSG00000079974.19"
"31334","ENSG00000223442.1_23628",23620,23628,9,"ENSG00000223442.1",0,NA,"VVVVUVUVV",2,7,0.775983436853002,85,91,133,136,151,157,171,174,"ATGATGA","CAGC","CTCATGG","CTGA",2.59026644369651,42,15,14,80,1.4258962358456,4.67358479845559,7.7775185458676,101,"ENSG00000079974.19"
"5115","ENSG00000103194.16_53977",53969,53977,9,"ENSG00000103194.16",1,8,"VVVVVUVMV",1,7,0.806211180124224,114,120,133,136,160,166,177,180,"GTGTTGA","AGGA","GGGATGG","CTGA",2.41239191555761,13,24,11,57,2.12807343632238,4.5526715516766,7.7775162721735,101,"ENSG00000079974.19"
"45519","ENSG00000285679.2_94578",94570,94578,9,"ENSG00000285679.2",0,NA,"VVUVVUVVV",2,7,0.805797101449275,74,80,100,103,110,116,133,136,"ATGATGC","GTGA","GTGGGGA","GTGA",2.40435552605178,20,7,17,53,2.18813195291709,4.55429219831557,7.77748060411267,101,"ENSG00000079974.19"
"35109","ENSG00000234948.2_441390",441382,441390,9,"ENSG00000234948.2",1,1,"MVVVVUVVV",1,7,0.82815734989648,113,119,133,136,161,167,180,183,"GCTTTGA","CTGA","GTGTGGA","CTGA",2.37785266741689,14,25,13,61,2.00689908396037,4.46481255001824,7.77744194960416,101,"ENSG00000079974.19"
"31218","ENSG00000219481.11_23582",23574,23582,9,"ENSG00000219481.11",1,2,"VMVUVVVVV",1,7,0.764803312629399,114,120,133,136,143,149,201,204,"ATGAAGA","CATA","ATGCTGA","CTGA",2.53131929330568,13,7,52,81,1.99713005148096,4.71814800171304,7.77736125223063,101,"ENSG00000079974.19"
"42531","ENSG00000263956.8_27342",27334,27342,9,"ENSG00000263956.8",1,2,"VMVUVVVVV",1,7,0.764803312629399,114,120,133,136,143,149,201,204,"ATGAAGA","CATA","ATGCTGA","CTGA",2.53131929330568,13,7,52,81,1.99713005148096,4.71814800171304,7.77736125223063,101,"ENSG00000079974.19"
"43239","ENSG00000270231.5_23530",23522,23530,9,"ENSG00000270231.5",1,2,"VMVUVVVVV",1,7,0.764803312629399,114,120,133,136,143,149,201,204,"ATGAAGA","CATA","ATGCTGA","CTGA",2.53131929330568,13,7,52,81,1.99713005148096,4.71814800171304,7.77736125223063,101,"ENSG00000079974.19"
"43242","ENSG00000270231.5_29883",29875,29883,9,"ENSG00000270231.5",1,2,"VMVUVVVVV",1,7,0.764803312629399,114,120,133,136,143,149,201,204,"ATGAAGA","CATA","ATGCTGA","CTGA",2.53131929330568,13,7,52,81,1.99713005148096,4.71814800171304,7.77736125223063,101,"ENSG00000079974.19"
"43312","ENSG00000271254.7_2208",2200,2208,9,"ENSG00000271254.7",1,2,"VMVUVVVVV",1,7,0.764803312629399,114,120,133,136,143,149,201,204,"ATGAAGA","CATA","ATGCTGA","CTGA",2.53131929330568,13,7,52,81,1.99713005148096,4.71814800171304,7.77736125223063,101,"ENSG00000079974.19"
"43682","ENSG00000273136.8_83679",83671,83679,9,"ENSG00000273136.8",1,2,"VMVUVVVVV",1,7,0.764803312629399,114,120,133,136,143,149,201,204,"ATGAAGA","CATA","ATGCTGA","CTGA",2.53131929330568,13,7,52,81,1.99713005148096,4.71814800171304,7.77736125223063,101,"ENSG00000079974.19"
"18641","ENSG00000157985.20_341759",341751,341759,9,"ENSG00000157985.20",0,NA,"UVVVVUVVV",2,7,0.824844720496894,114,120,133,136,139,145,186,189,"AAGATTA","ATGA","TTGATAC","CTGA",2.42978129993418,13,3,41,66,1.7132386000143,4.47794514989387,7.77732403188145,101,"ENSG00000079974.19"
"31027","ENSG00000215262.8_97299",97291,97299,9,"ENSG00000215262.8",1,6,"UVVVVMVVV",1,7,0.805383022774327,110,116,133,136,144,150,170,173,"ATTCTGA","CTGG","TAGAGGA","CTGA",2.3947150711609,17,8,20,54,2.25811801375144,4.55572128870603,7.77725337980334,101,"ENSG00000079974.19"
"15275","ENSG00000147509.14_16464",16456,16464,9,"ENSG00000147509.14",1,7,"UVVVVVMVV",1,7,0.787991718426501,82,88,101,104,111,117,133,136,"AGGATGA","TTGG","ATGATGA","CTTA",2.36108626552297,13,7,16,45,2.7601645656331,4.62518491727989,7.77715179098589,101,"ENSG00000079974.19"
"41620","ENSG00000259363.6_4422",4414,4422,9,"ENSG00000259363.6",1,7,"VVVVUVMVV",1,7,0.775155279503105,105,111,133,136,147,153,161,164,"CTGGTGA","CTTA","GTAAGGA","CTGA",2.4829286092932,22,11,8,50,2.15303602505002,4.67647335508451,7.77709447309693,101,"ENSG00000079974.19"
"41743","ENSG00000259658.6_3455",3447,3455,9,"ENSG00000259658.6",1,7,"VVVVUVMVV",1,7,0.775155279503105,105,111,133,136,147,153,161,164,"CTGGTGA","CTTA","GTAAGGA","CTGA",2.4829286092932,22,11,8,50,2.15303602505002,4.67647335508451,7.77709447309693,101,"ENSG00000079974.19"
"48251","ENSG00000290760.1_4342",4334,4342,9,"ENSG00000290760.1",1,7,"VVVVUVMVV",1,7,0.775155279503105,105,111,133,136,147,153,161,164,"CTGGTGA","CTTA","GTAAGGA","CTGA",2.4829286092932,22,11,8,50,2.15303602505002,4.67647335508451,7.77709447309693,101,"ENSG00000079974.19"
"1868","ENSG00000066855.16_119861",119853,119861,9,"ENSG00000066855.16",1,8,"VVVVVVUMV",1,7,0.770186335403727,61,67,79,82,88,94,133,136,"ATGAAGA","CTGA","ATGCTGA","CTAA",2.51647791792574,12,6,39,66,2.00884724226449,4.69634167377569,7.77708701539059,101,"ENSG00000079974.19"
"25040","ENSG00000179242.16_362048",362040,362048,9,"ENSG00000179242.16",1,2,"VMVVVVUVV",1,7,0.770186335403727,81,87,101,104,111,117,133,136,"AGGAAGA","CTGG","AAGCTGA","CTGA",2.40882373478218,14,7,16,46,2.72653488024608,4.69633994469849,7.77708528631339,101,"ENSG00000079974.19"
"17088","ENSG00000153093.20_50237",50229,50237,9,"ENSG00000153093.20",1,8,"VVVVVUVMV",1,7,0.806211180124224,105,111,133,136,154,160,169,172,"GTGAAGA","ATGA","GGGCTGT","CTGA",2.47507737891718,22,18,9,58,1.70839598840346,4.55222796196284,7.77707268245973,101,"ENSG00000079974.19"
"33263","ENSG00000229140.12_991555",991547,991555,9,"ENSG00000229140.12",1,2,"UMVVVVVVV",1,7,0.786749482401656,68,74,91,94,108,114,133,136,"AAGATGA","CTGA","CTCATGA","CTTA",2.48508275988207,17,14,19,59,1.95304902503561,4.63006685606236,7.77706478566898,101,"ENSG00000079974.19"
"17883","ENSG00000155657.29_299803",299795,299803,9,"ENSG00000155657.29",1,2,"VMVVVUVVV",1,7,0.806211180124223,97,103,133,136,145,151,162,165,"CCGATGA","GTGA","AAGAAGC","CTGA",2.43434768125896,30,9,11,59,1.97989182660371,4.55221909208252,7.77706381257942,101,"ENSG00000079974.19"
"7111","ENSG00000112837.17_56628",56620,56628,9,"ENSG00000112837.17",1,8,"UVVVVVVMV",1,7,0.786749482401656,113,119,133,136,145,151,159,162,"GAGAGGA","CTTT","GTGATGT","CTGA",2.33883935243756,14,9,8,40,2.92774994011655,4.63000307242507,7.77700100203169,101,"ENSG00000079974.19"
"28936","ENSG00000196758.3_3991",3983,3991,9,"ENSG00000196758.3",1,8,"VVVVVUVMV",1,7,0.806211180124224,74,80,98,101,109,115,133,136,"AGGAGGA","CTGG","TTTATCA","CTGA",2.38785341062952,18,8,18,53,2.28921018425498,4.55205823044627,7.77690295094316,101,"ENSG00000079974.19"
"9496","ENSG00000124813.23_52347",52339,52347,9,"ENSG00000124813.23",1,5,"VVVVMUVVV",1,7,0.808695652173913,115,121,133,136,157,163,183,186,"ATGATTA","CACA","GTCATGG","CTGA",2.46202292236397,12,21,20,62,1.75491556311294,4.54210042805153,7.77688303674718,101,"ENSG00000079974.19"
"9652","ENSG00000125991.21_5854",5846,5854,9,"ENSG00000125991.21",1,6,"VVVVVMUVV",1,7,0.788819875776397,71,77,92,95,104,110,133,136,"ATGATAA","AAGA","TGGATTA","CTGA",2.44014525971007,15,9,23,56,2.21875753828843,4.62159815075555,7.77687765386114,101,"ENSG00000079974.19"
"24365","ENSG00000176092.17_22243",22235,22243,9,"ENSG00000176092.17",1,1,"MVVVUVVVV",1,7,0.795859213250517,90,96,109,112,116,122,133,136,"CTGATGG","CTGG","TTGATGT","CAGA",2.32133366743259,13,4,11,37,2.89801098999725,4.5933921932203,7.77682904622237,101,"ENSG00000079974.19"
"33593","ENSG00000230448.5_156855",156847,156855,9,"ENSG00000230448.5",1,8,"VVVUVVVMV",1,7,0.764803312629399,86,92,108,111,113,119,133,136,"ATTAGGA","CTGA","GTTATCT","CTGA",2.49173912577009,16,2,14,41,2.2586551665396,4.71756233458505,7.77677558510265,101,"ENSG00000079974.19"
"33897","ENSG00000231424.3_274431",274423,274431,9,"ENSG00000231424.3",1,6,"VVUVVMVVV",1,7,0.786335403726708,91,97,133,136,140,146,166,169,"AAGATGA","CAGT","GTGAAGA","CTGA",2.57479092247431,36,4,20,69,1.36025404243386,4.63138171473231,7.77672332963914,101,"ENSG00000079974.19"
"47299","ENSG00000287950.1_62782",62774,62782,9,"ENSG00000287950.1",1,3,"UVMVVVVVV",1,7,0.785507246376811,89,95,110,113,116,122,133,136,"CTGATGA","CTGT","CTGTTGT","CTGT",2.38241180376239,15,3,11,38,2.65595836413498,4.63467593063773,7.77670491614497,101,"ENSG00000079974.19"
"23558","ENSG00000173218.15_27165",27157,27165,9,"ENSG00000173218.15",1,8,"UVVVVVVMV",1,7,0.786749482401656,114,120,133,136,150,156,174,177,"ATTTTGA","CTGC","ATGAACA","CTGA",2.43955851874868,13,14,18,54,2.25456332875014,4.62957169676866,7.77656962637529,101,"ENSG00000079974.19"
"39521","ENSG00000253713.1_301",293,301,9,"ENSG00000253713.1",0,NA,"UVVVVUVVV",2,7,0.824844720496894,112,118,133,136,143,149,157,160,"ATCACCA","CTCA","ATTATGC","CTGA",2.24614799775946,15,7,8,39,2.93442611390744,4.47718652474262,7.7765654067302,101,"ENSG00000079974.19"
"2714","ENSG00000077585.14_51606",51598,51606,9,"ENSG00000077585.14",1,6,"VVVUVMVVV",1,7,0.78343685300207,105,111,133,136,159,165,179,182,"ATGATAA","GTGA","GCGATCA","CTGA",2.57845000297022,22,23,14,68,1.38148005998914,4.64278668661433,7.77653409862261,101,"ENSG00000079974.19"
"36844","ENSG00000243276.6_149273",149265,149273,9,"ENSG00000243276.6",1,2,"UMVVVVVVV",1,7,0.786749482401656,108,114,133,136,143,149,159,162,"ATGATCA","CTTA","ATGTTGA","CTCA",2.39027739544073,19,7,10,45,2.58282920340033,4.62950295991796,7.77650088952459,101,"ENSG00000079974.19"
"23526","ENSG00000173157.18_159383",159375,159383,9,"ENSG00000173157.18",1,2,"VMUVVVVVV",1,7,0.767701863354037,90,96,103,106,114,120,133,136,"ATGCTGA","AAGA","GAGAAAA","CTGA",2.4339440161235,7,8,13,37,2.59635984266714,4.70566332087262,7.77647077428877,101,"ENSG00000079974.19"
"23564","ENSG00000173230.17_73702",73694,73702,9,"ENSG00000173230.17",1,8,"VVUVVVVMV",1,7,0.767701863354037,115,121,133,136,138,144,154,157,"CAGATGA","CTGG","GTAGTAA","CTGA",2.41332148411938,12,2,10,33,2.73361353275093,4.70560585672003,7.77641331013618,101,"ENSG00000079974.19"
"30270","ENSG00000204406.14_437487",437479,437487,9,"ENSG00000204406.14",1,7,"VVVVUVMVV",1,7,0.775155279503105,107,113,133,136,146,152,204,207,"ATTATGA","CTCA","ATGTAGA","CTGA",2.59691462977609,20,10,52,91,1.39013193824303,4.67572403418758,7.7763451522,101,"ENSG00000079974.19"
"3945","ENSG00000091157.15_251456",251448,251456,9,"ENSG00000091157.15",0,NA,"UVUVVVVVV",2,7,0.786335403726708,108,114,133,136,141,147,160,163,"ATGATGT","ATGA","CTTATGA","CTGC",2.41385653228923,19,5,13,46,2.43153878799832,4.63097891748163,7.77632053238846,101,"ENSG00000079974.19"
"17323","ENSG00000153923.11_1125",1117,1125,9,"ENSG00000153923.11",1,2,"UMVVVVVVV",1,7,0.786749482401656,110,116,133,136,153,159,175,178,"ATGCTGA","TTAA","ATGAAAA","CTGA",2.4863199801664,17,17,16,59,1.94162107243271,4.62927190171884,7.77626983132546,101,"ENSG00000079974.19"
"48351","ENSG00000291014.1_1128",1120,1128,9,"ENSG00000291014.1",1,2,"UMVVVVVVV",1,7,0.786749482401656,110,116,133,136,153,159,175,178,"ATGCTGA","TTAA","ATGAAAA","CTGA",2.4863199801664,17,17,16,59,1.94162107243271,4.62927190171884,7.77626983132546,101,"ENSG00000079974.19"
"21731","ENSG00000168818.10_82984",82976,82984,9,"ENSG00000168818.10",1,3,"VVMUVVVVV",1,7,0.763561076604555,29,35,71,74,80,86,133,136,"AGGATGA","CAGA","ATGAGGA","CTGA",2.68399132964753,36,6,47,98,0.994748586443115,4.72200602935665,7.77625033577487,101,"ENSG00000079974.19"
"19763","ENSG00000163638.13_116081",116073,116081,9,"ENSG00000163638.13",1,2,"VMUVVVVVV",1,7,0.767701863354037,115,121,133,136,141,147,159,162,"ATGGTGA","GTGC","GAAAGGA","CTGA",2.3807270315131,12,5,12,38,2.94950207693477,4.70525390508886,7.776061358505,101,"ENSG00000079974.19"
"38661","ENSG00000250748.6_33725",33717,33725,9,"ENSG00000250748.6",1,7,"VVUVVVMVV",1,7,0.768944099378882,86,92,104,107,116,122,133,136,"ATGCTGC","ATGA","ATTGTAA","CTGA",2.37606728908141,12,9,11,41,2.96068183600898,4.70028260747126,7.77605900498678,101,"ENSG00000079974.19"
"39157","ENSG00000253154.4_22649",22641,22649,9,"ENSG00000253154.4",0,NA,"UVVUVVVVV",2,7,0.78343685300207,94,100,133,136,142,148,160,163,"ATGATGT","CTTT","GTTATAA","CTGA",2.49153454498367,33,6,12,60,1.95874767459899,4.64224449362253,7.77599190563081,101,"ENSG00000079974.19"
"36726","ENSG00000242808.12_232513",232505,232513,9,"ENSG00000242808.12",1,2,"UMVVVVVVV",1,7,0.786749482401656,56,62,76,79,83,89,133,136,"TTGTTGA","ATGA","ATGCAGA","CTGA",2.50577484596786,14,4,44,71,1.81071308802878,4.62896968195363,7.77596761156026,101,"ENSG00000079974.19"
"20174","ENSG00000164398.15_36304",36296,36304,9,"ENSG00000164398.15",1,2,"VMVVVUVVV",1,7,0.806211180124223,95,101,133,136,163,169,181,184,"ATTATGA","GTGA","GTGAGAG","CTGA",2.57029880086833,32,27,12,80,1.06909831700644,4.55110591403217,7.77595063452906,101,"ENSG00000079974.19"
"44427","ENSG00000281938.2_35698",35690,35698,9,"ENSG00000281938.2",1,2,"VMVVVUVVV",1,7,0.806211180124223,95,101,133,136,163,169,181,184,"ATTATGA","GTGA","GTGAGAG","CTGA",2.57029880086833,32,27,12,80,1.06909831700644,4.55110591403217,7.77595063452906,101,"ENSG00000079974.19"
"3621","ENSG00000087008.16_36631",36623,36631,9,"ENSG00000087008.16",0,NA,"VVVVUVUVV",2,7,0.775983436853002,73,79,93,96,103,109,133,136,"AGGATGT","CTGT","AGGATGG","CTGA",2.46151099539025,14,7,24,54,2.27779233743387,4.67196641000888,7.77590015742089,101,"ENSG00000079974.19"
"6923","ENSG00000112276.14_16323",16315,16323,9,"ENSG00000112276.14",1,8,"UVVVVVVMV",1,7,0.786749482401656,114,120,133,136,145,151,185,188,"ATGATGC","TTAA","CTTAGGA","CTGA",2.47585314644842,13,9,34,65,2.00974870811968,4.62885908777728,7.7758570173839,101,"ENSG00000079974.19"
"15670","ENSG00000149177.15_169648",169640,169648,9,"ENSG00000149177.15",1,2,"UMVVVVVVV",1,7,0.786749482401656,40,46,58,61,101,107,133,136,"ATCATGA","GTGA","TTGAATA","CTGA",2.59070794943115,12,40,26,87,1.24393644474557,4.62883069357165,7.77582862317827,101,"ENSG00000079974.19"
"18486","ENSG00000157450.16_27375",27367,27375,9,"ENSG00000157450.16",1,8,"VVVUVVVMV",1,7,0.764803312629399,116,122,133,136,146,152,160,163,"GTGTTGA","TTGG","CAGAAGA","CTGA",2.3930122221909,11,10,8,38,2.91299138763703,4.71660155056075,7.77581480107835,101,"ENSG00000079974.19"
"32070","ENSG00000225798.1_2583",2575,2583,9,"ENSG00000225798.1",1,8,"VVVUVVVMV",1,7,0.764803312629399,116,122,133,136,146,152,160,163,"GTGTTGA","TTGG","CAGAAGA","CTGA",2.3930122221909,11,10,8,38,2.91299138763703,4.71660155056075,7.77581480107835,101,"ENSG00000079974.19"
"29922","ENSG00000198879.13_159399",159391,159399,9,"ENSG00000198879.13",1,1,"MVVVVUVVV",1,7,0.82815734989648,105,111,133,136,142,148,165,168,"AGGTTGA","CTTA","ATGGGTA","CTGA",2.37511822525002,22,6,17,54,2.01853088251265,4.46316309604486,7.77579249563078,101,"ENSG00000079974.19"
"21493","ENSG00000168026.19_13685",13677,13685,9,"ENSG00000168026.19",0,NA,"VVUVUVVVV",2,7,0.773498964803312,85,91,133,136,150,156,165,168,"ATGATGG","CAGC","ATGATCA","CTGA",2.56573952395744,42,14,9,74,1.62211129905021,4.68176036469161,7.77575622390486,101,"ENSG00000079974.19"
"31686","ENSG00000224429.10_39562",39554,39562,9,"ENSG00000224429.10",1,8,"VVVVVUVMV",1,7,0.806211180124224,116,122,133,136,143,149,190,193,"GTGAGGA","ATTA","TGGATGA","CTGA",2.43180299225395,11,7,41,68,1.99154465118643,4.55089114988652,7.77573587038342,101,"ENSG00000079974.19"
"32723","ENSG00000227646.7_40801",40793,40801,9,"ENSG00000227646.7",1,5,"UVVVMVVVV",1,7,0.789233954451346,113,119,133,136,154,160,171,174,"ATGGTGA","TTGG","GAGAGGT","CTGA",2.42286479662489,14,18,11,52,2.32272363541228,4.61878890322789,7.77572472103328,101,"ENSG00000079974.19"
"20402","ENSG00000164796.18_442214",442206,442214,9,"ENSG00000164796.18",1,1,"MVVVVVUVV",1,7,0.792132505175983,21,27,41,44,89,95,133,136,"ATCATGT","CTGA","ATGAACA","CTGA",2.61474088767667,14,45,38,106,0.996831101140853,4.60710925474633,7.77563927545026,101,"ENSG00000079974.19"
"9644","ENSG00000125966.10_14266",14258,14266,9,"ENSG00000125966.10",1,6,"UVVVVMVVV",1,7,0.805383022774327,100,106,133,136,141,147,163,166,"ATGATAC","CTGC","GTAAAGA","CTGA",2.46356419785757,27,5,16,57,1.79262961981597,4.5540977347166,7.77562982581391,101,"ENSG00000079974.19"
"12382","ENSG00000138031.15_40649",40641,40649,9,"ENSG00000138031.15",1,3,"UVMVVVVVV",1,7,0.785507246376811,102,108,133,136,141,147,155,158,"ATGATGA","CTCA","GTTATTA","CTAA",2.46723715183313,25,5,8,47,2.08614250131555,4.63359754505077,7.77562653055802,101,"ENSG00000079974.19"
"30634","ENSG00000206120.11_360298",360290,360298,9,"ENSG00000206120.11",0,NA,"UVVUVVVVV",2,7,0.78343685300207,112,118,133,136,163,169,179,182,"AGGAGGA","CTGA","ATTTTGT","CTGA",2.48556053186214,15,27,10,61,1.99702938301739,4.64185823219124,7.77560564419953,101,"ENSG00000079974.19"
"23611","ENSG00000173406.16_307532",307524,307532,9,"ENSG00000173406.16",1,7,"VVVVUVMVV",1,7,0.775155279503105,107,113,133,136,187,193,205,208,"AGGAAGA","CTGA","CAGATGA","CTGA",2.58761193709588,20,51,12,92,1.44911768227434,4.67496598239505,7.77558710040748,101,"ENSG00000079974.19"
"14495","ENSG00000145147.20_258332",258324,258332,9,"ENSG00000145147.20",1,6,"UVVVVMVVV",1,7,0.805383022774327,111,117,133,136,145,151,171,174,"ATTATTT","CAGA","TTGATGG","CTGA",2.38668628377597,16,9,20,54,2.30496324787138,4.55405128492779,7.7755833760251,101,"ENSG00000079974.19"
"14789","ENSG00000145901.16_8505",8497,8505,9,"ENSG00000145901.16",1,2,"VMVVVVUVV",1,7,0.770186335403727,110,116,133,136,185,191,205,208,"GTGCTGA","CTGA","ATTAAAA","CTGA",2.57276328463255,17,49,14,89,1.62745072801405,4.69480148972443,7.77554683133934,101,"ENSG00000079974.19"
"38513","ENSG00000250349.3_1126912",1126904,1126912,9,"ENSG00000250349.3",1,8,"VVVVUVVMV",1,7,0.773913043478261,86,92,133,136,144,150,166,169,"ATAATGG","CAGA","TTGAAGA","CTGA",2.54599965280837,41,8,16,74,1.74615721044487,4.67987205729184,7.77552423120488,101,"ENSG00000079974.19"
"38968","ENSG00000251372.7_147293",147285,147293,9,"ENSG00000251372.7",1,7,"UVVVVVMVV",1,7,0.787991718426501,105,111,133,136,140,146,176,179,"ATGGTGA","CTTA","CTGAAAA","CTGA",2.57890602637154,22,4,30,65,1.30137515302632,4.62352049887581,7.77548737258181,101,"ENSG00000079974.19"
"33090","ENSG00000228655.7_222742",222734,222742,9,"ENSG00000228655.7",0,NA,"VVVUVUVVV",2,7,0.802898550724638,80,86,102,105,114,120,133,136,"GTGAAGA","ATGA","TTGATTA","CTCA",2.33176777467008,16,9,13,47,2.71037359831085,4.56387302402785,7.7754672269264,101,"ENSG00000079974.19"
"37820","ENSG00000248911.2_522",514,522,9,"ENSG00000248911.2",1,6,"VVVVUMVVV",1,7,0.792546583850932,116,122,133,136,177,183,208,211,"GTGATGA","CTTG","GTGAGCA","CTGA",2.57507616057007,11,41,25,86,1.25392087808764,4.60527382047203,7.77546015587575,101,"ENSG00000079974.19"
"2445","ENSG00000074771.4_37357",37349,37357,9,"ENSG00000074771.4",1,8,"UVVVVVVMV",1,7,0.786749482401656,111,117,133,136,140,146,183,186,"GTGATGA","GTAA","ATGAAAG","CTGA",2.52024304992501,16,4,37,66,1.71220814738506,4.62845712005461,7.77545504966123,101,"ENSG00000079974.19"
"30416","ENSG00000204930.10_5626",5618,5626,9,"ENSG00000204930.10",1,1,"MVVVUVVVV",1,7,0.795859213250517,116,122,133,136,148,154,210,213,"AAGATGA","GTGG","GTGCTGT","CTGA",2.49398996350533,11,12,56,88,1.74119868474029,4.59194961036061,7.77538646336268,101,"ENSG00000079974.19"
"45496","ENSG00000285645.1_5611",5603,5611,9,"ENSG00000285645.1",1,1,"MVVVUVVVV",1,7,0.795859213250517,116,122,133,136,148,154,210,213,"AAGATGA","GTGG","GTGCTGT","CTGA",2.49398996350533,11,12,56,88,1.74119868474029,4.59194961036061,7.77538646336268,101,"ENSG00000079974.19"
"44277","ENSG00000280560.3_19230",19222,19230,9,"ENSG00000280560.3",0,NA,"UVVVVUVVV",2,7,0.824844720496894,113,119,133,136,150,156,164,167,"ATGATGT","AAGA","GTGGTGG","CTGT",2.29966871728398,14,14,8,45,2.57287265732546,4.47599935980467,7.77537824179225,101,"ENSG00000079974.19"
"8784","ENSG00000120662.16_2156",2148,2156,9,"ENSG00000120662.16",0,NA,"VVVVUUVVV",2,7,0.812008281573499,112,118,133,136,171,177,200,203,"ATGTTGA","GTGC","TTGAAGA","CTGA",2.52318576141449,15,35,23,82,1.28809683276474,4.52733381054867,7.77536693684266,101,"ENSG00000079974.19"
"25590","ENSG00000182185.19_646386",646378,646386,9,"ENSG00000182185.19",1,2,"UMVVVVVVV",1,7,0.786749482401656,85,91,133,136,144,150,158,161,"ATGATGA","CTGC","CTGGAGA","CTGG",2.48190358302608,42,8,8,67,1.96744503431708,4.6283672302894,7.77536515989603,101,"ENSG00000079974.19"
"4817","ENSG00000101966.14_28930",28922,28930,9,"ENSG00000101966.14",1,3,"VVMUVVVVV",1,7,0.763561076604555,115,121,133,136,140,146,154,157,"GTGATAA","TTCA","TGGAGGA","CTGA",2.37872108624773,12,4,8,33,3.02631915951842,4.72111493362582,7.77535924004404,101,"ENSG00000079974.19"
"35484","ENSG00000236130.2_87523",87515,87523,9,"ENSG00000236130.2",0,NA,"VVVUUVVVV",2,7,0.770600414078675,84,90,133,136,142,148,162,165,"GTGATGT","TGGA","CTGAAGA","CTGA",2.53741722468238,43,6,14,72,1.85563114572369,4.69293649423488,7.77533815054958,101,"ENSG00000079974.19"
"7476","ENSG00000114423.23_171295",171287,171295,9,"ENSG00000114423.23",0,NA,"VVVUVUVVV",2,7,0.802898550724638,71,77,101,104,114,120,133,136,"ATGATAG","CTAA","TTGGTAA","CTGA",2.43292301557902,24,10,13,56,2.03535414026568,4.56371022769811,7.77530443059666,101,"ENSG00000079974.19"
"7025","ENSG00000112531.17_41681",41673,41681,9,"ENSG00000112531.17",0,NA,"VVVVVUUVV",2,7,0.808281573498965,113,119,133,136,169,175,184,187,"ATGAGGA","CTAT","TTGCTCA","CTGA",2.42654171853569,14,33,9,65,1.99166782367436,4.54215315347807,7.77527944747393,101,"ENSG00000079974.19"
"34911","ENSG00000234377.8_426318",426310,426318,9,"ENSG00000234377.8",0,NA,"VVVVUVUVV",2,7,0.775983436853002,114,120,133,136,144,150,160,163,"GTTATGA","ATGG","GTCTTGG","CTGA",2.35048777136974,13,8,10,40,3.01535129197326,4.67131744194288,7.77525118935488,101,"ENSG00000079974.19"
"10786","ENSG00000132842.15_144102",144094,144102,9,"ENSG00000132842.15",1,1,"MVUVVVVVV",1,7,0.789648033126294,114,120,133,136,145,151,162,165,"ATGATGA","CTAC","ATTATTA","CTTA",2.32755645026843,13,9,11,42,2.94939053734931,4.61660838478472,7.77520051728989,101,"ENSG00000079974.19"
"2792","ENSG00000078295.17_385385",385377,385385,9,"ENSG00000078295.17",1,5,"VVVVMUUVV",2,6,0.694824016563147,94,100,133,136,144,150,163,166,"ATGATGA","AAGA","ATGATGG","CTGA",2.70913969742584,33,8,13,63,1.92264814074271,4.99589486422874,7.77519093048132,101,"ENSG00000079974.19"
"7639","ENSG00000115239.24_298244",298236,298244,9,"ENSG00000115239.24",1,1,"MVVUVVVVV",1,7,0.786749482401656,116,122,133,136,143,149,161,164,"AAGATGA","ATGA","GTGAATT","CTGG",2.33024907540195,11,7,12,39,2.97765803553128,4.62816296788608,7.7751608974927,101,"ENSG00000079974.19"
"15502","ENSG00000148498.17_565965",565957,565965,9,"ENSG00000148498.17",1,2,"UMVVVVVVV",1,7,0.786749482401656,113,119,133,136,169,175,183,186,"TTGATGC","CTAA","TTGGTAA","CTGA",2.48091172411818,14,33,8,64,1.9731900417619,4.62815038397078,7.77514831357741,101,"ENSG00000079974.19"
"19169","ENSG00000162402.15_19045",19037,19045,9,"ENSG00000162402.15",1,2,"VMVVVUVVV",1,7,0.806211180124223,109,115,133,136,152,158,179,182,"ATAATGA","ATGC","CTGAGGT","CTGA",2.48783399652336,18,16,21,64,1.61528059546554,4.55021014307199,7.77505486356888,101,"ENSG00000079974.19"
"36277","ENSG00000239498.1_16422",16414,16422,9,"ENSG00000239498.1",0,NA,"UVVVVUVVV",2,7,0.824844720496894,100,106,133,136,139,145,156,159,"GTGAAGT","CTGC","ATGATTC","CTGA",2.41687069330856,27,3,11,50,1.79007145501664,4.47563568593509,7.77501456792267,101,"ENSG00000079974.19"
"32399","ENSG00000226965.2_262931",262923,262931,9,"ENSG00000226965.2",1,1,"MVVUVVVVV",1,7,0.786749482401656,105,111,133,136,166,172,196,199,"AAGAGGA","CTGA","CTGATGA","CTGA",2.67149889612619,22,30,24,85,0.701972298978927,4.62799123495505,7.77498916456167,101,"ENSG00000079974.19"
"32506","ENSG00000227110.7_104117",104109,104117,9,"ENSG00000227110.7",1,1,"MVVVVVUVV",1,7,0.792132505175983,116,122,133,136,138,144,157,160,"TTGCAGA","CTGA","GTTTTGG","CTGA",2.38122508535353,11,2,13,35,2.55080787024825,4.60641044315127,7.77494046385521,101,"ENSG00000079974.19"
"34151","ENSG00000231987.1_65522",65514,65522,9,"ENSG00000231987.1",1,6,"UVVVVMVVV",1,7,0.805383022774327,83,89,105,108,115,121,133,136,"AGGATGT","CAGA","GGGATGA","ATGA",2.31132054255587,16,7,12,44,2.80464300286273,4.55336165497546,7.77489374607277,101,"ENSG00000079974.19"
"2271","ENSG00000072401.15_28849",28841,28849,9,"ENSG00000072401.15",1,2,"UMVVVVVVV",1,7,0.786749482401656,57,63,76,79,93,99,133,136,"TTGATTA","TTGA","GTGGGGA","CTGA",2.52439554123389,13,14,34,70,1.68198725519817,4.62782271585603,7.77482064546265,101,"ENSG00000079974.19"
"44959","ENSG00000284612.2_3860",3852,3860,9,"ENSG00000284612.2",1,7,"VVVVUVMVV",1,7,0.775155279503105,115,121,133,136,141,147,156,159,"GTCATGT","ATGA","AGGATCC","CTGA",2.34514898766425,12,5,9,35,3.06188807165969,4.67405366402201,7.77467478203443,101,"ENSG00000079974.19"
"12970","ENSG00000139734.19_170653",170645,170653,9,"ENSG00000139734.19",1,8,"UVVVVVVMV",1,7,0.786749482401656,94,100,133,136,146,152,165,168,"AGGATGA","GAGA","TTGAAGT","CTGA",2.50145266222541,33,10,13,65,1.8342311731546,4.62764556366433,7.77464349327096,101,"ENSG00000079974.19"
"2379","ENSG00000073921.18_26255",26247,26255,9,"ENSG00000073921.18",1,6,"VVUVVMVVV",1,7,0.786335403726708,113,119,133,136,143,149,171,174,"ATGAACA","CTGT","TTGTGGA","CTGA",2.42180670482587,14,7,22,52,2.37177151875751,4.62928738773249,7.77462900263932,101,"ENSG00000079974.19"
"22939","ENSG00000171735.20_684959",684951,684959,9,"ENSG00000171735.20",1,8,"VVVVUVVMV",1,7,0.773913043478261,109,115,133,136,147,153,174,177,"CTGATGT","ATGA","CAGATGG","CTGA",2.5131011229329,18,11,21,59,1.96172589178912,4.67893334450211,7.77458551841516,101,"ENSG00000079974.19"
"43939","ENSG00000275688.4_16878",16870,16878,9,"ENSG00000275688.4",1,1,"MVVVUVVVV",1,7,0.795859213250517,70,76,98,101,115,121,133,136,"ATGATAT","CTGC","GAGATGG","CTGA",2.46698787559317,22,14,12,57,1.91787252577107,4.59111459076472,7.77455144376679,101,"ENSG00000079974.19"
"43983","ENSG00000276409.5_2261",2253,2261,9,"ENSG00000276409.5",1,1,"MVVVUVVVV",1,7,0.795859213250517,70,76,98,101,115,121,133,136,"ATGATAT","CTGC","GAGATGG","CTGA",2.46698787559317,22,14,12,57,1.91787252577107,4.59111459076472,7.77455144376679,101,"ENSG00000079974.19"
"14752","ENSG00000145819.18_201864",201856,201864,9,"ENSG00000145819.18",1,7,"VVVVUVMVV",1,7,0.775155279503105,106,112,133,136,165,171,184,187,"TTGATGA","GTGA","GGGAAGG","CTGA",2.5957668743582,21,29,13,72,1.39021644705571,4.67383223569426,7.77445335370668,101,"ENSG00000079974.19"
"34119","ENSG00000231918.1_44821",44813,44821,9,"ENSG00000231918.1",1,1,"MVVVVUVVV",1,7,0.82815734989648,64,70,78,81,87,93,133,136,"CTGAAGA","CTGA","GAGATGA","CAGA",2.41669982517173,8,6,40,63,1.73536011782286,4.4616730714086,7.77430247099452,101,"ENSG00000079974.19"
"11759","ENSG00000135976.21_31696",31688,31696,9,"ENSG00000135976.21",1,5,"UVVVMVVVV",1,7,0.789233954451346,112,118,133,136,138,144,153,156,"ATTCTGC","CTGG","GTGATGG","CTGA",2.38565728587032,15,2,9,35,2.56498500700451,4.61734172820166,7.77427754600704,101,"ENSG00000079974.19"
"44527","ENSG00000282924.1_20257",20249,20257,9,"ENSG00000282924.1",1,5,"UVVVMVVVV",1,7,0.789233954451346,112,118,133,136,138,144,153,156,"ATTCTGC","CTGG","GTGATGG","CTGA",2.38565728587032,15,2,9,35,2.56498500700451,4.61734172820166,7.77427754600704,101,"ENSG00000079974.19"
"44528","ENSG00000282924.1_22132",22124,22132,9,"ENSG00000282924.1",1,5,"UVVVMVVVV",1,7,0.789233954451346,112,118,133,136,138,144,153,156,"ATTCTGC","CTGG","GTGATGG","CTGA",2.38565728587032,15,2,9,35,2.56498500700451,4.61734172820166,7.77427754600704,101,"ENSG00000079974.19"
"3568","ENSG00000085998.15_24031",24023,24031,9,"ENSG00000085998.15",1,1,"MVVVVUVVV",1,7,0.82815734989648,105,111,133,136,143,149,189,192,"GTCATGG","GTGA","CTGATGG","CTGA",2.47326161724858,22,7,40,78,1.35750947934558,4.4614800652507,7.77410946483662,101,"ENSG00000079974.19"
"11807","ENSG00000136141.15_61623",61615,61623,9,"ENSG00000136141.15",1,1,"MVVVUVVVV",1,7,0.795859213250517,96,102,111,114,115,121,133,136,"ATTATGA","ATGA","ATAATGA","CTTA",2.38963023168678,9,1,12,31,2.43172325147433,4.59064786567988,7.77408471868195,101,"ENSG00000079974.19"
"8003","ENSG00000116329.12_38917",38909,38917,9,"ENSG00000116329.12",1,5,"UVVVMVVVV",1,7,0.789233954451346,36,42,52,55,106,112,133,136,"ATGAGAA","CTGA","ATGGGGA","CTGA",2.56323492246657,10,51,21,91,1.38030086510527,4.61713342038727,7.77406923819265,101,"ENSG00000079974.19"
"18835","ENSG00000158813.18_128283",128275,128283,9,"ENSG00000158813.18",0,NA,"VVUVVUVVV",2,7,0.805797101449275,115,121,133,136,141,147,165,168,"AAGATTA","AGGA","ATGTGGA","CTGA",2.34402535077476,12,5,18,44,2.57637255898621,4.55080205770448,7.77399046350158,101,"ENSG00000079974.19"
"25032","ENSG00000179241.13_63990",63982,63990,9,"ENSG00000179241.13",1,2,"VMVVVUVVV",1,7,0.806211180124223,89,95,133,136,161,167,182,185,"AAGATGA","CAGA","CTGGTGG","CTGA",2.58783509931698,38,25,15,87,0.944042268415468,4.54906906596551,7.7739137864624,101,"ENSG00000079974.19"
"44863","ENSG00000283913.1_43017",43009,43017,9,"ENSG00000283913.1",1,1,"MVVVVVUVV",1,7,0.792132505175983,47,53,63,66,114,120,133,136,"AGGATAA","CTGG","GTTATGA","CTGA",2.48722082894762,10,48,13,80,1.83977317069937,4.60531134092088,7.77384136162481,101,"ENSG00000079974.19"
"6365","ENSG00000109606.13_37412",37404,37412,9,"ENSG00000109606.13",1,8,"VVVVVVUMV",1,7,0.770186335403727,38,44,59,62,71,77,133,136,"GTGATGG","CTGT","TTGCTGG","CTGA",2.53673922070448,15,9,56,89,1.86060885463915,4.69305091483393,7.77379625644883,101,"ENSG00000079974.19"
"18397","ENSG00000157193.18_79459",79451,79459,9,"ENSG00000157193.18",1,8,"VVVVUVVMV",1,7,0.773913043478261,25,31,48,51,100,106,133,136,"ATGAGGA","TTGA","TTGAAGA","CTGA",2.66290875672532,17,49,27,102,0.959716367602271,4.67811035310943,7.77376252702247,101,"ENSG00000079974.19"
"38405","ENSG00000250131.2_140552",140544,140552,9,"ENSG00000250131.2",0,NA,"VVUVVUVVV",2,7,0.805797101449275,95,101,133,136,164,170,183,186,"ATAATGA","CTGT","ATTAAGA","CTGA",2.57792021071002,32,28,13,82,1.01592650985549,4.55051531198056,7.77370371777767,101,"ENSG00000079974.19"
"27637","ENSG00000186952.15_379018",379010,379018,9,"ENSG00000186952.15",0,NA,"VVVUVVUVV",2,7,0.766873706004141,115,121,133,136,173,179,218,221,"TTGATGA","ATGA","GTGTTAA","CTGA",2.66793372988707,12,37,39,97,1.03859993869456,4.70620620115209,7.77370102516865,101,"ENSG00000079974.19"
"16627","ENSG00000151914.22_395387",395379,395387,9,"ENSG00000151914.22",1,2,"VMVVVUVVV",1,7,0.806211180124223,114,120,133,136,149,155,164,167,"ATGATAA","CTAA","TTGAAAA","CTAA",2.32469776350342,13,13,9,44,2.69709426529491,4.54876983882943,7.77361455932632,101,"ENSG00000079974.19"
"8866","ENSG00000121104.8_52350",52342,52350,9,"ENSG00000121104.8",1,6,"UVVVVMVVV",1,7,0.805383022774327,94,100,108,111,116,122,133,136,"CTCAAGA","CTCA","TAGAAGA","CTGA",2.30275550505504,8,5,11,33,2.85660886966123,4.55207805917371,7.77361015027101,101,"ENSG00000079974.19"
"11478","ENSG00000135074.16_52571",52563,52571,9,"ENSG00000135074.16",1,8,"VVVVVUVMV",1,7,0.806211180124224,114,120,133,136,144,150,161,164,"CTGATGG","CAGA","GGGATGG","CTGT",2.28038989450939,13,8,11,41,2.99220180982414,4.54870027663836,7.77354499713525,101,"ENSG00000079974.19"
"8910","ENSG00000121440.15_41484",41476,41484,9,"ENSG00000121440.15",1,1,"MVVVVVUVV",1,7,0.792132505175983,113,119,133,136,143,149,167,170,"ATGTTCC","CTGG","GTGCTGA","CTGA",2.37269362310734,14,7,18,48,2.60179150803191,4.60493724885355,7.77346726955748,101,"ENSG00000079974.19"
"17974","ENSG00000155966.14_364247",364239,364247,9,"ENSG00000155966.14",1,3,"VVMVVVUVV",1,7,0.768944099378882,116,122,133,136,145,151,164,167,"ATGATGA","GGGA","CTGAAAA","TTGA",2.38931276758835,11,9,13,42,2.8619218755468,4.69766841486728,7.7734448123828,101,"ENSG00000079974.19"
"20090","ENSG00000164270.18_39471",39463,39471,9,"ENSG00000164270.18",1,1,"MVVUVVVVV",1,7,0.786749482401656,84,90,133,136,141,147,185,188,"ATGAAGA","TTGA","GTGGAGA","CTGA",2.63151421601312,43,5,38,95,0.962234724240153,4.62641570774857,7.77341363735519,101,"ENSG00000079974.19"
"39191","ENSG00000253288.2_195342",195334,195342,9,"ENSG00000253288.2",1,2,"VMVVVVUVV",1,7,0.770186335403727,33,39,49,52,74,80,133,136,"ATAGTGA","CTGA","GTGAGGA","CTGA",2.64698866562399,10,22,53,94,1.12406791261286,4.69266475419319,7.7734100958081,101,"ENSG00000079974.19"
"47317","ENSG00000287993.1_9340",9332,9340,9,"ENSG00000287993.1",1,2,"VMVVVUVVV",1,7,0.806211180124223,72,78,89,92,101,107,133,136,"GTGATAA","GGGA","GTAATTA","CTGA",2.40484220893488,11,9,26,55,2.1617623479615,4.54851093521517,7.77335565571206,101,"ENSG00000079974.19"
"33074","ENSG00000228624.8_348132",348124,348132,9,"ENSG00000228624.8",1,8,"UVVVVVVMV",1,7,0.786749482401656,83,89,133,136,151,157,166,169,"ATGATGG","ATGA","AGGGTGG","CTGA",2.54288843052984,44,15,9,77,1.5527952202764,4.6263461892855,7.77334411889213,101,"ENSG00000079974.19"
"1592","ENSG00000062822.16_744",736,744,9,"ENSG00000062822.16",1,6,"VVVVVMUVV",1,7,0.788819875776397,57,63,73,76,90,96,133,136,"ATAATGA","CTGT","GTGGTCC","CTGA",2.5340012917911,10,14,37,70,1.57867222842111,4.61800354342377,7.77328304652936,101,"ENSG00000079974.19"
"18855","ENSG00000158966.16_1737",1729,1737,9,"ENSG00000158966.16",1,2,"UMVVVVVVV",1,7,0.786749482401656,95,101,133,136,148,154,165,168,"CTGATGA","CTGA","CTGGAGA","CTGT",2.50947625087533,32,12,11,64,1.77500101403963,4.62621067163546,7.77320860124209,101,"ENSG00000079974.19"
"40436","ENSG00000256196.2_4525",4517,4525,9,"ENSG00000256196.2",1,8,"VVVUVVVMV",1,7,0.764803312629399,85,91,133,136,150,156,179,182,"CTGATGA","CGGA","ATAATGA","CTGA",2.68102001214062,42,14,23,88,0.982237205045135,4.71392598816232,7.77313923867992,101,"ENSG00000079974.19"
"9498","ENSG00000124813.23_65137",65129,65137,9,"ENSG00000124813.23",1,1,"MVUVVVVVV",1,7,0.789648033126294,38,44,59,62,111,117,133,136,"CTGATGC","CTGT","ATGGTGT","CTGA",2.51832264781543,15,49,16,89,1.66910515236401,4.61448070111673,7.7730728336219,101,"ENSG00000079974.19"
"3161","ENSG00000081853.15_46962",46954,46962,9,"ENSG00000081853.15",0,NA,"UVUVVVVVV",2,7,0.786335403726708,95,101,133,136,151,157,171,174,"CTCAGGA","CTGA","GTGAAGA","CTGA",2.55932964103836,32,15,14,70,1.44858220674804,4.6276949534176,7.77303656832444,101,"ENSG00000079974.19"
"30426","ENSG00000204956.6_55208",55200,55208,9,"ENSG00000204956.6",0,NA,"UVUVVVVVV",2,7,0.786335403726708,95,101,133,136,151,157,171,174,"CTCAGGA","CTGA","GTGAAGA","CTGA",2.55932964103836,32,15,14,70,1.44858220674804,4.6276949534176,7.77303656832444,101,"ENSG00000079974.19"
"39332","ENSG00000253485.3_21560",21552,21560,9,"ENSG00000253485.3",0,NA,"UVUVVVVVV",2,7,0.786335403726708,95,101,133,136,151,157,171,174,"CTCAGGA","CTGA","GTGAAGA","CTGA",2.55932964103836,32,15,14,70,1.44858220674804,4.6276949534176,7.77303656832444,101,"ENSG00000079974.19"
"39385","ENSG00000253537.3_2983",2975,2983,9,"ENSG00000253537.3",0,NA,"UVUVVVVVV",2,7,0.786335403726708,95,101,133,136,151,157,171,174,"CTCAGGA","CTGA","GTGAAGA","CTGA",2.55932964103836,32,15,14,70,1.44858220674804,4.6276949534176,7.77303656832444,101,"ENSG00000079974.19"
"39527","ENSG00000253731.3_11831",11823,11831,9,"ENSG00000253731.3",0,NA,"UVUVVVVVV",2,7,0.786335403726708,95,101,133,136,151,157,171,174,"CTCAGGA","CTGA","GTGAAGA","CTGA",2.55932964103836,32,15,14,70,1.44858220674804,4.6276949534176,7.77303656832444,101,"ENSG00000079974.19"
"39611","ENSG00000253910.3_25728",25720,25728,9,"ENSG00000253910.3",0,NA,"UVUVVVVVV",2,7,0.786335403726708,95,101,133,136,151,157,171,174,"CTCAGGA","CTGA","GTGAAGA","CTGA",2.55932964103836,32,15,14,70,1.44858220674804,4.6276949534176,7.77303656832444,101,"ENSG00000079974.19"
"39795","ENSG00000254221.3_35623",35615,35623,9,"ENSG00000254221.3",0,NA,"UVUVVVVVV",2,7,0.786335403726708,95,101,133,136,151,157,171,174,"CTCAGGA","CTGA","GTGAAGA","CTGA",2.55932964103836,32,15,14,70,1.44858220674804,4.6276949534176,7.77303656832444,101,"ENSG00000079974.19"
"39809","ENSG00000254245.3_41893",41885,41893,9,"ENSG00000254245.3",0,NA,"UVUVVVVVV",2,7,0.786335403726708,95,101,133,136,151,157,171,174,"CTCAGGA","CTGA","GTGAAGA","CTGA",2.55932964103836,32,15,14,70,1.44858220674804,4.6276949534176,7.77303656832444,101,"ENSG00000079974.19"
"42394","ENSG00000262209.3_15480",15472,15480,9,"ENSG00000262209.3",0,NA,"UVUVVVVVV",2,7,0.786335403726708,95,101,133,136,151,157,171,174,"CTCAGGA","CTGA","GTGAAGA","CTGA",2.55932964103836,32,15,14,70,1.44858220674804,4.6276949534176,7.77303656832444,101,"ENSG00000079974.19"
"42405","ENSG00000262576.3_30701",30693,30701,9,"ENSG00000262576.3",0,NA,"UVUVVVVVV",2,7,0.786335403726708,95,101,133,136,151,157,171,174,"CTCAGGA","CTGA","GTGAAGA","CTGA",2.55932964103836,32,15,14,70,1.44858220674804,4.6276949534176,7.77303656832444,101,"ENSG00000079974.19"
"34670","ENSG00000233723.11_96446",96438,96446,9,"ENSG00000233723.11",1,8,"UVVVVVVMV",1,7,0.786749482401656,98,104,133,136,144,150,169,172,"ATGTTAA","CTGA","CTGTTTA","CTGA",2.53252911079746,29,8,19,65,1.62048997619543,4.62600434537796,7.77300227498458,101,"ENSG00000079974.19"
"9272","ENSG00000123607.16_11272",11264,11272,9,"ENSG00000123607.16",1,1,"MVVUVVVVV",1,7,0.786749482401656,62,68,80,83,116,122,133,136,"ATGATGA","CTAA","GGGTTGA","CAGA",2.47333747148946,12,33,11,65,2.01507542576278,4.62599797558979,7.77299590519642,101,"ENSG00000079974.19"
"27374","ENSG00000186094.18_1108820",1108812,1108820,9,"ENSG00000186094.18",1,6,"UVVVVMVVV",1,7,0.805383022774327,89,95,105,108,111,117,133,136,"GTGAGGA","ATGA","CTGAAGA","TTGA",2.36509281731278,10,3,16,38,2.43853672168172,4.5514555426084,7.77298763370571,101,"ENSG00000079974.19"
"47343","ENSG00000288016.3_87456",87448,87456,9,"ENSG00000288016.3",1,2,"VMVVVUVVV",1,7,0.806211180124223,108,114,133,136,147,153,165,168,"AATATAA","GTGA","ATGAAGA","CTGA",2.37325970990723,19,11,12,51,2.3704658835757,4.5480493207393,7.77289404123619,101,"ENSG00000079974.19"
"26340","ENSG00000183878.16_167601",167593,167601,9,"ENSG00000183878.16",1,3,"VVMVVUVVV",1,7,0.804968944099379,92,98,133,136,145,151,161,164,"ATGATGA","CTGT","GGGTAGA","ATGA",2.43790900848551,35,9,10,63,1.95915357793364,4.55297007529259,7.77284585169011,101,"ENSG00000079974.19"
"29461","ENSG00000198010.13_63885",63877,63885,9,"ENSG00000198010.13",1,8,"VVVUVVVMV",1,7,0.764803312629399,113,119,133,136,146,152,194,197,"ATGAAGT","GTGA","ATGCTGA","CTGA",2.54678366611467,14,10,42,75,1.87581649226952,4.71359356659183,7.77280681710942,101,"ENSG00000079974.19"
"2512","ENSG00000075391.18_347688",347680,347688,9,"ENSG00000075391.18",1,5,"VVVVMUVVV",1,7,0.808695652173913,111,117,133,136,141,147,159,162,"GTTATGC","CTTA","ATCACCA","CTGA",2.31098864047823,16,5,12,42,2.74482874259766,4.5378549197798,7.77263752847545,101,"ENSG00000079974.19"
"3770","ENSG00000088970.16_35746",35738,35746,9,"ENSG00000088970.16",0,NA,"VVVVUUVVV",2,7,0.812008281573499,115,121,133,136,142,148,159,162,"TTCATTA","ATGA","ATAATAC","CTGA",2.26030716586715,12,6,11,38,3.02956426608759,4.52456967630049,7.77260280259449,101,"ENSG00000079974.19"
"18468","ENSG00000157445.15_510541",510533,510541,9,"ENSG00000157445.15",0,NA,"VVVUUVVVV",2,7,0.770600414078675,96,102,133,136,154,160,174,177,"ATGAGGA","CTCA","CTGGTGA","CTGA",2.62267476491123,31,18,14,72,1.27621005272805,4.69017712136739,7.77257877768209,101,"ENSG00000079974.19"
"23169","ENSG00000172264.19_765027",765019,765027,9,"ENSG00000172264.19",1,6,"UVVVVMVVV",1,7,0.805383022774327,79,85,96,99,104,110,133,136,"CTGATAC","CAGA","ATGCAGA","CTGA",2.39058322058575,11,5,23,48,2.26679467221333,4.55100403569624,7.77253612679355,101,"ENSG00000079974.19"
"15429","ENSG00000148219.18_561586",561578,561586,9,"ENSG00000148219.18",1,7,"VVVVUVMVV",1,7,0.775155279503105,115,121,133,136,181,187,197,200,"TTGAGGA","ATGA","CTGAGGC","CTGA",2.50269687385319,12,45,10,76,2.00272740745237,4.67184330828508,7.7724644262975,101,"ENSG00000079974.19"
"12480","ENSG00000138380.18_58934",58926,58934,9,"ENSG00000138380.18",1,3,"UVMVVVVVV",1,7,0.785507246376811,89,95,106,109,115,121,133,136,"ATGATGA","CTTC","ATTTTGA","CTTA",2.33176409580508,11,6,12,38,2.97649584985615,4.63039745547251,7.77242644097976,101,"ENSG00000079974.19"
"39487","ENSG00000253658.6_145244",145236,145244,9,"ENSG00000253658.6",1,7,"VVUVVVMVV",1,7,0.768944099378882,84,90,98,101,112,118,133,136,"ATTATGA","CTGA","TTGTAGA","CTTA",2.45861690844489,8,11,15,43,2.39569902918628,4.69661960470472,7.77239600222025,101,"ENSG00000079974.19"
"6953","ENSG00000112335.15_33779",33771,33779,9,"ENSG00000112335.15",1,7,"UVVVVVMVV",1,7,0.787991718426501,112,118,133,136,141,147,161,164,"ATCATGA","CAAA","AAAATGG","CTGA",2.36354371542243,15,5,14,43,2.7246821084173,4.62041005280837,7.77237692651437,101,"ENSG00000079974.19"
"28683","ENSG00000196353.13_211991",211983,211991,9,"ENSG00000196353.13",1,6,"VVUVVMVVV",1,7,0.786335403726708,23,29,65,68,116,122,133,136,"ATGATGT","CAGA","ATTATGT","CTGA",2.6272219963587,36,48,11,104,0.993297494769673,4.62702770095691,7.77236931586375,101,"ENSG00000079974.19"
"293","ENSG00000007402.12_111662",111654,111662,9,"ENSG00000007402.12",0,NA,"VVUUVVVVV",2,7,0.764389233954451,112,118,133,136,184,190,200,203,"GAGATGA","CTGG","GTGACCA","CTGA",2.54222408334881,15,48,10,82,1.9108048179167,4.71474134339386,7.77229827921167,101,"ENSG00000079974.19"
"36629","ENSG00000242337.8_23642",23634,23642,9,"ENSG00000242337.8",1,1,"MVUVVVVVV",1,7,0.789648033126294,114,120,133,136,170,176,184,187,"CTAATGA","CTGG","TTGGTGG","CTGA",2.46822579518768,13,34,8,64,1.99984668992684,4.61367133112784,7.77226346363302,101,"ENSG00000079974.19"
"48371","ENSG00000291042.1_49908",49900,49908,9,"ENSG00000291042.1",1,1,"MVUVVVVVV",1,7,0.789648033126294,114,120,133,136,170,176,184,187,"CTAATGA","CTGG","TTGGTGG","CTGA",2.46822579518768,13,34,8,64,1.99984668992684,4.61367133112784,7.77226346363302,101,"ENSG00000079974.19"
"2682","ENSG00000077264.16_76051",76043,76051,9,"ENSG00000077264.16",1,6,"UVVVVMVVV",1,7,0.805383022774327,111,117,133,136,169,175,186,189,"ATGATTC","CTTA","ATGGTGG","CTGA",2.45246091727161,16,33,11,69,1.85283103046588,4.55064261973582,7.77217471083313,101,"ENSG00000079974.19"
"792","ENSG00000033800.14_107829",107821,107829,9,"ENSG00000033800.14",1,5,"VVUVMVVVV",1,7,0.770186335403727,115,121,133,136,140,146,154,157,"CGGATGA","TAGA","GTTAAGT","CTGA",2.36083857938244,12,4,8,33,3.02631915951842,4.691310755517,7.77205609713191,101,"ENSG00000079974.19"
"12633","ENSG00000138738.11_15323",15315,15323,9,"ENSG00000138738.11",0,NA,"UVVVVVUVV",2,7,0.788819875776397,104,110,133,136,144,150,162,165,"ATAATCA","CGGA","CTGGAGA","CTGA",2.43736639248356,23,8,12,52,2.21798894371276,4.61677455673413,7.77205405983972,101,"ENSG00000079974.19"
"4628","ENSG00000101349.17_206441",206433,206441,9,"ENSG00000101349.17",1,2,"VMVVVUVVV",1,7,0.806211180124223,115,121,133,136,145,151,165,168,"TCGATCA","CAGA","ATGAGCT","CTGA",2.30364958175991,12,9,14,44,2.83078849053812,4.54711309223438,7.77195781273127,101,"ENSG00000079974.19"
"11551","ENSG00000135315.12_74602",74594,74602,9,"ENSG00000135315.12",1,2,"VMVVUVVVV",1,7,0.773913043478261,91,97,133,136,150,156,169,172,"TTGATGA","TTGA","GTTCTTA","CTGA",2.57351196535032,36,14,13,72,1.54802186366801,4.6761920748342,7.77184424874724,101,"ENSG00000079974.19"
"43540","ENSG00000272234.1_127",119,127,9,"ENSG00000272234.1",1,3,"UVMVVVVVV",1,7,0.785507246376811,102,108,129,132,135,141,161,164,"TAGATGA","CAGA","GTGAATA","CTGA",2.53379266812432,21,3,20,53,1.62724663947634,4.62979944007629,7.77182842558353,101,"ENSG00000079974.19"
"32332","ENSG00000226777.9_52175",52167,52175,9,"ENSG00000226777.9",1,1,"MVVVVVUVV",1,7,0.792132505175983,102,108,133,136,140,146,156,159,"ATGCTGA","AGGA","GTTCTGA","CTGA",2.46026439548284,25,4,10,48,2.01133505668868,4.60327442331023,7.77180444401417,101,"ENSG00000079974.19"
"23177","ENSG00000172264.19_908237",908229,908237,9,"ENSG00000172264.19",1,2,"UMVVVVVVV",1,7,0.786749482401656,1,7,19,22,73,79,133,136,"ATGATAA","CTGA","ATTTTGT","CTGA",2.62458664336531,12,51,54,126,1.00184743795707,4.62477293176479,7.77177086137141,101,"ENSG00000079974.19"
"20960","ENSG00000166068.13_50946",50938,50946,9,"ENSG00000166068.13",1,1,"MVVVVUVVV",1,7,0.82815734989648,116,122,133,136,144,150,159,162,"AGGCTGA","AGGA","AAAATGC","CTGA",2.21959218878425,11,8,9,37,3.03891519075247,4.45904911232854,7.77167851191446,101,"ENSG00000079974.19"
"23360","ENSG00000172765.19_207887",207879,207887,9,"ENSG00000172765.19",1,1,"MVVVUVVVV",1,7,0.795859213250517,86,92,106,109,111,117,133,136,"TTGATAG","CTGA","ATATGGA","CTGA",2.41214904919033,14,2,16,41,2.2718283059123,4.5882054917953,7.77164234479737,101,"ENSG00000079974.19"
"17166","ENSG00000153291.16_11182",11174,11182,9,"ENSG00000153291.16",1,2,"VMUVVVVVV",1,7,0.767701863354037,112,118,133,136,146,152,178,181,"GTGATGC","CACA","GTGGTGA","CTGA",2.51389187847605,15,10,26,60,2.04401054737475,4.70082243430377,7.77162988771992,101,"ENSG00000079974.19"
"42776","ENSG00000266602.2_407030",407022,407030,9,"ENSG00000266602.2",1,6,"VVVUVMVVV",1,7,0.78343685300207,80,86,102,105,111,117,133,136,"ATTATAA","CTTA","TGGAGGA","CTGA",2.39523829238844,16,6,16,47,2.58300164463542,4.63781423180625,7.77156164381453,101,"ENSG00000079974.19"
"19045","ENSG00000160392.14_796",788,796,9,"ENSG00000160392.14",1,8,"VVVVVUVMV",1,7,0.806211180124224,66,72,81,84,91,97,133,136,"ATAATGA","CTGA","TTGGTGT","CAGA",2.4459655941164,9,7,36,61,1.88032974033342,4.54669175861068,7.77153647910758,101,"ENSG00000079974.19"
"28781","ENSG00000196482.18_45088",45080,45088,9,"ENSG00000196482.18",1,7,"VVVVVUMVV",1,7,0.807453416149068,112,118,133,136,171,177,194,197,"GTGAAGA","TCGA","GAGATGA","CTGA",2.48091396096231,15,35,17,76,1.62699475068051,4.54160528927397,7.77141895387025,101,"ENSG00000079974.19"
"10506","ENSG00000131374.15_588865",588857,588865,9,"ENSG00000131374.15",1,1,"MVVVVUVVV",1,7,0.82815734989648,95,101,133,136,183,189,201,204,"ATGATAA","CATA","ATGCTGA","CTGA",2.52779071179545,32,47,12,100,0.983216064806449,4.45878853586069,7.77141793544661,101,"ENSG00000079974.19"
"24291","ENSG00000175764.17_111880",111872,111880,9,"ENSG00000175764.17",1,8,"VVUVVVVMV",1,7,0.767701863354037,84,90,133,136,147,153,162,165,"GGGATGA","TTGA","CTGATTT","CTGA",2.54522966929279,43,11,9,72,1.83418726410487,4.70059626484754,7.77140371826368,101,"ENSG00000079974.19"
"43275","ENSG00000270691.2_362",354,362,9,"ENSG00000270691.2",1,8,"VVVVVUVMV",1,7,0.806211180124224,30,36,48,51,90,96,133,136,"ATGATGC","CTGA","GTGATGT","CTGT",2.57105804482525,12,39,37,97,1.04584383986632,4.54655770134199,7.77140242183889,101,"ENSG00000079974.19"
"4210","ENSG00000099204.21_50651",50643,50651,9,"ENSG00000099204.21",1,7,"UVVVVVMVV",1,7,0.787991718426501,83,89,133,136,139,145,153,156,"ATGATAG","CTGC","TTGAAGA","CTGA",2.51946330665232,44,3,8,64,1.68131792353882,4.6194349919719,7.77140186567791,101,"ENSG00000079974.19"
"18390","ENSG00000157168.20_989405",989397,989405,9,"ENSG00000157168.20",1,1,"MVVUVVVVV",1,7,0.786749482401656,61,67,79,82,90,96,133,136,"TAGATGA","CTAA","ATTAAGA","CTGA",2.47113093724451,12,8,37,66,2.02334133328472,4.62438689539536,7.77138482500198,101,"ENSG00000079974.19"
"22693","ENSG00000171132.14_210015",210007,210015,9,"ENSG00000171132.14",1,1,"MVVVVVUVV",1,7,0.792132505175983,70,76,104,107,111,117,133,136,"ATGGTGA","CTGA","ATGCTGA","CTTA",2.51053682633384,28,4,16,57,1.67425400234697,4.60279154447648,7.77132156518042,101,"ENSG00000079974.19"
"4767","ENSG00000101868.13_243241",243233,243241,9,"ENSG00000101868.13",0,NA,"VVVVUUVVV",2,7,0.812008281573499,72,78,102,105,114,120,133,136,"ATGATCT","TTGA","ATTTTTA","CTGA",2.40078432415937,24,9,13,55,2.08775290843895,4.52324543404202,7.77127856033602,101,"ENSG00000079974.19"
"38391","ENSG00000250102.6_37624",37616,37624,9,"ENSG00000250102.6",1,2,"VMVVVVUVV",1,7,0.770186335403727,67,73,86,89,115,121,133,136,"ATGATTA","CAGA","ATCTTCA","CTGA",2.50561467979725,13,26,12,60,2.05798477522538,4.6905206601351,7.77126600175001,101,"ENSG00000079974.19"
"35673","ENSG00000236700.8_49705",49697,49705,9,"ENSG00000236700.8",1,8,"VVVVVUVMV",1,7,0.806211180124224,114,120,133,136,137,143,157,160,"ATTCTGA","ATGA","ATGACAC","CTGA",2.38711794806785,13,1,14,37,2.27153407300812,4.54641343169844,7.77125815219534,101,"ENSG00000079974.19"
"25991","ENSG00000183117.20_457128",457120,457128,9,"ENSG00000183117.20",1,8,"UVVVVVVMV",1,7,0.786749482401656,109,115,133,136,159,165,178,181,"GTGATCA","CTGC","CTGTTGG","CTGA",2.51075361115937,18,23,13,63,1.75855496403796,4.62422809294176,7.77122602254839,101,"ENSG00000079974.19"
"1237","ENSG00000050165.19_8096",8088,8096,9,"ENSG00000050165.19",1,8,"VVVVVUVMV",1,7,0.806211180124224,85,91,133,136,168,174,184,187,"ATGAAGA","CTGC","CTGGTGT","CTGA",2.57243434844217,42,32,10,93,1.03595749926101,4.5463799555522,7.77122467604909,101,"ENSG00000079974.19"
"39418","ENSG00000253554.7_98911",98903,98911,9,"ENSG00000253554.7",1,7,"VVVVVUMVV",1,7,0.807453416149068,114,120,133,136,145,151,159,162,"ATGATAC","CAGG","ATAAAAA","CTGA",2.27905621913416,13,9,8,39,2.97115509755907,4.54121580628004,7.77102947087631,101,"ENSG00000079974.19"
"32269","ENSG00000226571.2_22498",22490,22498,9,"ENSG00000226571.2",1,8,"VVVVVVUMV",1,7,0.770186335403727,114,120,133,136,145,151,205,208,"TTGATGA","CTTT","TTAATGA","CTGA",2.52209581594058,13,9,54,85,1.94712854956453,4.69027516395877,7.77102050557368,101,"ENSG00000079974.19"
"22977","ENSG00000171848.16_5141",5133,5141,9,"ENSG00000171848.16",1,1,"MVVUVVVVV",1,7,0.786749482401656,76,82,97,100,106,112,133,136,"ATGAAGA","TTGA","CTGAGGA","TTGA",2.42130065423705,15,6,21,51,2.35406414652174,4.62401712702553,7.77101505663215,101,"ENSG00000079974.19"
"33283","ENSG00000229209.1_3158",3150,3158,9,"ENSG00000229209.1",1,1,"MVVVVUVVV",1,7,0.82815734989648,68,74,93,96,105,111,133,136,"GTGATGT","CTAA","CTGAAGA","CTTA",2.3847682661628,19,9,22,59,1.93498902292928,4.45836103267032,7.77099043225624,101,"ENSG00000079974.19"
"7758","ENSG00000115593.15_29673",29665,29673,9,"ENSG00000115593.15",1,8,"VVVVVUVMV",1,7,0.806211180124224,73,79,89,92,98,104,133,136,"GTGAAGT","CTTA","ATGGTGT","CTGA",2.41984210182596,10,6,29,54,2.05214982099762,4.54610762495934,7.77095234545623,101,"ENSG00000079974.19"
"7811","ENSG00000115808.12_43710",43702,43710,9,"ENSG00000115808.12",1,1,"MVVVVUVVV",1,7,0.82815734989648,114,120,133,136,142,148,157,160,"AAGATGA","GTGC","AAGAGGA","TTGA",2.21642764652851,13,6,9,37,3.05690452077254,4.45827220774065,7.77090160732657,101,"ENSG00000079974.19"
"22559","ENSG00000170832.13_179197",179189,179197,9,"ENSG00000170832.13",1,2,"VMVVVUVVV",1,7,0.806211180124223,74,80,94,97,111,117,133,136,"GTAAAGA","CTGT","ATGATCC","CTGA",2.37578494206099,14,14,16,53,2.34538451555173,4.54598769898957,7.77083241948647,101,"ENSG00000079974.19"
"9392","ENSG00000124422.12_5447",5439,5447,9,"ENSG00000124422.12",0,NA,"VVVUVUVVV",2,7,0.802898550724638,109,115,133,136,143,149,173,176,"GTGGTGA","CTCA","GTTTTTA","CTGA",2.4385164865729,18,7,24,58,1.980143248401,4.55922995638842,7.77082415928697,101,"ENSG00000079974.19"
"1311","ENSG00000053108.17_405222",405214,405222,9,"ENSG00000053108.17",1,7,"VVVUVVMVV",1,7,0.766045548654244,109,115,133,136,139,145,159,162,"ATGTGGA","CTAA","ATGTTGA","CTGA",2.48688647091862,18,3,14,44,2.24728178200999,4.70663123036686,7.77081342498384,101,"ENSG00000079974.19"
"11625","ENSG00000135541.22_166699",166691,166699,9,"ENSG00000135541.22",1,8,"UVVVVVVMV",1,7,0.786749482401656,91,97,107,110,115,121,133,136,"ATGATTA","TTGA","GGGCTGA","CTCA",2.33757769250377,10,5,12,36,2.9113933483765,4.62381115793375,7.77080908754037,101,"ENSG00000079974.19"
"27961","ENSG00000187720.15_361550",361542,361550,9,"ENSG00000187720.15",1,6,"UVVVVMVVV",1,7,0.805383022774327,113,119,133,136,153,159,178,181,"ATGATAA","CTTG","CTGGTAA","CTGA",2.43447410827077,14,17,19,59,1.96727791608823,4.54927632614,7.77080841723731,101,"ENSG00000079974.19"
"17567","ENSG00000154479.13_26734",26726,26734,9,"ENSG00000154479.13",1,5,"UVVVMVVVV",1,7,0.789233954451346,84,90,103,106,116,122,133,136,"CTGCTCA","CTGG","ATGAGCA","CTGA",2.33447705880133,13,10,11,43,2.89199271304926,4.61379327626453,7.77072909406991,101,"ENSG00000079974.19"
"23097","ENSG00000172260.15_585899",585891,585899,9,"ENSG00000172260.15",1,2,"UMVVVVVVV",1,7,0.786749482401656,78,84,100,103,112,118,133,136,"CTGCTCA","CTGA","GTAACAA","CTGA",2.38319769354746,16,9,15,49,2.60676869659968,4.62368833006236,7.77068625966898,101,"ENSG00000079974.19"
"27185","ENSG00000185736.16_511200",511192,511200,9,"ENSG00000185736.16",1,7,"UVVVVVMVV",1,7,0.787991718426501,94,100,133,136,145,151,160,163,"AGGAGGA","TTGA","TAGATGA","CTGA",2.47629060408079,33,9,9,60,1.96608671128481,4.61867268462252,7.77063955832852,101,"ENSG00000079974.19"
"1402","ENSG00000055044.11_16664",16656,16664,9,"ENSG00000055044.11",1,8,"UVVVVVVMV",1,7,0.786749482401656,94,100,133,136,158,164,176,179,"CTGATGG","CTGA","ATGAACC","CTGA",2.597401068588,33,22,12,76,1.17852619581145,4.62363332993286,7.77063125953948,101,"ENSG00000079974.19"
"1746","ENSG00000065833.9_76980",76972,76980,9,"ENSG00000065833.9",1,6,"VVVUVMVVV",1,7,0.78343685300207,81,87,98,101,111,117,133,136,"GTGCTTA","GTGA","GAGAAGA","CTGA",2.38671630120212,11,10,16,46,2.63565755816795,4.63677489154552,7.7705223035538,101,"ENSG00000079974.19"
"42965","ENSG00000267452.3_98105",98097,98105,9,"ENSG00000267452.3",0,NA,"VVUVVUVVV",2,7,0.805797101449275,107,113,133,136,144,150,163,166,"ATGATGA","AAGA","ATACTGA","TTGA",2.36885856808221,20,8,13,50,2.39688712076739,4.54731939366219,7.77050779945929,101,"ENSG00000079974.19"
"1696","ENSG00000065413.20_340745",340737,340745,9,"ENSG00000065413.20",1,1,"MVUVVVVVV",1,7,0.789648033126294,89,95,107,110,116,122,133,136,"ATTAAGA","CACA","AGGAAGA","CTGA",2.3127001477545,12,6,11,38,3.02956426608759,4.6118913127794,7.77048344528458,101,"ENSG00000079974.19"
"20632","ENSG00000165194.15_38966",38958,38966,9,"ENSG00000165194.15",0,NA,"UVVVVUVVV",2,7,0.824844720496894,86,92,102,105,111,117,133,136,"ATAATTA","GTGA","GTGATGG","CTAA",2.27976658365894,10,6,16,41,2.68581035137908,4.47106356060967,7.77044244259725,101,"ENSG00000079974.19"
"11827","ENSG00000136153.20_28937",28929,28937,9,"ENSG00000136153.20",1,2,"VMVVVUVVV",1,7,0.806211180124223,105,111,133,136,145,151,163,166,"GTGATGG","AGGA","GAGATCT","CTGA",2.39039550135936,22,9,12,52,2.24595056704475,4.54548014402678,7.77032486452368,101,"ENSG00000079974.19"
"42300","ENSG00000261553.5_99598",99590,99598,9,"ENSG00000261553.5",1,2,"VMVVVUVVV",1,7,0.806211180124223,105,111,133,136,145,151,163,166,"GTGATGG","AGGA","GAGATCT","CTGA",2.39039550135936,22,9,12,52,2.24595056704475,4.54548014402678,7.77032486452368,101,"ENSG00000079974.19"
"36404","ENSG00000240499.7_69405",69397,69405,9,"ENSG00000240499.7",1,1,"MVVVVVUVV",1,7,0.792132505175983,112,118,133,136,142,148,167,170,"AGTATGA","CTGC","ATGAGTC","CTGA",2.39060600678011,15,6,19,49,2.46976436755127,4.60178443652133,7.77031445722526,101,"ENSG00000079974.19"
"32193","ENSG00000226317.3_75028",75020,75028,9,"ENSG00000226317.3",1,1,"MVVVVUVVV",1,7,0.82815734989648,112,118,133,136,171,177,187,190,"TTGAAAA","GTGA","TTGATGG","CTGA",2.38520860746392,15,35,10,69,1.92932530395495,4.45767900509527,7.77030840468119,101,"ENSG00000079974.19"
"29101","ENSG00000197157.11_403420",403412,403420,9,"ENSG00000197157.11",1,5,"VVVUMVVVV",1,7,0.767287784679089,56,62,72,75,80,86,133,136,"ATGATGA","CTGG","ATGCTGA","CAGA",2.54234476100676,10,5,47,71,1.85551586518259,4.70112023464025,7.7702713733566,101,"ENSG00000079974.19"
"10297","ENSG00000130402.14_56933",56925,56933,9,"ENSG00000130402.14",1,6,"VVVUVMVVV",1,7,0.78343685300207,37,43,61,64,77,83,133,136,"GAGATGA","CTGA","GGGGTGC","CTGA",2.57743120458143,18,13,50,90,1.36298415923798,4.63646471411189,7.77021212612017,101,"ENSG00000079974.19"
"2652","ENSG00000077092.20_832887",832879,832887,9,"ENSG00000077092.20",1,3,"VVMVVVUVV",1,7,0.768944099378882,113,119,133,136,150,156,175,178,"ATGATAT","CTAA","CTCATGA","CTGA",2.49235636830365,14,14,19,56,2.16198171640419,4.69442270960714,7.77019910712266,101,"ENSG00000079974.19"
"6342","ENSG00000109452.13_550696",550688,550696,9,"ENSG00000109452.13",1,1,"MVVVVUVVV",1,7,0.82815734989648,115,121,133,136,175,181,194,197,"GTAAAGA","CAGA","CTGTTGC","CTGA",2.38528319579031,12,39,13,73,1.92831153163006,4.45754987589136,7.77017927547728,101,"ENSG00000079974.19"
"35661","ENSG00000236653.3_16571",16563,16571,9,"ENSG00000236653.3",1,8,"UVVVVVVMV",1,7,0.786749482401656,106,112,133,136,139,145,161,164,"ATGATGG","CTTT","ATGTTGG","CTGA",2.49333430036714,21,3,16,49,1.87040524816123,4.62315847931887,7.7701564089255,101,"ENSG00000079974.19"
"35549","ENSG00000236283.5_224884",224876,224884,9,"ENSG00000236283.5",0,NA,"UVVVVUVVV",2,7,0.824844720496894,113,119,133,136,142,148,166,169,"ACAATGA","GTGT","TTCAGGA","CTGA",2.29447841715542,14,6,18,47,2.586539808909,4.47076564748628,7.77014452947386,101,"ENSG00000079974.19"
"18441","ENSG00000157423.18_162610",162602,162610,9,"ENSG00000157423.18",1,3,"UVMVVVVVV",1,7,0.785507246376811,61,67,76,79,88,94,133,136,"ATCATAA","CTGA","ATGTACA","CTGA",2.50509677373209,9,9,39,66,1.81172683190582,4.62809299752994,7.77012198303719,101,"ENSG00000079974.19"
"4574","ENSG00000101126.18_26720",26712,26720,9,"ENSG00000101126.18",1,8,"VVVVVVUMV",1,7,0.770186335403727,73,79,96,99,106,112,133,136,"ATGATGA","CTGT","ATGTTCA","CTAA",2.48131513782914,17,7,21,54,2.21537333202209,4.68936856272075,7.77011390433566,101,"ENSG00000079974.19"
"28604","ENSG00000196220.17_323852",323844,323852,9,"ENSG00000196220.17",0,NA,"VVVUVUVVV",2,7,0.802898550724638,116,122,133,136,137,143,154,157,"GTGAAGA","TTGT","AAGAAGG","CTGA",2.35367562672695,11,1,11,32,2.54284999452133,4.55850520984191,7.77009941274046,101,"ENSG00000079974.19"
"41255","ENSG00000258744.3_61078",61070,61078,9,"ENSG00000258744.3",1,7,"UVVVVVMVV",1,7,0.787991718426501,115,121,133,136,144,150,158,161,"GAAATGA","CTCA","ATGGTTT","CTGA",2.31399302389004,12,8,8,37,3.04579407461945,4.61810355847159,7.77007043217759,101,"ENSG00000079974.19"
"27102","ENSG00000185565.12_366872",366864,366872,9,"ENSG00000185565.12",1,1,"MVVVVUVVV",1,7,0.82815734989648,115,121,133,136,142,148,164,167,"ATTTTGA","GTGT","GAGAGGC","CTGA",2.26122749686321,12,6,16,43,2.75487448034325,4.45743111485783,7.77006051444375,101,"ENSG00000079974.19"
"47478","ENSG00000288545.1_17278",17270,17278,9,"ENSG00000288545.1",1,1,"MVVVVUVVV",1,7,0.82815734989648,72,78,84,87,98,104,133,136,"TAGTTGA","CTGA","ATGTTAA","CTGA",2.45372700461577,6,11,29,55,1.47152332102797,4.45742583794994,7.77005523753586,101,"ENSG00000079974.19"
"33029","ENSG00000228566.2_176567",176559,176567,9,"ENSG00000228566.2",0,NA,"VVVVUUVVV",2,7,0.812008281573499,92,98,133,136,153,159,171,174,"GTGAAGG","CTGT","GTGAAGA","CTGA",2.50395917530976,35,17,12,73,1.39482201737779,4.52197079652738,7.77000392282138,101,"ENSG00000079974.19"
"4783","ENSG00000101871.17_378654",378646,378654,9,"ENSG00000101871.17",1,3,"UVMVVUVVV",2,6,0.707660455486542,109,115,133,136,147,153,163,166,"ATGATAA","ATGA","AAGAAGA","CTGA",2.5881168584991,18,11,10,48,2.50326153916375,4.93934348228943,7.7699853042356,101,"ENSG00000079974.19"
"33618","ENSG00000230489.1_14906",14898,14906,9,"ENSG00000230489.1",1,2,"VMVVVUVVV",1,7,0.806211180124223,109,115,133,136,163,169,183,186,"CTGATGC","CTGC","ATAATCA","CTGA",2.48328729957608,18,27,14,68,1.62530917736985,4.5451394603026,7.76998418079949,101,"ENSG00000079974.19"
"45781","ENSG00000285901.2_127727",127719,127727,9,"ENSG00000285901.2",1,8,"VVVVVUVMV",1,7,0.806211180124224,112,118,133,136,157,163,183,186,"GAGATGA","CTGC","TGGATTA","CTGA",2.47740911193184,15,21,20,65,1.66425011157811,4.54507771444759,7.76992243494449,101,"ENSG00000079974.19"
"13919","ENSG00000143951.16_340605",340597,340605,9,"ENSG00000143951.16",1,1,"MVVVVUVVV",1,7,0.82815734989648,115,121,133,136,139,145,154,157,"AAAATGC","ATGA","ATTTTCA","CTGA",2.23816919117757,12,3,9,33,2.90790712619639,4.45725876684505,7.76988816643098,101,"ENSG00000079974.19"
"11430","ENSG00000134909.19_189808",189800,189808,9,"ENSG00000134909.19",1,1,"MVUVVVVVV",1,7,0.789648033126294,61,67,82,85,91,97,133,136,"ATCATGT","CTCA","ATGCTGT","CTGA",2.4761322383515,15,6,36,66,1.93737894915079,4.61123180120686,7.76982393371203,101,"ENSG00000079974.19"
"7136","ENSG00000112941.14_12273",12265,12273,9,"ENSG00000112941.14",1,8,"VVVVVUVMV",1,7,0.806211180124224,76,82,99,102,106,112,133,136,"ATAATGA","CTGA","GTGGTTT","CTAA",2.41893856708937,17,4,21,51,2.05353556867877,4.54494817065198,7.76979289114887,101,"ENSG00000079974.19"
"5849","ENSG00000107077.19_133768",133760,133768,9,"ENSG00000107077.19",1,1,"MVVVVVUVV",1,7,0.792132505175983,106,112,133,136,138,144,154,157,"AGGATGT","CTAA","ATCAGGA","CTGA",2.46789143715868,21,2,10,42,1.95242585596718,4.60125885925626,7.76978887996019,101,"ENSG00000079974.19"
"2291","ENSG00000072682.20_19031",19023,19031,9,"ENSG00000072682.20",1,8,"VVVVUUVMV",2,6,0.696066252587992,85,91,101,104,111,117,133,136,"ATAATGA","ATGA","ATAATGT","CTGA",2.58701149457836,10,7,16,42,2.69523991124441,4.98549580210838,7.76976081246034,101,"ENSG00000079974.19"
"3080","ENSG00000080709.16_435560",435552,435560,9,"ENSG00000080709.16",1,8,"VVVVVUVMV",1,7,0.806211180124224,75,81,96,99,114,120,133,136,"TTGATAG","TTGA","CTGTTGC","CTGA",2.3695176349225,15,15,13,52,2.38271534722955,4.54487489501155,7.76971961550845,101,"ENSG00000079974.19"
"18025","ENSG00000156011.18_492361",492353,492361,9,"ENSG00000156011.18",1,6,"VVUVVMVVV",1,7,0.786335403726708,116,122,133,136,149,155,170,173,"ATGATGT","CTCT","ATTCTTA","CTGA",2.4014123906015,11,13,15,48,2.48788991463968,4.62432646299575,7.76966807790259,101,"ENSG00000079974.19"
"42484","ENSG00000263655.1_52864",52856,52864,9,"ENSG00000263655.1",1,8,"VVVVUVVMV",1,7,0.773913043478261,115,121,133,136,141,147,155,158,"AGGAAGA","GTGT","TTCATGA","CTGA",2.34262030904731,12,5,8,34,3.07847702438505,4.67398643784177,7.76963861175482,101,"ENSG00000079974.19"
"23431","ENSG00000172955.17_6158",6150,6158,9,"ENSG00000172955.17",1,3,"VVMVVUVVV",1,7,0.804968944099379,97,103,133,136,172,178,188,191,"ATTTTGA","CTGA","ATGAAAA","CTGA",2.57083061139827,30,36,10,85,1.05995743090807,4.54970704339081,7.76958281978832,101,"ENSG00000079974.19"
"31933","ENSG00000225321.2_14525",14517,14525,9,"ENSG00000225321.2",1,2,"VMVVUVVVV",1,7,0.773913043478261,96,102,133,136,145,151,164,167,"GTGATAA","CTTA","CTGCAGA","CTGA",2.51907600624908,31,9,13,62,1.90175349987761,4.67389838538455,7.76955055929759,101,"ENSG00000079974.19"
"37769","ENSG00000248789.5_26143",26135,26143,9,"ENSG00000248789.5",1,8,"VVVVVUVMV",1,7,0.806211180124224,112,118,133,136,149,155,177,180,"ATAATTA","ATGA","ATAATAA","CTGA",2.42514169208356,15,13,22,59,2.01120429644479,4.54470389425047,7.76954861474736,101,"ENSG00000079974.19"
"45435","ENSG00000285579.1_373767",373759,373767,9,"ENSG00000285579.1",1,8,"VVVVVVUMV",1,7,0.770186335403727,112,118,133,136,151,157,179,182,"CTGATGA","GTCA","ATGGAGA","CTGA",2.532621887796,15,15,22,61,1.87087885890464,4.68875619438616,7.76950153600107,101,"ENSG00000079974.19"
"26213","ENSG00000183690.13_158587",158579,158587,9,"ENSG00000183690.13",1,2,"UMVVVVVVV",1,7,0.786749482401656,111,117,133,136,143,149,171,174,"ATGGTGA","CTAT","TTGAGCA","CTGA",2.43665420399221,16,7,22,54,2.24556648166173,4.62248196040245,7.76947989000908,101,"ENSG00000079974.19"
"14213","ENSG00000144619.15_406946",406938,406946,9,"ENSG00000144619.15",1,1,"MVVVVUVVV",1,7,0.82815734989648,110,116,133,136,141,147,155,158,"TAGATAA","GTGA","AGGCAGA","CTGA",2.26739332393763,17,5,8,39,2.71140881442776,4.45684107683632,7.76947047642224,101,"ENSG00000079974.19"
"27710","ENSG00000187210.14_5941",5933,5941,9,"ENSG00000187210.14",1,7,"VVVUVVMVV",1,7,0.766045548654244,45,51,67,70,78,84,133,136,"ATTATCA","CTGA","GAGATGG","CTGA",2.54901569265101,16,8,49,82,1.82760439622571,4.70526058680812,7.7694427814251,101,"ENSG00000079974.19"
"27318","ENSG00000185942.13_616214",616206,616214,9,"ENSG00000185942.13",1,2,"UMVVVUVVV",2,6,0.708902691511387,81,87,102,105,109,115,133,136,"TTGATGA","CGGA","CAGATAA","CTGA",2.60217797099927,15,4,18,46,2.38742097017111,4.93381852754156,7.76942929358711,101,"ENSG00000079974.19"
"30694","ENSG00000206579.9_127572",127564,127572,9,"ENSG00000206579.9",1,2,"UMVVVVVVV",1,7,0.786749482401656,59,65,78,81,86,92,133,136,"AGGATGA","TGGA","ATTAAGA","CTGA",2.48186948392821,13,5,41,68,1.94383001974003,4.62240664481536,7.76940457442199,101,"ENSG00000079974.19"
"37841","ENSG00000248973.3_133911",133903,133911,9,"ENSG00000248973.3",0,NA,"VVVUVVUVV",2,7,0.766873706004141,71,77,89,92,100,106,133,136,"ATGATGA","CTAA","ATGATTT","GTGA",2.49258216260915,12,8,27,56,2.19036409146053,4.70189462721372,7.76938945123028,101,"ENSG00000079974.19"
"9959","ENSG00000128573.28_67124",67116,67124,9,"ENSG00000128573.28",0,NA,"UVVVVUVVV",2,7,0.824844720496894,115,121,133,136,162,168,181,184,"CTTATGA","ATGT","ATGTTTA","CTGA",2.37846095436809,12,26,13,60,2.02358452965431,4.46999772302706,7.76937660501464,101,"ENSG00000079974.19"
"14708","ENSG00000145743.18_434977",434969,434977,9,"ENSG00000145743.18",1,8,"UVVVVVVMV",1,7,0.786749482401656,110,116,133,136,141,147,168,171,"CTGATCA","ATGT","GTGATTA","CTGA",2.45136252124901,17,5,21,52,2.14704235461545,4.62236479073555,7.76936272034217,101,"ENSG00000079974.19"
"45484","ENSG00000285634.3_68185",68177,68185,9,"ENSG00000285634.3",1,8,"UVVVVVVMV",1,7,0.786749482401656,89,95,133,136,143,149,161,164,"ATAATGA","ATGA","ATGATGA","CTAA",2.47917486330423,38,7,12,66,1.96101275684839,4.62221129471915,7.76920922432578,101,"ENSG00000079974.19"
"9727","ENSG00000126777.18_23434",23426,23434,9,"ENSG00000126777.18",1,7,"UVVVVVMVV",1,7,0.787991718426501,110,116,133,136,154,160,172,175,"ATGTTAA","CTTA","AAGATGA","CTGA",2.45743788612473,17,18,12,56,2.08582511341122,4.61718608856068,7.76915296226669,101,"ENSG00000079974.19"
"2997","ENSG00000080224.18_285742",285734,285742,9,"ENSG00000080224.18",1,1,"MVVUVVVVV",1,7,0.786749482401656,109,115,133,136,139,145,164,167,"TTGATGA","CAGT","TTAATGC","CTGA",2.48173233371618,18,3,19,49,1.94370750119977,4.62214743149357,7.7691453611002,101,"ENSG00000079974.19"
"10121","ENSG00000129484.14_12796",12788,12796,9,"ENSG00000129484.14",1,8,"VVVVUVVMV",1,7,0.773913043478261,116,122,133,136,137,143,158,161,"ATGGTGA","TTCA","GAGAGGA","CTGA",2.47106799826208,11,1,15,36,2.22016898516939,4.67348891006247,7.76914108397552,101,"ENSG00000079974.19"
"618","ENSG00000021645.20_239190",239182,239190,9,"ENSG00000021645.20",1,2,"VMVVVVUVV",1,7,0.770186335403727,115,121,133,136,146,152,169,172,"ATGAAGG","CTAA","ATGAATT","CTGA",2.42336038087303,12,10,17,48,2.59782127016637,4.68838928566332,7.76913462727822,101,"ENSG00000079974.19"
"39302","ENSG00000253438.5_613681",613673,613681,9,"ENSG00000253438.5",0,NA,"UVVVVUVVV",2,7,0.824844720496894,61,67,81,84,95,101,133,136,"ATGAAGG","CTGA","GTCATGA","GTGA",2.39844231092798,14,11,32,66,1.88935100965064,4.46974160395929,7.76912048594687,101,"ENSG00000079974.19"
"34784","ENSG00000234147.4_158526",158518,158526,9,"ENSG00000234147.4",1,2,"UMVVVVVVV",1,7,0.786749482401656,110,116,133,136,145,151,159,162,"ATGCTCA","GTAA","ATGTTGA","CTGA",2.36852000542673,17,9,8,43,2.69811208993262,4.62206136486104,7.76905929446767,101,"ENSG00000079974.19"
"14860","ENSG00000145982.13_81348",81340,81348,9,"ENSG00000145982.13",1,3,"UVMVVVVVV",1,7,0.785507246376811,110,116,133,136,140,146,161,164,"ATGAACA","CTAA","CTGATAC","CTGA",2.41382903848619,17,4,15,45,2.41587732889948,4.62701772970185,7.76904671520909,101,"ENSG00000079974.19"
"42960","ENSG00000267440.2_11790",11782,11790,9,"ENSG00000267440.2",1,8,"VVUVVVVMV",1,7,0.767701863354037,113,119,133,136,145,151,163,166,"GAGAGGA","GTGA","CTGAGCA","CTGA",2.38675027572004,14,9,12,44,2.88123422355851,4.69822568208969,7.76903313550584,101,"ENSG00000079974.19"
"31463","ENSG00000223786.1_467994",467986,467994,9,"ENSG00000223786.1",1,6,"UVVVVMVVV",1,7,0.805383022774327,89,95,133,136,143,149,187,190,"ATAATAA","ATGA","ATGATGA","CTGA",2.57350692172746,38,7,38,92,1.03327221786133,4.54749625734443,7.76902834844174,101,"ENSG00000079974.19"
"11515","ENSG00000135250.17_234101",234093,234101,9,"ENSG00000135250.17",1,1,"MVVVVUVVV",1,7,0.82815734989648,114,120,133,136,143,149,162,165,"ATTAGGA","TTGG","ATCCTTA","CTGA",2.23400194162098,13,7,13,42,2.93215203790703,4.45637457884506,7.76900397843099,101,"ENSG00000079974.19"
"9679","ENSG00000126106.14_7567",7559,7567,9,"ENSG00000126106.14",1,5,"VVVVMUVVV",1,7,0.808695652173913,85,91,101,104,112,118,133,136,"GTGATGG","TTGA","AGGTTGA","ATGA",2.30945651995886,10,8,15,42,2.74045106834555,4.53420696701782,7.76898957571347,101,"ENSG00000079974.19"
"34572","ENSG00000233452.9_19945",19937,19945,9,"ENSG00000233452.9",1,6,"VVVUVMVVV",1,7,0.78343685300207,70,76,86,89,112,118,133,136,"TTAATGA","TTGA","TTGAGCA","CTGA",2.49471283938949,10,23,15,57,1.90948570465488,4.63522615847954,7.76897357048782,101,"ENSG00000079974.19"
"22746","ENSG00000171316.14_170073",170065,170073,9,"ENSG00000171316.14",1,1,"MVVUVVVVV",1,7,0.786749482401656,79,85,100,103,112,118,133,136,"GTGATGA","CTGT","ATGTTTG","GTGA",2.37132284893777,15,9,15,48,2.67899429046649,4.62195332084624,7.76895125045286,101,"ENSG00000079974.19"
"19257","ENSG00000162621.7_30947",30939,30947,9,"ENSG00000162621.7",1,7,"VVVVUUMVV",2,6,0.697308488612836,70,76,93,96,104,110,133,136,"CTAATGA","CTGA","ATGGTGA","CTGA",2.67277413263652,17,8,23,57,2.10031096129025,4.97970129471676,7.7689352491681,101,"ENSG00000079974.19"
"39580","ENSG00000253868.4_116403",116395,116403,9,"ENSG00000253868.4",1,3,"UVMVVVVVV",1,7,0.785507246376811,116,122,133,136,147,153,164,167,"ATGATGT","GTGG","GTGATGT","CTCA",2.35417198602967,11,11,11,42,2.81308666297025,4.62689164245867,7.76892062796592,101,"ENSG00000079974.19"
"37117","ENSG00000245466.1_459",451,459,9,"ENSG00000245466.1",1,1,"MVUVVUVVV",2,6,0.711801242236025,115,121,133,136,147,153,169,172,"ATGAAGA","GTGG","GTGAGGA","CTGA",2.56366335513973,12,11,16,48,2.59561591312909,4.92167623684849,7.76888120579258,101,"ENSG00000079974.19"
"41503","ENSG00000259115.1_365",357,365,9,"ENSG00000259115.1",1,1,"MVUVVUVVV",2,6,0.711801242236025,115,121,133,136,147,153,169,172,"ATGAAGA","GTGG","GTGAGGA","CTGA",2.56366335513973,12,11,16,48,2.59561591312909,4.92167623684849,7.76888120579258,101,"ENSG00000079974.19"
"32385","ENSG00000226921.7_3338",3330,3338,9,"ENSG00000226921.7",1,3,"VVMUVVVVV",1,7,0.763561076604555,115,121,133,136,145,151,163,166,"GTGATGA","GTAA","GTGGTGA","GTGA",2.38984367733813,12,9,12,42,2.92620981779387,4.71462525001202,7.76886955643024,101,"ENSG00000079974.19"
"28202","ENSG00000188452.15_41288",41280,41288,9,"ENSG00000188452.15",1,5,"UVVVMVVVV",1,7,0.789233954451346,115,121,133,136,155,161,178,181,"ATAATTA","CTCA","GTGAAGC","CTGA",2.46405012492191,12,19,17,57,2.02050287913843,4.61187592798778,7.76881174579317,101,"ENSG00000079974.19"
"47976","ENSG00000289873.1_30526",30518,30526,9,"ENSG00000289873.1",0,NA,"VVUVUVVVV",2,7,0.773498964803312,84,90,99,102,114,120,133,136,"GTGGAGA","CTGA","GTCCTGT","CTGA",2.42483495536821,9,12,13,43,2.53362300949733,4.67479734465468,7.76879320386793,101,"ENSG00000079974.19"
"537","ENSG00000018189.13_17570",17562,17570,9,"ENSG00000018189.13",1,1,"MVVVUVVVV",1,7,0.795859213250517,112,118,133,136,144,150,162,165,"TTGATCC","TTGA","ATGTGCA","CTGA",2.32178105306894,15,8,12,44,2.86287027441583,4.5853526570522,7.76878951005427,101,"ENSG00000079974.19"
"29357","ENSG00000197826.12_370187",370179,370187,9,"ENSG00000197826.12",1,2,"UMVVVVVVV",1,7,0.786749482401656,43,49,57,60,75,81,133,136,"ATGATGA","GTGA","GTGATTA","ATGA",2.58006992331148,8,15,52,84,1.28647965470287,4.62173645252818,7.7687343821348,101,"ENSG00000079974.19"
"42829","ENSG00000267097.1_30836",30828,30836,9,"ENSG00000267097.1",1,5,"UVVVMVVVV",1,7,0.789233954451346,91,97,108,111,115,121,133,136,"TGGATGA","ATGT","GTCAAGT","CTGA",2.33609234634581,11,4,12,36,2.87319208064017,4.61178526406973,7.76872108187511,101,"ENSG00000079974.19"
"44279","ENSG00000280560.3_269676",269668,269676,9,"ENSG00000280560.3",0,NA,"UVVVVUVVV",2,7,0.824844720496894,86,92,105,108,111,117,133,136,"GAAATGA","ATGA","GAAATGT","CTGA",2.30971296943007,13,3,16,41,2.4791944645903,4.46932023186435,7.76869911385193,101,"ENSG00000079974.19"
"29457","ENSG00000198010.13_468350",468342,468350,9,"ENSG00000198010.13",1,1,"MVVVVUVVV",1,7,0.82815734989648,68,74,89,92,103,109,133,136,"ATGCTGA","TTGA","GTGACTA","CTCA",2.36487681369624,15,11,24,59,2.05836841662053,4.45605346031554,7.76868285990146,101,"ENSG00000079974.19"
"40651","ENSG00000257261.7_279928",279920,279928,9,"ENSG00000257261.7",1,6,"VVVVVMUVV",1,7,0.788819875776397,57,63,75,78,87,93,133,136,"ATGAGGT","CTGC","CTGGGGA","CTGA",2.47235018700479,12,9,40,70,1.97119361901712,4.61338204976227,7.76866155286786,101,"ENSG00000079974.19"
"38539","ENSG00000250366.4_24937",24929,24937,9,"ENSG00000250366.4",1,8,"VVUVVVVMV",1,7,0.767701863354037,115,121,133,136,141,147,171,174,"CAGATGA","CAGA","CTCAGGA","CTGA",2.48172254710351,12,5,24,50,2.24619869107756,4.69775391794191,7.76856137135806,101,"ENSG00000079974.19"
"25246","ENSG00000180205.4_9127",9119,9127,9,"ENSG00000180205.4",1,2,"UMVVVVVVV",1,7,0.786749482401656,111,117,133,136,138,144,153,156,"AAGATGT","TTCA","GTGAAAA","CTGA",2.40323995939046,16,2,9,36,2.46431972997215,4.62147986481047,7.76847779441709,101,"ENSG00000079974.19"
"7445","ENSG00000114279.15_246499",246491,246499,9,"ENSG00000114279.15",1,8,"UVVVVVVMV",1,7,0.786749482401656,113,119,133,136,142,148,204,207,"TTGAAGA","CTCA","ATGACAA","CTGA",2.48064995516853,14,6,56,85,1.94823717980939,4.62147588689989,7.76847381650652,101,"ENSG00000079974.19"
"20490","ENSG00000164961.16_13781",13773,13781,9,"ENSG00000164961.16",1,1,"MVVUVVVVV",1,7,0.786749482401656,112,118,133,136,142,148,171,174,"ATAATTA","CTGT","CTGTGGA","CTGA",2.43505378659359,15,6,23,53,2.25213989393559,4.62145795113988,7.76845588074651,101,"ENSG00000079974.19"
"18084","ENSG00000156110.15_529147",529139,529147,9,"ENSG00000156110.15",1,6,"VVVUVMVVV",1,7,0.78343685300207,116,122,133,136,144,150,175,178,"ATGATGA","ATAA","ATGATGT","CTTA",2.44558510940316,11,8,25,53,2.2346495145557,4.63463756097753,7.76838497298581,101,"ENSG00000079974.19"
"5953","ENSG00000107338.10_129685",129677,129685,9,"ENSG00000107338.10",1,8,"VVVVVUVMV",1,7,0.806211180124224,113,119,133,136,137,143,161,164,"GTGGTGA","CAGA","GACCTGA","CTGA",2.43464340197391,14,1,18,42,1.94307802554194,4.54350850967533,7.76835323017223,101,"ENSG00000079974.19"
"40380","ENSG00000255872.3_129145",129137,129145,9,"ENSG00000255872.3",1,8,"VVVVVUVMV",1,7,0.806211180124224,113,119,133,136,137,143,161,164,"GTGGTGA","CAGA","GACCTGA","CTGA",2.43464340197391,14,1,18,42,1.94307802554194,4.54350850967533,7.76835323017223,101,"ENSG00000079974.19"
"34850","ENSG00000234273.1_42587",42579,42587,9,"ENSG00000234273.1",0,NA,"VVVUVUVVV",2,7,0.802898550724638,89,95,133,136,145,151,167,170,"GTGATAA","CTGT","ATGGGGT","CTGA",2.47723791894401,38,9,16,72,1.71209206076649,4.5567528800983,7.76834708299685,101,"ENSG00000079974.19"
"1357","ENSG00000054392.13_130149",130141,130149,9,"ENSG00000054392.13",1,8,"VVVVVUVMV",1,7,0.806211180124224,109,115,133,136,157,163,181,184,"GAGATGA","GTGA","TAGATAA","CTGA",2.49497699661878,18,21,18,66,1.54078323195016,4.54349080235217,7.76833552284907,101,"ENSG00000079974.19"
"27729","ENSG00000187240.17_196454",196446,196454,9,"ENSG00000187240.17",1,2,"UMVVVVVVV",1,7,0.786749482401656,110,116,133,136,140,146,161,164,"ATTATGG","CTAA","GTAAAAA","CTGA",2.41041370536902,17,4,15,45,2.41587732889948,4.6213255078399,7.76832343744652,101,"ENSG00000079974.19"
"2500","ENSG00000075303.13_29857",29849,29857,9,"ENSG00000075303.13",1,2,"VMUVVVVVV",1,7,0.767701863354037,112,118,133,136,140,146,158,161,"ATGATTA","ATTA","ATCAAGT","CTGA",2.40773472850679,15,4,12,40,2.73842218679623,4.69749676087704,7.76830421429319,101,"ENSG00000079974.19"
"33924","ENSG00000231505.1_15466",15458,15466,9,"ENSG00000231505.1",0,NA,"VVVVVUUVV",2,7,0.808281573498965,92,98,133,136,149,155,169,172,"TTGAGGT","CTGA","CTGCTAA","CTGA",2.48496836197524,35,13,14,71,1.57413959195775,4.53514883461484,7.7682751286107,101,"ENSG00000079974.19"
"29046","ENSG00000197081.16_133056",133048,133056,9,"ENSG00000197081.16",1,8,"VVVUVVVMV",1,7,0.764803312629399,82,88,99,102,114,120,133,136,"ATGGTGG","CTGC","ATTCTGA","CTGA",2.42556310352046,11,12,13,45,2.66580334278561,4.70905600823051,7.76826925874811,101,"ENSG00000079974.19"
"14368","ENSG00000144771.8_46836",46828,46836,9,"ENSG00000144771.8",1,5,"VVVVMUVVV",1,7,0.808695652173913,108,114,133,136,147,153,167,170,"CTTATGA","TAGA","GTGAAAG","CTGA",2.37757460572282,19,11,14,53,2.28344911358309,4.53348662126714,7.76826922996279,101,"ENSG00000079974.19"
"2527","ENSG00000075429.9_30314",30306,30314,9,"ENSG00000075429.9",1,6,"VVVUVMVVV",1,7,0.78343685300207,113,119,133,136,146,152,170,173,"ATCATCA","CTCA","ATCATGT","CTGA",2.40590065134812,14,10,18,51,2.49864537163068,4.63449576182121,7.76824317382949,101,"ENSG00000079974.19"
"43781","ENSG00000273540.5_621084",621076,621084,9,"ENSG00000273540.5",1,3,"VVMVVVUVV",1,7,0.768944099378882,111,117,133,136,158,164,177,180,"ATCAGGA","GTGA","GTGCTGA","CTGA",2.52133257988377,16,22,13,60,1.96052011857995,4.69235099611793,7.76812739363346,101,"ENSG00000079974.19"
"31961","ENSG00000225466.1_30641",30633,30641,9,"ENSG00000225466.1",1,2,"VMVVVUVVV",1,7,0.806211180124223,84,90,133,136,143,149,204,207,"ATGATGA","ATCA","TGGATGC","CTGA",2.57576616040321,43,7,55,114,1.00127159006392,4.54326149818799,7.76810621868489,101,"ENSG00000079974.19"
"33615","ENSG00000230476.1_30634",30626,30634,9,"ENSG00000230476.1",1,2,"VMVVVUVVV",1,7,0.806211180124223,84,90,133,136,143,149,204,207,"ATGATGA","ATCA","TGGATGC","CTGA",2.57576616040321,43,7,55,114,1.00127159006392,4.54326149818799,7.76810621868489,101,"ENSG00000079974.19"
"33777","ENSG00000231159.1_30631",30623,30631,9,"ENSG00000231159.1",1,2,"VMVVVUVVV",1,7,0.806211180124223,84,90,133,136,143,149,204,207,"ATGATGA","ATCA","TGGATGC","CTGA",2.57576616040321,43,7,55,114,1.00127159006392,4.54326149818799,7.76810621868489,101,"ENSG00000079974.19"
"35086","ENSG00000234888.1_30650",30642,30650,9,"ENSG00000234888.1",1,2,"VMVVVUVVV",1,7,0.806211180124223,84,90,133,136,143,149,204,207,"ATGATGA","ATCA","TGGATGC","CTGA",2.57576616040321,43,7,55,114,1.00127159006392,4.54326149818799,7.76810621868489,101,"ENSG00000079974.19"
"30909","ENSG00000214684.2_216",208,216,9,"ENSG00000214684.2",1,1,"MVVVVVUVV",1,7,0.792132505175983,116,122,133,136,142,148,158,161,"AAAATGT","CTAA","TTGCTTA","CTGA",2.30053743221866,11,6,10,36,3.06115136982541,4.59951689615412,7.76804691685806,101,"ENSG00000079974.19"
"18125","ENSG00000156218.13_11930",11922,11930,9,"ENSG00000156218.13",1,2,"VMVVVUVVV",1,7,0.806211180124223,112,118,133,136,145,151,206,209,"ATTATAA","CAGG","ATGATGA","CTGA",2.4467791754179,15,9,55,88,1.86078114439269,4.54316057846134,7.76800529895823,101,"ENSG00000079974.19"
"25361","ENSG00000181090.21_197809",197801,197809,9,"ENSG00000181090.21",1,1,"MVVVVUVVV",1,7,0.82815734989648,92,98,133,136,139,145,153,156,"ATGGTGA","CTGG","GTGAGGA","CAGA",2.4197372823213,35,3,8,55,1.6896778975847,4.45531494493167,7.7679443445176,101,"ENSG00000079974.19"
"7686","ENSG00000115355.18_83166",83158,83166,9,"ENSG00000115355.18",1,8,"VVVVVUVMV",1,7,0.806211180124224,115,121,133,136,137,143,157,160,"CTAATGA","CAGC","TTGAAAA","CTGA",2.38086152227898,12,1,14,36,2.29978357988248,4.54304843210225,7.76789315259914,101,"ENSG00000079974.19"
"15629","ENSG00000148948.8_291035",291027,291035,9,"ENSG00000148948.8",0,NA,"UVVVVVUVV",2,7,0.788819875776397,93,99,133,136,144,150,177,180,"CTGATGA","CTCA","ATGAATC","CTGA",2.58720447413704,34,8,27,78,1.20236409176626,4.61259847983663,7.76787798294222,101,"ENSG00000079974.19"
"10992","ENSG00000133424.22_188804",188796,188804,9,"ENSG00000133424.22",1,8,"VVVVVUVMV",1,7,0.806211180124224,59,65,94,97,104,110,133,136,"ATGATGT","CTGA","CTGAGGT","CTAA",2.51321845036008,29,7,23,68,1.41727220822483,4.543015469323,7.7678601898199,101,"ENSG00000079974.19"
"44073","ENSG00000277611.1_11000",10992,11000,9,"ENSG00000277611.1",1,1,"MVUVVVVVV",1,7,0.789648033126294,60,66,84,87,99,105,133,136,"AGGATAA","CTGA","GTGGGAA","CTGA",2.52453943666673,18,12,28,67,1.60672100658972,4.60924597942531,7.76783811193049,101,"ENSG00000079974.19"
"8231","ENSG00000117528.14_94733",94725,94733,9,"ENSG00000117528.14",1,1,"MVVVVUVVV",1,7,0.82815734989648,98,104,133,136,141,147,158,161,"ATGATGA","TTTA","CTGATTT","ATGA",2.37672716800924,29,5,11,54,1.97590351634942,4.45518782576942,7.76781722535534,101,"ENSG00000079974.19"
"19805","ENSG00000163714.18_57115",57107,57115,9,"ENSG00000163714.18",1,8,"VVVVVUVMV",1,7,0.806211180124224,88,94,133,136,149,155,164,167,"AAGATGA","TTGT","ATCAAGA","CTGA",2.47151624213064,39,13,9,70,1.69484135009588,4.54290407440836,7.76774879490526,101,"ENSG00000079974.19"
"32545","ENSG00000227157.2_6757",6749,6757,9,"ENSG00000227157.2",1,5,"VVVVMVUVV",1,7,0.772670807453416,85,91,102,105,114,120,133,136,"ATGTAGA","CTTA","TTTTTGA","CTGA",2.3769293054728,11,9,13,42,2.8619218755468,4.67702931134136,7.76771254115503,101,"ENSG00000079974.19"
"39748","ENSG00000254180.2_260136",260128,260136,9,"ENSG00000254180.2",1,7,"VVVUVVMVV",1,7,0.766045548654244,76,82,94,97,104,110,133,136,"AAGATGA","TTGA","CTGATGA","CTTA",2.46821148074937,12,7,23,51,2.35931571239066,4.70351472934662,7.7676969239636,101,"ENSG00000079974.19"
"33591","ENSG00000230426.5_67226",67218,67226,9,"ENSG00000230426.5",1,2,"VMVVUVVVV",1,7,0.773913043478261,106,112,133,136,142,148,192,195,"ATGATGC","CTGT","TTGATAC","CTGA",2.59276290273161,21,6,44,80,1.40269975426422,4.67194644311873,7.76759861703178,101,"ENSG00000079974.19"
"29548","ENSG00000198216.14_313595",313587,313595,9,"ENSG00000198216.14",1,8,"VVVUVVVMV",1,7,0.764803312629399,71,77,88,91,104,110,133,136,"GTGCTGA","CTGT","CTGAGAA","CTGA",2.52086775643852,11,13,23,56,2.02765316246161,4.70835955134628,7.76757280186388,101,"ENSG00000079974.19"
"30999","ENSG00000215196.5_107303",107295,107303,9,"ENSG00000215196.5",1,2,"UMVVVVVVV",1,7,0.786749482401656,113,119,133,136,139,145,164,167,"CTTATGA","ATGA","AGGAAAA","CTGA",2.43542405012968,14,3,19,45,2.24607967745371,4.6205600029129,7.76755793251952,101,"ENSG00000079974.19"
"36449","ENSG00000241111.1_1805",1797,1805,9,"ENSG00000241111.1",1,3,"UVMVVVVVV",1,7,0.785507246376811,89,95,110,113,116,122,133,136,"CTGATGA","CTGT","CTGTTGG","CTGT",2.37692193889752,15,3,11,38,2.65595836413498,4.62552615586295,7.7675551413702,101,"ENSG00000079974.19"
"41733","ENSG00000259639.6_169223",169215,169223,9,"ENSG00000259639.6",1,3,"UVMVVVVVV",1,7,0.785507246376811,89,95,110,113,116,122,133,136,"CTGATGA","CTGT","CTGTTGG","CTGT",2.37692193889752,15,3,11,38,2.65595836413498,4.62552615586295,7.7675551413702,101,"ENSG00000079974.19"
"2272","ENSG00000072401.15_34891",34883,34891,9,"ENSG00000072401.15",1,7,"UVVVVVMVV",1,7,0.787991718426501,47,53,61,64,113,119,133,136,"ATGTTGA","CTGT","TGGATTA","CTGA",2.52876653383271,8,49,14,80,1.60354212233554,4.61549642030508,7.76746329401108,101,"ENSG00000079974.19"
"43414","ENSG00000271860.9_417034",417026,417034,9,"ENSG00000271860.9",1,2,"VMVVVUVVV",1,7,0.806211180124223,85,91,99,102,112,118,133,136,"ATGTTTA","CTGA","TTGAGGA","CTTA",2.3559906186053,8,10,15,42,2.46384365899753,4.54261194575821,7.76745666625511,101,"ENSG00000079974.19"
"2643","ENSG00000077092.20_601406",601398,601406,9,"ENSG00000077092.20",1,6,"VVVVVMUVV",1,7,0.788819875776397,69,75,87,90,101,107,133,136,"ATGGTTA","CTCA","GTGAGGT","CTGA",2.45655933976484,12,11,26,58,2.07157458993158,4.61215921375762,7.76743871686321,101,"ENSG00000079974.19"
"8932","ENSG00000121753.13_34575",34567,34575,9,"ENSG00000121753.13",0,NA,"UVVVVUVVV",2,7,0.824844720496894,96,102,133,136,148,154,166,169,"GTGATGT","CTAG","TTGCTGC","CTGA",2.41743035342439,31,12,12,64,1.75596615282437,4.46804212724674,7.76742100923431,101,"ENSG00000079974.19"
"28233","ENSG00000188559.16_191667",191659,191667,9,"ENSG00000188559.16",0,NA,"VVVUVVUVV",2,7,0.766873706004141,94,100,133,136,152,158,177,180,"ATTATGA","CTGA","TTCATCA","CTGA",2.65782057639856,33,16,19,77,1.08086437704768,4.69991705492618,7.76741187894275,101,"ENSG00000079974.19"
"41745","ENSG00000259664.3_112425",112417,112425,9,"ENSG00000259664.3",1,1,"MVVVVVUVV",1,7,0.792132505175983,115,121,133,136,147,153,168,171,"GTGGGGA","CTGG","GTAATGC","CTGA",2.36105615863158,12,11,15,47,2.65511872150141,4.59887327809465,7.76740329879858,101,"ENSG00000079974.19"
"12658","ENSG00000138759.20_96039",96031,96039,9,"ENSG00000138759.20",1,2,"UMVVVVVVV",1,7,0.786749482401656,112,118,133,136,143,149,164,167,"ATGGTGG","CTGT","GAATTGA","CTGA",2.36262547878684,15,7,15,46,2.73068460625846,4.62038028287602,7.76737821248265,101,"ENSG00000079974.19"
"13812","ENSG00000143595.13_498",490,498,9,"ENSG00000143595.13",1,6,"UVVVVMVVV",1,7,0.805383022774327,114,120,133,136,176,182,224,227,"CTGATGA","CAGC","TTGATGG","CTGA",2.57494781040196,13,40,42,104,1.01680396330736,4.54578067483011,7.76731276592742,101,"ENSG00000079974.19"
"39781","ENSG00000254186.3_915229",915221,915229,9,"ENSG00000254186.3",1,1,"MVVVVUVVV",1,7,0.82815734989648,83,89,133,136,152,158,180,183,"ATGAAGA","TTAA","ATGATGC","CTGA",2.53827953499292,44,16,22,91,0.896637271251725,4.4546252094678,7.76725460905372,101,"ENSG00000079974.19"
"2827","ENSG00000078328.23_2153857",2153849,2153857,9,"ENSG00000078328.23",1,1,"MVVVUVVVV",1,7,0.795859213250517,115,121,133,136,147,153,165,168,"CTGATCT","CTGG","GTGCCAA","CTGA",2.32996768660274,12,11,12,44,2.80200557223349,4.5837808707296,7.76721772373167,101,"ENSG00000079974.19"
"31619","ENSG00000224187.1_12935",12927,12935,9,"ENSG00000224187.1",1,2,"VMUVVVVVV",1,7,0.767701863354037,73,79,93,96,101,107,133,136,"ATGATGA","CTCA","ATGAAAA","CAGA",2.49806485453583,14,5,26,54,2.13178613115871,4.69638795701607,7.76719541043222,101,"ENSG00000079974.19"
"30104","ENSG00000203710.12_121047",121039,121047,9,"ENSG00000203710.12",1,8,"UVVVVVVMV",1,7,0.786749482401656,116,122,133,136,140,146,161,164,"GTGCTGT","CACA","ATGATGT","CTGA",2.370920550585,11,4,15,39,2.67446341308508,4.62015010424626,7.76714803385289,101,"ENSG00000079974.19"
"37826","ENSG00000248932.8_212043",212035,212043,9,"ENSG00000248932.8",1,8,"VVVVUVVMV",1,7,0.773913043478261,84,90,101,104,112,118,133,136,"CTGCTGG","ATGA","GTCAGGA","CTGA",2.38413087268972,11,8,15,43,2.79091879929339,4.6712811543062,7.76693332821925,101,"ENSG00000079974.19"
"31308","ENSG00000222042.2_101469",101461,101469,9,"ENSG00000222042.2",1,2,"VMVVVUVVV",1,7,0.806211180124223,109,115,133,136,181,187,205,208,"ATAATGC","CTCA","ATGATGT","CTGA",2.52944660158559,18,45,18,90,1.30506875007805,4.54201152349549,7.76685624399238,101,"ENSG00000079974.19"
"21207","ENSG00000166833.23_130682",130674,130682,9,"ENSG00000166833.23",1,2,"VMUVVVVVV",1,7,0.767701863354037,98,104,133,136,185,191,201,204,"GTGAGGA","CTGA","GTTAAGA","CTGA",2.65865116395506,29,49,10,97,1.0596929489827,4.69600851050411,7.76681596392026,101,"ENSG00000079974.19"
"948","ENSG00000041515.16_288376",288368,288376,9,"ENSG00000041515.16",1,8,"VVVVVVUMV",1,7,0.770186335403727,70,76,85,88,107,113,133,136,"AAAATGA","CTGA","TTGTAGA","CTGA",2.56030149106411,9,19,20,57,1.67539826659457,4.68601871842215,7.76676406003706,101,"ENSG00000079974.19"
"15894","ENSG00000150275.20_1118114",1118106,1118114,9,"ENSG00000150275.20",1,5,"UVVVMVVVV",1,7,0.789233954451346,109,115,133,136,165,171,198,201,"TTGATGA","ATTA","TTGATGA","CTGA",2.62620399170082,18,29,27,83,0.931254768243253,4.60982034489552,7.7667561627009,101,"ENSG00000079974.19"
"19887","ENSG00000163885.12_4757",4749,4757,9,"ENSG00000163885.12",0,NA,"VVVVUUVVV",2,7,0.812008281573499,112,118,133,136,171,177,190,193,"ATCATGG","CTGG","ATTATCA","CTGA",2.43395176507076,15,35,13,72,1.84848724653022,4.51870808675049,7.76674121304448,101,"ENSG00000079974.19"
"42031","ENSG00000260372.7_255969",255961,255969,9,"ENSG00000260372.7",1,2,"VMVVVVUVV",1,7,0.770186335403727,114,120,133,136,142,148,156,159,"ATGATCC","AAGA","CTGACTA","CTGA",2.35225675811744,13,6,8,36,3.06214521483788,4.6859642339052,7.76670957552011,101,"ENSG00000079974.19"
"13089","ENSG00000140057.9_66730",66722,66730,9,"ENSG00000140057.9",1,5,"VVVVMUVVV",1,7,0.808695652173913,80,86,101,104,115,121,133,136,"AGGTTGA","CTGA","TTGAAGC","ATGA",2.3133247974131,15,11,12,47,2.70540742960106,4.5318931864221,7.76667579511775,101,"ENSG00000079974.19"
"4146","ENSG00000095777.17_221941",221933,221941,9,"ENSG00000095777.17",1,8,"VVUVVVVMV",1,7,0.767701863354037,98,104,133,136,155,161,170,173,"ATGATGA","CCAA","TTGAAAA","CTGA",2.61048650339952,29,19,9,66,1.37994736162503,4.69579767940546,7.76660513282161,101,"ENSG00000079974.19"
"83","ENSG00000004779.10_14300",14292,14300,9,"ENSG00000004779.10",1,6,"UVVVVMVVV",1,7,0.805383022774327,39,45,57,60,111,117,133,136,"GTGGTGA","TTGA","AAGCAGA","CTGA",2.46312547838699,12,51,16,88,1.75936064473542,4.54504929182884,7.76658138292615,101,"ENSG00000079974.19"
"20944","ENSG00000166016.6_158419",158411,158419,9,"ENSG00000166016.6",1,5,"VVUVMVVVV",1,7,0.770186335403727,116,122,133,136,138,144,154,157,"ATTAACA","CTGA","TTGAGGC","CTGA",2.39799240401305,11,2,10,32,2.75657841726969,4.68579861100583,7.76654395262074,101,"ENSG00000079974.19"
"37914","ENSG00000249174.1_54719",54711,54719,9,"ENSG00000249174.1",1,1,"MVVVVUVVV",1,7,0.82815734989648,52,58,71,74,86,92,133,136,"ATGTTTA","CTCA","GTTATTA","CTGA",2.40560590750407,13,12,41,75,1.77825029887066,4.45390575389111,7.76653515347703,101,"ENSG00000079974.19"
"21575","ENSG00000168386.19_87632",87624,87632,9,"ENSG00000168386.19",1,3,"VVMVUVVVV",1,7,0.772670807453416,116,122,133,136,149,155,171,174,"ATGCTGA","GAGA","GTGGGCA","CTGA",2.44116905248652,11,13,16,49,2.42868043522483,4.67578519628375,7.76646842609741,101,"ENSG00000079974.19"
"23288","ENSG00000172487.4_5206",5198,5206,9,"ENSG00000172487.4",1,2,"UMVVVVVVV",1,7,0.786749482401656,82,88,104,107,113,119,133,136,"GTGATTA","GTGA","ATGAGGA","GTGA",2.36681666397163,16,6,14,45,2.69908304135735,4.61946520029206,7.76646312989869,101,"ENSG00000079974.19"
"42596","ENSG00000264876.2_18546",18538,18546,9,"ENSG00000264876.2",1,1,"MVVVVUVVV",1,7,0.82815734989648,99,105,133,136,141,147,162,165,"TGGATGA","CTGT","ATTTTTA","CTGA",2.39832226634716,28,5,15,57,1.82651978820548,4.45383372429664,7.76646312388256,101,"ENSG00000079974.19"
"27655","ENSG00000187079.20_114338",114330,114338,9,"ENSG00000187079.20",1,2,"UMVVVVVVV",1,7,0.786749482401656,76,82,92,95,114,120,133,136,"ATCACGC","CTGA","GTGATCC","CTGA",2.44734158337943,10,19,13,51,2.16164984725315,4.619315100779,7.76631303038562,101,"ENSG00000079974.19"
"18012","ENSG00000156011.18_182486",182478,182486,9,"ENSG00000156011.18",1,2,"VMVVUVVVV",1,7,0.773913043478261,57,63,73,76,113,119,133,136,"TTGAAGA","GTGA","TTGATCA","CTGA",2.53173682896347,10,37,14,70,1.80410388916256,4.67058735389643,7.76623952780947,101,"ENSG00000079974.19"
"25937","ENSG00000183098.11_995344",995336,995344,9,"ENSG00000183098.11",0,NA,"VVUVVVUVV",2,7,0.769772256728778,112,118,133,136,142,148,160,163,"TTAATGA","TGGA","GTCATGG","CTGA",2.38192986320304,15,6,12,42,2.86875997561723,4.68707309924271,7.76616212615783,101,"ENSG00000079974.19"
"22341","ENSG00000170381.15_130632",130624,130632,9,"ENSG00000170381.15",1,1,"MVVVUVVVV",1,7,0.795859213250517,116,122,133,136,143,149,159,162,"ATAATTA","GAGA","ATGAACC","CTGA",2.29157418371161,11,7,10,37,3.05362272147605,4.58269598655503,7.7661328395571,101,"ENSG00000079974.19"
"7017","ENSG00000112530.12_426800",426792,426800,9,"ENSG00000112530.12",1,8,"VVVVVUVMV",1,7,0.806211180124224,107,113,133,136,146,152,164,167,"GTGAACA","GTGA","ATGGTCA","CTGA",2.37265293693807,20,10,12,51,2.34710825270671,4.54119862474012,7.76604334523702,101,"ENSG00000079974.19"
"31134","ENSG00000215910.8_19107",19099,19107,9,"ENSG00000215910.8",1,7,"VVVVUVMVV",1,7,0.775155279503105,95,101,108,111,114,120,133,136,"TTGCAGA","CTGA","GTGCAGT","CTGA",2.42598859886704,7,3,13,32,2.48831666262982,4.66539349710252,7.76601461511494,101,"ENSG00000079974.19"
"44510","ENSG00000282890.1_291500",291492,291500,9,"ENSG00000282890.1",1,8,"VVVVUVVMV",1,7,0.773913043478261,80,86,96,99,108,114,133,136,"CTGAAGG","CTGA","GAGAGTA","CTGA",2.434975752923,10,9,19,47,2.44794063374668,4.670278079975,7.76593025388805,101,"ENSG00000079974.19"
"38992","ENSG00000251388.1_94884",94876,94884,9,"ENSG00000251388.1",1,2,"VMVVVVUVV",1,7,0.770186335403727,112,118,133,136,161,167,220,223,"ATGATGA","TTGT","GTGATAT","CTGA",2.65589535483544,15,25,53,102,1.03464828179818,4.68515432850861,7.76589967012351,101,"ENSG00000079974.19"
"18503","ENSG00000157542.11_216128",216120,216128,9,"ENSG00000157542.11",1,8,"VVVVUVVMV",1,7,0.773913043478261,112,118,133,136,143,149,199,202,"CTGATCA","CTAA","GTGAAGC","CTGA",2.51532761274852,15,7,50,81,1.9119134560241,4.67019105192023,7.76584322583327,101,"ENSG00000079974.19"
"24758","ENSG00000177822.10_227206",227198,227206,9,"ENSG00000177822.10",0,NA,"VVVVUVUVV",2,7,0.775983436853002,113,119,133,136,142,148,204,207,"CTGATGA","CAAA","CTTAAGA","CTGA",2.50487711392326,14,6,56,85,1.94823717980939,4.66185448482444,7.76578823223645,101,"ENSG00000079974.19"
"16169","ENSG00000151025.11_390812",390804,390812,9,"ENSG00000151025.11",1,1,"MVVVUVVVV",1,7,0.795859213250517,114,120,133,136,142,148,157,160,"CACATGA","AGGA","GAGATGA","CTGA",2.2908501638553,13,6,9,37,3.05690452077254,4.58230973661864,7.76574658962071,101,"ENSG00000079974.19"
"46347","ENSG00000286481.2_788294",788286,788294,9,"ENSG00000286481.2",1,6,"VVVVVMUVV",1,7,0.788819875776397,106,112,133,136,147,153,165,168,"ATTATGC","CTGG","TTGTTCA","CTGA",2.43576850771319,21,11,12,53,2.20311905755079,4.61039394390968,7.76567344701527,101,"ENSG00000079974.19"
"31978","ENSG00000225522.2_390",382,390,9,"ENSG00000225522.2",0,NA,"UVVUVVVVV",2,7,0.78343685300207,99,105,133,136,145,151,202,205,"GAGATGA","CAGA","ATGAAGA","CTGA",2.62456095714376,28,9,51,97,1.03055424036229,4.63190682199684,7.76565423400512,101,"ENSG00000079974.19"
"19468","ENSG00000163092.22_238033",238025,238033,9,"ENSG00000163092.22",1,2,"UMVVVVVVV",1,7,0.786749482401656,96,102,133,136,143,149,162,165,"ATGAGGA","GTGG","ATGATTT","CTGA",2.47850384179787,31,7,13,60,1.95116192598105,4.61863021782505,7.76562814743168,101,"ENSG00000079974.19"
"5442","ENSG00000104723.21_24494",24486,24494,9,"ENSG00000104723.21",1,2,"UMVVVVVVV",1,7,0.786749482401656,113,119,133,136,175,181,200,203,"GTGAAGA","CTTG","GTGATGA","CTGA",2.53891773679697,14,39,19,81,1.54824280063773,4.61859026148771,7.76558819109434,101,"ENSG00000079974.19"
"32512","ENSG00000227110.7_255042",255034,255042,9,"ENSG00000227110.7",1,8,"VVVVVVUMV",1,7,0.770186335403727,74,80,97,100,113,119,133,136,"CTCATGA","CTGT","AGGTTGA","CTGA",2.46278921212145,17,13,14,53,2.32066559344437,4.68481508523017,7.76556042684508,101,"ENSG00000079974.19"
"43097","ENSG00000268516.4_16959",16951,16959,9,"ENSG00000268516.4",1,5,"UVVVMVVVV",1,7,0.789233954451346,116,122,133,136,144,150,200,203,"CTGATGT","TGGA","GTGAAGG","CTGA",2.47059232815565,11,8,50,78,1.96386681319483,4.60862058355812,7.7655564013635,101,"ENSG00000079974.19"
"44907","ENSG00000284418.3_385398",385390,385398,9,"ENSG00000284418.3",1,8,"VVUVVVVMV",1,7,0.767701863354037,88,94,133,136,145,151,170,173,"ATGATGA","AGGA","CTTATCA","CTGA",2.58765602273112,39,9,19,76,1.52794876476841,4.6947472290773,7.76555468249344,101,"ENSG00000079974.19"
"19242","ENSG00000162607.13_12239",12231,12239,9,"ENSG00000162607.13",1,1,"MVVVVUVVV",1,7,0.82815734989648,84,90,133,136,157,163,178,181,"ATGAAGA","TTGT","GTGAAAA","CTGA",2.51331801214341,43,21,15,88,1.05600535458759,4.45286469221926,7.76549409180518,101,"ENSG00000079974.19"
"2322","ENSG00000072958.9_40400",40392,40400,9,"ENSG00000072958.9",1,8,"VVVVVVUMV",1,7,0.770186335403727,61,67,79,82,90,96,133,136,"AAGTTGA","CTGA","TTTATGC","CTGA",2.50734713851113,12,8,37,66,2.02334133328472,4.68474723083973,7.76549257245464,101,"ENSG00000079974.19"
"886","ENSG00000038945.15_85699",85691,85699,9,"ENSG00000038945.15",1,2,"UMVVVVVVV",1,7,0.786749482401656,44,50,61,64,73,79,133,136,"GTACTGA","CTGA","GTTATCA","CTGA",2.4821398343474,11,9,54,83,1.92630225041701,4.61847528651659,7.76547321612321,101,"ENSG00000079974.19"
"6783","ENSG00000111877.18_17133",17125,17133,9,"ENSG00000111877.18",0,NA,"UVVVVVUVV",2,7,0.788819875776397,88,94,133,136,161,167,181,184,"GTGATGA","ATAA","GTTATGA","CTGA",2.61648085139982,39,25,14,87,0.997390721559299,4.61014909938953,7.76542860249512,101,"ENSG00000079974.19"
"34186","ENSG00000232058.1_34110",34102,34110,9,"ENSG00000232058.1",1,8,"VVVVVUVMV",1,7,0.806211180124224,12,18,32,35,74,80,133,136,"TTGATGA","CTTA","GGGAAAA","CTGA",2.57821431710758,14,39,53,115,0.974230454176643,4.54058147539013,7.76542619588702,101,"ENSG00000079974.19"
"25044","ENSG00000179242.16_418367",418359,418367,9,"ENSG00000179242.16",1,6,"VVVVVMUVV",1,7,0.788819875776397,111,117,133,136,144,150,159,162,"ATGCTGG","CTTG","ATGGGGA","CTGA",2.33997905305324,16,8,9,42,2.84056922269602,4.61010739409607,7.76538689720166,101,"ENSG00000079974.19"
"880","ENSG00000038945.15_174646",174638,174646,9,"ENSG00000038945.15",1,1,"MVVVUVVVV",1,7,0.795859213250517,114,120,133,136,179,185,199,202,"CTGCTGA","ATGG","GTGAAGA","CTGA",2.46846756308806,13,43,14,79,1.87096871632241,4.58185478422737,7.76529163722944,101,"ENSG00000079974.19"
"28489","ENSG00000189337.17_315828",315820,315828,9,"ENSG00000189337.17",1,3,"VVMUVVVVV",1,7,0.763561076604555,106,112,133,136,145,151,168,171,"ATGAGTA","CTGA","TTAATGT","CTGA",2.51791023336321,21,9,17,56,2.05800454579033,4.71101819205294,7.76526249847116,101,"ENSG00000079974.19"
"33001","ENSG00000228495.3_124084",124076,124084,9,"ENSG00000228495.3",1,8,"VVVVVVUMV",1,7,0.770186335403727,115,121,133,136,148,154,162,165,"GGGATGC","TTGA","GTGGGGG","CTGA",2.39512458670491,12,12,8,41,2.77032832616766,4.68445639271676,7.76520173433167,101,"ENSG00000079974.19"
"24463","ENSG00000176438.13_29925",29917,29925,9,"ENSG00000176438.13",0,NA,"VVUVVUVVV",2,7,0.805797101449275,112,118,133,136,149,155,168,171,"ATGTTCA","GTCA","TTGTTGA","CTGA",2.34665580747786,15,13,13,50,2.52352154294386,4.54197339819906,7.76516180399616,101,"ENSG00000079974.19"
"6780","ENSG00000111863.13_54715",54707,54715,9,"ENSG00000111863.13",1,8,"UVVVVVVMV",1,7,0.786749482401656,76,82,97,100,108,114,133,136,"ATCATGC","GTGA","GTTATTC","CTGA",2.40006232630273,15,8,19,51,2.47186958003076,4.61807127217891,7.76506920178553,101,"ENSG00000079974.19"
"19900","ENSG00000163939.18_6730",6722,6730,9,"ENSG00000163939.18",1,5,"UVVVMVVVV",1,7,0.789233954451346,105,111,133,136,151,157,171,174,"ATAATGT","CTAA","GTGATTT","CTGA",2.50054154492346,22,15,14,60,1.76218460023352,4.60811539159748,7.76505120940287,101,"ENSG00000079974.19"
"23572","ENSG00000173269.14_25167",25159,25167,9,"ENSG00000173269.14",0,NA,"VVVVVUUVV",2,7,0.808281573498965,86,92,133,136,185,191,206,209,"ATGATGT","CTGC","GTGAGTG","CTGA",2.59620190790353,41,49,15,114,0.819267126918185,4.53181996156877,7.76494625556463,101,"ENSG00000079974.19"
"10680","ENSG00000132334.17_12780",12772,12780,9,"ENSG00000132334.17",1,2,"VMVVVUVVV",1,7,0.806211180124223,81,87,101,104,116,122,133,136,"GTTATGT","CTGA","GTGCTGG","GTGA",2.31611430543483,14,12,11,46,2.71964231920111,4.54010108885833,7.76494580935523,101,"ENSG00000079974.19"
"24346","ENSG00000175894.18_69665",69657,69665,9,"ENSG00000175894.18",1,2,"UMVVVVVVV",1,7,0.786749482401656,116,122,133,136,148,154,193,196,"TTGCTGA","CAGA","GTGGTAA","CTGA",2.50589839682409,11,12,39,71,1.76555959709415,4.61788722731368,7.76488515692031,101,"ENSG00000079974.19"
"3174","ENSG00000081985.14_17508",17500,17508,9,"ENSG00000081985.14",1,2,"UMVVVUVVV",2,6,0.708902691511387,106,112,133,136,141,147,156,159,"TTGATGA","AAGA","ATGTTGA","CTGA",2.60526618515209,21,5,9,44,2.34858436457467,4.92925639973049,7.76486716577604,101,"ENSG00000079974.19"
"20447","ENSG00000164830.19_274391",274383,274391,9,"ENSG00000164830.19",1,1,"MVVVVVUVV",1,7,0.792132505175983,105,111,133,136,161,167,182,185,"ATTATGT","CTGT","GTGATGT","CTGA",2.56608485956847,22,25,15,71,1.27803469731913,4.59631677361057,7.7648467943145,101,"ENSG00000079974.19"
"16239","ENSG00000151229.13_236225",236217,236225,9,"ENSG00000151229.13",0,NA,"VVUUVVVVV",2,7,0.764389233954451,65,71,85,88,94,100,133,136,"ATGAGGA","CAGA","AGGATTT","CTGA",2.52082870733926,14,6,33,62,2.02360310963173,4.7072819563067,7.76483889212451,101,"ENSG00000079974.19"
"40345","ENSG00000255629.1_248",240,248,9,"ENSG00000255629.1",1,6,"VVVUVMVVV",1,7,0.78343685300207,110,116,133,136,145,151,173,176,"ATGGTGA","CGGG","ATGCTGT","CTGA",2.46166593740898,17,9,22,57,2.11315967117159,4.6310664801412,7.76481389214948,101,"ENSG00000079974.19"
"5301","ENSG00000104313.20_256270",256262,256270,9,"ENSG00000104313.20",1,2,"VMVVUVVVV",1,7,0.773913043478261,106,112,133,136,149,155,169,172,"ATGATGT","TAGA","GCAATGA","CTGA",2.50519869019897,21,13,14,57,1.97530151942476,4.66915653018781,7.76480870410085,101,"ENSG00000079974.19"
"28297","ENSG00000188641.14_475165",475157,475165,9,"ENSG00000188641.14",0,NA,"UVVVVVUVV",2,7,0.788819875776397,113,119,133,136,169,175,189,192,"AAGATGG","CAGA","ATGATTG","CTGA",2.4860277741725,14,33,14,70,1.86442002119651,4.60948462891996,7.76476413202555,101,"ENSG00000079974.19"
"32333","ENSG00000226782.2_1773",1765,1773,9,"ENSG00000226782.2",1,8,"VVVVVUVMV",1,7,0.806211180124224,94,100,133,136,144,150,198,201,"ACAATGA","CTGA","GAGAAGA","CTGA",2.57283153169048,33,8,48,98,1.00745504683941,4.53991631452731,7.76476103502421,101,"ENSG00000079974.19"
"29914","ENSG00000198865.10_19007",18999,19007,9,"ENSG00000198865.10",1,6,"UVVVVMVVV",1,7,0.805383022774327,108,114,133,136,143,149,176,179,"ATTATGA","CTTG","CTGAGAA","CTGA",2.45883979806077,19,7,27,62,1.78037649181875,4.54316045305597,7.76469254415328,101,"ENSG00000079974.19"
"33952","ENSG00000231609.7_34976",34968,34976,9,"ENSG00000231609.7",1,2,"VMVVVUVVV",1,7,0.806211180124223,115,121,133,136,144,150,173,176,"TTGAAGA","CGGG","GTAAAGA","CTGA",2.37202864220976,12,8,23,52,2.34576786956996,4.53982303774209,7.76466775823898,101,"ENSG00000079974.19"
"37767","ENSG00000248779.1_2271",2263,2271,9,"ENSG00000248779.1",1,8,"VVVVVUVMV",1,7,0.806211180124224,62,68,84,87,96,102,133,136,"ATGATAA","CAAA","ATTATTA","CTGA",2.43954590409663,16,9,31,65,1.89562820847133,4.53981689227889,7.76466161277578,101,"ENSG00000079974.19"
"7621","ENSG00000115183.15_234014",234006,234014,9,"ENSG00000115183.15",1,8,"VVVVVUVMV",1,7,0.806211180124224,108,114,133,136,141,147,158,161,"ATGATCC","CAGA","ATGATGA","CTAA",2.34845747927709,19,5,11,44,2.50276775571577,4.5397877377241,7.76463245822099,101,"ENSG00000079974.19"
"46155","ENSG00000286225.1_75012",75004,75012,9,"ENSG00000286225.1",1,2,"UMVVVVVVV",1,7,0.786749482401656,88,94,133,136,148,154,165,168,"ATGATGA","CTTG","ATTGTCA","CTGA",2.50752260004059,39,12,11,71,1.75369422449122,4.61762788952379,7.76462581913042,101,"ENSG00000079974.19"
"36374","ENSG00000240401.9_36271",36263,36271,9,"ENSG00000240401.9",1,1,"MVVVVUVVV",1,7,0.82815734989648,112,118,133,136,147,153,168,171,"TTAATGA","CATA","ATCTTTA","CTGA",2.28683210587124,15,11,15,50,2.56243358186305,4.4519952385845,7.76462463817042,101,"ENSG00000079974.19"
"21297","ENSG00000166984.14_13204",13196,13204,9,"ENSG00000166984.14",1,2,"VMUVVVVVV",1,7,0.767701863354037,107,113,133,136,142,148,189,192,"ATGACGA","ATGA","TTGTGGA","CTGA",2.59262891289647,20,6,41,76,1.49095185437973,4.69378615175572,7.76459360517187,101,"ENSG00000079974.19"
"13682","ENSG00000143164.16_11252",11244,11252,9,"ENSG00000143164.16",1,2,"UMVVVVVVV",1,7,0.786749482401656,82,88,98,101,110,116,133,136,"GTGAAGC","CTGG","TTGTTGG","CTGA",2.38451198698993,10,9,17,45,2.57352739955105,4.61756849487097,7.7645664244776,101,"ENSG00000079974.19"
"36049","ENSG00000237813.4_116202",116194,116202,9,"ENSG00000237813.4",1,7,"VVVVVUMVV",1,7,0.807453416149068,95,101,133,136,154,160,169,172,"GTGATGA","AGGA","GTTTTGT","CTGA",2.51162850217951,32,18,9,68,1.39478095832963,4.53474274321493,7.7645564078112,101,"ENSG00000079974.19"
"42995","ENSG00000267575.9_173132",173124,173132,9,"ENSG00000267575.9",1,5,"VVVVMUVVV",1,7,0.808695652173913,114,120,133,136,145,151,164,167,"TAGATGT","ATAA","GTGACAA","CTGA",2.28671285563412,13,9,13,44,2.87402150436547,4.5296934688149,7.76447607751055,101,"ENSG00000079974.19"
"43026","ENSG00000267623.4_29802",29794,29802,9,"ENSG00000267623.4",1,5,"VVVVMUVVV",1,7,0.808695652173913,114,120,133,136,145,151,164,167,"TAGATGT","ATAA","GTGACAA","CTGA",2.28671285563412,13,9,13,44,2.87402150436547,4.5296934688149,7.76447607751055,101,"ENSG00000079974.19"
"24125","ENSG00000175193.14_43381",43373,43381,9,"ENSG00000175193.14",1,2,"VMVVVVUVV",1,7,0.770186335403727,115,121,133,136,142,148,180,183,"GTGATGT","CTAA","GCGATAG","CTGA",2.49909017735971,12,6,32,59,2.0743026539103,4.68372595907709,7.764471300692,101,"ENSG00000079974.19"
"44846","ENSG00000283765.1_43337",43329,43337,9,"ENSG00000283765.1",1,2,"VMVVVVUVV",1,7,0.770186335403727,115,121,133,136,142,148,180,183,"GTGATGT","CTAA","GCGATAG","CTGA",2.49909017735971,12,6,32,59,2.0743026539103,4.68372595907709,7.764471300692,101,"ENSG00000079974.19"
"30470","ENSG00000205078.6_7997",7989,7997,9,"ENSG00000205078.6",1,6,"VVVUVMVVV",1,7,0.78343685300207,75,81,94,97,103,109,133,136,"GTGTTGG","CAGA","ATGAGAA","CTGA",2.43433196889298,13,6,24,52,2.29353035600265,4.63060253715563,7.76434994916391,101,"ENSG00000079974.19"
"34781","ENSG00000234129.10_70806",70798,70806,9,"ENSG00000234129.10",0,NA,"UVVVVVUVV",2,7,0.788819875776397,115,121,133,136,146,152,171,174,"TTCATGA","AGGA","GTGCTAA","CTGA",2.39427574893226,12,10,19,50,2.47441082317623,4.60906228734783,7.76434179045342,101,"ENSG00000079974.19"
"44172","ENSG00000279110.1_3699",3691,3699,9,"ENSG00000279110.1",1,8,"VVVVVVUMV",1,7,0.770186335403727,113,119,133,136,152,158,172,175,"CAGATGA","CTCA","CTGCTCA","CTGA",2.46152468575656,14,16,14,53,2.3240555566413,4.68355503208792,7.76430037370283,101,"ENSG00000079974.19"
"46679","ENSG00000287042.3_33674",33666,33674,9,"ENSG00000287042.3",1,1,"MVVVVVUVV",1,7,0.792132505175983,110,116,133,136,144,150,206,209,"ATGATGC","ATGG","TTGAATA","CTGA",2.49612341671869,17,8,56,90,1.74218315833386,4.59575148411461,7.76428150481854,101,"ENSG00000079974.19"
"36290","ENSG00000239572.3_30864",30856,30864,9,"ENSG00000239572.3",1,8,"UVVVVVVMV",1,7,0.786749482401656,112,118,133,136,137,143,151,154,"CTGAAGT","CAGA","ATGGGGA","CTGA",2.40682602037212,15,1,8,33,2.42358477214728,4.61727289365703,7.76427082326365,101,"ENSG00000079974.19"
"16005","ENSG00000150627.16_70611",70603,70611,9,"ENSG00000150627.16",1,2,"UMVVVVVVV",1,7,0.786749482401656,114,120,133,136,142,148,164,167,"CTTATGA","TTGT","ATCATAA","CTGA",2.35836351415566,13,6,16,44,2.74664955069004,4.61726824459861,7.76426617420523,101,"ENSG00000079974.19"
"26657","ENSG00000184774.10_3150",3142,3150,9,"ENSG00000184774.10",1,5,"VVVVMUVVV",1,7,0.808695652173913,102,108,133,136,140,146,156,159,"GTGATGA","TTGA","TTGCTCA","CTGG",2.41596944355894,25,4,10,48,2.01133505668868,4.52944950343707,7.76423211213272,101,"ENSG00000079974.19"
"18597","ENSG00000157827.20_130838",130830,130838,9,"ENSG00000157827.20",1,8,"VVVVUVVMV",1,7,0.773913043478261,115,121,133,136,187,193,205,208,"ATGTTGT","CTGG","AAGATGA","CTGA",2.50730394134725,12,51,12,84,1.958877246195,4.66855921379416,7.76421138770721,101,"ENSG00000079974.19"
"39170","ENSG00000253194.2_44162",44154,44162,9,"ENSG00000253194.2",1,2,"VMVVVUVVV",1,7,0.806211180124223,103,109,133,136,153,159,173,176,"ATGATGT","CAAA","CAGAAGA","CTGA",2.49598055858175,24,17,14,64,1.51748004410941,4.53933760866359,7.76418232916049,101,"ENSG00000079974.19"
"29119","ENSG00000197223.12_19507",19499,19507,9,"ENSG00000197223.12",1,7,"UVVVVVMVV",1,7,0.787991718426501,46,52,64,67,78,84,133,136,"GAGATGT","CTGA","ATGCACA","CTGA",2.49156061053997,12,11,49,81,1.83832015623499,4.61218105662536,7.76414793033137,101,"ENSG00000079974.19"
"14546","ENSG00000145362.21_216057",216049,216057,9,"ENSG00000145362.21",1,8,"VVVVUVVMV",1,7,0.773913043478261,85,91,108,111,116,122,133,136,"ATGAGTA","CTAA","TTCAAGA","CTGA",2.39764852531599,17,5,11,42,2.689644254218,4.66849193908116,7.7641441129942,101,"ENSG00000079974.19"
"11391","ENSG00000134775.16_371262",371254,371262,9,"ENSG00000134775.16",1,3,"UVMVVVVVV",1,7,0.785507246376811,110,116,133,136,151,157,208,211,"CTGATGT","CTGT","TTGATGG","CTGA",2.57664497419969,17,15,51,92,1.31079805995564,4.62210780532172,7.76413679082897,101,"ENSG00000079974.19"
"10923","ENSG00000133114.18_7748",7740,7748,9,"ENSG00000133114.18",1,1,"MVVUVVVVV",1,7,0.786749482401656,114,120,133,136,137,143,151,154,"ATGACCA","GTGA","GGGAGCA","CTGA",2.37829568713357,13,1,8,31,2.6131738857098,4.61711961665006,7.76411754625669,101,"ENSG00000079974.19"
"37055","ENSG00000244694.8_57626",57618,57626,9,"ENSG00000244694.8",1,7,"UVVVVVMVV",1,7,0.787991718426501,112,118,133,136,151,157,213,216,"TTGATGA","ATAA","ATGAAGT","CTGA",2.54767202183985,15,15,56,95,1.46388014253157,4.61209007203264,7.76405694573864,101,"ENSG00000079974.19"
"37315","ENSG00000247081.8_84660",84652,84660,9,"ENSG00000247081.8",0,NA,"VVVUVVUVV",2,7,0.766873706004141,111,117,133,136,140,146,162,165,"AACATGA","ATGA","ATGACTA","CTGA",2.45189096252549,16,4,16,45,2.44020888786436,4.69653715950858,7.76403198352514,101,"ENSG00000079974.19"
"34061","ENSG00000231871.5_105575",105567,105575,9,"ENSG00000231871.5",1,8,"UVVVVVVMV",1,7,0.786749482401656,21,27,64,67,75,81,133,136,"GTGATCA","CTGA","CAGAGGA","CTGA",2.62133313624139,37,8,52,106,0.992517221792501,4.61701786585045,7.76401579545707,101,"ENSG00000079974.19"
"35146","ENSG00000235121.1_13522",13514,13522,9,"ENSG00000235121.1",1,8,"UVVVVVVMV",1,7,0.786749482401656,21,27,64,67,75,81,133,136,"GTGATCA","CTGA","CAGAGGA","CTGA",2.62133313624139,37,8,52,106,0.992517221792501,4.61701786585045,7.76401579545707,101,"ENSG00000079974.19"
"15473","ENSG00000148481.14_39173",39165,39173,9,"ENSG00000148481.14",1,8,"VVVVVUVMV",1,7,0.806211180124224,115,121,133,136,177,183,220,223,"ATGAGGA","CTGT","CTGGTAA","CTGA",2.56707369685318,12,41,37,99,1.04283449145624,4.53916478428603,7.76400950478292,101,"ENSG00000079974.19"
"17835","ENSG00000155465.21_30444",30436,30444,9,"ENSG00000155465.21",1,1,"MVVVVUVVV",1,7,0.82815734989648,102,108,133,136,142,148,157,160,"GAGATGA","AGGA","GGGCTTA","CTGA",2.34751965974498,25,6,9,49,2.15538779387523,4.45137971471045,7.76400911429637,101,"ENSG00000079974.19"
"27039","ENSG00000185467.8_15089",15081,15089,9,"ENSG00000185467.8",1,5,"VVVUMVVVV",1,7,0.767287784679089,90,96,106,109,114,120,133,136,"AGGAGGA","CTGG","GTCAAGG","CTGA",2.3895425998187,10,5,13,37,2.84874359593107,4.69475689868061,7.76390803739697,101,"ENSG00000079974.19"
"7893","ENSG00000115970.19_207153",207145,207153,9,"ENSG00000115970.19",1,2,"VMUVVVVVV",1,7,0.767701863354037,85,91,107,110,116,122,133,136,"ATGATTA","CTGG","ATGGTGA","TTGA",2.3921182982803,16,6,11,42,2.82489093175048,4.69308656340478,7.76389401682093,101,"ENSG00000079974.19"
"3649","ENSG00000087258.16_158489",158481,158489,9,"ENSG00000087258.16",1,3,"VVMVUVVVV",1,7,0.772670807453416,82,88,105,108,110,116,133,136,"ATGATGT","CTGA","GGGAGGA","CGGA",2.50634103723267,17,2,17,45,1.98386806692839,4.67320207878654,7.7638853086002,101,"ENSG00000079974.19"
"16069","ENSG00000150672.19_1954530",1954522,1954530,9,"ENSG00000150672.19",1,6,"VVVVVMUVV",1,7,0.788819875776397,86,92,106,109,116,122,133,136,"ATAATAA","TTGT","CTGCTGT","CTGA",2.31908152088858,14,7,11,41,2.97383677531519,4.60859506197642,7.76387456508201,101,"ENSG00000079974.19"
"747","ENSG00000031003.11_65356",65348,65356,9,"ENSG00000031003.11",1,7,"UVVVVVMVV",1,7,0.787991718426501,94,100,133,136,143,149,165,168,"ATAATCA","CTTA","ATGATGT","CTGA",2.50081827913241,33,7,16,65,1.7754147641001,4.61188415624571,7.76385102995172,101,"ENSG00000079974.19"
"27699","ENSG00000187164.20_205266",205258,205266,9,"ENSG00000187164.20",1,6,"VVVVUMVVV",1,7,0.792546583850932,48,54,94,97,106,112,133,136,"TTGATGG","TTGA","ATGTTGT","CTGA",2.54433977534097,40,9,21,79,1.4123447662755,4.59365248380383,7.76383881920755,101,"ENSG00000079974.19"
"17033","ENSG00000152977.10_99076",99068,99076,9,"ENSG00000152977.10",1,1,"MVVVVVUVV",1,7,0.792132505175983,111,117,133,136,143,149,201,204,"AGAATGA","CTGC","TTGATTA","CTGA",2.48126670982613,16,7,52,84,1.83941674242265,4.59529870198255,7.76382872268648,101,"ENSG00000079974.19"
"32622","ENSG00000227330.1_50564",50556,50564,9,"ENSG00000227330.1",1,6,"VVUVVMVVV",1,7,0.786335403726708,111,117,133,136,144,150,160,163,"GTGTAGG","CTGA","TTGCTCA","CTGA",2.34555392769269,16,8,10,43,2.8368911233464,4.61847932699108,7.76382094189792,101,"ENSG00000079974.19"
"37404","ENSG00000248118.2_135082",135074,135082,9,"ENSG00000248118.2",1,2,"UMVVVVVVV",1,7,0.786749482401656,115,121,133,136,140,146,155,158,"ATGAAGA","CAGA","ATTGTGA","CAGA",2.31951983265023,12,4,9,34,3.00325370030578,4.61667981282682,7.76367774243345,101,"ENSG00000079974.19"
"33966","ENSG00000231672.8_221911",221903,221911,9,"ENSG00000231672.8",1,8,"VVUVVVVMV",1,7,0.767701863354037,43,49,62,65,114,120,133,136,"ATGATAG","CTGA","GGGAACA","CTGA",2.5282691830857,13,49,13,84,1.91582365635157,4.69273788589739,7.76354533931353,101,"ENSG00000079974.19"
"337","ENSG00000008513.16_62904",62896,62904,9,"ENSG00000008513.16",1,2,"VMVUVVVVV",1,7,0.764803312629399,108,114,133,136,144,150,166,169,"ATGAGGC","GTGA","GAGATGT","CTGA",2.47424777233451,19,8,16,52,2.32228287773656,4.70431700665832,7.76353025717592,101,"ENSG00000079974.19"
"13145","ENSG00000140386.13_522631",522623,522631,9,"ENSG00000140386.13",1,8,"UVVVVVVMV",1,7,0.786749482401656,42,48,65,68,80,86,133,136,"ATGAAGA","CTGA","GTGATTA","ATGA",2.54106165344697,17,12,47,85,1.52565345773407,4.61651612017848,7.7635140497851,101,"ENSG00000079974.19"
"30886","ENSG00000214513.4_8061",8053,8061,9,"ENSG00000214513.4",1,1,"MVVVVUVVV",1,7,0.82815734989648,108,114,133,136,139,145,155,158,"ATGGTGT","GTGT","TGGAGGA","CTGA",2.32524651544072,19,3,10,41,2.30185910235753,4.45087563465724,7.76350503424316,101,"ENSG00000079974.19"
"6376","ENSG00000109667.12_174983",174975,174983,9,"ENSG00000109667.12",1,1,"MVVVUVVVV",1,7,0.795859213250517,43,49,92,95,106,112,133,136,"ATGATTA","CTGA","GTGAGGA","TTGA",2.55359231140481,43,11,21,84,1.29591530538439,4.57996601202078,7.76340286502285,101,"ENSG00000079974.19"
"4684","ENSG00000101638.14_36881",36873,36881,9,"ENSG00000101638.14",1,8,"VVVUVVVMV",1,7,0.764803312629399,114,120,133,136,143,149,172,175,"CTGATAA","CAGA","GTGAGTC","CTGA",2.46932005993038,13,7,23,52,2.35459036143904,4.70418102357707,7.76339427409467,101,"ENSG00000079974.19"
"31388","ENSG00000223685.8_32926",32918,32926,9,"ENSG00000223685.8",1,2,"VMVVVUVVV",1,7,0.806211180124223,31,37,48,51,99,105,133,136,"ATGATTA","CTCA","ATCATGC","CTGA",2.55045060223408,11,48,28,96,1.15073087788701,4.53843372319522,7.76327844369212,101,"ENSG00000079974.19"
"18450","ENSG00000157423.18_348486",348478,348486,9,"ENSG00000157423.18",1,5,"VVVVMVUVV",1,7,0.772670807453416,95,101,133,136,142,148,156,159,"ATGATGA","CTGT","GTGATTT","CTGC",2.50541624786775,32,6,8,55,1.98738064755392,4.67253890833473,7.76322213814839,101,"ENSG00000079974.19"
"44028","ENSG00000276975.4_285950",285942,285950,9,"ENSG00000276975.4",1,5,"VVVVMVUVV",1,7,0.772670807453416,95,101,133,136,142,148,156,159,"ATGATGA","CTGT","GTGATTT","CTGC",2.50541624786775,32,6,8,55,1.98738064755392,4.67253890833473,7.76322213814839,101,"ENSG00000079974.19"
"46291","ENSG00000286458.1_114883",114875,114883,9,"ENSG00000286458.1",1,1,"MVVUVUVVV",2,6,0.708902691511387,80,86,106,109,113,119,133,136,"ATGATGT","CTAA","ATGTTGC","CTGA",2.62621567088429,20,4,14,47,2.20225582410093,4.92759007416571,7.76320084021126,101,"ENSG00000079974.19"
"5783","ENSG00000106688.12_86967",86959,86967,9,"ENSG00000106688.12",0,NA,"VVVVVUUVV",2,7,0.808281573498965,76,82,98,101,112,118,133,136,"ATGAGGA","ATGA","ACGAAGA","CTTA",2.34444442087597,16,11,15,51,2.49055936472019,4.53004720930666,7.76317350330252,101,"ENSG00000079974.19"
"1573","ENSG00000061936.10_11177",11169,11177,9,"ENSG00000061936.10",0,NA,"UVVVUVVVV",2,7,0.792546583850932,88,94,103,106,116,122,133,136,"ATGATGA","TTGA","ATGAAGA","GTTA",2.34102568032676,9,10,11,39,2.76505049678312,4.59297209140705,7.76315842681077,101,"ENSG00000079974.19"
"22519","ENSG00000170743.17_143922",143914,143922,9,"ENSG00000170743.17",0,NA,"VVVUUVVVV",2,7,0.770600414078675,92,98,133,136,144,150,172,175,"ATGATGG","TTGC","GTGATGT","CTGA",2.5980222760462,35,8,22,74,1.40287386570418,4.6807555931697,7.7631572494844,101,"ENSG00000079974.19"
"46292","ENSG00000286458.1_118817",118809,118817,9,"ENSG00000286458.1",1,1,"MVVVVUUVV",2,6,0.714285714285714,91,97,133,136,158,164,174,177,"CTGATGA","CTGA","ATGATTC","CTGA",2.76213069102977,36,22,10,77,1.209620049343,4.90595616405204,7.7630990211949,101,"ENSG00000079974.19"
"9358","ENSG00000124209.4_52582",52574,52582,9,"ENSG00000124209.4",1,7,"VVVVUVMVV",1,7,0.775155279503105,108,114,133,136,143,149,167,170,"AAGATGA","GTGT","TTGAACA","CTGA",2.4654772322196,19,7,18,53,2.21305168785662,4.66239164233015,7.76301276034257,101,"ENSG00000079974.19"
"4373","ENSG00000100345.23_59151",59143,59151,9,"ENSG00000100345.23",0,NA,"VVVVVUUVV",2,7,0.808281573498965,85,91,133,136,149,155,169,172,"GTGTTGA","GTGA","GTGCCTA","CTGA",2.48299114432329,42,13,14,78,1.5662140244916,4.52987207999505,7.76299837399091,101,"ENSG00000079974.19"
"11644","ENSG00000135605.13_64388",64380,64388,9,"ENSG00000135605.13",1,8,"VVVVUVVMV",1,7,0.773913043478261,80,86,104,107,116,122,133,136,"GTGATGT","TTTA","GAGTAGA","CTGA",2.40956843565555,18,9,11,47,2.60548191312479,4.66731787104045,7.7629700449535,101,"ENSG00000079974.19"
"24989","ENSG00000179008.9_23287",23279,23287,9,"ENSG00000179008.9",1,8,"VVUVVVVMV",1,7,0.767701863354037,83,89,133,136,144,150,181,184,"ATGATGA","ATAA","GTGGAGA","CTGA",2.65112323681629,44,8,31,92,1.09420459818898,4.6920898775744,7.76289733099054,101,"ENSG00000079974.19"
"15540","ENSG00000148655.15_625970",625962,625970,9,"ENSG00000148655.15",1,8,"VVVVVUVMV",1,7,0.806211180124224,93,99,133,136,182,188,196,199,"CTGATGG","ATGA","AAGATGA","CTGA",2.5736002026407,34,46,8,97,0.994441767324849,4.53794411289904,7.76278883339593,101,"ENSG00000079974.19"
"18058","ENSG00000156103.16_110501",110493,110501,9,"ENSG00000156103.16",0,NA,"UVVVUVVVV",2,7,0.792546583850932,88,94,104,107,114,120,133,136,"ATGATGA","CACA","GAGAAGG","CAGA",2.32306622871978,10,7,13,39,2.88322692080825,4.59258377806836,7.76277011347209,101,"ENSG00000079974.19"
"41142","ENSG00000258583.7_137867",137859,137867,9,"ENSG00000258583.7",1,1,"MVVVVVUVV",1,7,0.792132505175983,55,61,77,80,89,95,133,136,"TTGATGA","CAGA","ATGAGGA","ATGA",2.4837364526438,16,9,38,72,1.81870475278025,4.59423694260139,7.76276696330532,101,"ENSG00000079974.19"
"9770","ENSG00000127152.18_11570",11562,11570,9,"ENSG00000127152.18",1,8,"UVVVVVVMV",1,7,0.786749482401656,110,116,133,136,143,149,162,165,"AAGAGGA","CTGG","GTCTTGG","CTGA",2.36771069381249,17,7,13,46,2.67822954676562,4.61574187637888,7.76273980598551,101,"ENSG00000079974.19"
"36001","ENSG00000237667.7_50196",50188,50196,9,"ENSG00000237667.7",0,NA,"VVVVVUUVV",2,7,0.808281573498965,111,117,133,136,146,152,161,164,"ATCCTGA","ATTA","ATTAAGA","CTGA",2.3062534395255,16,10,9,44,2.74342649492762,4.5296123562744,7.76273865027026,101,"ENSG00000079974.19"
"41972","ENSG00000260192.3_580429",580421,580429,9,"ENSG00000260192.3",1,8,"VVVVVUVMV",1,7,0.806211180124224,61,67,81,84,110,116,133,136,"GTGATGA","CAGA","ATGAACA","CTCA",2.45786019533118,14,26,17,66,1.76583645755259,4.53789277327346,7.76273749377035,101,"ENSG00000079974.19"
"39162","ENSG00000253161.7_15242",15234,15242,9,"ENSG00000253161.7",1,8,"VVVVVUVMV",1,7,0.806211180124224,111,117,133,136,139,145,155,158,"ATCAGGG","ATGA","GGGATGT","CTGA",2.33290832648437,16,3,10,38,2.59857356385691,4.53782393510484,7.76266865560174,101,"ENSG00000079974.19"
"16671","ENSG00000152061.24_336791",336783,336791,9,"ENSG00000152061.24",1,1,"MVVVVUVVV",1,7,0.82815734989648,37,43,86,89,100,106,133,136,"ATGAAGA","TTGA","ATAATTC","CTGA",2.51411556736447,43,11,27,90,1.03920550083334,4.44999398748245,7.76262338706837,101,"ENSG00000079974.19"
"33842","ENSG00000231304.2_229380",229372,229380,9,"ENSG00000231304.2",1,1,"MVVVUVVVV",1,7,0.795859213250517,113,119,133,136,175,181,189,192,"ATGTTGA","GAGA","ATCATTA","CTGA",2.45454368770749,14,39,8,70,1.95306819585438,4.57917319514275,7.76261004814481,101,"ENSG00000079974.19"
"35855","ENSG00000237356.7_347983",347975,347983,9,"ENSG00000237356.7",1,5,"VVUVMVVVV",1,7,0.770186335403727,70,76,108,111,115,121,133,136,"GTGATGA","CTGA","CTGACTA","CTGT",2.53618290415882,32,4,12,57,1.81919954849881,4.68177139405607,7.76251673567098,101,"ENSG00000079974.19"
"1575","ENSG00000061936.10_48347",48339,48347,9,"ENSG00000061936.10",1,6,"VVVVUMVVV",1,7,0.792546583850932,112,118,133,136,178,184,194,197,"AGGATGG","CTCA","ATGTTAA","CTGA",2.46823614315609,15,42,10,76,1.91435745182754,4.59231626821704,7.76250260362076,101,"ENSG00000079974.19"
"23180","ENSG00000172273.13_1041",1033,1041,9,"ENSG00000172273.13",1,6,"VVVVVMUVV",1,7,0.788819875776397,87,93,133,136,165,171,180,183,"GTGATTA","CTGT","GTGATGG","CTGA",2.60505512173254,40,29,9,87,1.06138950380871,4.60710591217308,7.76238541527867,101,"ENSG00000079974.19"
"17788","ENSG00000155085.16_36034",36026,36034,9,"ENSG00000155085.16",1,2,"VMVUVVVVV",1,7,0.764803312629399,64,70,103,106,115,121,133,136,"ATGATGA","CTGA","AGGATAT","CTTA",2.53305984555985,33,9,12,63,1.92552841249862,4.70314851239106,7.76236176290866,101,"ENSG00000079974.19"
"25497","ENSG00000181938.14_96101",96093,96101,9,"ENSG00000181938.14",1,8,"VVVVVUVMV",1,7,0.806211180124224,102,108,133,136,149,155,183,186,"ATGAGGA","CAGA","GTGGGAA","CTGA",2.56643681544737,25,13,28,75,1.04046111847355,4.53750997203067,7.76235469252756,101,"ENSG00000079974.19"
"3581","ENSG00000086102.19_7601",7593,7601,9,"ENSG00000086102.19",1,8,"VVVVVUVMV",1,7,0.806211180124224,87,93,107,110,113,119,133,136,"ATGCTGA","CTGG","GGGAAGA","CTTA",2.33709961059246,14,3,14,40,2.56925200422459,4.53747901871025,7.76232373920714,101,"ENSG00000079974.19"
"27488","ENSG00000186298.12_21134",21126,21134,9,"ENSG00000186298.12",0,NA,"UVVVVVUVV",2,7,0.788819875776397,77,83,99,102,109,115,133,136,"TTAATGA","CTAA","ATCACCA","CTGA",2.39301159966416,16,7,18,50,2.4747132907515,4.60703098879481,7.7623104919004,101,"ENSG00000079974.19"
"24733","ENSG00000177694.16_521031",521023,521031,9,"ENSG00000177694.16",1,8,"VVVVVVUMV",1,7,0.770186335403727,113,119,133,136,144,150,161,164,"ATGATGA","AAGA","AAGATTA","CTGG",2.36581199472313,14,8,11,42,2.95372298478643,4.68145073740183,7.76219607901674,101,"ENSG00000079974.19"
"13689","ENSG00000143183.18_2776",2768,2776,9,"ENSG00000143183.18",0,NA,"VVVVUUVVV",2,7,0.812008281573499,112,118,133,136,141,147,160,163,"ATGATAA","TTTA","ATGATAA","ATGA",2.29185435191509,15,5,13,42,2.77747826044877,4.51412681830401,7.76215994459801,101,"ENSG00000079974.19"
"28240","ENSG00000188580.15_12269",12261,12269,9,"ENSG00000188580.15",1,1,"MVVVVUVVV",1,7,0.82815734989648,114,120,133,136,143,149,161,164,"ATGATGG","GAGA","GAGAATA","ATGA",2.22302748586445,13,7,12,41,2.97784358213778,4.44950670530853,7.76213610489446,101,"ENSG00000079974.19"
"45523","ENSG00000285681.2_209930",209922,209930,9,"ENSG00000285681.2",1,5,"UVVVMVVVV",1,7,0.789233954451346,100,106,133,136,144,150,169,172,"AGGATGA","TTGG","GTGGAGA","CTGA",2.51341493347664,27,8,19,63,1.66455205017098,4.60516290167047,7.76209871947585,101,"ENSG00000079974.19"
"35571","ENSG00000236341.1_21937",21929,21937,9,"ENSG00000236341.1",1,2,"VMVVVUVVV",1,7,0.806211180124223,73,79,90,93,113,119,133,136,"ATGATGG","TTGA","GTGATTG","CTGG",2.40370315247958,11,20,14,54,2.1242562511988,4.53723598359899,7.76208070409589,101,"ENSG00000079974.19"
"27436","ENSG00000186153.18_430464",430456,430464,9,"ENSG00000186153.18",1,3,"VVMVVUVVV",1,7,0.804968944099379,74,80,96,99,115,121,133,136,"ATTATAA","CTTA","GTGACCC","CTGA",2.38256937346952,16,16,12,53,2.28475512965969,4.54213773819745,7.76201351459497,101,"ENSG00000079974.19"
"10049","ENSG00000128918.15_342243",342235,342243,9,"ENSG00000128918.15",1,5,"VVVVMUVVV",1,7,0.808695652173913,115,121,133,136,139,145,155,158,"TTGATTG","TGGA","GTGATTT","CTGA",2.28615659125431,12,3,10,34,2.86771789302922,4.52719045868116,7.76197306737681,101,"ENSG00000079974.19"
"33696","ENSG00000230773.9_382584",382576,382584,9,"ENSG00000230773.9",1,8,"VVVUVVVMV",1,7,0.764803312629399,114,120,133,136,143,149,159,162,"AGGTTGA","CTGG","GTCTTGG","CTGA",2.36559354490635,13,7,10,39,3.04039141490683,4.70275376190395,7.76196701242155,101,"ENSG00000079974.19"
"9685","ENSG00000126217.22_35991",35983,35991,9,"ENSG00000126217.22",1,1,"MVVVVVUVV",1,7,0.792132505175983,102,108,133,136,145,151,199,202,"ATGATGG","ATGG","ATGAAGA","CTGA",2.58707320118911,25,9,48,91,1.12622274678527,4.59334435534484,7.76187437604877,101,"ENSG00000079974.19"
"2202","ENSG00000071242.12_192489",192481,192489,9,"ENSG00000071242.12",1,6,"VVVVUMVVV",1,7,0.792546583850932,115,121,133,136,150,156,199,202,"AAGCTGA","CTGG","GTGATGG","CTGA",2.50986335503051,12,14,43,78,1.63413248015895,4.59163871175726,7.76182504716099,101,"ENSG00000079974.19"
"3699","ENSG00000088305.19_24514",24506,24514,9,"ENSG00000088305.19",1,2,"VMVVVUVVV",1,7,0.806211180124223,54,60,75,78,87,93,133,136,"CAGATGA","TGGA","CTGTTGA","CTGA",2.44007367435717,15,9,40,73,1.880530055686,4.53692197118346,7.76176669168035,101,"ENSG00000079974.19"
"46815","ENSG00000287226.1_28747",28739,28747,9,"ENSG00000287226.1",1,2,"VMVUVVVVV",1,7,0.764803312629399,114,120,133,136,144,150,178,181,"GTGGTGT","CTGA","GTGTTTT","CTGA",2.49801129861336,13,8,28,58,2.15675520512419,4.70254096563665,7.76175421615425,101,"ENSG00000079974.19"
"28275","ENSG00000188596.11_281076",281068,281076,9,"ENSG00000188596.11",1,8,"VVVVVUVMV",1,7,0.806211180124224,105,111,133,136,160,166,174,177,"ATCAAGA","ATGA","GGGATGA","CTGA",2.50256097578152,22,24,8,63,1.46384819794384,4.53689700912182,7.76174172961871,101,"ENSG00000079974.19"
"41565","ENSG00000259245.2_29276",29268,29276,9,"ENSG00000259245.2",1,2,"VMVVVUVVV",1,7,0.806211180124223,115,121,133,136,151,157,167,170,"TTGGTGA","TTGG","ATAGTGA","CTGA",2.33841696002683,12,15,10,46,2.55807491051647,4.53688032767383,7.76172504817072,101,"ENSG00000079974.19"
"14894","ENSG00000146085.8_19847",19839,19847,9,"ENSG00000146085.8",1,1,"MVVVVVUVV",1,7,0.792132505175983,109,115,133,136,140,146,188,191,"TTGATGT","CTGC","ATGATAC","CTGA",2.52822366590006,18,4,42,73,1.51781424209701,4.59315967035769,7.76168969106162,101,"ENSG00000079974.19"
"18931","ENSG00000159322.18_10869",10861,10869,9,"ENSG00000159322.18",1,8,"VVVVUVVMV",1,7,0.773913043478261,116,122,133,136,145,151,164,167,"ATGATCT","TTCA","ATGGGGA","CTGA",2.37028378294231,11,9,13,42,2.8619218755468,4.66595344045721,7.76160561437026,101,"ENSG00000079974.19"
"17347","ENSG00000153936.18_88472",88464,88472,9,"ENSG00000153936.18",1,5,"UVVVMVVVV",1,7,0.789233954451346,111,117,133,136,142,148,156,159,"AAGATGG","ATGA","GTGAAGA","TTGA",2.33579575604898,16,6,8,39,2.84665549196025,4.60465679973836,7.76159261754374,101,"ENSG00000079974.19"
"42987","ENSG00000267561.2_10098",10090,10098,9,"ENSG00000267561.2",1,5,"UVVVMVVVV",1,7,0.789233954451346,111,117,133,136,142,148,156,159,"AAGATGG","ATGA","GTGAAGA","TTGA",2.33579575604898,16,6,8,39,2.84665549196025,4.60465679973836,7.76159261754374,101,"ENSG00000079974.19"
"28768","ENSG00000196470.12_54532",54524,54532,9,"ENSG00000196470.12",1,1,"MVVVUVVVV",1,7,0.795859213250517,76,82,97,100,102,108,133,136,"CTGATGA","CTGC","TTGATGA","CCGA",2.49065589567748,15,2,25,51,1.7082378209174,4.57815261469181,7.76158946769388,101,"ENSG00000079974.19"
"44020","ENSG00000276850.5_61767",61759,61767,9,"ENSG00000276850.5",1,1,"MVVVVUVVV",1,7,0.82815734989648,115,121,133,136,142,148,187,190,"AGTAGGA","CTGA","GAGAGGT","CTGA",2.36804327042286,12,6,39,66,2.00884724226449,4.44895059460422,7.76157999419014,101,"ENSG00000079974.19"
"23438","ENSG00000172965.17_374732",374724,374732,9,"ENSG00000172965.17",0,NA,"VVVVUUVVV",2,7,0.812008281573499,110,116,133,136,139,145,153,156,"GGGAGGA","CTGG","GAGAAGC","CTGA",2.33082926845629,17,3,8,37,2.51487483465362,4.51343415609056,7.76146728238455,101,"ENSG00000079974.19"
"10317","ENSG00000130508.11_46215",46207,46215,9,"ENSG00000130508.11",1,8,"VVVUVVVMV",1,7,0.764803312629399,116,122,133,136,159,165,176,179,"ATGCTGA","CTGG","GTTCTGC","CTGA",2.50125260287045,11,23,11,54,2.13375658766859,4.70219348503457,7.76140673555216,101,"ENSG00000079974.19"
"20909","ENSG00000165973.19_627080",627072,627080,9,"ENSG00000165973.19",1,8,"VVVVUVVMV",1,7,0.773913043478261,86,92,99,102,115,121,133,136,"AAGATCA","CAGA","ATGGGGA","CTGA",2.45622616151538,7,13,12,41,2.28813083262166,4.66574297734772,7.76139515126077,101,"ENSG00000079974.19"
"2374","ENSG00000073910.23_18606",18598,18606,9,"ENSG00000073910.23",1,2,"VMVVVUVVV",1,7,0.806211180124223,116,122,133,136,153,159,168,171,"GGGCTGA","ATGA","GTGAGTG","CTGA",2.36107737414883,11,17,9,46,2.40566913756503,4.53654624130598,7.76139096180287,101,"ENSG00000079974.19"
"22954","ENSG00000171793.17_20538",20530,20538,9,"ENSG00000171793.17",1,2,"VMVVVUVVV",1,7,0.806211180124223,104,110,133,136,140,146,160,163,"GTAATGG","CTCA","ATGAAAA","CTGA",2.42443643307198,23,4,14,50,1.98289351584503,4.53645076741455,7.76129548791145,101,"ENSG00000079974.19"
"26660","ENSG00000184792.16_114673",114665,114673,9,"ENSG00000184792.16",1,5,"VVVVMUVVV",1,7,0.808695652173913,83,89,101,104,114,120,133,136,"ATGAGGT","TTGA","GTGAAGG","ATGA",2.29192715882285,12,10,13,44,2.82618681826955,4.52642530260547,7.76120791130112,101,"ENSG00000079974.19"
"16430","ENSG00000151490.15_167868",167860,167868,9,"ENSG00000151490.15",1,8,"VVVVVUVMV",1,7,0.806211180124224,88,94,133,136,146,152,166,169,"GTGATGA","CTCT","AAGCTGC","CTGA",2.45601897760488,39,10,14,72,1.77163947678462,4.53627483187095,7.76111955236784,101,"ENSG00000079974.19"
"10242","ENSG00000130052.14_8461",8453,8461,9,"ENSG00000130052.14",1,1,"MVVVVVUVV",1,7,0.792132505175983,115,121,133,136,145,151,168,171,"TTGATGC","CAAA","ATGGAGT","CTGA",2.3578556658697,12,9,17,47,2.6511251156644,4.59254072203226,7.76107074273619,101,"ENSG00000079974.19"
"10558","ENSG00000131558.15_464070",464062,464070,9,"ENSG00000131558.15",1,2,"UMVVVVVVV",1,7,0.786749482401656,113,119,133,136,138,144,153,156,"AAGATGA","CTGA","AGGTTCA","CTTA",2.37021789501721,14,2,9,34,2.65446669549672,4.61397983223619,7.76097776184282,101,"ENSG00000079974.19"
"21432","ENSG00000167601.12_41807",41799,41807,9,"ENSG00000167601.12",1,7,"VVVVVUMVV",1,7,0.807453416149068,52,58,72,75,82,88,133,136,"ATGATGA","CTGA","ATGATAA","CTAG",2.42299107142857,14,7,45,75,1.97123367410731,4.53112687090778,7.76094053550405,101,"ENSG00000079974.19"
"4060","ENSG00000092853.14_40756",40748,40756,9,"ENSG00000092853.14",0,NA,"UVVVVUVVV",2,7,0.824844720496894,70,76,86,89,96,102,133,136,"TTGAAGA","CAGC","CTGGAGA","CTGA",2.37295410224426,10,7,31,57,2.02645098400139,4.46153624974079,7.76091513172836,101,"ENSG00000079974.19"
"17458","ENSG00000154188.10_116038",116030,116038,9,"ENSG00000154188.10",1,2,"UMVVVVVVV",1,7,0.786749482401656,93,99,105,108,116,122,133,136,"AGGAAGA","CGGA","ATTTAGA","CTGA",2.37432220415268,6,8,11,34,2.62656194355985,4.61384415947776,7.76084208908438,101,"ENSG00000079974.19"
"9298","ENSG00000123892.12_5086",5078,5086,9,"ENSG00000123892.12",1,1,"MVVVVUVVV",1,7,0.82815734989648,84,90,133,136,142,148,186,189,"AAGATGG","CTAA","GCGATGA","CTGA",2.51669374599539,43,6,38,96,1.0145854950744,4.44813595042758,7.7607653500135,101,"ENSG00000079974.19"
"22685","ENSG00000171100.16_53568",53560,53568,9,"ENSG00000171100.16",1,1,"MVVVVUVVV",1,7,0.82815734989648,94,100,133,136,148,154,173,176,"ATGATGG","AGGA","ATGGAAA","CTGA",2.46515613001907,33,12,19,73,1.35805961320471,4.44810845333296,7.76073785291888,101,"ENSG00000079974.19"
"29068","ENSG00000197102.14_25632",25624,25632,9,"ENSG00000197102.14",1,6,"VVVVVMUVV",1,7,0.788819875776397,116,122,133,136,182,188,197,200,"TTGTTGA","CTGG","CTGACAA","CTGA",2.46691926635822,11,46,9,75,1.97550950440251,4.60540948669765,7.76068898980324,101,"ENSG00000079974.19"
"38231","ENSG00000249815.2_11304",11296,11304,9,"ENSG00000249815.2",1,6,"UVVVVMVVV",1,7,0.805383022774327,57,63,80,83,96,102,133,136,"TTGATGA","CACA","TTGGTCA","CTGA",2.49003610447693,17,13,31,70,1.55632097281517,4.539140417332,7.76067250842931,101,"ENSG00000079974.19"
"16336","ENSG00000151338.21_19339",19331,19339,9,"ENSG00000151338.21",1,5,"UVVVMVVVV",1,7,0.789233954451346,111,117,133,136,165,171,184,187,"CTGAACA","ATGA","GTGATGA","CTGA",2.48948138242669,16,29,13,67,1.81828701987884,4.60370739234753,7.76064321015291,101,"ENSG00000079974.19"
"14712","ENSG00000145743.18_516153",516145,516153,9,"ENSG00000145743.18",1,1,"MVUVVVVVV",1,7,0.789648033126294,115,121,133,136,140,146,156,159,"ATAACGA","TTGG","CTGCTGG","CTGA",2.31578873900411,12,4,10,35,2.9695409736259,4.60203314174666,7.76062527425184,101,"ENSG00000079974.19"
"4570","ENSG00000101109.13_19954",19946,19954,9,"ENSG00000101109.13",0,NA,"UVVVVUVVV",2,7,0.824844720496894,101,107,133,136,140,146,158,161,"TTGTTGA","GTAA","ATGAAGT","CTGA",2.3872483094188,26,4,12,51,1.92989116592033,4.46121997384475,7.76059885583232,101,"ENSG00000079974.19"
"30243","ENSG00000204291.11_29404",29396,29404,9,"ENSG00000204291.11",0,NA,"VVVVVUUVV",2,7,0.808281573498965,109,115,133,136,162,168,181,184,"AGGATGA","CTTT","CTGCAGA","CTGA",2.46299982421844,18,26,13,66,1.68979981626451,4.52744966109686,7.76057595509272,101,"ENSG00000079974.19"
"16827","ENSG00000152380.10_2135",2127,2135,9,"ENSG00000152380.10",0,NA,"UVVVVVUVV",2,7,0.788819875776397,113,119,133,136,148,154,169,172,"AGGATGT","CCGT","GTGGTGG","CTGA",2.38102609872888,14,12,15,50,2.54760906120203,4.60527909651531,7.7605585996209,101,"ENSG00000079974.19"
"42924","ENSG00000267337.2_91632",91624,91632,9,"ENSG00000267337.2",1,8,"VVVUVVVMV",1,7,0.764803312629399,88,94,103,106,112,118,133,136,"ATGATGT","ATGA","CTAATGA","CAGA",2.41847163846683,9,6,15,39,2.68196591304732,4.70127754237322,7.76049079289082,101,"ENSG00000079974.19"
"24068","ENSG00000175061.20_1309",1301,1309,9,"ENSG00000175061.20",1,7,"VVVVUVMVV",1,7,0.775155279503105,96,102,133,136,140,146,157,160,"CTGATGA","ATAA","ACGAAGA","CTGA",2.5175613602785,31,4,11,55,1.85564178792783,4.65984604744612,7.76046716545854,101,"ENSG00000079974.19"
"44064","ENSG00000277370.1_40",32,40,9,"ENSG00000277370.1",1,7,"VVVVUVMVV",1,7,0.775155279503105,5,11,42,45,49,55,66,69,"CTGATGA","ATAA","ACGAAGA","CTGA",2.5175613602785,31,4,11,55,1.85564178792783,4.65984604744612,7.76046716545854,101,"ENSG00000079974.19"
"9424","ENSG00000124571.18_25888",25880,25888,9,"ENSG00000124571.18",1,3,"UVMVVVVVV",1,7,0.785507246376811,92,98,133,136,153,159,176,179,"GTGATGG","TTGA","CCGATGA","CTGA",2.60090198327932,35,17,17,78,1.13439857966212,4.6184362837144,7.76046526922165,101,"ENSG00000079974.19"
"42473","ENSG00000263551.6_141087",141079,141087,9,"ENSG00000263551.6",1,3,"UVMVVVVVV",1,7,0.785507246376811,111,117,133,136,146,152,170,173,"GTGTTAA","CTAA","GAGATGA","CTGA",2.41520947679323,16,10,18,53,2.37232817465647,4.61843117165283,7.76046015716008,101,"ENSG00000079974.19"
"31808","ENSG00000224897.9_466427",466419,466427,9,"ENSG00000224897.9",1,6,"UVVVVMVVV",1,7,0.805383022774327,115,121,133,136,150,156,168,171,"ATAATAA","TTGG","GGGAAGA","CTGA",2.33576992784998,12,14,12,47,2.58378750295285,4.53889675548818,7.76042884658549,101,"ENSG00000079974.19"
"9191","ENSG00000123104.12_278328",278320,278328,9,"ENSG00000123104.12",1,7,"VVVVVUMVV",1,7,0.807453416149068,112,118,133,136,161,167,176,179,"ATGATGG","CAGA","GTGAGAA","CTGT",2.41352947374989,15,25,9,58,2.03198369904472,4.53054504767766,7.76035871227394,101,"ENSG00000079974.19"
"26981","ENSG00000185352.9_386709",386701,386709,9,"ENSG00000185352.9",1,8,"VVVVVVUMV",1,7,0.770186335403727,102,108,133,136,144,150,158,161,"ATGATGG","GTTA","CTGGTGG","CTGA",2.48684656654445,25,8,8,50,2.13930864726638,4.67957143939068,7.76031678100559,101,"ENSG00000079974.19"
"29547","ENSG00000198216.14_292859",292851,292859,9,"ENSG00000198216.14",1,8,"UVVVVVVMV",1,7,0.786749482401656,77,83,92,95,102,108,133,136,"TTGAAGT","CTGA","TTAATTA","CTGA",2.45146233477656,9,7,25,50,2.11006886421621,4.61328777401498,7.7602857036216,101,"ENSG00000079974.19"
"24062","ENSG00000175054.16_107684",107676,107684,9,"ENSG00000175054.16",1,8,"UVVVVVVMV",1,7,0.786749482401656,115,121,133,136,150,156,197,200,"GGGAAGA","CTGG","GTGATGA","CTGA",2.52198540341977,12,14,41,76,1.63973666734755,4.6132431725365,7.76024110214312,101,"ENSG00000079974.19"
"37018","ENSG00000244327.1_1288",1280,1288,9,"ENSG00000244327.1",1,8,"UVVVVVVMV",1,7,0.786749482401656,115,121,133,136,150,156,197,200,"GGGAAGA","CTGG","GTGATGA","CTGA",2.52198540341977,12,14,41,76,1.63973666734755,4.6132431725365,7.76024110214312,101,"ENSG00000079974.19"
"8892","ENSG00000121297.8_26117",26109,26117,9,"ENSG00000121297.8",0,NA,"UVVUVVVVV",2,7,0.78343685300207,71,77,91,94,116,122,133,136,"TGGATCA","CTGA","TTGAATA","CTGA",2.45289939728013,14,22,11,56,2.1532040498401,4.62646667459358,7.76021408660186,101,"ENSG00000079974.19"
"30786","ENSG00000213468.7_87935",87927,87935,9,"ENSG00000213468.7",1,2,"UMVVVVVVV",1,7,0.786749482401656,112,118,133,136,142,148,174,177,"GTGATGT","CACA","CTGATAG","CTGA",2.44848109675219,15,6,26,56,2.12963612038352,4.6132108580162,7.76020878762283,101,"ENSG00000079974.19"
"25498","ENSG00000181982.20_155917",155909,155917,9,"ENSG00000181982.20",1,8,"VVVVVUVMV",1,7,0.806211180124224,52,58,103,106,112,118,133,136,"GTCATAA","CTGA","GTCAAGT","CTGA",2.45102871263995,45,6,15,75,1.80113759495439,4.53533225313852,7.76017697363541,101,"ENSG00000079974.19"
"9973","ENSG00000128607.14_30680",30672,30680,9,"ENSG00000128607.14",1,6,"VVVUVMVVV",1,7,0.78343685300207,66,72,90,93,100,106,133,136,"ATGATGA","TAGA","GTGAAGA","CTTA",2.49532845412461,18,7,27,61,1.8698898767074,4.62635322605119,7.76010063805947,101,"ENSG00000079974.19"
"32415","ENSG00000226983.3_111671",111663,111671,9,"ENSG00000226983.3",1,6,"VVVVVMUVV",1,7,0.788819875776397,48,54,63,66,76,82,133,136,"ATGTGGA","CTGA","TTTATTA","CTGA",2.50241844923611,9,10,51,79,1.73639459485384,4.60479606410698,7.76007556721257,101,"ENSG00000079974.19"
"39883","ENSG00000254394.2_293047",293039,293047,9,"ENSG00000254394.2",1,8,"VVVVUVVMV",1,7,0.773913043478261,110,116,133,136,144,150,162,165,"TTGATGC","TTTA","GTTATAA","CTGA",2.39307917160322,17,8,12,46,2.70380730046761,4.66441711112226,7.76006928503531,101,"ENSG00000079974.19"
"25928","ENSG00000183098.11_851292",851284,851292,9,"ENSG00000183098.11",1,2,"VMVVVUVVV",1,7,0.806211180124223,84,90,103,106,112,118,133,136,"ATCATGT","CTGA","ATGGTAT","GTGA",2.29979759617088,13,6,15,43,2.80890812931346,4.53522302594649,7.76006774644339,101,"ENSG00000079974.19"
"18764","ENSG00000158427.15_25699",25691,25699,9,"ENSG00000158427.15",0,NA,"VVUVVUVVV",2,7,0.805797101449275,35,41,53,56,99,105,133,136,"CTGATGG","ATGA","GGGAAGA","CTGA",2.54530628372178,12,43,28,92,1.17872066444898,4.53685730564854,7.76004571144564,101,"ENSG00000079974.19"
"62","ENSG00000003393.16_66321",66313,66321,9,"ENSG00000003393.16",0,NA,"VVVVVUUVV",2,7,0.808281573498965,113,119,133,136,144,150,162,165,"CTGATGA","GTGT","ATGTTGG","CTGT",2.27799813634027,14,8,12,43,2.92097912702687,4.52690834232384,7.7600346363197,101,"ENSG00000079974.19"
"36138","ENSG00000237978.6_282351",282343,282351,9,"ENSG00000237978.6",1,2,"VMVVVUVVV",1,7,0.806211180124223,104,110,133,136,159,165,173,176,"CTCATGA","CTAA","CTCATGA","CTGA",2.50717641064663,23,23,8,63,1.42623831194809,4.53518692906474,7.76003164956164,101,"ENSG00000079974.19"
"42323","ENSG00000261645.7_428977",428969,428977,9,"ENSG00000261645.7",1,8,"VVVVVUVMV",1,7,0.806211180124224,78,84,93,96,111,117,133,136,"ATGATTA","ATGA","CTGATGC","CAGA",2.39863797055404,9,15,16,49,2.14981293765938,4.53518318533824,7.76002790583513,101,"ENSG00000079974.19"
"42429","ENSG00000262801.6_93509",93501,93509,9,"ENSG00000262801.6",1,7,"VVUVVVMVV",1,7,0.768944099378882,109,115,133,136,144,150,175,178,"CTGCTGA","CTGC","TTGTTGA","CTGA",2.52162575491568,18,8,25,60,1.92601331991953,4.68421292150602,7.75998931902155,101,"ENSG00000079974.19"
"6148","ENSG00000108175.19_208547",208539,208547,9,"ENSG00000108175.19",1,7,"VVVVVUMVV",1,7,0.807453416149068,44,50,62,65,95,101,133,136,"ATGAGGA","CTAA","GTGAGCC","CTGA",2.54684940889188,12,30,32,83,1.14163969421945,4.53015893837466,7.75997260297093,101,"ENSG00000079974.19"
"4818","ENSG00000101972.20_112875",112867,112875,9,"ENSG00000101972.20",1,6,"UVVVVMVVV",1,7,0.805383022774327,110,116,133,136,141,147,159,162,"GTAATGG","TTGT","ATGTAGA","CTGA",2.32451476155691,17,5,12,43,2.65690039645844,4.53841636837612,7.75994845947343,101,"ENSG00000079974.19"
"21153","ENSG00000166669.14_30723",30715,30723,9,"ENSG00000166669.14",1,8,"VVVVVUVMV",1,7,0.806211180124224,112,118,133,136,148,154,163,166,"CTGATGG","CTAG","GGGACCA","CTGA",2.31904372579464,15,12,9,45,2.67998047954187,4.53506799620987,7.75991271670676,101,"ENSG00000079974.19"
"22995","ENSG00000171914.17_134774",134766,134774,9,"ENSG00000171914.17",1,3,"UVMVVVVVV",1,7,0.785507246376811,116,122,133,136,167,173,229,232,"GTGATGT","CTCA","GAGATGA","CTGA",2.61798985770338,11,31,56,107,1.01787440037898,4.61778502960038,7.75981401510763,101,"ENSG00000079974.19"
"41712","ENSG00000259583.4_11989",11981,11989,9,"ENSG00000259583.4",1,8,"VVVVUUVMV",2,6,0.696066252587992,86,92,102,105,114,120,133,136,"ATAATGG","CAGA","ATGAGGA","CTGA",2.56331384199756,10,9,13,41,2.81318230505451,4.97548531292623,7.75975032327819,101,"ENSG00000079974.19"
"2221","ENSG00000071909.19_202615",202607,202615,9,"ENSG00000071909.19",1,6,"UVVVVMVVV",1,7,0.805383022774327,116,122,133,136,181,187,199,202,"AAGATGT","TTAA","ATGTTGA","CTGA",2.43256663039814,11,45,12,77,1.93546332911125,4.53814354960804,7.75967564070535,101,"ENSG00000079974.19"
"36853","ENSG00000243276.6_427753",427745,427753,9,"ENSG00000243276.6",1,2,"VMVVVUVVV",1,7,0.806211180124223,106,112,133,136,179,185,200,203,"ATAAAGA","CTGA","ATAATAA","CTGA",2.53622488269851,21,43,15,88,1.23092736259746,4.53477331181354,7.75961803231043,101,"ENSG00000079974.19"
"13493","ENSG00000141576.16_88299",88291,88299,9,"ENSG00000141576.16",1,1,"MVVVUVVVV",1,7,0.795859213250517,111,117,133,136,156,162,175,178,"TTGCTGA","CTGG","GCAATGA","CTGA",2.44045341492103,16,20,13,58,2.03501299660381,4.57617560735268,7.75961246035475,101,"ENSG00000079974.19"
"13206","ENSG00000140564.13_14538",14530,14538,9,"ENSG00000140564.13",1,8,"VVVVVUVMV",1,7,0.806211180124224,86,92,133,136,140,146,166,169,"GTGGTGG","CTGA","GTCATGC","CTGA",2.51754754048332,41,4,20,74,1.355163293389,4.53470339081945,7.75954811131635,101,"ENSG00000079974.19"
"33675","ENSG00000230647.3_77158",77150,77158,9,"ENSG00000230647.3",1,8,"VVVVVUVMV",1,7,0.806211180124224,114,120,133,136,140,146,154,157,"GTGAAGA","CTGT","AGGAAGA","ATGA",2.27378049659324,13,4,8,34,2.98024488749675,4.53469538286292,7.75954010335981,101,"ENSG00000079974.19"
"30080","ENSG00000203585.4_11622",11614,11622,9,"ENSG00000203585.4",1,8,"UVVVVVVMV",1,7,0.786749482401656,112,118,133,136,157,163,171,174,"GGGAGGA","CTCA","ATGATGT","CTGA",2.44828922685023,15,21,8,53,2.12816768379384,4.61252396569884,7.75952189530547,101,"ENSG00000079974.19"
"6976","ENSG00000112394.18_50377",50369,50377,9,"ENSG00000112394.18",1,1,"MVVUVVVVV",1,7,0.786749482401656,115,121,133,136,142,148,193,196,"ATGAGGT","CTCA","ATGCTAA","CTGA",2.4688143060049,12,6,45,72,1.99129244324766,4.61251362082007,7.7595115504267,101,"ENSG00000079974.19"
"20403","ENSG00000164796.18_492068",492060,492068,9,"ENSG00000164796.18",1,1,"MVVVVUVVV",1,7,0.82815734989648,93,99,133,136,143,149,174,177,"ATTATGT","AAGA","GTGATGT","CTGA",2.47534643653969,34,7,25,75,1.28519105190805,4.44687515720982,7.75950455679574,101,"ENSG00000079974.19"
"9176","ENSG00000123066.9_273334",273326,273334,9,"ENSG00000123066.9",1,2,"VMVVVVUVV",1,7,0.770186335403727,115,121,133,136,142,148,164,167,"ATGAAAA","CTGG","GAAATGA","CTGA",2.39401501727851,12,6,16,43,2.75487448034325,4.67874364888332,7.75948899049823,101,"ENSG00000079974.19"
"2797","ENSG00000078319.13_1289",1281,1289,9,"ENSG00000078319.13",1,1,"MVVUVVVVV",1,7,0.786749482401656,116,122,133,136,177,183,196,199,"ATGAAGA","TTGT","ATGCTGT","CTGA",2.48249030944071,11,41,13,74,1.89994518384576,4.61247014502929,7.75946807463592,101,"ENSG00000079974.19"
"42645","ENSG00000265479.7_78098",78090,78098,9,"ENSG00000265479.7",1,1,"MVVUVVVVV",1,7,0.786749482401656,116,122,133,136,177,183,196,199,"ATGAAGA","TTGT","ATGCTGT","CTGA",2.48249030944071,11,41,13,74,1.89994518384576,4.61247014502929,7.75946807463592,101,"ENSG00000079974.19"
"44121","ENSG00000278416.1_1872",1864,1872,9,"ENSG00000278416.1",1,1,"MVVUVVVVV",1,7,0.786749482401656,116,122,133,136,177,183,196,199,"ATGAAGA","TTGT","ATGCTGT","CTGA",2.48249030944071,11,41,13,74,1.89994518384576,4.61247014502929,7.75946807463592,101,"ENSG00000079974.19"
"45540","ENSG00000285702.1_23819",23811,23819,9,"ENSG00000285702.1",1,1,"MVVUVVVVV",1,7,0.786749482401656,116,122,133,136,177,183,196,199,"ATGAAGA","TTGT","ATGCTGT","CTGA",2.48249030944071,11,41,13,74,1.89994518384576,4.61247014502929,7.75946807463592,101,"ENSG00000079974.19"
"48489","ENSG00000291178.1_1736",1728,1736,9,"ENSG00000291178.1",1,1,"MVVUVVVVV",1,7,0.786749482401656,116,122,133,136,177,183,196,199,"ATGAAGA","TTGT","ATGCTGT","CTGA",2.48249030944071,11,41,13,74,1.89994518384576,4.61247014502929,7.75946807463592,101,"ENSG00000079974.19"
"3227","ENSG00000082482.14_143211",143203,143211,9,"ENSG00000082482.14",0,NA,"VVVUVUVVV",2,7,0.802898550724638,98,104,133,136,148,154,178,181,"ATGATGA","ATGG","GTCTTGG","CTGA",2.55796836417143,29,12,24,74,1.13828171184779,4.54785103491433,7.75944523781288,101,"ENSG00000079974.19"
"26647","ENSG00000184672.12_8112",8104,8112,9,"ENSG00000184672.12",1,1,"MVUVVVVVV",1,7,0.789648033126294,110,116,133,136,156,162,172,175,"TTTTTGA","CTGA","GTTAGGA","CTGA",2.4555550720975,17,20,10,56,2.03298891186486,4.60083901479539,7.75943114730056,101,"ENSG00000079974.19"
"35708","ENSG00000236813.1_430",422,430,9,"ENSG00000236813.1",1,2,"UMVVVUVVV",2,6,0.708902691511387,103,109,133,136,151,157,178,181,"ATGATGA","TTGA","ATGAGGC","CTGA",2.76944628843487,24,15,21,69,1.23214920357492,4.92378111495184,7.75939188099739,101,"ENSG00000079974.19"
"24582","ENSG00000177103.15_151332",151324,151332,9,"ENSG00000177103.15",0,NA,"VVVVUUVVV",2,7,0.812008281573499,92,98,133,136,146,152,162,165,"ATGCTGA","CCGG","GTGACCT","CTGA",2.42076770620908,35,10,10,64,1.90678761505725,4.51130974744612,7.75934287374012,101,"ENSG00000079974.19"
"5806","ENSG00000106771.13_47454",47446,47454,9,"ENSG00000106771.13",1,8,"VVUVVVVMV",1,7,0.767701863354037,111,117,133,136,187,193,208,211,"ATAATGG","CTGA","CAGATGT","CTGA",2.56474827862443,16,51,15,91,1.6556809846581,4.68850071053857,7.75930816395471,101,"ENSG00000079974.19"
"13964","ENSG00000144043.13_19775",19767,19775,9,"ENSG00000144043.13",1,2,"UMVVVVVVV",1,7,0.786749482401656,85,91,109,112,116,122,133,136,"AGATTGA","CTGA","TTGACTA","CTGA",2.3912582969349,18,4,11,42,2.50730467495223,4.61225666362956,7.75925459323619,101,"ENSG00000079974.19"
"41341","ENSG00000258881.6_20238",20230,20238,9,"ENSG00000258881.6",1,2,"UMVVVVVVV",1,7,0.786749482401656,85,91,109,112,116,122,133,136,"AGATTGA","CTGA","TTGACTA","CTGA",2.3912582969349,18,4,11,42,2.50730467495223,4.61225666362956,7.75925459323619,101,"ENSG00000079974.19"
"27438","ENSG00000186153.18_451397",451389,451397,9,"ENSG00000186153.18",1,8,"UVVVVVVMV",1,7,0.786749482401656,89,95,133,136,144,150,166,169,"GAGATGA","AGGA","ATGAAGA","CTGA",2.50503655163687,38,8,16,71,1.74814273856038,4.61209660403489,7.75909453364151,101,"ENSG00000079974.19"
"6799","ENSG00000111886.11_60693",60685,60693,9,"ENSG00000111886.11",1,3,"VVMVUVVVV",1,7,0.772670807453416,113,119,133,136,186,192,204,207,"ATGGTGA","CCCA","ATGATTA","CTGA",2.51260640776043,14,50,12,85,1.92281145132836,4.66838020909948,7.75906343891315,101,"ENSG00000079974.19"
"30224","ENSG00000204179.11_76518",76510,76518,9,"ENSG00000204179.11",1,5,"VVVVMVUVV",1,7,0.772670807453416,110,116,133,136,142,148,162,165,"TTAATGA","CATA","GTGAGAA","CTGA",2.40887602479016,17,6,14,46,2.61427567441327,4.66836229325359,7.75904552306725,101,"ENSG00000079974.19"
"47736","ENSG00000289143.1_76521",76513,76521,9,"ENSG00000289143.1",1,5,"VVVVMVUVV",1,7,0.772670807453416,110,116,133,136,142,148,162,165,"TTAATGA","CATA","GTGAGAA","CTGA",2.40887602479016,17,6,14,46,2.61427567441327,4.66836229325359,7.75904552306725,101,"ENSG00000079974.19"
"47828","ENSG00000289444.1_76502",76494,76502,9,"ENSG00000289444.1",1,5,"VVVVMVUVV",1,7,0.772670807453416,110,116,133,136,142,148,162,165,"TTAATGA","CATA","GTGAGAA","CTGA",2.40887602479016,17,6,14,46,2.61427567441327,4.66836229325359,7.75904552306725,101,"ENSG00000079974.19"
"20205","ENSG00000164418.22_687098",687090,687098,9,"ENSG00000164418.22",1,8,"VVVVVUVMV",1,7,0.806211180124224,113,119,133,136,139,145,153,156,"AAGAGTA","CAGA","ATGATTC","CTGA",2.29873519754506,14,3,8,34,2.81163651498766,4.53413445798869,7.75897917848558,101,"ENSG00000079974.19"
"37949","ENSG00000249252.5_325457",325449,325457,9,"ENSG00000249252.5",1,2,"VMVVVVUVV",1,7,0.770186335403727,83,89,100,103,110,116,133,136,"GTGATGA","ATGA","TTTACGA","ATGA",2.40475655558604,11,7,17,44,2.6811065779692,4.6782042371357,7.75894957875061,101,"ENSG00000079974.19"
"24530","ENSG00000176771.18_468728",468720,468728,9,"ENSG00000176771.18",1,8,"UVVVVVVMV",1,7,0.786749482401656,114,120,133,136,159,165,185,188,"ATGGTTA","GTGA","ATGAAGA","CTGA",2.51440297031654,13,23,20,65,1.68511101468263,4.61194937086489,7.75894730047152,101,"ENSG00000079974.19"
"42469","ENSG00000263508.6_9469",9461,9469,9,"ENSG00000263508.6",1,5,"UVVVMVVVV",1,7,0.789233954451346,86,92,133,136,174,180,194,197,"ATGATGC","CTGC","GTGTTGC","CTGA",2.6286735004382,41,38,14,102,0.88347970348367,4.60199242660125,7.75892824440663,101,"ENSG00000079974.19"
"45233","ENSG00000285220.1_124366",124358,124366,9,"ENSG00000285220.1",1,5,"UVVVMVVVV",1,7,0.789233954451346,86,92,133,136,174,180,194,197,"ATGATGC","CTGC","GTGTTGC","CTGA",2.6286735004382,41,38,14,102,0.88347970348367,4.60199242660125,7.75892824440663,101,"ENSG00000079974.19"
"46602","ENSG00000286891.1_33661",33653,33661,9,"ENSG00000286891.1",1,8,"VVVVUVVMV",1,7,0.773913043478261,81,87,101,104,115,121,133,136,"CAGATGA","CTGG","ACAATGT","CTGA",2.38376067330857,14,11,12,46,2.76117004326452,4.66322696633041,7.75887914024345,101,"ENSG00000079974.19"
"32844","ENSG00000228065.13_153761",153753,153761,9,"ENSG00000228065.13",1,8,"VVVVVUVMV",1,7,0.806211180124224,104,110,133,136,141,147,155,158,"ATGATGG","ATAA","AAATTGA","CTGA",2.39179901977992,23,5,8,45,2.19064528318488,4.53399302042942,7.75883774092631,101,"ENSG00000079974.19"
"23023","ENSG00000171970.14_1937",1929,1937,9,"ENSG00000171970.14",0,NA,"VVVVVUUVV",2,7,0.808281573498965,41,47,64,67,77,83,133,136,"TTGCTGA","CTGG","GTCATAA","CTGA",2.46705814465076,17,10,50,86,1.65566783905907,4.52568053418271,7.75880682817857,101,"ENSG00000079974.19"
"27870","ENSG00000187527.12_90368",90360,90368,9,"ENSG00000187527.12",0,NA,"VVVUVUVVV",2,7,0.802898550724638,82,88,133,136,141,147,155,158,"ATGATCA","TTTA","AAGCTGA","CTGA",2.44154680163621,45,5,8,67,1.91181383392828,4.54719812787576,7.75879233077431,101,"ENSG00000079974.19"
"24255","ENSG00000175600.16_219597",219589,219597,9,"ENSG00000175600.16",1,7,"VVVUVVMVV",1,7,0.766045548654244,81,87,96,99,112,118,133,136,"CTAATGA","CTGG","GTGCGGT","CTGA",2.46400282221471,9,13,15,46,2.35162665822397,4.69457803491384,7.75876022953082,101,"ENSG00000079974.19"
"35601","ENSG00000236449.2_221843",221835,221843,9,"ENSG00000236449.2",0,NA,"UVVVUVVVV",2,7,0.792546583850932,87,93,133,136,159,165,179,182,"GTGATGA","GTTA","GTGAGGG","CTGA",2.5962412360022,40,23,14,86,1.04594289324268,4.588554449981,7.75874078538472,101,"ENSG00000079974.19"
"41395","ENSG00000258969.2_349847",349839,349847,9,"ENSG00000258969.2",1,8,"UVVVVVVMV",1,7,0.786749482401656,115,121,133,136,141,147,164,167,"ATTAAGG","CTGA","ATAAAAA","CTGA",2.37078388153503,12,5,17,43,2.64161687617601,4.61171068826905,7.75870861787567,101,"ENSG00000079974.19"
"18039","ENSG00000156049.7_106979",106971,106979,9,"ENSG00000156049.7",0,NA,"UVVVVVUVV",2,7,0.788819875776397,81,87,102,105,113,119,133,136,"CTCATTA","CAGA","GGGATGG","CTGA",2.34631293362624,15,8,14,46,2.77158901242648,4.60341880915035,7.75869831225594,101,"ENSG00000079974.19"
"40519","ENSG00000256789.1_10265",10257,10265,9,"ENSG00000256789.1",1,2,"VMVVVUVVV",1,7,0.806211180124223,114,120,133,136,180,186,194,197,"ATTATCT","CTGA","GTGTAGG","CTGA",2.4234491526636,13,44,8,74,1.9789830527142,4.53382768428455,7.75867240478145,101,"ENSG00000079974.19"
"32241","ENSG00000226453.4_5166",5158,5166,9,"ENSG00000226453.4",1,2,"VMVVVUVVV",1,7,0.806211180124223,103,109,133,136,143,149,160,163,"ATGAAGA","CAGA","GTGAAGG","CAGA",2.38962118400158,24,7,11,51,2.20425651625447,4.53376610239958,7.75861082289647,101,"ENSG00000079974.19"
"41379","ENSG00000258932.5_463404",463396,463404,9,"ENSG00000258932.5",1,8,"VVVVVUVMV",1,7,0.806211180124224,37,43,75,78,85,91,133,136,"CTGATTA","ATGA","ATGATGC","CTGA",2.56463569826335,32,7,42,90,1.03715116192448,4.53368062092003,7.75852534141693,101,"ENSG00000079974.19"
"13868","ENSG00000143786.8_112248",112240,112248,9,"ENSG00000143786.8",1,8,"VVVVUVVMV",1,7,0.773913043478261,83,89,133,136,143,149,191,194,"ATGATGA","CATA","GTGACAA","CTGA",2.64560271707878,44,7,42,102,1.01411679892097,4.66286706152821,7.75851923544125,101,"ENSG00000079974.19"
"40613","ENSG00000257165.5_22772",22764,22772,9,"ENSG00000257165.5",1,7,"VVUVVVMVV",1,7,0.768944099378882,116,122,133,136,146,152,165,168,"ATTTTGA","CTTA","CAGATGC","CTGA",2.38889817050932,11,10,13,43,2.80452405124675,4.68262796366056,7.75840436117609,101,"ENSG00000079974.19"
"19083","ENSG00000160963.14_72159",72151,72159,9,"ENSG00000160963.14",1,8,"VVVUVVVMV",1,7,0.764803312629399,116,122,133,136,187,193,205,208,"GTGAGGA","CTGT","CTGAGGC","CTGA",2.52947523035563,11,51,12,83,1.93352024828362,4.69917211266362,7.75838536318122,101,"ENSG00000079974.19"
"7450","ENSG00000114279.15_394929",394921,394929,9,"ENSG00000114279.15",1,6,"VVVVVMUVV",1,7,0.788819875776397,94,100,133,136,139,145,153,156,"ATGATGA","CTCC","GCCATGC","CTGA",2.50714628505226,33,3,8,53,1.69809508125982,4.60310091206872,7.75838041517431,101,"ENSG00000079974.19"
"46771","ENSG00000287157.1_7335",7327,7335,9,"ENSG00000287157.1",1,2,"VMVVVUVVV",1,7,0.806211180124223,112,118,133,136,142,148,157,160,"AGGAGGA","CTGA","GTGGACA","CTTA",2.27960010715171,15,6,9,39,2.93671406819146,4.53351202896739,7.75835674946428,101,"ENSG00000079974.19"
"36108","ENSG00000237886.2_2767",2759,2767,9,"ENSG00000237886.2",1,7,"VVVVVUMVV",1,7,0.807453416149068,108,114,133,136,145,151,162,165,"TTGAGGG","CTGC","CTAAGGA","CTGA",2.33987102470912,19,9,11,48,2.51503176545526,4.52854298254568,7.75835664714195,101,"ENSG00000079974.19"
"14651","ENSG00000145642.12_10878",10870,10878,9,"ENSG00000145642.12",1,1,"MVVVVUVVV",1,7,0.82815734989648,108,114,133,136,144,150,163,166,"ATTCTAA","CTGC","CTAATGA","CTGA",2.29485836473086,19,8,13,49,2.48379494369927,4.44571267714292,7.75834207672884,101,"ENSG00000079974.19"
"38119","ENSG00000249618.6_10547",10539,10547,9,"ENSG00000249618.6",1,7,"UVVVVVMVV",1,7,0.787991718426501,109,115,133,136,161,167,180,183,"AAGATGG","CTAA","CTGGTGA","CTGA",2.50740320545485,18,25,13,65,1.70936634844759,4.60634692953664,7.75831380324265,101,"ENSG00000079974.19"
"15788","ENSG00000149571.12_114970",114962,114970,9,"ENSG00000149571.12",1,8,"VVVUVVVMV",1,7,0.764803312629399,111,117,133,136,143,149,195,198,"ATGATTA","GTGT","GTGATCA","CTGA",2.54288519107824,16,7,46,78,1.84382597198101,4.69909847812566,7.75831172864326,101,"ENSG00000079974.19"
"15754","ENSG00000149403.13_139454",139446,139454,9,"ENSG00000149403.13",1,8,"VVVVUUVMV",2,6,0.696066252587992,83,89,133,136,147,153,171,174,"AAGATGA","CTGA","GAGATGA","CTGA",2.76367831972763,44,11,18,82,1.47152009572941,4.97401055681174,7.75827556716371,101,"ENSG00000079974.19"
"32078","ENSG00000225839.2_31921",31913,31921,9,"ENSG00000225839.2",0,NA,"UVVVVUVVV",2,7,0.824844720496894,113,119,133,136,138,144,153,156,"AGGAAGA","GTGT","TTTATTA","CTGA",2.27716422796623,14,2,9,34,2.65446669549672,4.45889038715123,7.7582692691388,101,"ENSG00000079974.19"
"4981","ENSG00000102554.14_19248",19240,19248,9,"ENSG00000102554.14",1,2,"VMVVVUVVV",1,7,0.806211180124223,90,96,133,136,139,145,167,170,"ATCATGA","CAGT","ATGAGGA","CTGA",2.55310921959994,37,3,22,71,1.11274810704866,4.53336905942874,7.75821377992563,101,"ENSG00000079974.19"
"31562","ENSG00000224082.1_3389",3381,3389,9,"ENSG00000224082.1",1,8,"VVVVUVVMV",1,7,0.773913043478261,101,107,133,136,165,171,182,185,"ATGATGA","TTGT","CTGCTGT","CTGA",2.62042238186246,26,29,11,75,1.18066973029365,4.66253806901085,7.7581902429239,101,"ENSG00000079974.19"
"29631","ENSG00000198498.10_15483",15475,15483,9,"ENSG00000198498.10",1,2,"VMVVUVVVV",1,7,0.773913043478261,116,122,133,136,148,154,164,167,"ATGATGG","CAGA","TTGAGAA","TTGA",2.38375751429043,11,12,10,42,2.75804318249551,4.66243998610793,7.75809216002097,101,"ENSG00000079974.19"
"27606","ENSG00000186684.14_23922",23914,23922,9,"ENSG00000186684.14",1,1,"MVVVVUVVV",1,7,0.82815734989648,109,115,133,136,145,151,161,164,"ATTATTT","TTGA","ATAAAAA","CTGA",2.27412106289175,18,9,10,46,2.62102556697454,4.44545816322989,7.75808756281581,101,"ENSG00000079974.19"
"24545","ENSG00000176783.15_12215",12207,12215,9,"ENSG00000176783.15",1,8,"VVVUVVVMV",1,7,0.764803312629399,102,108,133,136,151,157,178,181,"CTGATGA","CTGC","ATGATCT","CTGA",2.64141603081261,25,15,21,70,1.1858975445591,4.69883443749413,7.75804768801172,101,"ENSG00000079974.19"
"20093","ENSG00000164287.13_53444",53436,53444,9,"ENSG00000164287.13",1,8,"VVVVVVUMV",1,7,0.770186335403727,11,17,30,33,77,83,133,136,"ATGATGT","CTGT","GTGAGTA","CTGA",2.65615279668343,13,44,50,116,1.00139250692297,4.67726945453645,7.75801479615136,101,"ENSG00000079974.19"
"30124","ENSG00000203727.4_221487",221479,221487,9,"ENSG00000203727.4",1,8,"VVVUVVVMV",1,7,0.764803312629399,111,117,133,136,160,166,211,214,"ATGATGA","TTGG","TTGTTGA","CTGA",2.67047227531035,16,24,45,94,0.99200588742893,4.69878859737449,7.75800184789209,101,"ENSG00000079974.19"
"32741","ENSG00000227681.5_69474",69466,69474,9,"ENSG00000227681.5",1,8,"VVVUVVVMV",1,7,0.764803312629399,111,117,133,136,160,166,211,214,"ATGATGA","TTGG","TTGTTGA","CTGA",2.67047227531035,16,24,45,94,0.99200588742893,4.69878859737449,7.75800184789209,101,"ENSG00000079974.19"
"6190","ENSG00000108559.13_27517",27509,27517,9,"ENSG00000108559.13",0,NA,"VVUVVVUVV",2,7,0.769772256728778,86,92,133,136,140,146,160,163,"ATTATGA","ATGA","GGGAAGG","CTGA",2.55082714288369,41,4,14,68,1.71009004677008,4.67890108316534,7.75799011008045,101,"ENSG00000079974.19"
"42155","ENSG00000260923.7_47778",47770,47778,9,"ENSG00000260923.7",0,NA,"UVVUVVVVV",2,7,0.78343685300207,79,85,103,106,111,117,133,136,"ATGAGGC","CTGA","GTGTTGA","GTGA",2.42081274284543,18,5,16,48,2.35817836532336,4.62423249607322,7.7579799080815,101,"ENSG00000079974.19"
"48475","ENSG00000291147.1_77163",77155,77163,9,"ENSG00000291147.1",0,NA,"UVVUVVVVV",2,7,0.78343685300207,79,85,103,106,111,117,133,136,"ATGAGGC","CTGA","GTGTTGA","GTGA",2.42081274284543,18,5,16,48,2.35817836532336,4.62423249607322,7.7579799080815,101,"ENSG00000079974.19"
"23905","ENSG00000174473.16_243685",243677,243685,9,"ENSG00000174473.16",1,8,"UVVVVVVMV",1,7,0.786749482401656,113,119,133,136,144,150,187,190,"ATGATAG","GTCA","ATGATGA","CTGA",2.46852389336544,14,8,37,68,1.98709224361307,4.61097954984566,7.75797747945229,101,"ENSG00000079974.19"
"26570","ENSG00000184454.7_34990",34982,34990,9,"ENSG00000184454.7",1,1,"MVUVVVVVV",1,7,0.789648033126294,114,120,133,136,142,148,171,174,"CTGAGGA","ATGA","AACAAGA","CTGA",2.40881932039995,13,6,23,51,2.33859485386565,4.59934758079967,7.75793971330484,101,"ENSG00000079974.19"
"2974","ENSG00000079841.20_308523",308515,308523,9,"ENSG00000079841.20",1,1,"MVVUVVVVV",1,7,0.786749482401656,82,88,95,98,111,117,133,136,"CTGAAGA","CTGA","GTGAGGA","CTAA",2.45597347382038,7,13,16,45,2.07045181611698,4.61090207706321,7.75790000666983,101,"ENSG00000079974.19"
"25717","ENSG00000182621.18_750928",750920,750928,9,"ENSG00000182621.18",1,7,"VVVVVUMVV",1,7,0.807453416149068,76,82,95,98,109,115,133,136,"TTGATGG","CTGC","GTGATGG","CTGG",2.34674639425651,13,11,18,51,2.46725140640158,4.52805684202791,7.75787050662418,101,"ENSG00000079974.19"
"18420","ENSG00000157388.20_215819",215811,215819,9,"ENSG00000157388.20",1,7,"VVUVVVMVV",1,7,0.768944099378882,84,90,101,104,110,116,133,136,"ATGGCGA","TTGA","GTGGGGC","CTGA",2.40896115616074,11,6,17,43,2.6686106490974,4.68208792254226,7.75786432005778,101,"ENSG00000079974.19"
"4888","ENSG00000102287.19_18457",18449,18457,9,"ENSG00000102287.19",1,6,"VVVVUMVVV",1,7,0.792546583850932,106,112,133,136,186,192,205,208,"GTGATGT","CTTA","TTGATTT","CTGA",2.55312890397744,21,50,13,93,1.32981497526078,4.5876685837776,7.75785491918132,101,"ENSG00000079974.19"
"5601","ENSG00000105967.16_27402",27394,27402,9,"ENSG00000105967.16",1,2,"UMVVVVVVV",1,7,0.786749482401656,112,118,133,136,148,154,190,193,"TTGATGA","TTAA","CTGATCC","CTGA",2.50857120324904,15,12,36,72,1.71944829667772,4.6108140795845,7.75781200919112,101,"ENSG00000079974.19"
"5959","ENSG00000107338.10_94615",94607,94615,9,"ENSG00000107338.10",0,NA,"VVVUUVVVV",2,7,0.770600414078675,48,54,66,69,75,81,133,136,"AGGATGA","CCGA","ACGACCA","CTGA",2.50739019393735,12,6,52,79,1.98547059052093,4.67535130419248,7.75775296050718,101,"ENSG00000079974.19"
"40390","ENSG00000255872.3_94075",94067,94075,9,"ENSG00000255872.3",0,NA,"VVVUUVVVV",2,7,0.770600414078675,48,54,66,69,75,81,133,136,"AGGATGA","CCGA","ACGACCA","CTGA",2.50739019393735,12,6,52,79,1.98547059052093,4.67535130419248,7.75775296050718,101,"ENSG00000079974.19"
"24494","ENSG00000176571.13_535623",535615,535623,9,"ENSG00000176571.13",1,6,"UVVVVMVVV",1,7,0.805383022774327,80,86,99,102,109,115,133,136,"ATGAAGA","CTGG","ATAAAGA","CTTA",2.32655916541899,13,7,18,47,2.63444819381204,4.53621065748465,7.75774274858196,101,"ENSG00000079974.19"
"15056","ENSG00000146938.16_106983",106975,106983,9,"ENSG00000146938.16",1,8,"VVVVVVUMV",1,7,0.770186335403727,115,121,133,136,149,155,193,196,"ACGAAGA","TTGA","GTGAGGA","CTGA",2.54750298177252,12,13,38,72,1.72453783705162,4.67697276221711,7.75771810383202,101,"ENSG00000079974.19"
"9585","ENSG00000125676.20_61115",61107,61115,9,"ENSG00000125676.20",1,1,"MVVVVVUVV",1,7,0.792132505175983,110,116,133,136,141,147,156,159,"AAGATGT","ATGT","ATAATAA","CTGA",2.34577687208538,17,5,9,40,2.7181999961723,4.58917811918538,7.75770813988931,101,"ENSG00000079974.19"
"28107","ENSG00000188124.4_5803",5795,5803,9,"ENSG00000188124.4",1,7,"UVVVVVMVV",1,7,0.787991718426501,115,121,133,136,183,189,200,203,"CTGCTGA","GTGA","ATAATTA","CTGA",2.4652916125756,12,47,11,79,1.98761098469212,4.60572210046569,7.75768897417169,101,"ENSG00000079974.19"
"11647","ENSG00000135631.17_11395",11387,11395,9,"ENSG00000135631.17",1,8,"VVUVVVVMV",1,7,0.767701863354037,107,113,133,136,149,155,169,172,"AGGATGA","GTGA","GACATTA","CTGA",2.50373169344687,20,13,14,56,2.05587729183541,4.68685547870363,7.75766293211978,101,"ENSG00000079974.19"
"19459","ENSG00000163075.13_91401",91393,91401,9,"ENSG00000163075.13",0,NA,"VVUUVVVVV",2,7,0.764389233954451,73,79,89,92,110,116,133,136,"ATAGTGA","CTGA","TGGAGGA","CTGA",2.52156636832669,10,18,17,54,1.98977058471558,4.70005326005671,7.75761019587451,101,"ENSG00000079974.19"
"23547","ENSG00000173210.20_57702",57694,57702,9,"ENSG00000173210.20",1,8,"VVVVVUVMV",1,7,0.806211180124224,110,116,133,136,157,163,173,176,"GAGATGA","CAGC","ATGTTAA","CTGA",2.42065372935903,17,21,10,57,1.9933342361561,4.53275644130407,7.75760116180096,101,"ENSG00000079974.19"
"18021","ENSG00000156011.18_382543",382535,382543,9,"ENSG00000156011.18",1,1,"MVVVVUVVV",1,7,0.82815734989648,106,112,133,136,147,153,170,173,"AAGATGA","CTGT","TTGATTA","CAGA",2.37548332242164,21,11,17,58,1.94249317316176,4.44476216399317,7.75739156357909,101,"ENSG00000079974.19"
"38785","ENSG00000251026.2_227938",227930,227938,9,"ENSG00000251026.2",1,1,"MVVVVUVVV",1,7,0.82815734989648,93,99,133,136,150,156,170,173,"TTGATCT","TTGA","CTGATAA","CTGA",2.44091419026401,34,14,14,71,1.50628674301039,4.44476200285928,7.7573914024452,101,"ENSG00000079974.19"
"3767","ENSG00000088888.18_22160",22152,22160,9,"ENSG00000088888.18",1,1,"MVVVVUVVV",1,7,0.82815734989648,95,101,110,113,114,120,133,136,"ATGATGG","CTGG","GTAAGGC","TTGA",2.31620104590089,9,1,13,32,2.33765792287138,4.44474955721933,7.75737895680525,101,"ENSG00000079974.19"
"28041","ENSG00000188010.16_36751",36743,36751,9,"ENSG00000188010.16",1,8,"VVVVVUVMV",1,7,0.806211180124224,108,114,133,136,144,150,159,162,"TTGTTGA","AGGA","ATGAAAG","CTGA",2.33429254545709,19,8,9,45,2.56812167267675,4.532517993931,7.7573627144279,101,"ENSG00000079974.19"
"30912","ENSG00000214694.13_22852",22844,22852,9,"ENSG00000214694.13",1,8,"VVVVVUVMV",1,7,0.806211180124224,108,114,133,136,144,150,159,162,"TTGTTGA","AGGA","ATGAAAG","CTGA",2.33429254545709,19,8,9,45,2.56812167267675,4.532517993931,7.7573627144279,101,"ENSG00000079974.19"
"45049","ENSG00000284876.1_33296",33288,33296,9,"ENSG00000284876.1",1,2,"VMVVVUVVV",1,7,0.806211180124223,87,93,102,105,113,119,133,136,"ATTATGA","ATGA","ATGAGTT","CAGA",2.31038916025821,9,8,14,40,2.72737354667585,4.53249198709931,7.75733670759621,101,"ENSG00000079974.19"
"20663","ENSG00000165264.11_11284",11276,11284,9,"ENSG00000165264.11",1,8,"UVVVVUVMV",2,6,0.708902691511387,60,66,77,80,108,114,133,136,"TTGATGA","TTGA","ATGGTGA","CTGA",2.70949169508005,11,28,19,67,1.62343334017717,4.92167782684437,7.75728859288992,101,"ENSG00000079974.19"
"17024","ENSG00000152969.21_161594",161586,161594,9,"ENSG00000152969.21",1,3,"VVMVVVUVV",1,7,0.768944099378882,86,92,105,108,115,121,133,136,"CTGACGC","CTCA","GTCAGGA","CTGA",2.36222849471725,13,7,12,41,2.97784358213778,4.68150838672986,7.75728478424539,101,"ENSG00000079974.19"
"25379","ENSG00000181215.16_161558",161550,161558,9,"ENSG00000181215.16",1,3,"VVMVVVUVV",1,7,0.768944099378882,86,92,105,108,115,121,133,136,"CTGACGC","CTCA","GTCAGGA","CTGA",2.36222849471725,13,7,12,41,2.97784358213778,4.68150838672986,7.75728478424539,101,"ENSG00000079974.19"
"7830","ENSG00000115896.16_119816",119808,119816,9,"ENSG00000115896.16",1,8,"VVVVVUVMV",1,7,0.806211180124224,94,100,109,112,115,121,133,136,"CAGGTGA","CTGG","TTGACAA","CTGA",2.31394035678527,9,3,12,33,2.70344767915189,4.53242918109675,7.75727390159365,101,"ENSG00000079974.19"
"29743","ENSG00000198673.11_155500",155492,155500,9,"ENSG00000198673.11",1,6,"UVVVVMVVV",1,7,0.805383022774327,115,121,133,136,166,172,187,190,"ATGAAGA","TTAA","GTGGGGG","CTGA",2.44115115661454,12,30,15,66,1.86829946269839,4.53566012669884,7.75719221779615,101,"ENSG00000079974.19"
"46901","ENSG00000287347.1_9852",9844,9852,9,"ENSG00000287347.1",1,8,"UVVVVVVMV",1,7,0.786749482401656,51,57,66,69,79,85,133,136,"GTGATGC","CTTA","TAGATAA","CTGA",2.50536401002562,9,10,48,76,1.73829426326732,4.61018024919287,7.75717817879949,101,"ENSG00000079974.19"
"23346","ENSG00000172725.14_7045",7037,7045,9,"ENSG00000172725.14",1,8,"VVUVVVVMV",1,7,0.767701863354037,82,88,102,105,111,117,133,136,"AAAATGA","CTGC","GTGACAT","CTGA",2.40495845246856,14,6,16,45,2.71225618073006,4.68632813263012,7.75713558604627,101,"ENSG00000079974.19"
"30781","ENSG00000213402.3_906",898,906,9,"ENSG00000213402.3",1,8,"VVUVVVVMV",1,7,0.767701863354037,82,88,102,105,111,117,133,136,"AAAATGA","CTGC","GTGACAT","CTGA",2.40495845246856,14,6,16,45,2.71225618073006,4.68632813263012,7.75713558604627,101,"ENSG00000079974.19"
"29145","ENSG00000197321.16_145655",145647,145655,9,"ENSG00000197321.16",0,NA,"UVVVVUVVV",2,7,0.824844720496894,110,116,133,136,156,162,177,180,"TTGAGGG","CTGG","GTGAGAA","CTGA",2.39708464477474,17,20,15,61,1.8500802281782,4.45766113166912,7.7570400136567,101,"ENSG00000079974.19"
"29","ENSG00000002586.20_12626",12618,12626,9,"ENSG00000002586.20",1,8,"UVVVVVVMV",1,7,0.786749482401656,112,118,133,136,181,187,197,200,"GGGATGA","CTGA","GTGATCA","CTGT",2.47921002178456,15,45,10,79,1.91206386146996,4.61003266834176,7.75703059794839,101,"ENSG00000079974.19"
"32","ENSG00000002586.20_PAR_Y_12626",12618,12626,9,"ENSG00000002586.20_PAR_Y",1,8,"UVVVVVVMV",1,7,0.786749482401656,112,118,133,136,181,187,197,200,"GGGATGA","CTGA","GTGATCA","CTGT",2.47921002178456,15,45,10,79,1.91206386146996,4.61003266834176,7.75703059794839,101,"ENSG00000079974.19"
"33548","ENSG00000230262.8_19385",19377,19385,9,"ENSG00000230262.8",1,2,"VMVVVUVVV",1,7,0.806211180124223,80,86,104,107,116,122,133,136,"AAGATGA","CAGA","ATAGTGA","ATGA",2.32848423059111,18,9,11,47,2.60548191312479,4.53217752926639,7.75702224976328,101,"ENSG00000079974.19"
"1629","ENSG00000064225.13_54300",54292,54300,9,"ENSG00000064225.13",1,8,"VVVVUVVMV",1,7,0.773913043478261,115,121,133,136,157,163,174,177,"GTGATGT","CGGC","ATGCAGA","CTGA",2.46313465440872,12,21,11,53,2.22446802164912,4.66134142942682,7.75699360333986,101,"ENSG00000079974.19"
"47915","ENSG00000289699.1_53332",53324,53332,9,"ENSG00000289699.1",1,2,"VMVVVUUVV",2,6,0.692339544513457,112,118,133,136,146,152,162,165,"GTGAAGA","ATGA","GTGAGTA","CTGA",2.57009427080908,15,10,10,44,2.8163612972043,4.98758077564954,7.75693895370337,101,"ENSG00000079974.19"
"24078","ENSG00000175104.15_5688",5680,5688,9,"ENSG00000175104.15",1,8,"VVVVUVVMV",1,7,0.773913043478261,112,118,133,136,146,152,176,179,"AAGTTGA","CTCA","TTGAGGA","CTGA",2.47853578648326,15,10,24,58,2.1214885103556,4.66126510506099,7.75691727897404,101,"ENSG00000079974.19"
"45310","ENSG00000285402.1_78763",78755,78763,9,"ENSG00000285402.1",1,1,"MVVVVUVVV",1,7,0.82815734989648,115,121,133,136,172,178,187,190,"AGTAGGA","CTGA","GAGAAGC","CTGA",2.36424259474718,12,36,9,66,2.01512365519929,4.44418523837846,7.75681463796438,101,"ENSG00000079974.19"
"23323","ENSG00000172572.7_72389",72381,72389,9,"ENSG00000172572.7",1,1,"MVUVVVVVV",1,7,0.789648033126294,116,122,133,136,146,152,163,166,"TTTATGA","GAGA","GTTTTGT","CTGA",2.32647733845421,11,10,11,41,2.88295945323706,4.59820209406629,7.75679422657146,101,"ENSG00000079974.19"
"9070","ENSG00000122507.21_754602",754594,754602,9,"ENSG00000122507.21",1,8,"VVVUVVVMV",1,7,0.764803312629399,102,108,133,136,137,143,151,154,"AGGATGA","TGGA","TTGATGA","CTGA",2.59504515960389,25,1,8,43,1.48999904934176,4.69757502834192,7.75678827885952,101,"ENSG00000079974.19"
"11659","ENSG00000135679.27_36975",36967,36975,9,"ENSG00000135679.27",0,NA,"UVVVVVUVV",2,7,0.788819875776397,92,98,133,136,144,150,158,161,"ATGATGG","TTTA","TTTATGG","CTGA",2.46459165753657,35,8,8,60,1.9753773550264,4.60149710131756,7.75677660442315,101,"ENSG00000079974.19"
"23306","ENSG00000172554.12_350098",350090,350098,9,"ENSG00000172554.12",0,NA,"UVUVVVVVV",2,7,0.786335403726708,105,111,133,136,180,186,196,199,"GTGATGT","TTTA","TTGATGA","CTGA",2.56581843565555,22,44,10,85,1.34025822179765,4.61142861487533,7.75677022978217,101,"ENSG00000079974.19"
"46849","ENSG00000287291.1_230171",230163,230171,9,"ENSG00000287291.1",0,NA,"VVUVVUVVV",2,7,0.805797101449275,116,122,133,136,142,148,160,163,"ATGGTGT","CTGA","ATTAAGG","CTGT",2.27366478441593,11,6,12,38,2.97649584985615,4.53356526982392,7.75675367562103,101,"ENSG00000079974.19"
"7343","ENSG00000113600.12_63079",63071,63079,9,"ENSG00000113600.12",1,1,"MVVUVVVVV",1,7,0.786749482401656,112,118,133,136,145,151,183,186,"AAGATGA","GAGA","CTGGTAA","CTGA",2.47328629675973,15,9,32,65,1.95041415209687,4.60974736595711,7.75674529556373,101,"ENSG00000079974.19"
"14212","ENSG00000144619.15_396055",396047,396055,9,"ENSG00000144619.15",1,2,"UMVVVVVVV",1,7,0.786749482401656,85,91,102,105,114,120,133,136,"ATGCTGG","CTGA","GGGAGGA","CTGT",2.33655876961496,11,9,13,42,2.8619218755468,4.60974508491164,7.75674301451826,101,"ENSG00000079974.19"
"42710","ENSG00000265995.1_48863",48855,48863,9,"ENSG00000265995.1",1,5,"UVVVMVVVV",1,7,0.789233954451346,108,114,133,136,147,153,199,202,"ATTTTGA","CTGA","GTAATGG","CTGA",2.54718196274962,19,11,46,85,1.41789879856965,4.59977797089179,7.75671378869717,101,"ENSG00000079974.19"
"3661","ENSG00000087301.9_69467",69459,69467,9,"ENSG00000087301.9",1,6,"UVVVVMVVV",1,7,0.805383022774327,104,110,133,136,145,151,164,167,"AGGATGA","CTGA","ATGCTTC","CTTA",2.39965115237478,23,9,13,54,2.14279737361078,4.53511793069399,7.7566500217913,101,"ENSG00000079974.19"
"27605","ENSG00000186660.15_7112",7104,7112,9,"ENSG00000186660.15",1,5,"UVVVMVVVV",1,7,0.789233954451346,97,103,133,136,142,148,178,181,"ATGATGT","TAGA","CTGATTA","CTGA",2.58670206857735,30,6,30,75,1.15399459171924,4.59966876222539,7.75660458003077,101,"ENSG00000079974.19"
"40132","ENSG00000255073.8_7003",6995,7003,9,"ENSG00000255073.8",1,5,"UVVVMVVVV",1,7,0.789233954451346,97,103,133,136,142,148,178,181,"ATGATGT","TAGA","CTGATTA","CTGA",2.58670206857735,30,6,30,75,1.15399459171924,4.59966876222539,7.75660458003077,101,"ENSG00000079974.19"
"6917","ENSG00000112249.14_21374",21366,21374,9,"ENSG00000112249.14",1,1,"MVVVVUVVV",1,7,0.82815734989648,92,98,133,136,144,150,168,171,"AAGATGG","CTTA","CTAATCA","CTGA",2.42166152666717,35,8,18,70,1.63132233362566,4.4439331278517,7.75656252743763,101,"ENSG00000079974.19"
"22618","ENSG00000170962.13_101198",101190,101198,9,"ENSG00000170962.13",1,1,"MVVVVUVVV",1,7,0.82815734989648,84,90,107,110,113,119,133,136,"ATGATGA","CTGA","ATGTGTA","GTCA",2.31539575289575,17,3,14,43,2.33961415404067,4.44389646000309,7.75652585958901,101,"ENSG00000079974.19"
"28697","ENSG00000196353.13_566979",566971,566979,9,"ENSG00000196353.13",1,1,"MVVVVVUVV",1,7,0.792132505175983,115,121,133,136,149,155,168,171,"GTGAGGA","TAGA","GAAAAGA","CTGA",2.36036234008739,12,13,13,47,2.61620668258222,4.58798890412454,7.75651892482847,101,"ENSG00000079974.19"
"29924","ENSG00000198879.13_220259",220251,220259,9,"ENSG00000198879.13",1,8,"VVUVVVVMV",1,7,0.767701863354037,113,119,133,136,140,146,176,179,"CTGAAGA","CTGT","GTGTAGA","CTGA",2.52204971203562,14,4,30,57,1.92824628418445,4.68547775777214,7.75628521118829,101,"ENSG00000079974.19"
"47778","ENSG00000289309.1_16996",16988,16996,9,"ENSG00000289309.1",1,3,"VVMVVUVVV",1,7,0.804968944099379,112,118,133,136,145,151,179,182,"GTAATGC","ATGA","TTGAGAA","CTGA",2.41662213468212,15,9,28,61,2.0345561333471,4.53634259114031,7.75621836753783,101,"ENSG00000079974.19"
"13419","ENSG00000141376.23_670538",670530,670538,9,"ENSG00000141376.23",1,3,"UVMVVVVVV",1,7,0.785507246376811,90,96,109,112,116,122,133,136,"AAGAAGA","CTGA","CAGATGA","CAGA",2.33378799441013,13,4,11,37,2.89801098999725,4.61414940484952,7.75617839035677,101,"ENSG00000079974.19"
"27053","ENSG00000185518.12_1632",1624,1632,9,"ENSG00000185518.12",1,8,"VVVUVVVMV",1,7,0.764803312629399,111,117,133,136,142,148,157,160,"ATGATGG","GTGA","GAGAGGA","TTGA",2.39015328349518,16,6,9,40,2.85344667370478,4.6969504742515,7.75616372476909,101,"ENSG00000079974.19"
"36819","ENSG00000243156.9_8635",8627,8635,9,"ENSG00000243156.9",1,2,"VMVVVUVVV",1,7,0.806211180124223,75,81,96,99,107,113,133,136,"CAGATGC","CTGT","GTTATAA","CTGA",2.35674758916469,15,8,20,52,2.41280433582448,4.53111373256393,7.75595845306083,101,"ENSG00000079974.19"
"4110","ENSG00000095319.14_58293",58285,58293,9,"ENSG00000095319.14",0,NA,"VVVVUUVVV",2,7,0.812008281573499,71,77,91,94,101,107,133,136,"GTGAGGA","CTGA","TTGCTTA","CTCA",2.37471655970796,14,7,26,56,2.20024090186636,4.50792115831319,7.75595428460718,101,"ENSG00000079974.19"
"12057","ENSG00000136944.19_71677",71669,71677,9,"ENSG00000136944.19",1,1,"MVVUVUVVV",2,6,0.708902691511387,96,102,133,136,144,150,161,164,"TTGAGGA","CTGA","GTGAAGT","CTGA",2.65149773980049,31,8,11,59,2.00445588193863,4.92027687015215,7.75588763619769,101,"ENSG00000079974.19"
"35771","ENSG00000237031.7_8953",8945,8953,9,"ENSG00000237031.7",1,2,"UMVVVVVVV",1,7,0.786749482401656,101,107,133,136,138,144,153,156,"ATGATGG","CCCA","ATGAGGT","CTGA",2.51609237211223,26,2,9,46,1.66156916606316,4.6088795783695,7.75587750797612,101,"ENSG00000079974.19"
"35051","ENSG00000234810.4_489485",489477,489485,9,"ENSG00000234810.4",1,1,"MVVVVUVVV",1,7,0.82815734989648,59,65,88,91,107,113,133,136,"GTGGTGA","CTGA","GTGATGG","CGGA",2.47423541582085,23,16,20,68,1.27805555847582,4.44323958265371,7.75586898223963,101,"ENSG00000079974.19"
"44707","ENSG00000283403.1_77877",77869,77877,9,"ENSG00000283403.1",1,1,"MVVVVUVVV",1,7,0.82815734989648,86,92,101,104,109,115,133,136,"ATAATGA","CTGT","GTGACTT","CTGG",2.30173777827758,9,5,18,41,2.42795312230377,4.44321791103858,7.7558473106245,101,"ENSG00000079974.19"
"20185","ENSG00000164418.22_1015332",1015324,1015332,9,"ENSG00000164418.22",1,2,"UMVVVVVVV",1,7,0.786749482401656,109,115,133,136,141,147,160,163,"ATTATAA","TTAA","ATGATGG","CTGA",2.386828286638,18,5,13,45,2.52296193527474,4.60878762821536,7.75578555782198,101,"ENSG00000079974.19"
"34807","ENSG00000234173.1_5305",5297,5305,9,"ENSG00000234173.1",1,5,"UVVVMVVVV",1,7,0.789233954451346,112,118,133,136,144,150,160,163,"ATGATTA","CTTA","AAGAAGA","CTTA",2.32228125082474,15,8,10,42,2.91350402497271,4.59884475761775,7.75578057542313,101,"ENSG00000079974.19"
"7765","ENSG00000115602.17_28265",28257,28265,9,"ENSG00000115602.17",0,NA,"UVVVVVUVV",2,7,0.788819875776397,116,122,133,136,149,155,163,166,"GTAATGT","CTCA","GTACAGA","CTGA",2.35929208309391,11,13,8,41,2.67327712232689,4.60047275240491,7.7557522555105,101,"ENSG00000079974.19"
"7766","ENSG00000115604.12_28238",28230,28238,9,"ENSG00000115604.12",0,NA,"UVVVVVUVV",2,7,0.788819875776397,116,122,133,136,149,155,163,166,"GTAATGT","CTCA","GTACAGA","CTGA",2.35929208309391,11,13,8,41,2.67327712232689,4.60047275240491,7.7557522555105,101,"ENSG00000079974.19"
"19560","ENSG00000163293.12_97387",97379,97387,9,"ENSG00000163293.12",1,1,"MVVVVVUVV",1,7,0.792132505175983,116,122,133,136,149,155,164,167,"ATTGTCA","TTGA","TTGAAGA","CTGA",2.34957071861664,11,13,9,42,2.68499463647624,4.58719985681345,7.75572987751739,101,"ENSG00000079974.19"
"3504","ENSG00000085276.19_353119",353111,353119,9,"ENSG00000085276.19",1,8,"VVUVVVVMV",1,7,0.767701863354037,115,121,133,136,145,151,177,180,"CTGATTA","TTGA","CAGAAGA","CTGA",2.48288285264551,12,9,26,56,2.18708596256015,4.68490957838256,7.75571703179871,101,"ENSG00000079974.19"
"41032","ENSG00000258416.1_11739",11731,11739,9,"ENSG00000258416.1",1,2,"UMVVVVVVV",1,7,0.786749482401656,110,116,133,136,143,149,173,176,"AAGATGA","CATA","CTGGTTA","CTGA",2.45488914491452,17,7,24,57,2.06879430624794,4.60868048475285,7.75567841435948,101,"ENSG00000079974.19"
"14916","ENSG00000146147.15_17330",17322,17330,9,"ENSG00000146147.15",1,1,"MVVUVVVVV",1,7,0.786749482401656,115,121,133,136,140,146,157,160,"AGGATTA","CAAA","ATGACTA","CTGA",2.32626860288929,12,4,11,36,2.92626049687161,4.60867946236671,7.75567739197334,101,"ENSG00000079974.19"
"35680","ENSG00000236740.6_17290",17282,17290,9,"ENSG00000236740.6",1,1,"MVVUVVVVV",1,7,0.786749482401656,115,121,133,136,140,146,157,160,"AGGATTA","CAAA","ATGACTA","CTGA",2.32626860288929,12,4,11,36,2.92626049687161,4.60867946236671,7.75567739197334,101,"ENSG00000079974.19"
"27367","ENSG00000186086.19_5299",5291,5299,9,"ENSG00000186086.19",1,8,"VVVVUUVMV",2,6,0.696066252587992,113,119,133,136,186,192,205,208,"ATGATGA","CTAA","AGGCTGA","CTGA",2.70026194060143,14,50,13,86,1.88388050699381,4.9714066944175,7.75567170476947,101,"ENSG00000079974.19"
"28743","ENSG00000196427.14_5317",5309,5317,9,"ENSG00000196427.14",1,8,"VVVVUUVMV",2,6,0.696066252587992,113,119,133,136,186,192,205,208,"ATGATGA","CTAA","AGGCTGA","CTGA",2.70026194060143,14,50,13,86,1.88388050699381,4.9714066944175,7.75567170476947,101,"ENSG00000079974.19"
"36969","ENSG00000243967.5_5001",4993,5001,9,"ENSG00000243967.5",1,8,"VVVVUUVMV",2,6,0.696066252587992,113,119,133,136,186,192,205,208,"ATGATGA","CTAA","AGGCTGA","CTGA",2.70026194060143,14,50,13,86,1.88388050699381,4.9714066944175,7.75567170476947,101,"ENSG00000079974.19"
"48177","ENSG00000290552.1_5282",5274,5282,9,"ENSG00000290552.1",1,8,"VVVVUUVMV",2,6,0.696066252587992,113,119,133,136,186,192,205,208,"ATGATGA","CTAA","AGGCTGA","CTGA",2.70026194060143,14,50,13,86,1.88388050699381,4.9714066944175,7.75567170476947,101,"ENSG00000079974.19"
"8151","ENSG00000117020.19_307809",307801,307809,9,"ENSG00000117020.19",1,8,"VVVVVUVMV",1,7,0.806211180124224,43,49,73,76,82,88,133,136,"GTGAGGA","CTTA","GTGTTCA","CTGA",2.53710723657963,24,6,45,84,1.20920047068865,4.53081217863821,7.7556568991351,101,"ENSG00000079974.19"
"37291","ENSG00000246662.6_359991",359983,359991,9,"ENSG00000246662.6",1,7,"VVVVVUMVV",1,7,0.807453416149068,112,118,133,136,141,147,200,203,"ATAATGG","ATGA","TTTATAA","CTGA",2.43917376402848,15,5,53,82,1.84212534870238,4.52582094388972,7.755634608486,101,"ENSG00000079974.19"
"5019","ENSG00000102755.12_31808",31800,31808,9,"ENSG00000102755.12",1,5,"VVUVMVVVV",1,7,0.770186335403727,116,122,133,136,150,156,168,171,"CTGCTGT","CTGT","CTGATTA","CTGA",2.42095942803249,11,14,12,46,2.55977849698248,4.67487700429977,7.75562234591468,101,"ENSG00000079974.19"
"8579","ENSG00000119682.18_19565",19557,19565,9,"ENSG00000119682.18",1,6,"VVVVUMVVV",1,7,0.792546583850932,96,102,109,112,116,122,133,136,"GGGATAA","CTGT","TTTATGT","CTGA",2.33918395548867,7,4,11,31,2.74698355691928,4.58538581504427,7.75557215044799,101,"ENSG00000079974.19"
"26796","ENSG00000185038.15_40599",40591,40599,9,"ENSG00000185038.15",1,8,"VVUVVVVMV",1,7,0.767701863354037,88,94,104,107,116,122,133,136,"TTGATGT","TTGT","TTATTGA","CTGA",2.37577962689861,10,9,11,39,2.90046542025052,4.68474906656031,7.75555651997646,101,"ENSG00000079974.19"
"2119","ENSG00000070366.14_37670",37662,37670,9,"ENSG00000070366.14",1,2,"VMUVVVVVV",1,7,0.767701863354037,102,108,133,136,146,152,170,173,"AAGATGT","TTGA","ATGGTGA","CTGA",2.55493982493184,25,10,18,62,1.70600887483148,4.68473526026095,7.75554271367709,101,"ENSG00000079974.19"
"39320","ENSG00000253452.6_51967",51959,51967,9,"ENSG00000253452.6",1,1,"MVVVUVVVV",1,7,0.795859213250517,83,89,104,107,112,118,133,136,"CTGATGA","CTTA","ATGACAT","ATGA",2.34322913817171,15,5,15,44,2.666730280727,4.57206446713461,7.75550132013668,101,"ENSG00000079974.19"
"35769","ENSG00000237031.7_30873",30865,30873,9,"ENSG00000237031.7",1,5,"VVVVMUVVV",1,7,0.808695652173913,54,60,72,75,85,91,133,136,"ATGATGA","ATAA","GTAATGA","CCGA",2.42561648005953,12,10,42,73,1.91206541839817,4.5207104880321,7.75549309672775,101,"ENSG00000079974.19"
"46938","ENSG00000287390.1_177318",177310,177318,9,"ENSG00000287390.1",0,NA,"UVVVVVUVV",2,7,0.788819875776397,112,118,133,136,146,152,168,171,"GACATGA","GTGA","GTTATCA","CTGA",2.37506482968826,15,10,16,50,2.56698142449996,4.60018673893876,7.75546624204435,101,"ENSG00000079974.19"
"21867","ENSG00000169224.13_25355",25347,25355,9,"ENSG00000169224.13",1,2,"UMVVVVVVV",1,7,0.786749482401656,91,97,133,136,142,148,161,164,"ATGATGA","AAGA","ATGAAGA","GTGA",2.4786558653795,36,6,13,64,1.90899736710387,4.60834245074181,7.75534038034843,101,"ENSG00000079974.19"
"45074","ENSG00000284977.3_481650",481642,481650,9,"ENSG00000284977.3",0,NA,"VVVVUUVVV",2,7,0.812008281573499,114,120,133,136,185,191,220,223,"ATTATGC","GTGA","TTGAAGA","CTGA",2.53252479936153,13,49,29,100,1.14571929042793,4.50730448820954,7.75533761450354,101,"ENSG00000079974.19"
"15125","ENSG00000147099.21_69410",69402,69410,9,"ENSG00000147099.21",1,1,"MVVVUVVVV",1,7,0.795859213250517,112,118,133,136,144,150,158,161,"ATCATGA","CAGA","TTATTGA","CAGA",2.30671203543876,15,8,8,40,2.90938599097387,4.57186655680806,7.75530340981013,101,"ENSG00000079974.19"
"45405","ENSG00000285547.1_69152",69144,69152,9,"ENSG00000285547.1",1,1,"MVVVUVVVV",1,7,0.795859213250517,112,118,133,136,144,150,158,161,"ATCATGA","CAGA","TTATTGA","CAGA",2.30671203543876,15,8,8,40,2.90938599097387,4.57186655680806,7.75530340981013,101,"ENSG00000079974.19"
"16601","ENSG00000151838.12_47272",47264,47272,9,"ENSG00000151838.12",1,8,"UVVVVVVMV",1,7,0.786749482401656,114,120,133,136,148,154,173,176,"ACGATGA","CTTT","GTAAAGT","CTGA",2.41442431018995,13,12,19,53,2.33691292363537,4.60826874789208,7.75526667749871,101,"ENSG00000079974.19"
"31","ENSG00000002586.20_2826",2818,2826,9,"ENSG00000002586.20",1,2,"VMVVVUUVV",2,6,0.692339544513457,114,120,133,136,148,154,164,167,"GTGTTGA","CTGA","GAGTTGC","CTGA",2.57600278471838,13,12,10,44,2.77014281131419,4.98587367735918,7.75523185541301,101,"ENSG00000079974.19"
"34","ENSG00000002586.20_PAR_Y_2826",2818,2826,9,"ENSG00000002586.20_PAR_Y",1,2,"VMVVVUUVV",2,6,0.692339544513457,114,120,133,136,148,154,164,167,"GTGTTGA","CTGA","GAGTTGC","CTGA",2.57600278471838,13,12,10,44,2.77014281131419,4.98587367735918,7.75523185541301,101,"ENSG00000079974.19"
"41830","ENSG00000259805.1_147679",147671,147679,9,"ENSG00000259805.1",1,1,"MVVVVVUVV",1,7,0.792132505175983,110,116,133,136,160,166,222,225,"ATCATGA","CTAA","AGGATGA","CTGA",2.61666734123848,17,24,56,106,0.902303646996725,4.58668814714665,7.75521816785058,101,"ENSG00000079974.19"
"42018","ENSG00000260351.1_50992",50984,50992,9,"ENSG00000260351.1",1,1,"MVVVVVUVV",1,7,0.792132505175983,110,116,133,136,160,166,222,225,"ATCATGA","CTAA","AGGATGA","CTGA",2.61666734123848,17,24,56,106,0.902303646996725,4.58668814714665,7.75521816785058,101,"ENSG00000079974.19"
"41957","ENSG00000260173.1_4506",4498,4506,9,"ENSG00000260173.1",1,8,"VVVVVUVMV",1,7,0.806211180124224,84,90,107,110,115,121,133,136,"AGGATGA","TTGA","ATGGAGG","ATGA",2.31967659138879,17,5,12,43,2.65690039645844,4.53035275142927,7.75519747192616,101,"ENSG00000079974.19"
"18785","ENSG00000158470.5_74907",74899,74907,9,"ENSG00000158470.5",1,5,"VVVVMVUVV",1,7,0.772670807453416,85,91,107,110,116,122,133,136,"ATGATGT","CTGG","CTGATAT","CTCA",2.37497078858692,16,6,11,42,2.82489093175048,4.66450738058248,7.75519061039615,101,"ENSG00000079974.19"
"38866","ENSG00000251199.6_108193",108185,108193,9,"ENSG00000251199.6",0,NA,"VVVUVUVVV",2,7,0.802898550724638,88,94,109,112,115,121,133,136,"ATGAAGA","TTGA","CTCAGGA","ATGA",2.33415659053049,15,3,12,39,2.61321897172966,4.5435657271499,7.75515993004845,101,"ENSG00000079974.19"
"6152","ENSG00000108187.16_29370",29362,29370,9,"ENSG00000108187.16",1,2,"UMVVVVVVV",1,7,0.786749482401656,73,79,90,93,98,104,133,136,"GTGGTGC","TTGA","TTGATAA","CTGA",2.45660147688019,11,5,29,54,2.05529922055219,4.60816059993837,7.755158529545,101,"ENSG00000079974.19"
"7499","ENSG00000114455.15_71144",71136,71144,9,"ENSG00000114455.15",1,1,"MVVVVVUVV",1,7,0.792132505175983,70,76,85,88,97,103,133,136,"CTGAAGA","CTGA","GTGAAGA","ATGA",2.46493220934161,9,9,30,57,1.9134270066895,4.58657710057506,7.755107121279,101,"ENSG00000079974.19"
"36090","ENSG00000237877.8_376460",376452,376460,9,"ENSG00000237877.8",1,8,"VVVVVUVMV",1,7,0.806211180124224,95,101,133,136,142,148,191,194,"ATGATAA","ATTA","GTGAAGA","CTGA",2.56539049869123,32,6,43,90,1.01842372949155,4.53025676352493,7.75510148402183,101,"ENSG00000079974.19"
"13399","ENSG00000141367.13_11846",11838,11846,9,"ENSG00000141367.13",1,1,"MVUVVVVVV",1,7,0.789648033126294,115,121,133,136,144,150,193,196,"AAGTTGA","CAGA","ATGGAGA","CTGA",2.45819310728967,12,8,43,72,1.99794420593802,4.59647456363395,7.75506669613913,101,"ENSG00000079974.19"
"1534","ENSG00000059758.8_59193",59185,59193,9,"ENSG00000059758.8",1,2,"UMVVVVVVV",1,7,0.786749482401656,107,113,133,136,165,171,184,187,"ATGATAA","AGGA","CTGAAGA","CTGA",2.54416834177211,20,29,13,71,1.47077134398904,4.60797340561743,7.75497133522406,101,"ENSG00000079974.19"
"18513","ENSG00000157542.11_502011",502003,502011,9,"ENSG00000157542.11",1,8,"UVVVVVVMV",1,7,0.786749482401656,114,120,133,136,149,155,190,193,"ATAATGG","CAGA","TAGATGA","CTGA",2.50334762578134,13,13,35,70,1.74281247308949,4.60794916124128,7.75494709084791,101,"ENSG00000079974.19"
"21913","ENSG00000169306.10_1299188",1299180,1299188,9,"ENSG00000169306.10",1,7,"VVUVVVMVV",1,7,0.768944099378882,105,111,133,136,151,157,167,170,"TTAATGA","TTGA","ATGTAGA","CTGA",2.52385135290301,22,15,10,56,1.89083282208511,4.67912712702629,7.75490352454181,101,"ENSG00000079974.19"
"48165","ENSG00000290551.1_516206",516198,516206,9,"ENSG00000290551.1",1,3,"UVMVVVVVV",1,7,0.785507246376811,89,95,110,113,116,122,133,136,"CTGATGA","CTGT","TTGTTGG","CTGT",2.36932058754617,15,3,11,38,2.65595836413498,4.61285723694403,7.75488622245128,101,"ENSG00000079974.19"
"284","ENSG00000007341.19_13985",13977,13985,9,"ENSG00000007341.19",1,1,"MVVVUVVVV",1,7,0.795859213250517,112,118,133,136,170,176,186,189,"TTGATGG","GAGA","GTGAGAA","CTGA",2.45282916664091,15,34,10,68,1.9335456103633,4.571435013659,7.75487186666107,101,"ENSG00000079974.19"
"11160","ENSG00000134121.10_16666",16658,16666,9,"ENSG00000134121.10",1,2,"VMVVVVUVV",1,7,0.770186335403727,116,122,133,136,153,159,179,182,"CTGCTGA","CTGC","AAGATGA","CTGA",2.51655818734812,11,17,20,57,1.919320070133,4.67409366311344,7.75483900472835,101,"ENSG00000079974.19"
"21075","ENSG00000166387.14_75278",75270,75278,9,"ENSG00000166387.14",1,2,"VMVVUVVVV",1,7,0.773913043478261,113,119,133,136,140,146,155,158,"AGGATAA","AGGA","GTGTTGT","CTGA",2.36008397291136,14,4,9,36,2.90285289478319,4.6591865118814,7.75483868579444,101,"ENSG00000079974.19"
"10153","ENSG00000129595.14_17485",17477,17485,9,"ENSG00000129595.14",1,2,"UMVVVVVVV",1,7,0.786749482401656,116,122,133,136,139,145,153,156,"ATGATCA","CTTA","CTGACTA","TTGA",2.31957276223609,11,3,8,31,2.96752828093801,4.60783667396132,7.75483460356795,101,"ENSG00000079974.19"
"32981","ENSG00000228412.9_432107",432099,432107,9,"ENSG00000228412.9",1,7,"VVVUVVMVV",1,7,0.766045548654244,110,116,133,136,139,145,165,168,"GGGATGT","GTGA","GTGATAA","CTGA",2.51835384912407,17,3,20,49,1.97347505032258,4.69062517778743,7.75480737240441,101,"ENSG00000079974.19"
"24134","ENSG00000175216.15_27877",27869,27877,9,"ENSG00000175216.15",1,8,"VVVUVVVMV",1,7,0.764803312629399,85,91,133,136,156,162,175,178,"ATGAAGA","CAGA","TTGATCA","CTGA",2.63766051797841,42,20,13,84,1.1978679704492,4.69556785590965,7.75478110642725,101,"ENSG00000079974.19"
"15817","ENSG00000149742.10_12620",12612,12620,9,"ENSG00000149742.10",1,1,"MVVUVVVVV",1,7,0.786749482401656,109,115,133,136,146,152,171,174,"AAGATGA","TTGC","ATGTAGT","CTGA",2.44365994794534,18,10,19,56,2.1398482473028,4.60772864173459,7.75472657134122,101,"ENSG00000079974.19"
"11247","ENSG00000134343.14_395831",395823,395831,9,"ENSG00000134343.14",1,5,"UVVVMVVVV",1,7,0.789233954451346,104,110,133,136,144,150,163,166,"ATCATGT","ATAA","CTGAAGA","CTGA",2.4318269623308,23,8,13,53,2.17893053849912,4.59777757184277,7.75471338964816,101,"ENSG00000079974.19"
"31287","ENSG00000221986.7_11773",11765,11773,9,"ENSG00000221986.7",1,6,"VVVUVMVVV",1,7,0.78343685300207,76,82,88,91,97,103,133,136,"AAGATCA","CTGA","AAGATGG","CTGA",2.53282951706117,6,6,30,51,1.59831944998843,4.62096239093239,7.75470980294067,101,"ENSG00000079974.19"
"26984","ENSG00000185352.9_543500",543492,543500,9,"ENSG00000185352.9",1,5,"UVVVMVVVV",1,7,0.789233954451346,81,87,96,99,110,116,133,136,"GTGAAGA","CTGA","TTGTAGA","TTGA",2.40268495335869,9,11,17,46,2.37308882546753,4.59774712863137,7.75468294643675,101,"ENSG00000079974.19"
"14472","ENSG00000145087.13_205032",205024,205032,9,"ENSG00000145087.13",1,8,"UVVVVVVMV",1,7,0.786749482401656,115,121,133,136,145,151,172,175,"AGGATGA","GTTA","AGGAATA","CTGA",2.402880333639,12,9,21,51,2.41151398869837,4.6076790532396,7.75467698284622,101,"ENSG00000079974.19"
"33647","ENSG00000230563.4_25810",25802,25810,9,"ENSG00000230563.4",1,1,"MVVVVUVVV",1,7,0.82815734989648,107,113,133,136,144,150,167,170,"GGGATGG","CTCA","GGGATTG","CTGA",2.33899916314503,20,8,17,54,2.17469626997483,4.44200600606875,7.75463540565468,101,"ENSG00000079974.19"
"42807","ENSG00000266908.2_153380",153372,153380,9,"ENSG00000266908.2",1,1,"MVVVVUVVV",1,7,0.82815734989648,107,113,133,136,144,150,167,170,"GGGATGG","CTCA","GGGATTG","CTGA",2.33899916314503,20,8,17,54,2.17469626997483,4.44200600606875,7.75463540565468,101,"ENSG00000079974.19"
"8888","ENSG00000121297.8_15978",15970,15978,9,"ENSG00000121297.8",1,1,"MVVVVVUVV",1,7,0.792132505175983,109,115,133,136,153,159,213,216,"AAGATGA","CCGA","GAGATGG","CTGA",2.58733193657978,18,17,54,98,1.09545804562279,4.58608440570533,7.75461442640926,101,"ENSG00000079974.19"
"46508","ENSG00000286749.1_286357",286349,286357,9,"ENSG00000286749.1",1,1,"MVVVVUVVV",1,7,0.82815734989648,114,120,133,136,187,193,204,207,"TTGAAGA","CAGT","GAGATAA","CTGA",2.36787120724037,13,51,11,84,1.98205796575043,4.4419665035049,7.75459590309082,101,"ENSG00000079974.19"
"35216","ENSG00000235385.3_5903",5895,5903,9,"ENSG00000235385.3",1,3,"UVMVVVVVV",1,7,0.785507246376811,114,120,133,136,152,158,167,170,"ATGCTGA","ATGA","TTGATGT","CTAA",2.39468709174651,13,16,9,47,2.48565864088016,4.61255981313088,7.75458879863813,101,"ENSG00000079974.19"
"25939","ENSG00000183111.12_65817",65809,65817,9,"ENSG00000183111.12",0,NA,"VVVVUUVVV",2,7,0.812008281573499,116,122,133,136,146,152,183,186,"CAGATCA","CTGA","GGGAAGC","CTGA",2.40686899187473,11,10,31,61,1.98015343727765,4.50648667911062,7.75451980540462,101,"ENSG00000079974.19"
"16140","ENSG00000150907.10_38165",38157,38165,9,"ENSG00000150907.10",0,NA,"UVVVVVUVV",2,7,0.788819875776397,90,96,133,136,142,148,202,205,"ATGGTGA","CAGA","ATGAGGG","CTGA",2.61117767928227,37,6,54,106,0.9890826139685,4.59923345229591,7.7545129554015,101,"ENSG00000079974.19"
"39296","ENSG00000253438.5_398348",398340,398348,9,"ENSG00000253438.5",1,1,"MVVVVVUVV",1,7,0.792132505175983,116,122,133,136,145,151,159,162,"AAGATGA","ATGA","TTAATTA","CTAA",2.3039158225062,11,9,8,37,2.98438640412829,4.58595630520907,7.75448632591301,101,"ENSG00000079974.19"
"10819","ENSG00000132932.19_384764",384756,384764,9,"ENSG00000132932.19",0,NA,"VVVVVUUVV",2,7,0.808281573498965,103,109,133,136,146,152,205,208,"AGGATTA","CTTA","CTGATGA","CTGA",2.54517082018794,24,10,53,96,1.11746861008859,4.52131851950204,7.7544448134979,101,"ENSG00000079974.19"
"12250","ENSG00000137760.15_20324",20316,20324,9,"ENSG00000137760.15",1,2,"UMVVVVVVV",1,7,0.786749482401656,101,107,133,136,143,149,159,162,"ATGTTGA","TTTA","ATCTTGA","CTGA",2.44435834200509,26,7,10,52,2.13384596267896,4.60739206067823,7.75438999028485,101,"ENSG00000079974.19"
"32556","ENSG00000227193.2_1669",1661,1669,9,"ENSG00000227193.2",1,2,"VMVVVUVVV",1,7,0.806211180124223,45,51,64,67,75,81,133,136,"ATTATGA","CTGA","GTAAAGT","GTGA",2.42015769029817,13,8,52,82,1.98377686084244,4.52954036570756,7.75438508620446,101,"ENSG00000079974.19"
"33540","ENSG00000230186.3_1663",1655,1663,9,"ENSG00000230186.3",1,2,"VMVVVUVVV",1,7,0.806211180124223,45,51,64,67,75,81,133,136,"ATTATGA","CTGA","GTAAAGT","GTGA",2.42015769029817,13,8,52,82,1.98377686084244,4.52954036570756,7.75438508620446,101,"ENSG00000079974.19"
"27329","ENSG00000185973.12_72401",72393,72401,9,"ENSG00000185973.12",1,2,"VMVVVUVVV",1,7,0.806211180124223,79,85,96,99,103,109,133,136,"AGGAAGA","CTGT","CAGATTA","CTGA",2.39846978728023,11,4,24,48,2.12822338841365,4.52950549257047,7.75435021306736,101,"ENSG00000079974.19"
"27191","ENSG00000185737.13_141496",141488,141496,9,"ENSG00000185737.13",0,NA,"UVVVVVUVV",2,7,0.788819875776397,66,72,98,101,111,117,133,136,"ATGATGC","CTGA","GTTATGT","ATGA",2.49088188652409,26,10,16,61,1.79030757011141,4.59904670340133,7.75432620650692,101,"ENSG00000079974.19"
"33084","ENSG00000228649.11_13821",13813,13821,9,"ENSG00000228649.11",1,8,"VVUVVVVMV",1,7,0.767701863354037,111,117,133,136,140,146,162,165,"TTGAGGA","CAAA","ATGATGT","CTGA",2.44407524377506,16,4,16,45,2.44020888786436,4.68351096159118,7.75431841500733,101,"ENSG00000079974.19"
"16685","ENSG00000152061.24_831235",831227,831235,9,"ENSG00000152061.24",1,1,"MVUVVVVVV",1,7,0.789648033126294,80,86,103,106,111,117,133,136,"ATGAAGT","CTGT","ATTATAC","CTGA",2.39026464318059,17,5,16,47,2.44775496710294,4.59571314707672,7.7543052795819,101,"ENSG00000079974.19"
"16081","ENSG00000150672.19_2168174",2168166,2168174,9,"ENSG00000150672.19",0,NA,"UVVVVUVVV",2,7,0.824844720496894,91,97,133,136,141,147,156,159,"GTGATAA","CAAA","GTGAATC","CTGA",2.38252176192341,36,5,9,59,1.93614120134436,4.45490490354177,7.75428378552935,101,"ENSG00000079974.19"
"970","ENSG00000042781.14_121246",121238,121246,9,"ENSG00000042781.14",1,6,"VVVVVMUVV",1,7,0.788819875776397,108,114,133,136,147,153,191,194,"ATGATCA","CAGA","GTCTAGA","CTGA",2.54305459854451,19,11,38,77,1.44218143708643,4.59896969017912,7.75424919328471,101,"ENSG00000079974.19"
"31683","ENSG00000224406.6_4442",4434,4442,9,"ENSG00000224406.6",0,NA,"VVVVUUVVV",2,7,0.812008281573499,104,110,133,136,142,148,159,162,"GTGAGGC","CTGC","GTGCATA","CTGA",2.36713885358245,23,6,11,49,2.24378980174033,4.5061788730725,7.7542119993665,101,"ENSG00000079974.19"
"14360","ENSG00000144736.14_81186",81178,81186,9,"ENSG00000144736.14",0,NA,"UVVVVVUVV",2,7,0.788819875776397,89,95,133,136,142,148,161,164,"ATTATGT","ATGT","TTGATGA","CTGA",2.47344953416171,38,6,13,66,1.90589165275231,4.5988888034576,7.75416830656319,101,"ENSG00000079974.19"
"29355","ENSG00000197826.12_360921",360913,360921,9,"ENSG00000197826.12",1,1,"MVUVVVVVV",1,7,0.789648033126294,114,120,133,136,179,185,198,201,"GTGATAA","ATAA","ATGATTA","CTGA",2.46953033260297,13,43,13,78,1.91873242896472,4.5955669949128,7.75415912741798,101,"ENSG00000079974.19"
"36938","ENSG00000243729.5_65088",65080,65088,9,"ENSG00000243729.5",1,2,"VMVVUVVVV",1,7,0.773913043478261,116,122,133,136,182,188,197,200,"TTAATGT","CTGA","TTGAGAA","CTGA",2.49877095691316,11,46,9,75,1.97550950440251,4.65849563762256,7.7541478115356,101,"ENSG00000079974.19"
"18097","ENSG00000156113.24_425577",425569,425577,9,"ENSG00000156113.24",1,7,"VVVUVVMVV",1,7,0.766045548654244,86,92,109,112,115,121,133,136,"CTGACGA","TTGA","ATGTCAA","CTGA",2.44826013668679,17,3,12,41,2.43810185030288,4.68995902372037,7.75414121833735,101,"ENSG00000079974.19"
"18801","ENSG00000158528.12_55525",55517,55525,9,"ENSG00000158528.12",1,3,"VVMVVVUVV",1,7,0.768944099378882,88,94,133,136,157,163,171,174,"ATGATGT","GTGA","TTGATCT","CTGA",2.62390492772561,39,21,8,77,1.22061965397528,4.6783297930365,7.75410619055203,101,"ENSG00000079974.19"
"42754","ENSG00000266433.7_4274",4266,4274,9,"ENSG00000266433.7",1,7,"VVUVVVMVV",1,7,0.768944099378882,92,98,133,136,145,151,165,168,"ATGTGGA","CTGA","CTGCTTA","CTGA",2.53240155734422,35,9,14,67,1.83055063527812,4.67830692105989,7.75408331857542,101,"ENSG00000079974.19"
"48101","ENSG00000290422.1_6122",6114,6122,9,"ENSG00000290422.1",1,7,"VVUVVVMVV",1,7,0.768944099378882,92,98,133,136,145,151,165,168,"ATGTGGA","CTGA","CTGCTTA","CTGA",2.53240155734422,35,9,14,67,1.83055063527812,4.67830692105989,7.75408331857542,101,"ENSG00000079974.19"
"4417","ENSG00000100504.17_61138",61130,61138,9,"ENSG00000100504.17",1,8,"VVVVVUVMV",1,7,0.806211180124224,59,65,103,106,115,121,133,136,"GTGATGA","CTGC","GAGAGGA","CTGG",2.43079160301502,38,9,12,68,1.91160872787052,4.52922152032599,7.75406624082289,101,"ENSG00000079974.19"
"15156","ENSG00000147202.19_810897",810889,810897,9,"ENSG00000147202.19",1,2,"UMVVVVVVV",1,7,0.786749482401656,114,120,133,136,142,148,156,159,"ATGATGA","CCCA","ATTAAGT","ATGA",2.30491707177408,13,6,8,36,3.06214521483788,4.60706475666627,7.7540626862729,101,"ENSG00000079974.19"
"19208","ENSG00000162542.14_4372",4364,4372,9,"ENSG00000162542.14",1,1,"MVVVVUVVV",1,7,0.82815734989648,72,78,101,104,113,119,133,136,"GTGATAA","TTGA","GAGATGA","GTGA",2.35061279541846,23,9,14,55,2.09498088444603,4.44143321347561,7.75406261306153,101,"ENSG00000079974.19"
"23090","ENSG00000172260.15_452780",452772,452780,9,"ENSG00000172260.15",1,2,"VMVVVVUVV",1,7,0.770186335403727,80,86,101,104,112,118,133,136,"AGGATGG","CTGT","AAGAGTA","CTGA",2.39658777780075,15,8,15,47,2.71598342368375,4.67330881892218,7.75405416053709,101,"ENSG00000079974.19"
"33150","ENSG00000228853.1_7253",7245,7253,9,"ENSG00000228853.1",1,2,"VMVVVVUVV",1,7,0.770186335403727,80,86,101,104,112,118,133,136,"AGGATGG","CTGT","AAGAGTA","CTGA",2.39658777780075,15,8,15,47,2.71598342368375,4.67330881892218,7.75405416053709,101,"ENSG00000079974.19"
"10668","ENSG00000132274.17_447",439,447,9,"ENSG00000132274.17",1,8,"VVVVVUVMV",1,7,0.806211180124224,85,91,102,105,111,117,133,136,"AAGAGGC","CTGT","GAGATGG","CTGA",2.30733612318212,11,6,16,42,2.73454992187137,4.52919768577138,7.75404240626827,101,"ENSG00000079974.19"
"47761","ENSG00000289202.3_33599",33591,33599,9,"ENSG00000289202.3",1,2,"VMVVVUVVV",1,7,0.806211180124223,86,92,133,136,143,149,161,164,"GTGAAGT","CTAA","GGGAAGA","CTGA",2.42365810493796,41,7,12,69,1.95902703963499,4.52918693480535,7.75403165530224,101,"ENSG00000079974.19"
"36000","ENSG00000237667.7_33611",33603,33611,9,"ENSG00000237667.7",1,8,"VVVVVVUMV",1,7,0.770186335403727,76,82,96,99,106,112,133,136,"TTCAAGA","CTGA","TTGCTGT","CTGA",2.44022481594156,14,7,21,51,2.42466892800458,4.67320859190374,7.75395393351865,101,"ENSG00000079974.19"
"7668","ENSG00000115306.16_18050",18042,18050,9,"ENSG00000115306.16",1,7,"UVVVVVMVV",1,7,0.787991718426501,51,57,102,105,116,122,133,136,"GTGATAA","CTGG","GTGTGTA","CTGA",2.48801416374325,45,11,11,76,1.82110998792517,4.60196776988671,7.75393464359271,101,"ENSG00000079974.19"
"39979","ENSG00000254587.2_216450",216442,216450,9,"ENSG00000254587.2",1,8,"VVVUVVVMV",1,7,0.764803312629399,96,102,133,136,145,151,162,165,"CTGGTGA","CAGA","CAGATGA","CTGA",2.52153472166339,31,9,11,60,1.96840042542332,4.69465797579482,7.75387122631242,101,"ENSG00000079974.19"
"15907","ENSG00000150275.20_1624843",1624835,1624843,9,"ENSG00000150275.20",1,2,"UMVVVVVVV",1,7,0.786749482401656,86,92,133,136,149,155,166,169,"ATGATGT","CAGT","ATCAAGA","CTGA",2.51198187357008,41,13,11,74,1.6809236341042,4.60686736447618,7.7538652940828,101,"ENSG00000079974.19"
"39835","ENSG00000254300.1_97041",97033,97041,9,"ENSG00000254300.1",1,1,"MVVVVUVVV",1,7,0.82815734989648,87,93,133,136,146,152,171,174,"ATGAAGA","TTCA","TGGAAGA","CTGA",2.44349678290416,40,10,19,78,1.47494784584765,4.44123159963552,7.75386099922144,101,"ENSG00000079974.19"
"26925","ENSG00000185305.12_214376",214368,214376,9,"ENSG00000185305.12",0,NA,"UVVUVVVVV",2,7,0.78343685300207,97,103,133,136,140,146,154,157,"ATTATGG","CTAA","GTGCAGA","CTGA",2.49276167834199,30,4,8,51,1.86194899489343,4.62009004596001,7.75383745796829,101,"ENSG00000079974.19"
"25832","ENSG00000182938.7_1517",1509,1517,9,"ENSG00000182938.7",1,5,"UVVVMVVVV",1,7,0.789233954451346,111,117,133,136,148,154,165,168,"AAGATGA","CTGG","TTGATCA","CTGC",2.36939783942165,16,12,11,48,2.59136078271335,4.59683659471442,7.7537724125198,101,"ENSG00000079974.19"
"18032","ENSG00000156026.15_16172",16164,16172,9,"ENSG00000156026.15",0,NA,"VVVVVUUVV",2,7,0.808281573498965,115,121,133,136,183,189,221,224,"GTGAAGA","CAGA","TTGAAGT","CTGA",2.54854178121059,12,47,32,100,1.09228778132966,4.5206415806834,7.75376787467926,101,"ENSG00000079974.19"
"38252","ENSG00000249853.9_170840",170832,170840,9,"ENSG00000249853.9",1,1,"MVVVVVUVV",1,7,0.792132505175983,112,118,133,136,156,162,174,177,"ATAATGG","AAGA","TTGATGT","CTGA",2.42929338145567,15,20,12,56,2.14555820052259,4.58521185255676,7.75374187326069,101,"ENSG00000079974.19"
"34309","ENSG00000232624.8_126289",126281,126289,9,"ENSG00000232624.8",1,1,"MVVVVUVVV",1,7,0.82815734989648,111,117,133,136,141,147,156,159,"ATGGAGA","ATGC","AAGTGGA","CTGA",2.24274897678238,16,5,9,39,2.81278283517189,4.44111067009694,7.75374006968286,101,"ENSG00000079974.19"
"21980","ENSG00000169436.17_8853",8845,8853,9,"ENSG00000169436.17",1,8,"UVVVVVVMV",1,7,0.786749482401656,115,121,133,136,139,145,153,156,"ATGGTGG","TTGT","GTGTGAA","CTGA",2.32337244289739,12,3,8,32,2.93775089458213,4.60672512847451,7.75372305808113,101,"ENSG00000079974.19"
"23597","ENSG00000173406.16_1268879",1268871,1268879,9,"ENSG00000173406.16",1,8,"VVVVUVVMV",1,7,0.773913043478261,106,112,133,136,139,145,155,158,"ATGCTGG","CAGT","ATGATGA","CTGA",2.47633932602959,21,3,10,43,2.12304135006302,4.65799254756508,7.75364472147812,101,"ENSG00000079974.19"
"37567","ENSG00000248491.6_119459",119451,119459,9,"ENSG00000248491.6",1,5,"VVVVMUVVV",1,7,0.808695652173913,112,118,133,136,165,171,180,183,"ATGGTGA","CCCA","GTGCACA","CTGA",2.41590032667935,15,29,9,62,1.96935336779664,4.51883888641475,7.7536214951104,101,"ENSG00000079974.19"
"46733","ENSG00000287101.1_1269",1261,1269,9,"ENSG00000287101.1",1,5,"VVVVMUVVV",1,7,0.808695652173913,112,118,133,136,165,171,180,183,"ATGGTGA","CCCA","GTGCACA","CTGA",2.41590032667935,15,29,9,62,1.96935336779664,4.51883888641475,7.7536214951104,101,"ENSG00000079974.19"
"11109","ENSG00000133961.21_175649",175641,175649,9,"ENSG00000133961.21",1,8,"VVVVVVUMV",1,7,0.770186335403727,96,102,133,136,147,153,171,174,"TTGATGA","CTAA","GTGCCCA","CTGA",2.5782296445439,31,11,18,69,1.50323105449565,4.67285717119708,7.75360251281199,101,"ENSG00000079974.19"
"36379","ENSG00000240405.7_240421",240413,240421,9,"ENSG00000240405.7",1,5,"VVVVMUVVV",1,7,0.808695652173913,114,120,133,136,139,145,169,172,"CTGACCA","TTGA","TTGAAGA","CTGA",2.4095566042906,13,3,24,49,2.01151440851396,4.51880627594615,7.7535888846418,101,"ENSG00000079974.19"
"20737","ENSG00000165487.14_37745",37737,37745,9,"ENSG00000165487.14",1,2,"UMVVVUVVV",2,6,0.708902691511387,111,117,133,136,142,148,157,160,"ATGATGT","CTGA","ATGAGAA","TTGA",2.52275030364193,16,6,9,40,2.85344667370478,4.91794550782942,7.75355627387497,101,"ENSG00000079974.19"
"44890","ENSG00000284237.1_6367",6359,6367,9,"ENSG00000284237.1",1,2,"VMVVVUVVV",1,7,0.806211180124223,114,120,133,136,144,150,193,196,"AGGATGC","ATGA","ATGGTAC","CTGA",2.41819211503651,13,8,43,73,1.99341350440132,4.52867356782784,7.75351828832474,101,"ENSG00000079974.19"
"5964","ENSG00000107362.14_9924",9916,9924,9,"ENSG00000107362.14",1,1,"MVVUVVVVV",1,7,0.786749482401656,60,66,96,99,116,122,133,136,"TTGATGA","CTGA","GTGAGAA","TTGA",2.5452879259502,30,17,11,67,1.45745713145524,4.60651082611414,7.75350875572076,101,"ENSG00000079974.19"
"9824","ENSG00000127603.32_156683",156675,156683,9,"ENSG00000127603.32",0,NA,"UVUVVVVVV",2,7,0.786335403726708,116,122,133,136,142,148,157,160,"AAGAAGA","TTAA","ATTACGA","CTGA",2.30153555742326,11,6,9,35,3.08888184458108,4.6081130568507,7.75345467175753,101,"ENSG00000079974.19"
"13991","ENSG00000144227.5_95442",95434,95442,9,"ENSG00000144227.5",0,NA,"VVVVVUUVV",2,7,0.808281573498965,113,119,133,136,139,145,174,177,"GTGAAGA","CTCT","TTGATGG","CTGA",2.44013082410204,14,3,29,55,1.8137629324934,4.52032543996009,7.75345173395595,101,"ENSG00000079974.19"
"28834","ENSG00000196569.14_371588",371580,371588,9,"ENSG00000196569.14",1,2,"VMVVVUVVV",1,7,0.806211180124223,108,114,133,136,145,151,173,176,"AAGATGA","CTTC","TTTAAGA","CTGA",2.42682513754044,19,9,22,59,1.93498902292928,4.52845581829972,7.75330053879661,101,"ENSG00000079974.19"
"29290","ENSG00000197585.10_93409",93401,93409,9,"ENSG00000197585.10",1,5,"UVVVMVVVV",1,7,0.789233954451346,100,106,133,136,145,151,162,165,"AGGTTGA","CTGT","ATGAAAA","CTGA",2.45194567848548,27,9,11,56,2.03901558767135,4.59633002772698,7.75326584553236,101,"ENSG00000079974.19"
"26397","ENSG00000184156.17_92637",92629,92637,9,"ENSG00000184156.17",0,NA,"UVVVVUVVV",2,7,0.824844720496894,85,91,133,136,149,155,205,208,"TTGATGA","TTTA","TTGTTGA","CTGA",2.56767749743434,42,13,50,114,0.697392763176683,4.45381068651807,7.75318956850565,101,"ENSG00000079974.19"
"11448","ENSG00000134986.14_271332",271324,271332,9,"ENSG00000134986.14",0,NA,"VVUVVUVVV",2,7,0.805797101449275,84,90,105,108,113,119,133,136,"TTGAGGG","GTGA","AAGAAAA","CTGA",2.30929701750417,15,5,14,43,2.7246821084173,4.52999888961127,7.75318729540837,101,"ENSG00000079974.19"
"12612","ENSG00000138688.17_91650",91642,91650,9,"ENSG00000138688.17",1,1,"MVUVVVVVV",1,7,0.789648033126294,115,121,133,136,144,150,163,166,"TAGTTGA","CTGT","GTTTTGA","CTGA",2.31821661155687,12,8,13,42,2.92332954603795,4.59452673910428,7.75311887160946,101,"ENSG00000079974.19"
"4127","ENSG00000095627.10_22292",22284,22292,9,"ENSG00000095627.10",0,NA,"UVUVVVVVV",2,7,0.786335403726708,93,99,108,111,115,121,133,136,"TTTATGA","TTCA","AGGATTA","CTGA",2.34483537891019,9,4,12,34,2.79879425326128,4.60775752816564,7.75309914307247,101,"ENSG00000079974.19"
"27284","ENSG00000185842.16_33156",33148,33156,9,"ENSG00000185842.16",1,1,"MVVVVUVVV",1,7,0.82815734989648,114,120,133,136,142,148,164,167,"ATGCAGG","CAGA","GTCTTTA","CTGA",2.25221156558565,13,6,16,44,2.74664955069004,4.44034833031526,7.75297772990118,101,"ENSG00000079974.19"
"4283","ENSG00000100077.16_160662",160654,160662,9,"ENSG00000100077.16",1,5,"UVVVMVVVV",1,7,0.789233954451346,77,83,99,102,115,121,133,136,"TTGATGA","TTGA","ATCATGC","TTGA",2.38399097114182,16,13,12,50,2.49087202509275,4.59603629150956,7.75297210931494,101,"ENSG00000079974.19"
"6350","ENSG00000109452.13_699667",699659,699667,9,"ENSG00000109452.13",1,1,"MVVVVUUVV",2,6,0.714285714285714,53,59,72,75,81,87,133,136,"ATGATGA","ATGC","GTGTTTA","CTGA",2.63969055491662,13,6,46,74,1.98534912272963,4.89582153887677,7.75296439601963,101,"ENSG00000079974.19"
"6061","ENSG00000107864.15_3713",3705,3713,9,"ENSG00000107864.15",1,8,"UVVVVVVMV",1,7,0.786749482401656,114,120,133,136,139,145,153,156,"ATTTTGA","TAGA","ATTAAGA","CTGA",2.33081881455763,13,3,8,33,2.88489831338736,4.60592260260955,7.75292053221618,101,"ENSG00000079974.19"
"551","ENSG00000018408.15_15688",15680,15688,9,"ENSG00000018408.15",1,2,"VMVVVUVVV",1,7,0.806211180124223,80,86,103,106,111,117,133,136,"AAGAAGT","CAGA","ATGATCT","CTGA",2.34967432474566,17,5,16,47,2.44775496710294,4.52806261635183,7.75290733684872,101,"ENSG00000079974.19"
"28508","ENSG00000189337.17_983286",983278,983286,9,"ENSG00000189337.17",1,8,"VVVVVUVMV",1,7,0.806211180124224,43,49,63,66,115,121,133,136,"GTGATGA","GTGA","AGGAGGA","CAGA",2.42836069426566,14,49,12,84,1.92303637554461,4.52802691766226,7.75287163815915,101,"ENSG00000079974.19"
"5502","ENSG00000105397.15_22085",22077,22085,9,"ENSG00000105397.15",1,5,"VVVVMUVVV",1,7,0.808695652173913,80,86,101,104,115,121,133,136,"AAGTTGA","CTGA","TTGAGGC","ATGA",2.3050064049204,15,11,12,47,2.70540742960106,4.51802919893426,7.75281180762991,101,"ENSG00000079974.19"
"19485","ENSG00000163116.10_184585",184577,184585,9,"ENSG00000163116.10",1,3,"UVMVVVVVV",1,7,0.785507246376811,89,95,110,113,116,122,133,136,"CTGATGA","CTGC","TTGTTGG","CTGT",2.3680690230906,15,3,11,38,2.65595836413498,4.61077129618475,7.75280028169199,101,"ENSG00000079974.19"
"19786","ENSG00000163689.21_39356",39348,39356,9,"ENSG00000163689.21",1,3,"UVMVVVVVV",1,7,0.785507246376811,89,95,110,113,116,122,133,136,"CTGATGA","CTGC","TTGTTGG","CTGT",2.3680690230906,15,3,11,38,2.65595836413498,4.61077129618475,7.75280028169199,101,"ENSG00000079974.19"
"38797","ENSG00000251031.2_16604",16596,16604,9,"ENSG00000251031.2",1,3,"UVMVVVVVV",1,7,0.785507246376811,89,95,110,113,116,122,133,136,"CTGATGA","CTGC","TTGTTGG","CTGT",2.3680690230906,15,3,11,38,2.65595836413498,4.61077129618475,7.75280028169199,101,"ENSG00000079974.19"
"14814","ENSG00000145934.17_378090",378082,378090,9,"ENSG00000145934.17",1,8,"VVUVVVVMV",1,7,0.767701863354037,115,121,133,136,141,147,158,161,"ATTTTGA","TTGT","AAGATGA","CTGA",2.35974961488236,12,5,11,37,2.99624312688554,4.68197680652531,7.75278425994146,101,"ENSG00000079974.19"
"45065","ENSG00000284966.3_26682",26674,26682,9,"ENSG00000284966.3",1,1,"MVVVVVUVV",1,7,0.792132505175983,65,71,80,83,114,120,133,136,"ATAATGT","CTGG","ATGACTA","CTGA",2.48086640200833,9,31,13,62,1.79781273540792,4.58423052053253,7.75276054123647,101,"ENSG00000079974.19"
"27809","ENSG00000187391.22_592273",592265,592273,9,"ENSG00000187391.22",1,8,"VVVVVUVMV",1,7,0.806211180124224,113,119,133,136,143,149,200,203,"ATGTTCA","CAGA","ATTATGT","CTGA",2.42185855246314,14,7,51,81,1.96582162589043,4.52788632724451,7.7527310477414,101,"ENSG00000079974.19"
"38408","ENSG00000250131.2_220074",220066,220074,9,"ENSG00000250131.2",1,2,"UMVVVVVVV",1,7,0.786749482401656,57,63,94,97,116,122,133,136,"AGGATGC","CTGA","TTAAAGA","CTGA",2.56234771071354,31,19,11,70,1.34059830960615,4.60572909525743,7.75272702486406,101,"ENSG00000079974.19"
"19011","ENSG00000160190.14_16581",16573,16581,9,"ENSG00000160190.14",1,8,"VVVVVUVMV",1,7,0.806211180124224,103,109,133,136,147,153,166,169,"ATGGAGA","CTGG","CTGCGGA","CTGA",2.42089184117368,24,11,13,57,1.97222106920249,4.52787500259009,7.75271972308698,101,"ENSG00000079974.19"
"33030","ENSG00000228566.2_179189",179181,179189,9,"ENSG00000228566.2",0,NA,"VVVVUUVVV",2,7,0.812008281573499,91,97,133,136,140,146,163,166,"GTCATGA","CAGT","CTGATGG","CTGA",2.47159183418348,36,4,17,66,1.5414521466161,4.50468276029315,7.75271588658715,101,"ENSG00000079974.19"
"12293","ENSG00000137817.17_22388",22380,22388,9,"ENSG00000137817.17",1,1,"MVVVVVUVV",1,7,0.792132505175983,91,97,133,136,150,156,165,168,"ATGATGT","GTGG","TTGGAGA","CTGA",2.50634983352001,36,14,9,68,1.62750561378243,4.58412612597896,7.7526561466829,101,"ENSG00000079974.19"
"36576","ENSG00000241956.11_184136",184128,184136,9,"ENSG00000241956.11",1,2,"VMVVVUVVV",1,7,0.806211180124223,54,60,76,79,116,122,133,136,"ATGTAGA","CTGT","TTTATGA","CTGA",2.44108783978934,16,37,11,73,1.83712310719107,4.52776050978,7.7526052302769,101,"ENSG00000079974.19"
"35791","ENSG00000237136.8_30750",30742,30750,9,"ENSG00000237136.8",1,8,"VVVVVUVMV",1,7,0.806211180124224,114,120,133,136,144,150,169,172,"GTCATGG","AAGA","GTGACCA","CTGA",2.33284538750194,13,8,19,49,2.55873418354306,4.52775919172233,7.75260391221922,101,"ENSG00000079974.19"
"46719","ENSG00000287097.1_124225",124217,124225,9,"ENSG00000287097.1",1,2,"UMVVVVVVV",1,7,0.786749482401656,106,112,133,136,157,163,180,183,"AAGATGA","CTAA","TTGACTA","CTGA",2.56149093600473,21,21,17,68,1.34579675249498,4.60560074813164,7.75259867773826,101,"ENSG00000079974.19"
"37092","ENSG00000245275.9_105154",105146,105154,9,"ENSG00000245275.9",1,8,"VVVVUVVMV",1,7,0.773913043478261,75,81,100,103,111,117,133,136,"AAGATGT","CTGG","TTAAGGA","CTGA",2.445810063913,19,8,16,52,2.32228287773656,4.65692082595581,7.75257299986886,101,"ENSG00000079974.19"
"16511","ENSG00000151718.16_109778",109770,109778,9,"ENSG00000151718.16",0,NA,"UVVVUVVVV",2,7,0.792546583850932,113,119,133,136,148,154,171,174,"AAGATTA","TTAA","ATGTTGA","CTGA",2.38528363816102,14,12,17,52,2.42764947298967,4.58238509851578,7.7525714339195,101,"ENSG00000079974.19"
"31029","ENSG00000215274.6_5859",5851,5859,9,"ENSG00000215274.6",1,3,"VVMVVUVVV",1,7,0.804968944099379,83,89,133,136,146,152,163,166,"TTGATGA","CGCA","AAGAGAA","CTGA",2.43696459194437,44,10,11,74,1.88431722706912,4.5326869600079,7.75256273640541,101,"ENSG00000079974.19"
"31810","ENSG00000224897.9_484499",484491,484499,9,"ENSG00000224897.9",1,1,"MVVVVUVVV",1,7,0.82815734989648,114,120,133,136,187,193,202,205,"ATCATCA","ATGG","TTGATGG","CTGA",2.36472428646634,13,51,9,82,1.99489928757087,4.43993196600329,7.75256136558921,101,"ENSG00000079974.19"
"14788","ENSG00000145901.16_56670",56662,56670,9,"ENSG00000145901.16",1,8,"VVVVUUVMV",2,6,0.696066252587992,47,53,69,72,86,92,133,136,"AGGATGA","CTGA","CTGCTGA","CTGA",2.75932779330142,16,14,41,80,1.47749265915393,4.96825282029084,7.75251783064281,101,"ENSG00000079974.19"
"11522","ENSG00000135269.18_18899",18891,18899,9,"ENSG00000135269.18",1,1,"MVVUVVVVV",1,7,0.786749482401656,114,120,133,136,152,158,172,175,"ATGCTGA","GAGA","GTCCTGG","CTGA",2.40991905248652,13,16,14,52,2.3559012426619,4.60550706480968,7.75250499441631,101,"ENSG00000079974.19"
"31830","ENSG00000224944.2_59497",59489,59497,9,"ENSG00000224944.2",1,8,"VVVVVUVMV",1,7,0.806211180124224,63,69,84,87,106,112,133,136,"TTGATGA","TTGA","TTGAAGA","CAGA",2.4627192529951,15,19,21,64,1.69251181484054,4.52766004203531,7.7525047625322,101,"ENSG00000079974.19"
"2645","ENSG00000077092.20_628818",628810,628818,9,"ENSG00000077092.20",1,1,"MVUVVVVVV",1,7,0.789648033126294,84,90,133,136,144,150,166,169,"CTGATGA","AAGA","GTATAGA","CTGA",2.49449673980696,43,8,16,76,1.74564616492709,4.59390610757671,7.75249824008188,101,"ENSG00000079974.19"
"25157","ENSG00000179833.4_98505",98497,98505,9,"ENSG00000179833.4",1,1,"MVVUVVVVV",1,7,0.786749482401656,114,120,133,136,141,147,157,160,"ATAATGT","TAGA","GTAGTCA","CTGA",2.31237929396788,13,5,10,37,3.00590809002966,4.60544251245388,7.7524404420605,101,"ENSG00000079974.19"
"11585","ENSG00000135387.21_8942",8934,8942,9,"ENSG00000135387.21",1,1,"MVVVVUVVV",1,7,0.82815734989648,114,120,133,136,147,153,177,180,"AGGACGA","CACA","TAGATGA","CTGA",2.34213340511207,13,11,24,57,2.1445220835538,4.43968619607524,7.75231559566116,101,"ENSG00000079974.19"
"5628","ENSG00000106018.14_76468",76460,76468,9,"ENSG00000106018.14",1,8,"VVVUVVVMV",1,7,0.764803312629399,107,113,133,136,146,152,167,170,"CTGATGG","CTGG","CAGATGG","CTGA",2.48491354194997,20,10,15,54,2.20575139360382,4.69296041831757,7.75217366883517,101,"ENSG00000079974.19"
"5215","ENSG00000103995.14_55223",55215,55223,9,"ENSG00000103995.14",1,2,"VMVVVUVVV",1,7,0.806211180124223,100,106,133,136,143,149,161,164,"TTCAAGA","CTGA","ATGGAAA","CTGA",2.40728562675237,27,7,12,55,2.0607414158775,4.52732806522333,7.75217278572022,101,"ENSG00000079974.19"
"43416","ENSG00000271860.9_470503",470495,470503,9,"ENSG00000271860.9",0,NA,"UVVVVUVVV",2,7,0.824844720496894,92,98,133,136,145,151,167,170,"GTGATGG","CTAA","TTGATGA","TTGA",2.41398718177793,35,9,16,69,1.71772859861249,4.452744119283,7.75212300127058,101,"ENSG00000079974.19"
"31473","ENSG00000223797.8_58852",58844,58852,9,"ENSG00000223797.8",1,8,"VVVVVVUMV",1,7,0.770186335403727,91,97,107,110,116,122,133,136,"ATGGTTG","CTAA","GTAATGA","CTGA",2.35409557751993,10,6,11,36,2.99145553752933,4.67135651358221,7.75210185519712,101,"ENSG00000079974.19"
"38173","ENSG00000249738.10_485720",485712,485720,9,"ENSG00000249738.10",1,6,"UVVVVMVVV",1,7,0.805383022774327,116,122,133,136,163,169,218,221,"GTGCTGA","CTTA","TTGTTGA","CTGA",2.55848287077063,11,27,49,96,1.06553349547335,4.53052149181939,7.75205358291669,101,"ENSG00000079974.19"
"17545","ENSG00000154380.19_162421",162413,162421,9,"ENSG00000154380.19",1,8,"VVVVVUVMV",1,7,0.806211180124224,116,122,133,136,177,183,195,198,"ATATTGA","CTGT","GGGATGG","CTGA",2.42547416462865,11,41,12,73,1.93887612964134,4.52717597345808,7.75202069395498,101,"ENSG00000079974.19"
"33181","ENSG00000228971.4_122264",122256,122264,9,"ENSG00000228971.4",1,8,"UVVVVVVMV",1,7,0.786749482401656,108,114,133,136,142,148,169,172,"AAGATGA","AGGA","GTGAAAG","CTGA",2.45986474786415,19,6,21,55,2.02098056751477,4.60501972165228,7.75201765125891,101,"ENSG00000079974.19"
"32702","ENSG00000227579.6_82161",82153,82161,9,"ENSG00000227579.6",1,8,"VVUVVVVMV",1,7,0.767701863354037,116,122,133,136,142,148,158,161,"ATCATGG","ATGT","AGGAAGA","CTGA",2.34954357324314,11,6,10,36,3.06115136982541,4.68119379786158,7.75200125127773,101,"ENSG00000079974.19"
"5998","ENSG00000107643.17_6503",6495,6503,9,"ENSG00000107643.17",1,2,"UMVVVVVVV",1,7,0.786749482401656,99,105,133,136,149,155,170,173,"ATGATTA","CAGA","GCGGTGG","CTGA",2.52461805817563,28,13,15,65,1.58921385924123,4.60500022843636,7.75199815804298,101,"ENSG00000079974.19"
"20591","ENSG00000165124.19_137843",137835,137843,9,"ENSG00000165124.19",1,7,"VVVVVUMVV",1,7,0.807453416149068,85,91,133,136,144,150,165,168,"GTGATCA","CTAG","TTGATGT","CTGA",2.4426379556102,42,8,15,74,1.80441802527192,4.52216776566831,7.75198143026458,101,"ENSG00000079974.19"
"33413","ENSG00000229656.9_81178",81170,81178,9,"ENSG00000229656.9",1,8,"VVVVVUVMV",1,7,0.806211180124224,106,112,133,136,185,191,208,211,"ATTATGA","ATGA","TTAATCA","CTGA",2.5499825482891,21,49,17,96,1.10854740901924,4.52710776606997,7.75195248656686,101,"ENSG00000079974.19"
"2356","ENSG00000073737.17_12864",12856,12864,9,"ENSG00000073737.17",1,2,"VMVVVUVVV",1,7,0.806211180124223,96,102,133,136,164,170,182,185,"AAGATGG","CTGA","CTAATGG","CTGA",2.55671896755612,31,28,12,80,1.06353401131213,4.52708178208824,7.75192650258513,101,"ENSG00000079974.19"
"10715","ENSG00000132549.20_304939",304931,304939,9,"ENSG00000132549.20",1,5,"VVVVMUVVV",1,7,0.808695652173913,116,122,133,136,145,151,174,177,"ATTTTGA","TTCA","TTGATGT","CTGA",2.36763108834581,11,9,23,52,2.2843601990788,4.51714186367938,7.75192447237503,101,"ENSG00000079974.19"
"29019","ENSG00000196951.13_37102",37094,37102,9,"ENSG00000196951.13",0,NA,"UVVVVVUVV",2,7,0.788819875776397,100,106,133,136,149,155,169,172,"GTGATGA","GTGG","GGGAATA","CTGA",2.50774696106393,27,13,14,63,1.66814654553606,4.5966149048239,7.75189440792949,101,"ENSG00000079974.19"
"21879","ENSG00000169258.7_11742",11734,11742,9,"ENSG00000169258.7",1,1,"MVVVVUVVV",1,7,0.82815734989648,114,120,133,136,138,144,153,156,"CTGCTGG","ATCA","CTGAAAA","CTGA",2.25439046660779,13,2,9,33,2.72772849389642,4.43924956782042,7.75187896740634,101,"ENSG00000079974.19"
"31346","ENSG00000223511.7_17900",17892,17900,9,"ENSG00000223511.7",0,NA,"VVVVUUVVV",2,7,0.812008281573499,62,68,89,92,108,114,133,136,"ATGCTGA","CTGT","GGAATAA","CTGA",2.48118581753067,21,16,19,65,1.47371232772393,4.50373777781543,7.75177090410942,101,"ENSG00000079974.19"
"31348","ENSG00000223511.7_PAR_Y_17900",17892,17900,9,"ENSG00000223511.7_PAR_Y",0,NA,"VVVVUUVVV",2,7,0.812008281573499,62,68,89,92,108,114,133,136,"ATGCTGA","CTGT","GGAATAA","CTGA",2.48118581753067,21,16,19,65,1.47371232772393,4.50373777781543,7.75177090410942,101,"ENSG00000079974.19"
"46530","ENSG00000286784.1_46915",46907,46915,9,"ENSG00000286784.1",1,2,"UMVVVVVVV",1,7,0.786749482401656,86,92,105,108,111,117,133,136,"GTGATGA","TTTA","ATGATGT","CAGA",2.39098077680127,13,3,16,41,2.4791944645903,4.60476657748302,7.75176450708964,101,"ENSG00000079974.19"
"35954","ENSG00000237505.8_589338",589330,589338,9,"ENSG00000237505.8",1,1,"MVVVUVVVV",1,7,0.795859213250517,90,96,133,136,145,151,162,165,"GTGTTGA","CTAA","GAGATCT","CTGA",2.449828914509,37,9,11,66,1.94061037428869,4.5682007844205,7.75163763742257,101,"ENSG00000079974.19"
"37195","ENSG00000245832.7_65197",65189,65197,9,"ENSG00000245832.7",0,NA,"UVVVVVUVV",2,7,0.788819875776397,110,116,133,136,157,163,184,187,"ATCATGG","CTTA","ATGAGGA","CTGA",2.53976022919822,17,21,21,68,1.45367551562775,4.5963525942373,7.75163209734289,101,"ENSG00000079974.19"
"40104","ENSG00000254987.1_83113",83105,83113,9,"ENSG00000254987.1",0,NA,"VVUUVVVVV",2,7,0.764389233954451,115,121,133,136,137,143,152,155,"ATGATGC","ATCA","ATAGAGA","CTGA",2.42101580754506,12,1,9,31,2.63618269851883,4.69407202053813,7.75162895635594,101,"ENSG00000079974.19"
"1913","ENSG00000067715.15_237526",237518,237526,9,"ENSG00000067715.15",0,NA,"UVVVVVUVV",2,7,0.788819875776397,19,25,66,69,75,81,133,136,"ATGAAGT","CTGA","GGGAAGA","CTGA",2.60981219840165,41,6,52,108,0.986404671665612,4.59628816525248,7.75156766835807,101,"ENSG00000079974.19"
"6680","ENSG00000111404.7_109494",109486,109494,9,"ENSG00000111404.7",1,2,"VMVVVUVVV",1,7,0.806211180124223,114,120,133,136,147,153,205,208,"AGGATGA","CCAA","TTGCTTA","CTGA",2.44118253994418,13,11,52,85,1.83224861302956,4.52669971983102,7.75154444032792,101,"ENSG00000079974.19"
"11270","ENSG00000134376.17_71845",71837,71845,9,"ENSG00000134376.17",1,7,"VVUVVVMVV",1,7,0.768944099378882,87,93,105,108,114,120,133,136,"AATATGT","CAGA","GTGTTAA","CTGA",2.36502156816056,12,6,13,40,2.93620699704671,4.67575436286262,7.75153076037814,101,"ENSG00000079974.19"
"27159","ENSG00000185666.15_111224",111216,111224,9,"ENSG00000185666.15",1,7,"VVVUVVMVV",1,7,0.766045548654244,114,120,133,136,141,147,199,202,"ATGAAGA","GAGA","GTGAGGG","CTGA",2.52311171542116,13,5,52,79,1.92858912092354,4.68733347259949,7.75151566721646,101,"ENSG00000079974.19"
"24406","ENSG00000176204.14_140420",140412,140420,9,"ENSG00000176204.14",0,NA,"VVVUVUVVV",2,7,0.802898550724638,76,82,93,96,103,109,133,136,"ATTATCA","TTGA","AAGAAGC","CTGA",2.38053968378858,11,7,24,51,2.28908886880327,4.53983835684846,7.75143255974701,101,"ENSG00000079974.19"
"539","ENSG00000018236.15_229965",229957,229965,9,"ENSG00000018236.15",1,7,"VVVVUVMVV",1,7,0.775155279503105,76,82,95,98,106,112,133,136,"AAGATGC","CTGT","CTAATAA","CTGA",2.42400879002681,13,8,21,51,2.44303396251353,4.65077314067306,7.75139425868548,101,"ENSG00000079974.19"
"25682","ENSG00000182512.5_4516",4508,4516,9,"ENSG00000182512.5",1,2,"VMVVVUVVV",1,7,0.806211180124223,68,74,90,93,106,112,133,136,"ATCATCA","CTTA","ATGCTCA","CTGA",2.41705321113569,16,13,21,59,1.99232659131806,4.526503666389,7.7513483868859,101,"ENSG00000079974.19"
"18305","ENSG00000156970.13_45371",45363,45371,9,"ENSG00000156970.13",1,2,"VMVUVVVVV",1,7,0.764803312629399,60,66,85,88,109,115,133,136,"ATAATGT","CTGA","AAGAAGA","CTGA",2.59757690161933,19,21,18,67,1.45127143850322,4.69211269565803,7.75132594617562,101,"ENSG00000079974.19"
"42103","ENSG00000260706.5_57183",57175,57183,9,"ENSG00000260706.5",0,NA,"UVVVVUVVV",2,7,0.824844720496894,109,115,133,136,137,143,152,155,"ATCTTGA","CTGC","ACGAGGT","CTGA",2.36072780244663,18,1,9,37,2.06953411318097,4.45192986570629,7.75130874769387,101,"ENSG00000079974.19"
"12170","ENSG00000137509.12_58534",58526,58534,9,"ENSG00000137509.12",1,8,"VVVVVUVMV",1,7,0.806211180124224,86,92,133,136,148,154,167,170,"ATGCTGA","TGGA","CTGTTTA","CTGA",2.46297100932446,41,12,13,75,1.68597547661635,4.52644555136153,7.75129027185842,101,"ENSG00000079974.19"
"40010","ENSG00000254689.3_25889",25881,25889,9,"ENSG00000254689.3",1,8,"UVVVVVVMV",1,7,0.786749482401656,108,114,133,136,185,191,209,212,"CTGATGA","CTCA","ACCATGA","CTGA",2.58044771738028,19,49,18,95,1.2140220356765,4.60425170455292,7.75124963415955,101,"ENSG00000079974.19"
"12334","ENSG00000137872.17_298179",298171,298179,9,"ENSG00000137872.17",1,1,"MVVUVVVVV",1,7,0.786749482401656,114,120,133,136,185,191,201,204,"TTAAAGA","ATGA","CTGATGA","CTGA",2.46302685582882,13,49,10,81,1.99666168092245,4.60421017994531,7.75120810955193,101,"ENSG00000079974.19"
"8816","ENSG00000120784.17_60113",60105,60113,9,"ENSG00000120784.17",1,2,"UMVVVVVVV",1,7,0.786749482401656,112,118,133,136,149,155,167,170,"ATTATTT","CTAA","ATGCTGA","CTGA",2.3780786069502,15,13,12,49,2.56289048897069,4.60418696715968,7.75118489676631,101,"ENSG00000079974.19"
"15423","ENSG00000148219.18_187855",187847,187855,9,"ENSG00000148219.18",0,NA,"VVVUVVUVV",2,7,0.766873706004141,108,114,133,136,185,191,203,206,"GTGATGG","CTGT","GTGATAG","CTGA",2.57981354502881,19,49,12,89,1.53599555676756,4.68368813090657,7.75118295492313,101,"ENSG00000079974.19"
"812","ENSG00000035403.18_34687",34679,34687,9,"ENSG00000035403.18",1,8,"UVVVVVVMV",1,7,0.786749482401656,82,88,133,136,145,151,165,168,"ATTATGA","TAGA","AAGAAGA","CTGA",2.48917702280116,45,9,14,77,1.82218148770881,4.60417374326246,7.75117167286909,101,"ENSG00000079974.19"
"34255","ENSG00000232307.1_33754",33746,33754,9,"ENSG00000232307.1",1,8,"UVVVVVVMV",1,7,0.786749482401656,111,117,133,136,155,161,174,177,"ATAGTGA","GTGA","GTAAAGA","CTGA",2.45051418739106,16,19,13,57,2.07975136178488,4.60412815276465,7.75112608237128,101,"ENSG00000079974.19"
"16321","ENSG00000151322.20_530405",530397,530405,9,"ENSG00000151322.20",1,6,"VVVVVMUVV",1,7,0.788819875776397,113,119,133,136,137,143,157,160,"ATGATGC","CTTT","GTTCAGA","CTGA",2.42434397535617,14,1,14,38,2.22078621623475,4.59576984631897,7.75104934942456,101,"ENSG00000079974.19"
"43410","ENSG00000271860.9_13370",13362,13370,9,"ENSG00000271860.9",1,8,"VVVVVVUMV",1,7,0.770186335403727,84,90,101,104,113,119,133,136,"ATAATGA","GAGA","AAAATAA","CTGA",2.38080885107128,11,9,14,43,2.80912572351533,4.67029618266429,7.7510415242792,101,"ENSG00000079974.19"
"11566","ENSG00000135338.14_23964",23956,23964,9,"ENSG00000135338.14",1,8,"VVVVVUVMV",1,7,0.806211180124224,44,50,74,77,114,120,133,136,"ATGAAGT","CTGA","GTACAGA","CTGA",2.54308922542867,24,37,13,83,1.15063278256492,4.52614023802236,7.75098495851925,101,"ENSG00000079974.19"
"1337","ENSG00000053900.11_2385",2377,2385,9,"ENSG00000053900.11",1,8,"VVVVVUVMV",1,7,0.806211180124224,97,103,110,113,116,122,133,136,"TTCATGA","CTGA","ATGAGCT","CAGA",2.31491485168377,7,3,11,30,2.67173332818336,4.5261247515188,7.75096947201569,101,"ENSG00000079974.19"
"28196","ENSG00000188419.14_65500",65492,65500,9,"ENSG00000188419.14",1,8,"VVVVVUVMV",1,7,0.806211180124224,114,120,133,136,167,173,191,194,"ATAATCA","TTAA","GTGATGA","CTGA",2.46453665176036,13,31,18,71,1.67414384575308,4.52609704770554,7.75094176820243,101,"ENSG00000079974.19"
"27821","ENSG00000187391.22_773812",773804,773812,9,"ENSG00000187391.22",1,1,"MVVUVUVVV",2,6,0.708902691511387,73,79,97,100,109,115,133,136,"ATGCTGA","TTGA","GTGGTGG","CTGA",2.61122695848389,18,9,18,54,2.25307701936664,4.91531418564814,7.75092495169369,101,"ENSG00000079974.19"
"17827","ENSG00000155313.16_63744",63736,63744,9,"ENSG00000155313.16",1,2,"VMVVVUVVV",1,7,0.806211180124223,105,111,133,136,154,160,190,193,"ATAATGG","CTAA","ATGATGA","CTGA",2.59017913814477,22,18,30,79,0.83643582413777,4.52607418627573,7.75091890677262,101,"ENSG00000079974.19"
"40137","ENSG00000255087.6_107306",107298,107306,9,"ENSG00000255087.6",0,NA,"VVVUVUVVV",2,7,0.802898550724638,80,86,98,101,114,120,133,136,"ATGGTGA","CTGG","CTGGAGA","ATGA",2.33114534216686,12,13,13,47,2.61620668258222,4.53929390759032,7.75088811048887,101,"ENSG00000079974.19"
"7186","ENSG00000113269.14_113567",113559,113567,9,"ENSG00000113269.14",0,NA,"VVUVVUVVV",2,7,0.805797101449275,115,121,133,136,147,153,163,166,"CAGATCA","CTGA","GTGCTGA","TTGA",2.28871624090947,12,11,10,42,2.85263932279037,4.52768689888005,7.75087530467715,101,"ENSG00000079974.19"
"9733","ENSG00000126804.14_12968",12960,12968,9,"ENSG00000126804.14",1,2,"UMVVVVVVV",1,7,0.786749482401656,93,99,109,112,116,122,133,136,"GTGTTGA","CTGA","AGGAAAA","CTCA",2.32585196425506,10,4,11,34,2.9095552101882,4.60380874297215,7.75080667257878,101,"ENSG00000079974.19"
"3362","ENSG00000083067.25_24025",24017,24025,9,"ENSG00000083067.25",1,7,"UVVVVVMVV",1,7,0.787991718426501,115,121,133,136,141,147,156,159,"CTGATAA","TAGA","ATTCTTA","CTGA",2.29999945647336,12,5,9,35,3.06188807165969,4.59880444537052,7.75077131907653,101,"ENSG00000079974.19"
"16000","ENSG00000150625.17_304183",304175,304183,9,"ENSG00000150625.17",1,8,"UVVVVVVMV",1,7,0.786749482401656,114,120,133,136,145,151,180,183,"CAGAGGA","CTGA","AAGATGT","CTGA",2.44798769526407,13,9,29,60,2.09512994249798,4.60376197773128,7.75075990733791,101,"ENSG00000079974.19"
"8198","ENSG00000117154.12_8268",8260,8268,9,"ENSG00000117154.12",1,1,"MVVUVVVVV",1,7,0.786749482401656,116,122,133,136,141,147,155,158,"CAGATGA","TTGG","ATTGTGT","CTGA",2.29805493471641,11,5,8,33,3.09466359973071,4.60375745779336,7.75075538739998,101,"ENSG00000079974.19"
"10846","ENSG00000132964.13_159546",159538,159546,9,"ENSG00000132964.13",0,NA,"UVVUVVVVV",2,7,0.78343685300207,112,118,133,136,146,152,161,164,"CTGATTA","TGGA","ATGAATT","CTGA",2.34729582240501,15,10,9,43,2.81870118800301,4.6168350010091,7.75058241301739,101,"ENSG00000079974.19"
"9071","ENSG00000122507.21_767179",767171,767179,9,"ENSG00000122507.21",1,1,"MVVVVUVVV",1,7,0.82815734989648,86,92,133,136,148,154,167,170,"ATGCTGA","AAGA","GTTTTCA","CTGA",2.40987307017756,41,12,13,75,1.68597547661635,4.43794898611668,7.7505783857026,101,"ENSG00000079974.19"
"6745","ENSG00000111783.13_157784",157776,157784,9,"ENSG00000111783.13",1,6,"UVVVVMVVV",1,7,0.805383022774327,115,121,133,136,150,156,168,171,"ATGAAAA","GGGA","GTGGTCA","CTGA",2.32984644084851,12,14,12,47,2.58378750295285,4.5290242771524,7.75055636824971,101,"ENSG00000079974.19"
"31509","ENSG00000223930.9_198232",198224,198232,9,"ENSG00000223930.9",0,NA,"UVVVVUVVV",2,7,0.824844720496894,116,122,133,136,137,143,156,159,"GTGTAGA","TTGC","TTGATGT","CTGA",2.31273139456839,11,1,13,34,2.38634217617838,4.45113786832524,7.75051675031282,101,"ENSG00000079974.19"
"23004","ENSG00000171914.17_369226",369218,369226,9,"ENSG00000171914.17",1,8,"VVVVVUVMV",1,7,0.806211180124224,114,120,133,136,142,148,158,161,"GGTATGA","ATGT","CTGGTGG","CTGA",2.25951229284488,13,6,10,38,3.03922922923171,4.52566112871607,7.75050584921296,101,"ENSG00000079974.19"
"15175","ENSG00000147246.10_54011",54003,54011,9,"ENSG00000147246.10",1,1,"MVVVVUVVV",1,7,0.82815734989648,114,120,133,136,140,146,160,163,"TTGCTTA","ATGA","AGGTTAA","CTGA",2.2519831109548,13,4,14,40,2.73786037673368,4.43777027910808,7.750399678694,101,"ENSG00000079974.19"
"17431","ENSG00000154162.15_413356",413348,413356,9,"ENSG00000154162.15",1,2,"UMVVVVVVV",1,7,0.786749482401656,114,120,133,136,141,147,155,158,"ATGAGGA","TTGT","ATGATGT","TTGA",2.30620507216064,13,5,8,35,3.03887925885067,4.60339493498039,7.75039286458702,101,"ENSG00000079974.19"
"9048","ENSG00000122484.9_12360",12352,12360,9,"ENSG00000122484.9",1,1,"MVVVVUVVV",1,7,0.82815734989648,71,77,91,94,97,103,133,136,"ATGATGA","CTGC","AAGACTA","CTGT",2.39394508881759,14,3,30,56,1.79137701750945,4.43775273574,7.75038213532593,101,"ENSG00000079974.19"
"30942","ENSG00000214846.4_522",514,522,9,"ENSG00000214846.4",1,1,"MVVVVVUVV",1,7,0.792132505175983,84,90,102,105,112,118,133,136,"ATGAAGA","CTGG","CTGTTGG","CAGA",2.32459849939582,12,7,15,43,2.82962898783847,4.58173807928598,7.75026809998992,101,"ENSG00000079974.19"
"7277","ENSG00000113448.20_199674",199666,199674,9,"ENSG00000113448.20",1,1,"MVVVVVUVV",1,7,0.792132505175983,69,75,88,91,94,100,133,136,"TTGGAGA","CTGA","GTGAGGG","CTGA",2.48313761229472,13,3,33,58,1.77239622864031,4.58166174431795,7.75019176502188,101,"ENSG00000079974.19"
"46964","ENSG00000287421.1_13600",13592,13600,9,"ENSG00000287421.1",1,8,"VVVVVUVMV",1,7,0.806211180124224,106,112,133,136,165,171,186,189,"ATGTTGA","TGGA","GTGAAGT","CTGA",2.52195375265354,21,29,15,74,1.28819513343007,4.52530503778008,7.75014975827697,101,"ENSG00000079974.19"
"11734","ENSG00000135932.12_73810",73802,73810,9,"ENSG00000135932.12",1,7,"VVVUVVMVV",1,7,0.766045548654244,113,119,133,136,141,147,168,171,"ATGAAGA","TTAA","TTGATCT","CTGA",2.45804304850644,14,5,21,49,2.35685975405862,4.68595335269205,7.75013554730903,101,"ENSG00000079974.19"
"15789","ENSG00000149571.12_131476",131468,131476,9,"ENSG00000149571.12",1,6,"UVVVVMVVV",1,7,0.805383022774327,85,91,133,136,142,148,163,166,"CTGCTGA","CAGG","GTGGTGA","CTGA",2.44691507348958,42,6,15,72,1.8015810603772,4.52858705424359,7.7501191453409,101,"ENSG00000079974.19"
"24229","ENSG00000175497.17_72361",72353,72361,9,"ENSG00000175497.17",1,2,"VMVVVVUVV",1,7,0.770186335403727,83,89,107,110,115,121,133,136,"ATTTTGC","CTGA","TTGGGGA","CTGA",2.41692485313472,18,5,12,44,2.56456802442776,4.6693500946648,7.75009543627971,101,"ENSG00000079974.19"
"18129","ENSG00000156218.13_281202",281194,281202,9,"ENSG00000156218.13",1,8,"UVVVVVVMV",1,7,0.786749482401656,108,114,133,136,144,150,166,169,"GTGGTGA","AGGA","TTGTAGA","CTGA",2.4135142667373,19,8,16,52,2.32228287773656,4.60309449732963,7.75009242693626,101,"ENSG00000079974.19"
"5338","ENSG00000104343.21_40038",40030,40038,9,"ENSG00000104343.21",1,8,"VVVVVUVMV",1,7,0.806211180124224,113,119,133,136,150,156,185,188,"CTGATTA","GTCA","GTGATGT","CTGA",2.45478924746336,14,14,29,66,1.73564401211365,4.52522641546735,7.75007113596424,101,"ENSG00000079974.19"
"41200","ENSG00000258677.2_39982",39974,39982,9,"ENSG00000258677.2",1,8,"VVVVVUVMV",1,7,0.806211180124224,113,119,133,136,150,156,185,188,"CTGATTA","GTCA","GTGATGT","CTGA",2.45478924746336,14,14,29,66,1.73564401211365,4.52522641546735,7.75007113596424,101,"ENSG00000079974.19"
"32822","ENSG00000228033.6_85657",85649,85657,9,"ENSG00000228033.6",1,8,"VVVVVUVMV",1,7,0.806211180124224,96,102,133,136,143,149,162,165,"AGGTTGA","AAGA","ATGAAGA","CTGA",2.4224403635648,31,7,13,60,1.95116192598105,4.5251910874366,7.7500358079335,101,"ENSG00000079974.19"
"14924","ENSG00000146151.14_106918",106910,106918,9,"ENSG00000146151.14",1,6,"UVVVVMVVV",1,7,0.805383022774327,108,114,133,136,142,148,161,164,"ATGATAA","CTGG","ATGTGGA","CTCA",2.34471856653424,19,6,13,47,2.48254156689008,4.52849966927958,7.75003176037689,101,"ENSG00000079974.19"
"44080","ENSG00000277654.6_162152",162144,162152,9,"ENSG00000277654.6",1,7,"VVUVVVMVV",1,7,0.768944099378882,95,101,108,111,116,122,133,136,"ATCATGT","CTGA","GTGTAGA","CTGG",2.38670034713613,7,5,11,32,2.78555061077569,4.67422156458747,7.749997962103,101,"ENSG00000079974.19"
"40407","ENSG00000255944.1_31044",31036,31044,9,"ENSG00000255944.1",1,1,"MVVVUUVVV",2,6,0.718012422360248,112,118,133,136,139,145,155,158,"CTGATAA","ATGA","CTAATGA","CTGA",2.52338944142076,15,3,10,37,2.68918365767444,4.87794498345321,7.7499946728942,101,"ENSG00000079974.19"
"40516","ENSG00000256732.2_31040",31032,31040,9,"ENSG00000256732.2",1,1,"MVVVUUVVV",2,6,0.718012422360248,112,118,133,136,139,145,155,158,"CTGATAA","ATGA","CTAATGA","CTGA",2.52338944142076,15,3,10,37,2.68918365767444,4.87794498345321,7.7499946728942,101,"ENSG00000079974.19"
"25237","ENSG00000180152.3_204",196,204,9,"ENSG00000180152.3",1,3,"VVMUVVVVV",1,7,0.763561076604555,115,121,133,136,139,145,154,157,"GTGATAA","TTCA","GTGGAGG","CTGA",2.38125487003152,12,3,9,33,2.90790712619639,4.69573489826829,7.74997920468651,101,"ENSG00000079974.19"
"16752","ENSG00000152208.13_917920",917912,917920,9,"ENSG00000152208.13",1,6,"VVVVUMVVV",1,7,0.792546583850932,78,84,99,102,111,117,133,136,"ATGAGGA","TTGA","GTCATGT","CTCA",2.35490320653227,15,9,16,49,2.61978481105164,4.57978488031669,7.74997121572042,101,"ENSG00000079974.19"
"35686","ENSG00000236747.3_3590",3582,3590,9,"ENSG00000236747.3",1,7,"VVVVUUMVV",2,6,0.697308488612836,116,122,133,136,144,150,160,163,"AAGATGA","GGGA","CTGGTGA","CTGA",2.52325532476772,11,8,10,38,3.02123989921163,4.96073551608243,7.74996947053378,101,"ENSG00000079974.19"
"43015","ENSG00000267586.7_454050",454042,454050,9,"ENSG00000267586.7",0,NA,"VVVUVUVVV",2,7,0.802898550724638,110,116,133,136,143,149,162,165,"CCAATGA","CAGA","GTGACAC","CTGA",2.32128116447176,17,7,13,46,2.67822954676562,4.53835932747768,7.74995353037623,101,"ENSG00000079974.19"
"14713","ENSG00000145743.18_520736",520728,520736,9,"ENSG00000145743.18",1,1,"MVVVUVVVV",1,7,0.795859213250517,112,118,133,136,146,152,167,170,"GAGATGT","CTTC","GGGATGA","CTGA",2.34600810402845,15,10,15,49,2.62598377392594,4.56650945019557,7.74994630319764,101,"ENSG00000079974.19"
"45323","ENSG00000285407.1_44686",44678,44686,9,"ENSG00000285407.1",1,2,"VMVVVUVVV",1,7,0.806211180124223,112,118,133,136,140,146,161,164,"ATAAAGA","TTGT","ATGCTGC","CTGA",2.32852226456097,15,4,15,43,2.57672307349191,4.52505120930793,7.74989592980482,101,"ENSG00000079974.19"
"27457","ENSG00000186197.15_29707",29699,29707,9,"ENSG00000186197.15",1,1,"MVUVVVVVV",1,7,0.789648033126294,83,89,102,105,111,117,133,136,"CTTATAA","CTGC","ATGATAT","CTGA",2.3427421694954,13,6,16,44,2.74664955069004,4.59123267016484,7.74982480267002,101,"ENSG00000079974.19"
"8854","ENSG00000121039.10_4917",4909,4917,9,"ENSG00000121039.10",1,2,"UMVVVVVVV",1,7,0.786749482401656,109,115,133,136,182,188,199,202,"AAGATGA","CAGT","ATTATGA","CTGA",2.5135578143662,18,46,11,84,1.6542471240486,4.60282480495582,7.74982273456244,101,"ENSG00000079974.19"
"44103","ENSG00000278175.6_93002",92994,93002,9,"ENSG00000278175.6",1,1,"MVVVVUVVV",1,7,0.82815734989648,76,82,100,103,115,121,133,136,"AAGATGG","CTGA","TAGATAA","ATGA",2.30370255828971,18,12,12,51,2.39073842822428,4.43718887087226,7.74981827045818,101,"ENSG00000079974.19"
"3888","ENSG00000090372.15_1788",1780,1788,9,"ENSG00000090372.15",0,NA,"VVVUVUVVV",2,7,0.802898550724638,114,120,133,136,150,156,174,177,"AGGATGT","CTGA","GTGTTGG","GTGA",2.38469634018659,13,14,18,54,2.25456332875014,4.53813473249852,7.74972893539707,101,"ENSG00000079974.19"
"11089","ENSG00000133818.14_83088",83080,83088,9,"ENSG00000133818.14",1,6,"UVVVVMVVV",1,7,0.805383022774327,115,121,133,136,144,150,160,163,"ATTATGA","CACA","TTGATAA","CTGC",2.262166969211,12,8,10,39,3.03156892303775,4.52817051277778,7.74970260387508,101,"ENSG00000079974.19"
"9851","ENSG00000127922.10_186317",186309,186317,9,"ENSG00000127922.10",1,1,"MVVUVVVVV",1,7,0.786749482401656,84,90,133,136,149,155,174,177,"ATGTTGA","GAGA","GTGATGT","CTGA",2.57109774176154,43,13,19,84,1.26995042145386,4.60265050829937,7.749648437906,101,"ENSG00000079974.19"
"25579","ENSG00000182185.19_346496",346488,346496,9,"ENSG00000182185.19",1,6,"UVVVVMVVV",1,7,0.805383022774327,61,67,93,96,107,113,133,136,"ATGAAGA","CTGA","GTGAAAA","CTCA",2.49409616116898,26,11,20,66,1.48508684806882,4.52809864729884,7.74963073839615,101,"ENSG00000079974.19"
"41590","ENSG00000259336.1_14188",14180,14188,9,"ENSG00000259336.1",1,1,"MVVVVUVVV",1,7,0.82815734989648,115,121,133,136,144,150,168,171,"CTGATGA","CAGT","GAGCTGA","CTGG",2.2683446451278,12,8,18,47,2.62562570194296,4.43698083403208,7.749610233618,101,"ENSG00000079974.19"
"35698","ENSG00000236790.7_189765",189757,189765,9,"ENSG00000236790.7",1,8,"VVVUVVVMV",1,7,0.764803312629399,110,116,133,136,146,152,175,178,"ATGGTGA","CTCA","GGGCAGA","CTGA",2.51243252063802,17,10,23,59,2.01187408378177,4.69035605534214,7.74956930585974,101,"ENSG00000079974.19"
"8509","ENSG00000119333.12_12133",12125,12133,9,"ENSG00000119333.12",0,NA,"UVVVVVUVV",2,7,0.788819875776397,60,66,79,82,90,96,133,136,"ATGCTGT","CCGA","GTGCAGT","CTGA",2.4537190982651,13,8,37,67,2.01881052810521,4.59423446246814,7.74951396557373,101,"ENSG00000079974.19"
"30184","ENSG00000204020.6_4778",4770,4778,9,"ENSG00000204020.6",1,8,"VVVVUVVMV",1,7,0.773913043478261,52,58,69,72,114,120,133,136,"ATGATTA","TTGA","AGGGTAA","CTGA",2.50749202648061,11,42,13,75,1.89882597537468,4.65385987131135,7.74951204522439,101,"ENSG00000079974.19"
"2978","ENSG00000079931.15_31978",31970,31978,9,"ENSG00000079931.15",1,8,"VVVVVUVMV",1,7,0.806211180124224,59,65,78,81,116,122,133,136,"ATGATGC","CAGA","GTGAAAA","CTCA",2.41461033599761,13,35,11,68,2.00126252169091,4.52466619041874,7.74951091091564,101,"ENSG00000079974.19"
"33381","ENSG00000229588.3_33832",33824,33832,9,"ENSG00000229588.3",1,8,"UVVVVVVMV",1,7,0.786749482401656,110,116,133,136,147,153,203,206,"AGAATGA","TTGA","ATGATTA","CTGA",2.5226100909106,17,11,50,87,1.59255564868864,4.60248906368982,7.74948699329645,101,"ENSG00000079974.19"
"17574","ENSG00000154493.20_180076",180068,180076,9,"ENSG00000154493.20",1,1,"MVUVVVVVV",1,7,0.789648033126294,34,40,53,56,85,91,133,136,"ATGGTGA","CTCA","GTGATTT","CTGA",2.5939358990164,13,29,42,93,1.07067288612976,4.5908947198931,7.74948685239828,101,"ENSG00000079974.19"
"33613","ENSG00000230461.10_44939",44931,44939,9,"ENSG00000230461.10",1,7,"UVVVVVMVV",1,7,0.787991718426501,75,81,91,94,100,106,133,136,"CTGTTGG","CTGA","TTTATGC","CTGA",2.44242123872284,10,6,27,52,2.10696606710715,4.59744358131486,7.74941045502087,101,"ENSG00000079974.19"
"18616","ENSG00000157856.12_27865",27857,27865,9,"ENSG00000157856.12",1,1,"MVVVVVUVV",1,7,0.792132505175983,74,80,90,93,108,114,133,136,"GTGATGA","GTGA","TTGAGGT","CTGG",2.4411804336479,10,15,19,53,2.04857445960062,4.58077767097999,7.74930769168393,101,"ENSG00000079974.19"
"23895","ENSG00000174473.16_1089192",1089184,1089192,9,"ENSG00000174473.16",0,NA,"VVVVVUUVV",2,7,0.808281573498965,107,113,133,136,147,153,186,189,"GTGATTA","CTGT","CTGGTCA","CTGA",2.49948079740822,20,11,33,73,1.4013988619047,4.51615104448987,7.74927733848573,101,"ENSG00000079974.19"
"25196","ENSG00000179915.25_493100",493092,493100,9,"ENSG00000179915.25",0,NA,"UVVVVVUVV",2,7,0.788819875776397,108,114,133,136,178,184,204,207,"CTGATGT","CAGA","TTGATAA","CTGA",2.59163309279388,19,42,20,90,1.09820283371384,4.59393919641825,7.74921869952384,101,"ENSG00000079974.19"
"23469","ENSG00000172995.17_133530",133522,133530,9,"ENSG00000172995.17",1,3,"UVMVVVVVV",1,7,0.785507246376811,64,70,76,79,91,97,133,136,"ATGATGA","CTGA","GTTAAGT","ATGA",2.56961872586873,6,12,36,63,1.29737355978564,4.60704126639429,7.74907025190153,101,"ENSG00000079974.19"
"7925","ENSG00000116117.19_158166",158158,158166,9,"ENSG00000116117.19",1,7,"UVVVVVMVV",1,7,0.787991718426501,81,87,98,101,105,111,133,136,"CTGATGA","CTGT","ATTATGA","CAGA",2.42461136939945,11,4,22,46,2.22427906912927,4.59708871628141,7.74905558998741,101,"ENSG00000079974.19"
"7558","ENSG00000114805.18_293179",293171,293179,9,"ENSG00000114805.18",1,1,"MVVVUUVVV",2,6,0.718012422360248,57,63,75,78,97,103,133,136,"CTGATGT","CTGA","CTGATGG","CTGA",2.7087769888802,12,19,30,70,1.44950599377421,4.87700481324389,7.74905450268488,101,"ENSG00000079974.19"
"39727","ENSG00000254126.8_25661",25653,25661,9,"ENSG00000254126.8",1,8,"VVUVVVVMV",1,7,0.767701863354037,114,120,133,136,143,149,162,165,"ATGAACA","CAGA","GTCCTTA","CTGA",2.367115769366,13,7,13,42,2.93215203790703,4.67823095842009,7.74903841183624,101,"ENSG00000079974.19"
"19122","ENSG00000161681.17_9690",9682,9690,9,"ENSG00000161681.17",1,8,"VVVVUVVMV",1,7,0.773913043478261,116,122,133,136,184,190,204,207,"CTGATGG","CTGG","TTGAGGC","CTGA",2.51489665005808,11,48,14,82,1.8475096284786,4.65337182388311,7.74902399779615,101,"ENSG00000079974.19"
"36110","ENSG00000237899.1_13883",13875,13883,9,"ENSG00000237899.1",1,8,"VVVVVUVMV",1,7,0.806211180124224,114,120,133,136,143,149,158,161,"GGGACGA","GTGG","AGGAGGA","CTGA",2.25639304672263,13,7,9,38,3.05406504890221,4.5241713400966,7.7490160605935,101,"ENSG00000079974.19"
"22406","ENSG00000170485.17_68277",68269,68277,9,"ENSG00000170485.17",0,NA,"UVVVVUVVV",2,7,0.824844720496894,107,113,133,136,150,156,193,196,"AAGATGC","TTGG","GTGATGA","CTGA",2.49730564758524,20,14,37,80,1.14976981209556,4.44961853233262,7.7489974143202,101,"ENSG00000079974.19"
"11949","ENSG00000136643.12_66500",66492,66500,9,"ENSG00000136643.12",1,1,"MVVVUVVVV",1,7,0.795859213250517,90,96,133,136,186,192,204,207,"ATAATGA","CTTA","CTGAGGT","CTGA",2.59484275747455,37,50,12,108,0.963270037424841,4.56555543848046,7.74899229148253,101,"ENSG00000079974.19"
"15329","ENSG00000147852.17_20327",20319,20327,9,"ENSG00000147852.17",1,1,"MVVVUVVVV",1,7,0.795859213250517,108,114,133,136,142,148,203,206,"ATGAAGA","CAGT","GTGACGT","CTGA",2.5051062060006,19,6,55,89,1.56136865078655,4.56551917269764,7.74895602569971,101,"ENSG00000079974.19"
"2586","ENSG00000076003.5_11296",11288,11296,9,"ENSG00000076003.5",1,8,"VVVUVVVMV",1,7,0.764803312629399,84,90,133,136,138,144,153,156,"CTAATGA","CAGA","ATGAGGA","CTGA",2.585191047361,43,2,9,63,1.52428958342042,4.68972414145678,7.74893739197438,101,"ENSG00000079974.19"
"14435","ENSG00000145002.13_2364",2356,2364,9,"ENSG00000145002.13",1,2,"VMVVUVVVV",1,7,0.773913043478261,114,120,133,136,147,153,163,166,"TTGCAGA","CAGA","CTCATGA","CTGA",2.36543254061855,13,11,10,43,2.84307618458625,4.65315661384415,7.74880878775719,101,"ENSG00000079974.19"
"19688","ENSG00000163612.10_2300",2292,2300,9,"ENSG00000163612.10",1,2,"VMVVUVVVV",1,7,0.773913043478261,114,120,133,136,147,153,163,166,"TTGCAGA","CAGA","CTCATGA","CTGA",2.36543254061855,13,11,10,43,2.84307618458625,4.65315661384415,7.74880878775719,101,"ENSG00000079974.19"
"20456","ENSG00000164845.17_2316",2308,2316,9,"ENSG00000164845.17",1,2,"VMVVUVVVV",1,7,0.773913043478261,114,120,133,136,147,153,163,166,"TTGCAGA","CAGA","CTCATGA","CTGA",2.36543254061855,13,11,10,43,2.84307618458625,4.65315661384415,7.74880878775719,101,"ENSG00000079974.19"
"22653","ENSG00000171084.18_2312",2304,2312,9,"ENSG00000171084.18",1,2,"VMVVUVVVV",1,7,0.773913043478261,114,120,133,136,147,153,163,166,"TTGCAGA","CAGA","CTCATGA","CTGA",2.36543254061855,13,11,10,43,2.84307618458625,4.65315661384415,7.74880878775719,101,"ENSG00000079974.19"
"23579","ENSG00000173295.11_2310",2302,2310,9,"ENSG00000173295.11",1,2,"VMVVUVVVV",1,7,0.773913043478261,114,120,133,136,147,153,163,166,"TTGCAGA","CAGA","CTCATGA","CTGA",2.36543254061855,13,11,10,43,2.84307618458625,4.65315661384415,7.74880878775719,101,"ENSG00000079974.19"
"36977","ENSG00000244026.9_2312",2304,2312,9,"ENSG00000244026.9",1,2,"VMVVUVVVV",1,7,0.773913043478261,114,120,133,136,147,153,163,166,"TTGCAGA","CAGA","CTCATGA","CTGA",2.36543254061855,13,11,10,43,2.84307618458625,4.65315661384415,7.74880878775719,101,"ENSG00000079974.19"
"39121","ENSG00000251669.7_2318",2310,2318,9,"ENSG00000251669.7",1,2,"VMVVUVVVV",1,7,0.773913043478261,114,120,133,136,147,153,163,166,"TTGCAGA","CAGA","CTCATGA","CTGA",2.36543254061855,13,11,10,43,2.84307618458625,4.65315661384415,7.74880878775719,101,"ENSG00000079974.19"
"39614","ENSG00000253917.4_2318",2310,2318,9,"ENSG00000253917.4",1,2,"VMVVUVVVV",1,7,0.773913043478261,114,120,133,136,147,153,163,166,"TTGCAGA","CAGA","CTCATGA","CTGA",2.36543254061855,13,11,10,43,2.84307618458625,4.65315661384415,7.74880878775719,101,"ENSG00000079974.19"
"48074","ENSG00000290374.1_2331",2323,2331,9,"ENSG00000290374.1",1,2,"VMVVUVVVV",1,7,0.773913043478261,114,120,133,136,147,153,163,166,"TTGCAGA","CAGA","CTCATGA","CTGA",2.36543254061855,13,11,10,43,2.84307618458625,4.65315661384415,7.74880878775719,101,"ENSG00000079974.19"
"48312","ENSG00000290940.1_2316",2308,2316,9,"ENSG00000290940.1",1,2,"VMVVUVVVV",1,7,0.773913043478261,114,120,133,136,147,153,163,166,"TTGCAGA","CAGA","CTCATGA","CTGA",2.36543254061855,13,11,10,43,2.84307618458625,4.65315661384415,7.74880878775719,101,"ENSG00000079974.19"
"48376","ENSG00000291049.1_2320",2312,2320,9,"ENSG00000291049.1",1,2,"VMVVUVVVV",1,7,0.773913043478261,114,120,133,136,147,153,163,166,"TTGCAGA","CAGA","CTCATGA","CTGA",2.36543254061855,13,11,10,43,2.84307618458625,4.65315661384415,7.74880878775719,101,"ENSG00000079974.19"
"48408","ENSG00000291071.1_2327",2319,2327,9,"ENSG00000291071.1",1,2,"VMVVUVVVV",1,7,0.773913043478261,114,120,133,136,147,153,163,166,"TTGCAGA","CAGA","CTCATGA","CTGA",2.36543254061855,13,11,10,43,2.84307618458625,4.65315661384415,7.74880878775719,101,"ENSG00000079974.19"
"48518","ENSG00000291223.1_2327",2319,2327,9,"ENSG00000291223.1",1,2,"VMVVUVVVV",1,7,0.773913043478261,114,120,133,136,147,153,163,166,"TTGCAGA","CAGA","CTCATGA","CTGA",2.36543254061855,13,11,10,43,2.84307618458625,4.65315661384415,7.74880878775719,101,"ENSG00000079974.19"
"18388","ENSG00000157168.20_923717",923709,923717,9,"ENSG00000157168.20",1,8,"VVVVVUVMV",1,7,0.806211180124224,89,95,133,136,151,157,170,173,"TTGATGT","ATGA","TTTATTA","CTGA",2.49295840611587,38,15,13,75,1.47594900078514,4.52391792705607,7.74876264755297,101,"ENSG00000079974.19"
"29592","ENSG00000198373.13_118487",118479,118487,9,"ENSG00000198373.13",1,1,"MVVVVUVVV",1,7,0.82815734989648,113,119,133,136,148,154,167,170,"CTGATCT","CTTC","GTGCTGG","CTGA",2.26396351754006,14,12,13,48,2.65071350396686,4.43595090522514,7.74858030481107,101,"ENSG00000079974.19"
"11176","ENSG00000134146.12_226138",226130,226138,9,"ENSG00000134146.12",1,1,"MVVVVUVVV",1,7,0.82815734989648,113,119,133,136,140,146,157,160,"GGGCTGA","CAAA","AAGATCA","CTGA",2.23446587920583,14,4,11,38,2.84726313322388,4.43592558198235,7.74855498156827,101,"ENSG00000079974.19"
"2417","ENSG00000074416.16_247574",247566,247574,9,"ENSG00000074416.16",1,1,"MVVVVUVVV",1,7,0.82815734989648,109,115,133,136,164,170,180,183,"CTTAAGA","GTGA","TTGATGT","CTGA",2.40057850055744,18,28,10,65,1.73967040642796,4.43588176920272,7.74851116878864,101,"ENSG00000079974.19"
"27721","ENSG00000187239.19_143208",143200,143208,9,"ENSG00000187239.19",1,6,"VVVVVMUVV",1,7,0.788819875776397,92,98,133,136,143,149,199,202,"ATGATGA","CTCT","TTGAAGG","CTGA",2.60425933599432,35,7,50,101,1.01113310647909,4.59321550327697,7.74849500638256,101,"ENSG00000079974.19"
"34464","ENSG00000233117.4_21146",21138,21146,9,"ENSG00000233117.4",1,8,"VVUVVVVMV",1,7,0.767701863354037,116,122,133,136,149,155,171,174,"ATGATGA","TTGG","ATGTTGA","CAGA",2.44228091430649,11,13,16,49,2.42868043522483,4.67763829931703,7.74844575273318,101,"ENSG00000079974.19"
"10754","ENSG00000132670.21_57859",57851,57859,9,"ENSG00000132670.21",1,1,"MVVVVUVVV",1,7,0.82815734989648,114,120,133,136,145,151,195,198,"GTTATGC","CAGA","GGGAAAA","CTGA",2.36817583392951,13,9,44,75,1.95526980846721,4.43577717533265,7.74840657491857,101,"ENSG00000079974.19"
"12776","ENSG00000139117.14_171814",171806,171814,9,"ENSG00000139117.14",1,2,"VMVVUVVVV",1,7,0.773913043478261,102,108,133,136,143,149,177,180,"TTGATGT","GTGA","TTGATGT","CTGA",2.58971046950592,25,7,28,69,1.34627594308588,4.65275310161467,7.74840527552771,101,"ENSG00000079974.19"
"25370","ENSG00000181143.15_99485",99477,99485,9,"ENSG00000181143.15",1,5,"VVVVMVUVV",1,7,0.772670807453416,89,95,105,108,114,120,133,136,"ATGATGA","CAAA","TTGAGCA","CTGG",2.36225655802862,10,6,13,38,2.88206473513312,4.65761044716431,7.74829367697797,101,"ENSG00000079974.19"
"9409","ENSG00000124491.16_17933",17925,17933,9,"ENSG00000124491.16",1,1,"MVVVUVVVV",1,7,0.795859213250517,115,121,133,136,174,180,189,192,"TTCATGA","CATA","ATGATGC","CTGA",2.43744203787452,12,38,9,68,2.00979309079366,4.56485166915595,7.74828852215802,101,"ENSG00000079974.19"
"24658","ENSG00000177338.14_12897",12889,12897,9,"ENSG00000177338.14",1,1,"MVVVVVUVV",1,7,0.792132505175983,89,95,133,136,144,150,178,181,"GTGATGT","CTCA","GAGAAGA","CTGA",2.57322634418987,38,8,28,83,1.16418592149488,4.5797570540235,7.74828707472744,101,"ENSG00000079974.19"
"6677","ENSG00000111371.16_41558",41550,41558,9,"ENSG00000111371.16",1,8,"VVVVVUVMV",1,7,0.806211180124224,110,116,133,136,144,150,161,164,"GTGGTGA","CTTC","ATCTTGC","CTGA",2.30403884560277,17,8,11,45,2.73343017903204,4.52342228742929,7.74826700792619,101,"ENSG00000079974.19"
"47800","ENSG00000289362.1_1491",1483,1491,9,"ENSG00000289362.1",0,NA,"UVVVVVUVV",2,7,0.788819875776397,52,58,66,69,79,85,133,136,"AGGATGG","CAGA","GTGACAA","CTGA",2.5108157612598,8,10,48,75,1.63315245035975,4.59298104802294,7.74826055112853,101,"ENSG00000079974.19"
"33173","ENSG00000228956.9_304730",304722,304730,9,"ENSG00000228956.9",1,2,"VMVUVVVVV",1,7,0.764803312629399,113,119,133,136,147,153,167,170,"GGGATGG","TTGA","TTGATTC","CTGA",2.41259464144561,14,11,14,48,2.67218893375837,4.6890383025156,7.7482515530332,101,"ENSG00000079974.19"
"26854","ENSG00000185053.14_439846",439838,439846,9,"ENSG00000185053.14",1,6,"UVVVVMVVV",1,7,0.805383022774327,81,87,101,104,114,120,133,136,"ATAATGG","ATTA","GTTAGTA","CTGA",2.29820416097737,14,10,13,46,2.78535128930058,4.52667809062076,7.74821018171806,101,"ENSG00000079974.19"
"16425","ENSG00000151474.23_704409",704401,704409,9,"ENSG00000151474.23",1,7,"UVVVVVMVV",1,7,0.787991718426501,81,87,102,105,115,121,133,136,"GTGACAA","CTCA","AAGACGA","CTGA",2.34225863071069,15,10,12,46,2.76986761191382,4.59623128749627,7.74819816120227,101,"ENSG00000079974.19"
"22317","ENSG00000170310.15_106181",106173,106181,9,"ENSG00000170310.15",1,1,"MVVVVVUVV",1,7,0.792132505175983,36,42,50,53,104,110,133,136,"TTGAAGA","CTGA","TTGTTTA","CTGA",2.58420792881802,8,51,23,91,1.09050737367638,4.5796400581158,7.74817007881973,101,"ENSG00000079974.19"
"47602","ENSG00000288714.1_231902",231894,231902,9,"ENSG00000288714.1",1,3,"UVMVVVVVV",1,7,0.785507246376811,90,96,133,136,142,148,159,162,"GTGATGG","CTTT","ATCATGA","CTGA",2.46756015819391,37,6,11,63,1.97382517682596,4.60605655786301,7.74808554337026,101,"ENSG00000079974.19"
"34927","ENSG00000234418.4_30001",29993,30001,9,"ENSG00000234418.4",1,7,"VVVVUVMVV",1,7,0.775155279503105,107,113,133,136,142,148,159,162,"GGGATGA","ATTA","ATGATCC","CTGA",2.41886764158924,20,6,11,46,2.4640621002461,4.64746159437693,7.74808271238935,101,"ENSG00000079974.19"
"15445","ENSG00000148225.16_19003",18995,19003,9,"ENSG00000148225.16",1,2,"VMUVVVVVV",1,7,0.767701863354037,105,111,133,136,142,148,157,160,"GTCATGA","CTGT","ATGGTTC","CTGA",2.45782356810764,22,6,9,46,2.32357500372946,4.67726636444509,7.74807381786124,101,"ENSG00000079974.19"
"15435","ENSG00000148219.18_776830",776822,776830,9,"ENSG00000148219.18",1,5,"UVVVMVVVV",1,7,0.789233954451346,49,55,66,69,113,119,133,136,"CTAATAA","CTGA","GTGCTGG","CTGA",2.47725942465048,11,44,14,78,1.84938746908818,4.59111257502284,7.74804839282822,101,"ENSG00000079974.19"
"10275","ENSG00000130338.13_55788",55780,55788,9,"ENSG00000130338.13",0,NA,"VVVUVVUVV",2,7,0.766873706004141,84,90,98,101,108,114,133,136,"CGGGTGA","CTGA","GTCATGT","CTGA",2.46050641105114,8,7,19,43,2.31878197294375,4.6805395116545,7.74803433567106,101,"ENSG00000079974.19"
"43819","ENSG00000274023.1_5183",5175,5183,9,"ENSG00000274023.1",0,NA,"VVVUVVUVV",2,7,0.766873706004141,84,90,98,101,108,114,133,136,"CGGGTGA","CTGA","GTCATGT","CTGA",2.46050641105114,8,7,19,43,2.31878197294375,4.6805395116545,7.74803433567106,101,"ENSG00000079974.19"
"28021","ENSG00000187957.8_61132",61124,61132,9,"ENSG00000187957.8",0,NA,"VVUVVVUVV",2,7,0.769772256728778,102,108,133,136,141,147,156,159,"TTTATGA","ATGA","CTGCTGG","CTGA",2.4858049819613,25,5,9,48,2.10368215472248,4.66892884194945,7.74801786886457,101,"ENSG00000079974.19"
"7874","ENSG00000115935.19_25984",25976,25984,9,"ENSG00000115935.19",1,7,"VVUVVVMVV",1,7,0.768944099378882,112,118,133,136,147,153,167,170,"TGGATGC","CTGA","ATTTTGT","CTGA",2.4107546038452,15,11,14,49,2.61712918035591,4.67220663483098,7.74798303234651,101,"ENSG00000079974.19"
"17938","ENSG00000155875.15_177329",177321,177329,9,"ENSG00000155875.15",1,2,"UMVVVVVVV",1,7,0.786749482401656,93,99,106,109,111,117,133,136,"AAGATGA","TTGT","GTGTGGC","CTGA",2.45124597186037,7,2,16,34,2.06221761627877,4.6009643571703,7.74796228677693,101,"ENSG00000079974.19"
"470","ENSG00000012779.12_25820",25812,25820,9,"ENSG00000012779.12",1,5,"UVVVMVVVV",1,7,0.789233954451346,98,104,133,136,144,150,161,164,"ATGGTTA","CTGC","GTGGAGA","CTGA",2.4499600856296,29,8,11,57,2.03098421573193,4.59101286331565,7.74794868112103,101,"ENSG00000079974.19"
"35575","ENSG00000236356.1_16328",16320,16328,9,"ENSG00000236356.1",1,2,"VMVVVUUVV",2,6,0.692339544513457,86,92,106,109,115,121,133,136,"ATGATGA","ATAA","AAGCAGA","CTGA",2.54766039897845,14,6,12,41,2.92993519723474,4.97858446427277,7.7479426423266,101,"ENSG00000079974.19"
"260","ENSG00000007080.11_6551",6543,6551,9,"ENSG00000007080.11",1,8,"VVVVVUVMV",1,7,0.806211180124224,100,106,133,136,147,153,165,168,"ATGAGGA","CAGA","ATGAGGA","CAGA",2.42946167065972,27,11,12,59,1.89578489335941,4.52304900777273,7.74789372826962,101,"ENSG00000079974.19"
"9140","ENSG00000122870.12_103021",103013,103021,9,"ENSG00000122870.12",1,6,"VVVVVMUVV",1,7,0.788819875776397,105,111,133,136,151,157,210,213,"GTGCTGA","CTGA","TTGCTGG","CTGA",2.62174977111904,22,15,53,99,0.892109267347964,4.59261026870205,7.74788977180764,101,"ENSG00000079974.19"
"19464","ENSG00000163092.22_142226",142218,142226,9,"ENSG00000163092.22",0,NA,"UVVUVVVVV",2,7,0.78343685300207,110,116,133,136,159,165,180,183,"CTGTTGA","CTGC","GTGCGGA","CTGA",2.50670647121773,17,23,15,64,1.74517121777053,4.61413692313885,7.74788433514713,101,"ENSG00000079974.19"
"7637","ENSG00000115239.24_147784",147776,147784,9,"ENSG00000115239.24",0,NA,"VVVUVUVVV",2,7,0.802898550724638,113,119,133,136,144,150,165,168,"ATTTTGT","CTAA","CTGTTAA","CTGA",2.30599898498526,14,8,15,46,2.77174603734722,4.53626815097891,7.74786235387746,101,"ENSG00000079974.19"
"6119","ENSG00000108018.16_570695",570687,570695,9,"ENSG00000108018.16",1,2,"UMVVVVVVV",1,7,0.786749482401656,108,114,133,136,146,152,167,170,"ATGTTAA","CAGA","ATAATGC","CTGA",2.41665210660303,19,10,15,53,2.29230370715312,4.60082943779333,7.74782736739995,101,"ENSG00000079974.19"
"28014","ENSG00000187957.8_121166",121158,121166,9,"ENSG00000187957.8",1,8,"VVVVVUVMV",1,7,0.806211180124224,115,121,133,136,142,148,188,191,"GAGATGA","GTGC","CTGGAGA","CTGA",2.41311368775297,12,6,40,67,2.00440743253021,4.5229580043875,7.74780272488439,101,"ENSG00000079974.19"
"17918","ENSG00000155846.17_65668",65660,65668,9,"ENSG00000155846.17",1,7,"VVVUVVMVV",1,7,0.766045548654244,114,120,133,136,153,159,171,174,"ATGATGC","CAGC","GAGAAGG","CTGA",2.45283028002755,13,17,12,51,2.38227935566718,4.68362030562938,7.74780250024636,101,"ENSG00000079974.19"
"22916","ENSG00000171723.16_580825",580817,580825,9,"ENSG00000171723.16",1,2,"VMVVVUVVV",1,7,0.806211180124223,109,115,133,136,143,149,187,190,"ATGATGC","TGGA","GGGAAAA","CTGA",2.45926093236324,18,7,38,72,1.69657456815192,4.52291186264338,7.74775658314027,101,"ENSG00000079974.19"
"37571","ENSG00000248491.6_27190",27182,27190,9,"ENSG00000248491.6",1,6,"UVVVVMVVV",1,7,0.805383022774327,115,121,133,136,139,145,156,159,"TTAATGA","AAGA","GCTATCA","CTGA",2.29293665378587,12,3,11,35,2.81845516435072,4.52617488073079,7.7477069718281,101,"ENSG00000079974.19"
"16570","ENSG00000151789.13_955937",955929,955937,9,"ENSG00000151789.13",1,8,"VVVVVVUMV",1,7,0.770186335403727,113,119,133,136,162,168,177,180,"ATGAAGT","ATGA","TTGTAGA","CTGA",2.49014984596786,14,26,9,58,2.06683197752049,4.66695773765989,7.7477030792748,101,"ENSG00000079974.19"
"35951","ENSG00000237505.8_544000",543992,544000,9,"ENSG00000237505.8",1,8,"VVVVVVUMV",1,7,0.770186335403727,115,121,133,136,174,180,189,192,"GTGATGA","CTTA","GTGGTGA","CTAA",2.49864597485288,12,38,9,68,2.00979309079366,4.66685823078655,7.74760357240146,101,"ENSG00000079974.19"
"20893","ENSG00000165970.12_17403",17395,17403,9,"ENSG00000165970.12",1,1,"MVVVVUVVV",1,7,0.82815734989648,97,103,133,136,145,151,162,165,"AGGATGT","TTGT","GTTATCA","CTGA",2.36398093247377,30,9,11,59,1.97989182660371,4.43494117744054,7.74757057702646,101,"ENSG00000079974.19"
"10156","ENSG00000129595.14_218982",218974,218982,9,"ENSG00000129595.14",1,5,"VVVUMVVVV",1,7,0.767287784679089,94,100,133,136,140,146,158,161,"ATGATAA","CTGT","GGGAAGT","CTGA",2.53510665571183,33,4,12,58,1.8127081529414,4.67835479775506,7.74750593647142,101,"ENSG00000079974.19"
"8748","ENSG00000120594.17_243322",243314,243322,9,"ENSG00000120594.17",1,8,"UVVVVVVMV",1,7,0.786749482401656,94,100,133,136,173,179,188,191,"AGGATTA","CTGA","TTGATGG","CTGA",2.60590393675256,33,37,9,88,1.02904645342329,4.60043484127676,7.74743277088338,101,"ENSG00000079974.19"
"9270","ENSG00000123600.21_93799",93791,93799,9,"ENSG00000123600.21",1,8,"VVVVVUVMV",1,7,0.806211180124224,115,121,133,136,142,148,170,173,"AGGAAGA","AAGA","CTGAAGC","CTGA",2.35460636425145,12,6,22,49,2.39275669173859,4.52253311335373,7.74737783385062,101,"ENSG00000079974.19"
"23639","ENSG00000173452.14_49388",49380,49388,9,"ENSG00000173452.14",1,8,"VVVVVUVMV",1,7,0.806211180124224,112,118,133,136,152,158,171,174,"GTAATGT","CTTC","ATGATGT","CTGA",2.36586173942108,15,16,13,53,2.31740464751081,4.52245406091283,7.74729878140972,101,"ENSG00000079974.19"
"19184","ENSG00000162415.7_37640",37632,37640,9,"ENSG00000162415.7",1,8,"VVVVVVUMV",1,7,0.770186335403727,113,119,133,136,160,166,187,190,"ATGATGG","CTTC","ATGAGGA","CTGA",2.56429557374941,14,24,21,68,1.57089215256012,4.66654899438904,7.74729433600395,101,"ENSG00000079974.19"
"18375","ENSG00000157168.20_304941",304933,304941,9,"ENSG00000157168.20",1,7,"VVVVUVMVV",1,7,0.775155279503105,45,51,64,67,98,104,133,136,"ATGATTA","ATGA","GTGCTAA","CTGA",2.60993743966601,13,31,29,82,1.18708204557727,4.646666244171,7.74728736218342,101,"ENSG00000079974.19"
"26972","ENSG00000185345.24_922460",922452,922460,9,"ENSG00000185345.24",1,8,"VVUVVVVMV",1,7,0.767701863354037,88,94,106,109,114,120,133,136,"GTGATGA","CTGT","ATGGATA","CTGC",2.37153399758642,12,5,13,39,2.89554315851381,4.67644245227248,7.74724990568863,101,"ENSG00000079974.19"
"16036","ENSG00000150672.19_1075913",1075905,1075913,9,"ENSG00000150672.19",1,5,"UVVVMVVVV",1,7,0.789233954451346,114,120,133,136,146,152,165,168,"ATGTGGA","CAAA","GTGATCC","CTGA",2.33131352077824,13,10,13,45,2.8189809746876,4.5902677783023,7.74720359610768,101,"ENSG00000079974.19"
"45626","ENSG00000285744.1_50348",50340,50348,9,"ENSG00000285744.1",0,NA,"VVUVVUVVV",2,7,0.805797101449275,40,46,71,74,81,87,133,136,"ATGATGA","GTGA","GTGAGGT","CTCA",2.53774970130375,25,7,46,87,1.17772637184593,4.52401442846774,7.74720283426484,101,"ENSG00000079974.19"
"23159","ENSG00000172264.19_50594",50586,50594,9,"ENSG00000172264.19",1,8,"VVVVVUVMV",1,7,0.806211180124224,109,115,133,136,146,152,163,166,"TTGAAGA","CAGA","ATGAAGA","CAGA",2.33051118524135,18,10,11,48,2.55217806762677,4.52222982564227,7.74707454613917,101,"ENSG00000079974.19"
"29403","ENSG00000197953.6_17277",17269,17277,9,"ENSG00000197953.6",1,2,"UMVVVVVVV",1,7,0.786749482401656,113,119,133,136,149,155,207,210,"ATGATGG","GAGA","GAGATTA","CTGA",2.51109457080654,14,13,52,88,1.6595970395779,4.60005687790537,7.747054807512,101,"ENSG00000079974.19"
"1248","ENSG00000050628.21_105980",105972,105980,9,"ENSG00000050628.21",1,7,"VVVVUVMVV",1,7,0.775155279503105,113,119,133,136,144,150,180,183,"GTGAGGC","CAGA","TTGAGGA","CTGA",2.47628394203761,14,8,30,61,2.07710699323052,4.64641665170365,7.74703776971608,101,"ENSG00000079974.19"
"46700","ENSG00000287069.1_206324",206316,206324,9,"ENSG00000287069.1",1,1,"MVVUVVVVV",1,7,0.786749482401656,111,117,133,136,149,155,168,171,"ATGATTC","CTGA","ATGATTA","CAGA",2.39226618634589,16,13,13,51,2.451647325801,4.60002214202673,7.74702007163336,101,"ENSG00000079974.19"
"35437","ENSG00000236052.2_139997",139989,139997,9,"ENSG00000236052.2",1,6,"UVVVVMVVV",1,7,0.805383022774327,98,104,133,136,141,147,163,166,"GGGATGA","CTGG","ACGCGGA","CTGA",2.45299180016584,29,5,16,59,1.74854763592005,4.52545657592308,7.74698866702039,101,"ENSG00000079974.19"
"17023","ENSG00000152969.21_136181",136173,136181,9,"ENSG00000152969.21",0,NA,"VVVUVVUVV",2,7,0.766873706004141,114,120,133,136,151,157,173,176,"AAGAAGA","CTGA","AAGGTCA","CTGA",2.46147259865723,13,15,16,53,2.30813507608819,4.67948810011743,7.746982924134,101,"ENSG00000079974.19"
"25378","ENSG00000181215.16_136145",136137,136145,9,"ENSG00000181215.16",0,NA,"VVVUVVUVV",2,7,0.766873706004141,114,120,133,136,151,157,173,176,"AAGAAGA","CTGA","AAGGTCA","CTGA",2.46147259865723,13,15,16,53,2.30813507608819,4.67948810011743,7.746982924134,101,"ENSG00000079974.19"
"9391","ENSG00000124422.12_14959",14951,14959,9,"ENSG00000124422.12",1,5,"VVVVMUVVV",1,7,0.808695652173913,75,81,96,99,110,116,133,136,"ATGAAGT","CTGA","CTGATCC","TTGA",2.34089931230126,15,11,17,52,2.44247399365069,4.51211735224811,7.74689996094376,101,"ENSG00000079974.19"
"38304","ENSG00000249917.3_131595",131587,131595,9,"ENSG00000249917.3",1,1,"MVVVVUVVV",1,7,0.82815734989648,58,64,74,77,87,93,133,136,"ATGCTGA","CTGA","GTAATAG","CTGG",2.38485499437334,10,10,40,69,1.83797108378878,4.43425109490277,7.74688049448869,101,"ENSG00000079974.19"
"27072","ENSG00000185532.20_325379",325371,325379,9,"ENSG00000185532.20",1,8,"UVVVVVVMV",1,7,0.786749482401656,114,120,133,136,144,150,182,185,"TTGTTGA","AAGA","ATGATAA","CTGA",2.44901946339505,13,8,32,62,2.07259957744687,4.59984900002014,7.74684692962676,101,"ENSG00000079974.19"
"24746","ENSG00000177694.16_757343",757335,757343,9,"ENSG00000177694.16",1,5,"VVVUMVVVV",1,7,0.767287784679089,116,122,133,136,139,145,153,156,"ATCATGT","TTAA","ATGCTTA","CTGA",2.36147614373999,11,3,8,31,2.96752828093801,4.67767564313449,7.74682678185084,101,"ENSG00000079974.19"
"38976","ENSG00000251372.7_213116",213108,213116,9,"ENSG00000251372.7",1,6,"VVVUVMVVV",1,7,0.78343685300207,112,118,133,136,150,156,167,170,"ATAAAGA","CTGG","TTCATAA","CTGA",2.3899535722767,15,14,11,49,2.51925178332569,4.61306889962592,7.7468163116342,101,"ENSG00000079974.19"
"18003","ENSG00000155974.14_559658",559650,559658,9,"ENSG00000155974.14",1,8,"UVVVVVVMV",1,7,0.786749482401656,72,78,95,98,110,116,133,136,"GTGATTA","ATGT","ATGAACA","CTGA",2.42711574227173,17,12,17,55,2.21849575262139,4.59981684194156,7.74681477154819,101,"ENSG00000079974.19"
"18843","ENSG00000158813.18_379346",379338,379346,9,"ENSG00000158813.18",1,1,"MVUVVVVVV",1,7,0.789648033126294,112,118,133,136,144,150,171,174,"ATGATTT","GTCA","GTGAAGT","CTGA",2.39943998941915,15,8,21,53,2.35657900258347,4.58821139967778,7.74680353218296,101,"ENSG00000079974.19"
"4664","ENSG00000101489.20_55297",55289,55297,9,"ENSG00000101489.20",0,NA,"VVVUVUVVV",2,7,0.802898550724638,115,121,133,136,163,169,182,185,"CTGGTGA","GAGA","GTGAGGG","CTGA",2.42007713532236,12,27,13,61,2.00685490408264,4.53517561822459,7.74676982112314,101,"ENSG00000079974.19"
"26931","ENSG00000185313.9_21985",21977,21985,9,"ENSG00000185313.9",1,6,"UVVVVMVVV",1,7,0.805383022774327,75,81,97,100,109,115,133,136,"ATGAGGA","CTAA","GTGGTGG","GTGA",2.35141625252122,16,9,18,52,2.42482102039496,4.52523234263411,7.74676443373142,101,"ENSG00000079974.19"
"2860","ENSG00000078687.18_67625",67617,67625,9,"ENSG00000078687.18",1,7,"VVVVUVMVV",1,7,0.775155279503105,116,122,133,136,148,154,168,171,"ATGTTCA","CCTA","GTGAGGA","CTGA",2.39525065153969,11,12,14,46,2.61612816994928,4.64611646172014,7.74673757973256,101,"ENSG00000079974.19"
"19935","ENSG00000164035.10_368601",368593,368601,9,"ENSG00000164035.10",1,2,"UMVVVVVVV",1,7,0.786749482401656,111,117,133,136,142,148,170,173,"GTGAGGT","TTGA","TTGATTT","CTGA",2.42541942591603,16,6,22,53,2.2294588142099,4.59973041341253,7.74672834301916,101,"ENSG00000079974.19"
"19759","ENSG00000163637.13_287567",287559,287567,9,"ENSG00000163637.13",1,1,"MVVVVUVVV",1,7,0.82815734989648,112,118,133,136,141,147,160,163,"ATCAAGA","GTTA","AAGCAGA","CTGA",2.24381640909343,15,5,13,42,2.77747826044877,4.4340635802679,7.74669297985382,101,"ENSG00000079974.19"
"40210","ENSG00000255248.11_372238",372230,372238,9,"ENSG00000255248.11",1,7,"UVVVVVMVV",1,7,0.787991718426501,99,105,133,136,143,149,170,173,"ATGAAGT","GTGA","TTGCTGA","CTGA",2.5260910985471,28,7,21,65,1.53826168692923,4.59471725264414,7.74668412635014,101,"ENSG00000079974.19"
"31075","ENSG00000215472.10_3164",3156,3164,9,"ENSG00000215472.10",1,1,"MVVVVUVVV",1,7,0.82815734989648,114,120,133,136,144,150,194,197,"TTTGTGA","TTGT","GTGATGA","CTGA",2.36172818351804,13,8,44,74,1.99132048180848,4.43404375964885,7.74667315923477,101,"ENSG00000079974.19"
"42680","ENSG00000265681.8_3193",3185,3193,9,"ENSG00000265681.8",1,1,"MVVVVUVVV",1,7,0.82815734989648,114,120,133,136,144,150,194,197,"TTTGTGA","TTGT","GTGATGA","CTGA",2.36172818351804,13,8,44,74,1.99132048180848,4.43404375964885,7.74667315923477,101,"ENSG00000079974.19"
"38006","ENSG00000249334.1_8067",8059,8067,9,"ENSG00000249334.1",1,8,"VVVVUVVMV",1,7,0.773913043478261,53,59,65,68,79,85,133,136,"ATGCTGA","CTGG","TTCATGA","CTGA",2.59162422449207,6,11,48,74,1.32634916794572,4.65096099947322,7.74661317338626,101,"ENSG00000079974.19"
"4576","ENSG00000101134.12_132884",132876,132884,9,"ENSG00000101134.12",1,1,"MVVVVUVVV",1,7,0.82815734989648,115,121,133,136,157,163,176,179,"AAGAGGA","TTTA","GGGAAGA","CTGA",2.33671544637481,12,21,13,55,2.15769039011203,4.43394834148603,7.74657774107195,101,"ENSG00000079974.19"
"44652","ENSG00000283240.1_61181",61173,61181,9,"ENSG00000283240.1",1,8,"UVVVVVVMV",1,7,0.786749482401656,114,120,133,136,186,192,207,210,"TAGAAGA","CTGA","GTGAACA","CTGA",2.48766665395106,13,50,15,87,1.8135774227441,4.59950544560445,7.74650337521108,101,"ENSG00000079974.19"
"42228","ENSG00000261190.5_66197",66189,66197,9,"ENSG00000261190.5",1,1,"MVVVVVUVV",1,7,0.792132505175983,110,116,133,136,141,147,162,165,"AATATGG","CAGA","GTGAAAA","CTGA",2.37062199921971,17,5,15,46,2.50766730677879,4.57795349206088,7.74648351276481,101,"ENSG00000079974.19"
"32810","ENSG00000227954.7_98433",98425,98433,9,"ENSG00000227954.7",0,NA,"VVVVVUUVV",2,7,0.808281573498965,68,74,85,88,93,99,133,136,"GTGATGA","CTTA","CTGTTGG","CTGT",2.4125274902969,11,5,34,59,1.96979659432385,4.51332829907579,7.74645459307165,101,"ENSG00000079974.19"
"3527","ENSG00000085382.12_82937",82929,82937,9,"ENSG00000085382.12",1,2,"VMVVVUVVV",1,7,0.806211180124223,115,121,133,136,139,145,162,165,"AAGATGA","CTGT","GTAAAGA","TTGA",2.34954220273052,12,3,17,41,2.42281833002045,4.52160825372264,7.74645297421953,101,"ENSG00000079974.19"
"42742","ENSG00000266268.5_141777",141769,141777,9,"ENSG00000266268.5",0,NA,"VVVVUUVVV",2,7,0.812008281573499,112,118,133,136,141,147,171,174,"TTGATGG","TGGA","CAGATTA","CTGA",2.37581355591128,15,5,24,53,2.15491927742682,4.49841907920883,7.74645220550283,101,"ENSG00000079974.19"
"44336","ENSG00000281016.1_21800",21792,21800,9,"ENSG00000281016.1",1,2,"VMVVVUVVV",1,7,0.806211180124223,112,118,133,136,145,151,166,169,"CAGATGA","AGGA","ATTCAGA","CTGA",2.31110016862366,15,9,15,48,2.67899429046649,4.52158218698939,7.74642690748628,101,"ENSG00000079974.19"
"8775","ENSG00000120658.14_365439",365431,365439,9,"ENSG00000120658.14",1,8,"UVVVVVVMV",1,7,0.786749482401656,107,113,133,136,143,149,160,163,"GTGATGT","CAGT","ATAAACA","CTGA",2.38781246112658,20,7,11,47,2.47890426806547,4.59941350222734,7.74641143183396,101,"ENSG00000079974.19"
"31390","ENSG00000223685.8_94999",94991,94999,9,"ENSG00000223685.8",1,7,"UVVVVVMVV",1,7,0.787991718426501,68,74,95,98,109,115,133,136,"ATGTTGA","CTGA","GTGATCT","CTAA",2.4745146199418,21,11,18,59,1.88093518349723,4.59442482911064,7.74639170281664,101,"ENSG00000079974.19"
"5076","ENSG00000102935.12_95009",95001,95009,9,"ENSG00000102935.12",1,1,"MVVVVVUVV",1,7,0.792132505175983,109,115,133,136,138,144,160,163,"ATCATGA","CTGA","GAGATTA","GTGA",2.45323575777991,18,2,16,45,1.95613675912077,4.57776045274671,7.74629047345064,101,"ENSG00000079974.19"
"1114","ENSG00000047662.5_89289",89281,89289,9,"ENSG00000047662.5",0,NA,"UVVVVVUVV",2,7,0.788819875776397,67,73,85,88,92,98,133,136,"ATGATGA","CTTA","TTGATAT","CTGG",2.47093918073267,12,4,35,60,1.89092246410227,4.59096258391336,7.74624208701895,101,"ENSG00000079974.19"
"17654","ENSG00000154678.18_220464",220456,220464,9,"ENSG00000154678.18",1,8,"UVVVVVVMV",1,7,0.786749482401656,101,107,133,136,137,143,159,162,"ATGATGA","ATTA","GTGGCAA","CTGA",2.57678358505564,26,1,16,52,1.21810907052771,4.599166576058,7.74616450566463,101,"ENSG00000079974.19"
"46716","ENSG00000287092.1_64397",64389,64397,9,"ENSG00000287092.1",1,8,"VVUVVVVMV",1,7,0.767701863354037,94,100,133,136,171,177,189,192,"CTGATGA","CAGA","TTGAAGG","CTGA",2.65596652467318,33,35,12,89,0.994919750321843,4.67534081203576,7.74614826545191,101,"ENSG00000079974.19"
"71","ENSG00000003989.18_8717",8709,8717,9,"ENSG00000003989.18",1,2,"VMVVVUVVV",1,7,0.806211180124223,106,112,133,136,140,146,165,168,"CTGATAC","CTGA","TTAATAA","CTGA",2.43931495450991,21,4,19,53,1.82300737886206,4.5212767688987,7.74612148939559,101,"ENSG00000079974.19"
"38936","ENSG00000251314.2_547380",547372,547380,9,"ENSG00000251314.2",1,6,"VVUVVMVVV",1,7,0.786335403726708,116,122,133,136,151,157,185,188,"TGGATGT","CTGA","TTGAAAA","CTGA",2.50497220049972,11,15,28,63,1.70313127533511,4.60073648633332,7.74607810124015,101,"ENSG00000079974.19"
"41469","ENSG00000259072.2_104897",104889,104897,9,"ENSG00000259072.2",1,8,"UVVVVVVMV",1,7,0.786749482401656,115,121,133,136,144,150,166,169,"ATAATGA","TTGA","GGGATTA","CAGA",2.34674634201072,12,8,16,45,2.75134207376402,4.59907942179221,7.74607735139884,101,"ENSG00000079974.19"
"327","ENSG00000008277.15_252271",252263,252271,9,"ENSG00000008277.15",1,3,"VVMVVUVVV",1,7,0.804968944099379,109,115,133,136,144,150,164,167,"ATGTTGA","TTGA","TTGTTGT","CTCA",2.33686631378207,18,8,14,49,2.52554291813936,4.52616291917163,7.74603869556914,101,"ENSG00000079974.19"
"2349","ENSG00000073711.11_5554",5546,5554,9,"ENSG00000073711.11",1,8,"VVVVVUVMV",1,7,0.806211180124224,54,60,71,74,81,87,133,136,"TTTATCA","CTGA","TGGATGT","CTGA",2.41558136956646,11,7,46,73,1.98071298480314,4.52114719547822,7.74599191597512,101,"ENSG00000079974.19"
"24010","ENSG00000174842.17_23786",23778,23786,9,"ENSG00000174842.17",1,1,"MVUVVVVVV",1,7,0.789648033126294,98,104,133,136,142,148,161,164,"ATGAGGA","TTAA","CTGGTAA","CTGA",2.45818758921864,29,6,13,57,1.9615048839495,4.58735553635177,7.74594766885695,101,"ENSG00000079974.19"
"37119","ENSG00000245482.2_8500",8492,8500,9,"ENSG00000245482.2",1,2,"UMVVVVVVV",1,7,0.786749482401656,87,93,102,105,113,119,133,136,"TTTATGA","TAGA","ATGTGGC","CTGA",2.35025283485174,9,8,14,40,2.72737354667585,4.59893144475519,7.74592937436182,101,"ENSG00000079974.19"
"36945","ENSG00000243797.6_358113",358105,358113,9,"ENSG00000243797.6",1,8,"VVVVVVUMV",1,7,0.770186335403727,113,119,133,136,148,154,186,189,"GAGATGA","GAGA","GTGAGGA","CTGA",2.52605945188381,14,12,32,67,1.82011176085228,4.66512702668608,7.74587236830099,101,"ENSG00000079974.19"
"11031","ENSG00000133657.17_84867",84859,84867,9,"ENSG00000133657.17",1,1,"MVVVVUVVV",1,7,0.82815734989648,116,122,133,136,164,170,181,184,"ATGACGA","GAGA","CTGATGA","GTGA",2.35484446437008,11,28,11,59,2.03390705499679,4.43321753769933,7.74584693728525,101,"ENSG00000079974.19"
"12796","ENSG00000139144.11_311277",311269,311277,9,"ENSG00000139144.11",1,8,"UVVVVVVMV",1,7,0.786749482401656,115,121,133,136,137,143,156,159,"ATCATGT","CTGC","ATATGGA","CTGA",2.40281001124329,12,1,13,35,2.37663210732001,4.59884137890215,7.74583930850877,101,"ENSG00000079974.19"
"19926","ENSG00000164024.12_9907",9899,9907,9,"ENSG00000164024.12",1,2,"VMVVVUVVV",1,7,0.806211180124223,65,71,82,85,93,99,133,136,"GTGATGA","CTTA","CTGGTGG","CTGG",2.40884747099188,11,8,34,62,2.02497498745781,4.52098953185092,7.74583425234781,101,"ENSG00000079974.19"
"24439","ENSG00000176393.11_6225",6217,6225,9,"ENSG00000176393.11",1,1,"MVVVVVUVV",1,7,0.792132505175983,104,110,133,136,146,152,180,183,"TTGATGA","CACA","CAGATGA","CTGA",2.54451245582828,23,10,28,70,1.34575000676489,4.57729159473835,7.74582161544228,101,"ENSG00000079974.19"
"39705","ENSG00000254101.8_383733",383725,383733,9,"ENSG00000254101.8",1,6,"VVVVVMUVV",1,7,0.788819875776397,109,115,133,136,142,148,162,165,"CTGAGGC","CAGA","GGGATGC","CTGA",2.3756752617271,18,6,14,47,2.52428954133017,4.59053115487771,7.7458106579833,101,"ENSG00000079974.19"
"29911","ENSG00000198860.14_63707",63699,63707,9,"ENSG00000198860.14",1,8,"UVVVVVVMV",1,7,0.786749482401656,93,99,133,136,146,152,195,198,"ATAATGA","CAGG","GTGATGA","CTGA",2.62104580266618,34,10,43,96,0.921581522558124,4.59880505174983,7.74580298135645,101,"ENSG00000079974.19"
"13226","ENSG00000140694.18_100106",100098,100106,9,"ENSG00000140694.18",1,1,"MVVVVUVVV",1,7,0.82815734989648,98,104,133,136,140,146,161,164,"ATGATGA","GGGA","GTGGGGA","CGGA",2.40288660928719,29,4,15,57,1.71343136559937,4.43316885687849,7.74579825646441,101,"ENSG00000079974.19"
"9346","ENSG00000124201.15_18631",18623,18631,9,"ENSG00000124201.15",1,1,"MVVVVVUVV",1,7,0.792132505175983,102,108,133,136,161,167,179,182,"ATAATGA","ATGA","ATGAATC","CTGA",2.55829527836215,25,25,12,71,1.25373132545279,4.57725829530011,7.74578831600404,101,"ENSG00000079974.19"
"42793","ENSG00000266846.2_211997",211989,211997,9,"ENSG00000266846.2",1,2,"VMVVVUVVV",1,7,0.806211180124223,113,119,133,136,141,147,179,182,"GTGAGCA","CGGA","AAGATGA","CTGA",2.41468154726431,14,5,32,60,1.98569817523472,4.5208937892492,7.74573850974609,101,"ENSG00000079974.19"
"8357","ENSG00000118420.17_153990",153982,153990,9,"ENSG00000118420.17",1,8,"VVVVVUVMV",1,7,0.806211180124224,114,120,133,136,146,152,172,175,"CCGATGA","TTAA","ATAATCA","CTGA",2.35095268582548,13,10,20,52,2.41052112524927,4.52088475768811,7.74572947818501,101,"ENSG00000079974.19"
"24202","ENSG00000175497.17_11705",11697,11705,9,"ENSG00000175497.17",1,8,"VVVVVVUMV",1,7,0.770186335403727,114,120,133,136,148,154,201,204,"GGGATGA","AGGA","TTGATGA","CTGA",2.53404751169715,13,12,47,81,1.76626267349133,4.66497818786808,7.74572352948299,101,"ENSG00000079974.19"
"22452","ENSG00000170579.17_801917",801909,801917,9,"ENSG00000170579.17",1,8,"UVVVVVVMV",1,7,0.786749482401656,101,107,133,136,172,178,189,192,"ATGAGGA","CAGT","CTGATGA","CTGA",2.58886561157767,26,36,11,82,1.13577856612156,4.5987206608265,7.74571859043313,101,"ENSG00000079974.19"
"15428","ENSG00000148219.18_496979",496971,496979,9,"ENSG00000148219.18",0,NA,"VVUVVVUVV",2,7,0.769772256728778,113,119,133,136,160,166,187,190,"ATGATGG","CTTC","ATGAGGA","CTGA",2.56429557374941,14,24,21,68,1.57089215256012,4.66654899438904,7.74563802130415,101,"ENSG00000079974.19"
"35926","ENSG00000237484.7_56239",56231,56239,9,"ENSG00000237484.7",1,8,"UVVVVVVMV",1,7,0.786749482401656,93,99,105,108,112,118,133,136,"CTGATGA","ATGA","ATGATAC","GTGA",2.41282910114425,6,4,15,34,2.30900909342729,4.59863410859724,7.74563203820387,101,"ENSG00000079974.19"
"28886","ENSG00000196632.11_1739",1731,1739,9,"ENSG00000196632.11",1,7,"UVVVVVMVV",1,7,0.787991718426501,78,84,100,103,116,122,133,136,"GTGGTGA","CTGA","TTGACTA","GTGA",2.37831360114904,16,13,11,49,2.51902144510395,4.59361136319105,7.74557823689705,101,"ENSG00000079974.19"
"20953","ENSG00000166035.11_138596",138588,138596,9,"ENSG00000166035.11",1,1,"MVVVVUVVV",1,7,0.82815734989648,114,120,133,136,151,157,176,179,"TGGAAGA","CTGT","CTGAGGC","CTGA",2.3410489777092,13,15,19,56,2.12473227694065,4.43293136541715,7.74556076500308,101,"ENSG00000079974.19"
"613","ENSG00000021645.20_1475667",1475659,1475667,9,"ENSG00000021645.20",1,7,"VVVUVVMVV",1,7,0.766045548654244,114,120,133,136,142,148,197,200,"AGGAAGC","CTGA","ATGATGT","CTGA",2.51140888153503,13,6,49,77,1.98248073634324,4.68130165331086,7.74548384792783,101,"ENSG00000079974.19"
"3153","ENSG00000081803.17_496702",496694,496702,9,"ENSG00000081803.17",1,8,"VVVVVVUMV",1,7,0.770186335403727,113,119,133,136,143,149,160,163,"AGAATGA","GTGT","GTGATAG","CTGA",2.35276676902175,14,7,11,41,2.97383677531519,4.66473714219838,7.74548248381329,101,"ENSG00000079974.19"
"69","ENSG00000003436.16_82831",82823,82831,9,"ENSG00000003436.16",1,1,"MVVUVVVVV",1,7,0.786749482401656,99,105,133,136,146,152,172,175,"ATGATTA","ATGA","GGGAGCA","CTGA",2.53519081804438,28,10,20,67,1.49259001586699,4.59846553404072,7.74546346364735,101,"ENSG00000079974.19"
"12578","ENSG00000138669.10_104000",103992,104000,9,"ENSG00000138669.10",1,6,"VVVUVMVVV",1,7,0.78343685300207,116,122,133,136,144,150,158,161,"AAGAAGT","CAGA","GGCATGA","CTGA",2.31040067609701,11,8,8,36,3.0441558848178,4.61170676469947,7.74545417670775,101,"ENSG00000079974.19"
"29283","ENSG00000197585.10_243379",243371,243379,9,"ENSG00000197585.10",1,2,"UMVVVVVVV",1,7,0.786749482401656,113,119,133,136,156,162,176,179,"CTAATGA","CAGT","ATGATCA","CTGA",2.44207930295076,14,20,14,57,2.11325728462596,4.59844649274109,7.74544442234772,101,"ENSG00000079974.19"
"14957","ENSG00000146374.14_58874",58866,58874,9,"ENSG00000146374.14",1,5,"UVVVMVVVV",1,7,0.789233954451346,73,79,94,97,107,113,133,136,"GCGATGT","TTGA","CAGATGC","CTGA",2.40444910176337,15,10,20,54,2.32417832519765,4.58845975090503,7.74539556871041,101,"ENSG00000079974.19"
"16904","ENSG00000152601.18_177119",177111,177119,9,"ENSG00000152601.18",1,2,"VMVVVVUVV",1,7,0.770186335403727,114,120,133,136,148,154,173,176,"CTGATGG","CAGC","GTGAAGC","CTGA",2.44822494471694,13,12,19,53,2.33691292363537,4.66460313877041,7.74534848038532,101,"ENSG00000079974.19"
"11118","ENSG00000133983.16_35990",35982,35990,9,"ENSG00000133983.16",1,6,"UVVVVMVVV",1,7,0.805383022774327,110,116,133,136,143,149,164,167,"ATTATGC","CTCT","TTGTAGA","CTGA",2.32819104602121,17,7,15,48,2.57392178479345,4.52379885623371,7.74533094733102,101,"ENSG00000079974.19"
"30782","ENSG00000213463.5_36096",36088,36096,9,"ENSG00000213463.5",1,6,"UVVVVMVVV",1,7,0.805383022774327,110,116,133,136,143,149,164,167,"ATTATGC","CTCT","TTGTAGA","CTGA",2.32819104602121,17,7,15,48,2.57392178479345,4.52379885623371,7.74533094733102,101,"ENSG00000079974.19"
"41184","ENSG00000258644.6_36080",36072,36080,9,"ENSG00000258644.6",1,6,"UVVVVMVVV",1,7,0.805383022774327,110,116,133,136,143,149,164,167,"ATTATGC","CTCT","TTGTAGA","CTGA",2.32819104602121,17,7,15,48,2.57392178479345,4.52379885623371,7.74533094733102,101,"ENSG00000079974.19"
"17868","ENSG00000155629.15_88445",88437,88445,9,"ENSG00000155629.15",1,3,"VVMVVUVVV",1,7,0.804968944099379,108,114,133,136,150,156,171,174,"CTGATCA","CTTC","CTGATGT","CTGA",2.41275640887882,19,14,15,57,2.01671851161793,4.52544030936918,7.7453160857667,101,"ENSG00000079974.19"
"6299","ENSG00000109320.14_54362",54354,54362,9,"ENSG00000109320.14",1,2,"VMVVVUVVV",1,7,0.806211180124223,31,37,62,65,76,82,133,136,"ATGATTA","ATGA","CTAACGA","CTGA",2.56095095317952,25,11,51,96,1.00884550349956,4.52046296450742,7.74530768500432,101,"ENSG00000079974.19"
"8615","ENSG00000119787.14_21083",21075,21083,9,"ENSG00000119787.14",1,2,"UMVVVVVVV",1,7,0.786749482401656,75,81,96,99,116,122,133,136,"TCGATGA","CTCA","AAGAAAA","CTGA",2.41041538794428,15,17,11,52,2.32366327493513,4.59827479864092,7.74527272824754,101,"ENSG00000079974.19"
"18099","ENSG00000156113.24_590457",590449,590457,9,"ENSG00000156113.24",1,1,"MVVVUVVVV",1,7,0.795859213250517,115,121,133,136,138,144,159,162,"CAGATGG","CTGT","CTGAAAA","CTGA",2.37675142768917,12,2,15,38,2.40231030417994,4.56182995552693,7.745266808529,101,"ENSG00000079974.19"
"24718","ENSG00000177694.16_1174055",1174047,1174055,9,"ENSG00000177694.16",1,8,"VVVVVVUMV",1,7,0.770186335403727,105,111,133,136,141,147,178,181,"TTGATTA","CTGA","CTGTTAA","CTGA",2.59236479333956,22,5,31,67,1.37564687129027,4.66451970672184,7.74526504833675,101,"ENSG00000079974.19"
"46955","ENSG00000287409.1_67906",67898,67906,9,"ENSG00000287409.1",1,6,"VVVVVMUVV",1,7,0.788819875776397,43,49,70,73,79,85,133,136,"GAGATGA","CTGA","GTGATGA","CAGA",2.54434119492892,21,6,48,84,1.39746560244136,4.58993505882521,7.7452145619308,101,"ENSG00000079974.19"
"5509","ENSG00000105464.4_30105",30097,30105,9,"ENSG00000105464.4",0,NA,"VVVVUVUVV",2,7,0.775983436853002,111,117,133,136,153,159,170,173,"ATGCTAA","TTGA","GTAAGGA","CTGA",2.44696225049785,16,17,11,53,2.25195535187037,4.64125925546401,7.74519300287601,101,"ENSG00000079974.19"
"22943","ENSG00000171735.20_779344",779336,779344,9,"ENSG00000171735.20",1,8,"VVUVVVVMV",1,7,0.767701863354037,113,119,133,136,142,148,157,160,"AGGAGGA","GTGA","AGAAGGA","CTGA",2.3536975401157,14,6,9,38,3.00615666399917,4.67436839952596,7.7451758529421,101,"ENSG00000079974.19"
"20555","ENSG00000165084.16_148326",148318,148326,9,"ENSG00000165084.16",1,8,"UVVVVVVMV",1,7,0.786749482401656,92,98,133,136,142,148,204,207,"ATGAGGA","ATGA","GAGAAGA","CTGA",2.60994876450531,35,6,56,106,0.993042208554945,4.59817515964759,7.74517308925422,101,"ENSG00000079974.19"
"29771","ENSG00000198690.10_9624",9616,9624,9,"ENSG00000198690.10",1,8,"UVVVVUVMV",2,6,0.708902691511387,112,118,133,136,184,190,199,202,"ATGATGA","AAGA","TGGATGA","CTGA",2.65930861634476,15,48,9,81,1.90945047783163,4.90954364669917,7.74515441274471,101,"ENSG00000079974.19"
"42311","ENSG00000261628.1_703",695,703,9,"ENSG00000261628.1",1,8,"UVVVVUVMV",2,6,0.708902691511387,112,118,133,136,184,190,199,202,"ATGATGA","AAGA","TGGATGA","CTGA",2.65930861634476,15,48,9,81,1.90945047783163,4.90954364669917,7.74515441274471,101,"ENSG00000079974.19"
"44736","ENSG00000283480.1_5577",5569,5577,9,"ENSG00000283480.1",1,8,"VVVVUVVMV",1,7,0.773913043478261,116,122,133,136,142,148,165,168,"CTGACAA","CTGG","CTGATGT","CTGA",2.38939269470894,11,6,17,43,2.6686106490974,4.64947382012258,7.74512599403562,101,"ENSG00000079974.19"
"19568","ENSG00000163320.12_59241",59233,59241,9,"ENSG00000163320.12",1,2,"VMVUVVVVV",1,7,0.764803312629399,79,85,102,105,110,116,133,136,"ATGATGT","GTGA","ATGGTGA","ATGA",2.45365878872947,17,5,17,48,2.38590967313099,4.68590873283186,7.74512198334946,101,"ENSG00000079974.19"
"15299","ENSG00000147649.10_35188",35180,35188,9,"ENSG00000147649.10",0,NA,"UVVVVUVVV",2,7,0.824844720496894,94,100,133,136,149,155,210,213,"ATGATGA","CCAA","TTTCTGA","CTGA",2.56065542231844,33,13,55,110,0.711871786111359,4.44572698372524,7.74510586571282,101,"ENSG00000079974.19"
"4540","ENSG00000100991.12_50279",50271,50279,9,"ENSG00000100991.12",1,2,"VMVVVUVVV",1,7,0.806211180124223,106,112,133,136,139,145,164,167,"ATCATTA","ATGA","ATGCAGA","CTGA",2.45919757003279,21,3,19,52,1.68624469237357,4.5202237898147,7.7450685103116,101,"ENSG00000079974.19"
"22074","ENSG00000169760.18_894599",894591,894599,9,"ENSG00000169760.18",0,NA,"UVVVUVVVV",2,7,0.792546583850932,38,44,70,73,113,119,133,136,"TTGCTGA","CTGA","GAGATAA","CTGA",2.5930591848023,26,40,14,89,1.01239473142527,4.57486399086016,7.74505032626388,101,"ENSG00000079974.19"
"19891","ENSG00000163902.12_25490",25482,25490,9,"ENSG00000163902.12",1,1,"MVVVUVVVV",1,7,0.795859213250517,107,113,133,136,140,146,186,189,"ATGAGGA","TTAA","TTGAAGA","CTGA",2.53462340002945,20,4,40,73,1.34859553188124,4.56152121635272,7.74495806935479,101,"ENSG00000079974.19"
"46588","ENSG00000286863.2_249264",249256,249264,9,"ENSG00000286863.2",0,NA,"UVVVVVUVV",2,7,0.788819875776397,93,99,106,109,112,118,133,136,"GTGATGG","CTGC","GTGAAGA","TTGA",2.40931125663502,7,3,15,34,2.29642989754895,4.58962623544559,7.74490573855118,101,"ENSG00000079974.19"
"21143","ENSG00000166573.6_18095",18087,18095,9,"ENSG00000166573.6",1,2,"VMVVVUVVV",1,7,0.806211180124223,95,101,133,136,143,149,158,161,"GCGATGA","CAAA","ACGAAGA","CTGA",2.4087211816148,32,7,9,57,2.02199465735455,4.52003396702997,7.74487868752687,101,"ENSG00000079974.19"
"28300","ENSG00000188641.14_592831",592823,592831,9,"ENSG00000188641.14",1,2,"VMVVVUVVV",1,7,0.806211180124223,114,120,133,136,142,148,162,165,"GTAATCA","CCGC","GTGTTGT","CTGA",2.28179053448312,13,6,14,42,2.86819816555468,4.5200337655272,7.7448784860241,101,"ENSG00000079974.19"
"34293","ENSG00000232542.1_17972",17964,17972,9,"ENSG00000232542.1",1,2,"VMVVVUVVV",1,7,0.806211180124223,114,120,133,136,142,148,162,165,"GTAATCA","CCGC","GTGTTGT","CTGA",2.28179053448312,13,6,14,42,2.86819816555468,4.5200337655272,7.7448784860241,101,"ENSG00000079974.19"
"6739","ENSG00000111731.13_47654",47646,47654,9,"ENSG00000111731.13",1,2,"UMVVVVVVV",1,7,0.786749482401656,115,121,133,136,140,146,160,163,"GTAACGT","ATGA","CTGATGT","CTGA",2.34559721288312,12,4,14,39,2.75407800779817,4.59784819008808,7.7448461196947,101,"ENSG00000079974.19"
"38620","ENSG00000250634.6_221106",221098,221106,9,"ENSG00000250634.6",1,1,"MVVVVVUVV",1,7,0.792132505175983,82,88,100,103,111,117,133,136,"ATTAAGA","CTGA","CAGATGA","CTAA",2.33308227810808,12,8,16,45,2.75134207376402,4.57630598195447,7.74483600265841,101,"ENSG00000079974.19"
"8887","ENSG00000121289.18_27101",27093,27101,9,"ENSG00000121289.18",1,3,"VVMUVVVVV",1,7,0.763561076604555,110,116,133,136,152,158,173,176,"ATGAAGT","GTGG","GTGATGA","CTGA",2.50524208542259,17,16,15,57,2.0607174363451,4.69058283479058,7.7448271412088,101,"ENSG00000079974.19"
"14314","ENSG00000144668.12_326814",326806,326814,9,"ENSG00000144668.12",1,7,"VVVVVUMVV",1,7,0.807453416149068,112,118,133,136,173,179,190,193,"AGGGTGA","CTTA","GTTACGA","CTGA",2.42269327913241,15,37,11,72,1.90870357214995,4.51499802492484,7.74481168952112,101,"ENSG00000079974.19"
"26952","ENSG00000185345.24_462628",462620,462628,9,"ENSG00000185345.24",1,8,"UVVVVVVMV",1,7,0.786749482401656,107,113,133,136,142,148,185,188,"ATCATGA","CAAA","TTGAAGA","CTGA",2.53204033704405,20,6,37,72,1.51074456882269,4.59775337061242,7.74475130021904,101,"ENSG00000079974.19"
"36437","ENSG00000240963.1_8272",8264,8272,9,"ENSG00000240963.1",1,2,"VMVVUVVVV",1,7,0.773913043478261,115,121,133,136,139,145,154,157,"AGGCAGA","GTGA","TTGAAGA","CTGA",2.3532728586417,12,3,9,33,2.90790712619639,4.6490982126186,7.74475038653165,101,"ENSG00000079974.19"
"5733","ENSG00000106536.21_174287",174279,174287,9,"ENSG00000106536.21",1,2,"UMVVVVVVV",1,7,0.786749482401656,85,91,133,136,148,154,173,176,"ATCATGA","CTCA","CTGGTTA","CTGA",2.55735756212269,42,12,19,82,1.34185213884007,4.59772563824784,7.74472356785446,101,"ENSG00000079974.19"
"1087","ENSG00000047617.17_29342",29334,29342,9,"ENSG00000047617.17",1,6,"VVVVVMUVV",1,7,0.788819875776397,98,104,133,136,149,155,169,172,"ATTATGA","TTGA","GCCATGG","CTGA",2.5100371351037,29,13,14,65,1.62408447156051,4.58941634306295,7.74469584616855,101,"ENSG00000079974.19"
"25067","ENSG00000179387.10_2944",2936,2944,9,"ENSG00000179387.10",0,NA,"VVVUVUVVV",2,7,0.802898550724638,112,118,133,136,149,155,167,170,"ATGAAAA","CTCT","AAGATGA","CTGA",2.33542404207301,15,13,12,49,2.56289048897069,4.5330960256977,7.74469022859625,101,"ENSG00000079974.19"
"5651","ENSG00000106069.25_224649",224641,224649,9,"ENSG00000106069.25",0,NA,"VVUVUVVVV",2,7,0.773498964803312,95,101,133,136,139,145,192,195,"GTGATGA","GTGA","AAGAAGA","CTGA",2.68104529851277,32,3,47,91,0.729097935458767,4.65068331471931,7.74467917393256,101,"ENSG00000079974.19"
"45157","ENSG00000285162.1_248878",248870,248878,9,"ENSG00000285162.1",0,NA,"VVUVUVVVV",2,7,0.773498964803312,95,101,133,136,139,145,192,195,"GTGATGA","GTGA","AAGAAGA","CTGA",2.68104529851277,32,3,47,91,0.729097935458767,4.65068331471931,7.74467917393256,101,"ENSG00000079974.19"
"41378","ENSG00000258932.5_438447",438439,438447,9,"ENSG00000258932.5",1,8,"VVVVVUVMV",1,7,0.806211180124224,84,90,102,105,115,121,133,136,"CTGCTGA","CTGA","GTCCTAA","CTCA",2.28154770277763,12,10,12,43,2.86881199349382,4.51978250300285,7.74462722349974,101,"ENSG00000079974.19"
"1502","ENSG00000058091.17_458539",458531,458539,9,"ENSG00000058091.17",1,8,"VVVVVUVMV",1,7,0.806211180124224,114,120,133,136,175,181,203,206,"TTAATGA","CTGG","GTGCTGC","CTGA",2.50002564593822,13,39,22,83,1.41228980433157,4.51978186097992,7.74462658147682,101,"ENSG00000079974.19"
"798","ENSG00000033867.17_26234",26226,26234,9,"ENSG00000033867.17",1,2,"UMVVVVVVV",1,7,0.786749482401656,112,118,133,136,160,166,176,179,"TTGATGA","GTTA","GTATTGC","CTGA",2.45015200103682,15,24,10,58,2.05612333466116,4.59761750205998,7.74461543166661,101,"ENSG00000079974.19"
"10874","ENSG00000133026.14_138414",138406,138414,9,"ENSG00000133026.14",1,8,"VVVVUVVMV",1,7,0.773913043478261,95,101,133,136,145,151,163,166,"ATGACGA","AAGA","CTGAAGG","CTGA",2.49955596275609,32,9,12,62,1.9320078871085,4.64892857637061,7.74458075028366,101,"ENSG00000079974.19"
"28261","ENSG00000188580.15_599675",599667,599675,9,"ENSG00000188580.15",1,7,"UVVVVVMVV",1,7,0.787991718426501,112,118,133,136,144,150,162,165,"GTGAATA","TTGT","ATGATTA","CTGA",2.32609636477268,15,8,12,44,2.86287027441583,4.5925448432251,7.7445117169311,101,"ENSG00000079974.19"
"19239","ENSG00000162601.12_42193",42185,42193,9,"ENSG00000162601.12",1,7,"UVVVVVMVV",1,7,0.787991718426501,88,94,101,104,111,117,133,136,"CTGATGA","GTGA","GTAATGG","CTGC",2.39323825912889,7,7,16,39,2.41506977045634,4.59249787449558,7.74446474820158,101,"ENSG00000079974.19"
"2570","ENSG00000075884.14_417317",417309,417317,9,"ENSG00000075884.14",1,6,"UVVVVMVVV",1,7,0.805383022774327,84,90,104,107,116,122,133,136,"GTGATGT","CAGA","GAGATAG","TTGA",2.27679172484184,14,9,11,43,2.91263987276715,4.52281284292819,7.7443449340255,101,"ENSG00000079974.19"
"35460","ENSG00000236107.10_204908",204900,204908,9,"ENSG00000236107.10",1,7,"VVVVVUMVV",1,7,0.807453416149068,115,121,133,136,145,151,160,163,"TTAATCA","TAGA","TTAATGA","CTGA",2.25947351901508,12,9,9,39,2.9941639103681,4.5143301759505,7.74414384054677,101,"ENSG00000079974.19"
"47845","ENSG00000289484.1_65878",65870,65878,9,"ENSG00000289484.1",1,2,"VMUVVVVVV",1,7,0.767701863354037,104,110,133,136,141,147,165,168,"ATGAAGA","CAGA","GGGTTTA","CTGA",2.52786322068111,23,5,18,55,1.84056495289412,4.67324660602538,7.74405405944153,101,"ENSG00000079974.19"
"35819","ENSG00000237298.11_8283",8275,8283,9,"ENSG00000237298.11",1,8,"UVVVVVVMV",1,7,0.786749482401656,72,78,93,96,101,107,133,136,"GTAATGA","CTGA","AAGATGA","TTGA",2.44661519711692,15,5,26,55,2.07731873286347,4.59702167841073,7.74401960801736,101,"ENSG00000079974.19"
"21049","ENSG00000166326.7_19421",19413,19421,9,"ENSG00000166326.7",1,3,"UVMVVVVVV",1,7,0.785507246376811,112,118,133,136,181,187,199,202,"AGAATTA","CTGA","CTGAAGA","CTGA",2.48065210808903,15,45,12,81,1.87015678120542,4.60195937544975,7.74398836095699,101,"ENSG00000079974.19"
"4313","ENSG00000100154.15_295432",295424,295432,9,"ENSG00000100154.15",1,1,"MVVUVVVVV",1,7,0.786749482401656,89,95,133,136,143,149,168,171,"ATGATGA","GCGA","GTGATGA","CTCA",2.52145399383158,38,7,19,73,1.57826177425442,4.59698876661623,7.74398669622286,101,"ENSG00000079974.19"
"712","ENSG00000027075.17_77081",77073,77081,9,"ENSG00000027075.17",1,7,"VVVVVUMVV",1,7,0.807453416149068,116,122,133,136,145,151,164,167,"ATGGGGA","CATA","GTGACCT","CTGA",2.27921108506215,11,9,13,42,2.8619218755468,4.51416561065695,7.74397927525322,101,"ENSG00000079974.19"
"25615","ENSG00000182240.16_35978",35970,35978,9,"ENSG00000182240.16",0,NA,"VVUUVVVVV",2,7,0.764389233954451,109,115,133,136,148,154,165,168,"GTGAGGA","CCAA","CTGGTGA","CTGA",2.44903631600323,18,12,11,50,2.41874360150039,4.68641309371382,7.74397002953162,101,"ENSG00000079974.19"
"24785","ENSG00000178031.18_177010",177002,177010,9,"ENSG00000178031.18",1,6,"VVVVVMUVV",1,7,0.788819875776397,57,63,79,82,88,94,133,136,"ATGTTGA","TTGG","ATGCTGT","CTGA",2.47621879679655,16,6,39,70,1.84660301797306,4.58868208248752,7.74396158559311,101,"ENSG00000079974.19"
"23453","ENSG00000172987.13_238439",238431,238439,9,"ENSG00000172987.13",1,1,"MVVVVUVVV",1,7,0.82815734989648,95,101,112,115,116,122,133,136,"AAGATGT","TTGA","GTGTGGA","CTGT",2.27736984423686,11,1,11,32,2.54284999452133,4.43132890569177,7.74395830527769,101,"ENSG00000079974.19"
"9682","ENSG00000126216.15_81785",81777,81785,9,"ENSG00000126216.15",0,NA,"VVVUUVVVV",2,7,0.770600414078675,71,77,97,100,111,117,133,136,"CTCATGA","CTGT","CTGCGGA","CTGA",2.48432637428361,20,11,16,56,2.08398869561172,4.66154113104228,7.74394278735698,101,"ENSG00000079974.19"
"28556","ENSG00000196104.11_271625",271617,271625,9,"ENSG00000196104.11",1,8,"UVVVVUVMV",2,6,0.708902691511387,115,121,133,136,150,156,168,171,"ATGATCA","ATGA","GTGACAG","CTGA",2.55742803408894,12,14,12,47,2.58378750295285,4.90832693255311,7.74393769859866,101,"ENSG00000079974.19"
"3993","ENSG00000091651.9_5399",5391,5399,9,"ENSG00000091651.9",1,2,"VMVVVUVVV",1,7,0.806211180124223,115,121,133,136,152,158,171,174,"CTGATAT","GTGA","CTTTTGA","CTGA",2.35014928914772,12,16,13,50,2.40868406116155,4.51908649720326,7.74393121770015,101,"ENSG00000079974.19"
"37320","ENSG00000247134.8_12639",12631,12639,9,"ENSG00000247134.8",0,NA,"VVUVVUVVV",2,7,0.805797101449275,55,61,100,103,109,115,133,136,"ATGATGG","CTGA","CTCAAGA","CTGG",2.46913862080146,39,6,18,72,1.62193970092601,4.52071595990061,7.74390436569771,101,"ENSG00000079974.19"
"22442","ENSG00000170579.17_514846",514838,514846,9,"ENSG00000170579.17",1,6,"VVVUVMVVV",1,7,0.78343685300207,97,103,111,114,116,122,133,136,"TTAGTGA","CTGA","GGAAAGA","CTGA",2.37377393713403,8,2,11,30,2.6154655359637,4.61015627921431,7.74390369122259,101,"ENSG00000079974.19"
"25347","ENSG00000181031.16_133697",133689,133697,9,"ENSG00000181031.16",1,2,"VMVVVVUVV",1,7,0.770186335403727,113,119,133,136,144,150,167,170,"CTGTGGA","ATGA","GTTATGA","CTGA",2.40037665269696,14,8,17,48,2.64998840369942,4.66312485541979,7.7438701970347,101,"ENSG00000079974.19"
"3261","ENSG00000082805.21_213165",213157,213165,9,"ENSG00000082805.21",1,7,"VVVVUVMVV",1,7,0.775155279503105,111,117,133,136,145,151,169,172,"ATGATAC","CTAA","AGGATCA","CTGA",2.42220971759508,16,9,18,52,2.42482102039496,4.64322145109053,7.74384256910296,101,"ENSG00000079974.19"
"8165","ENSG00000117114.21_131970",131962,131970,9,"ENSG00000117114.21",1,1,"MVVVVUVVV",1,7,0.82815734989648,102,108,133,136,144,150,158,161,"GTGATCA","ATGA","TTGATGT","CTGG",2.33781943245626,25,8,8,50,2.13930864726638,4.43119288257702,7.74382228216294,101,"ENSG00000079974.19"
"7688","ENSG00000115355.18_97263",97255,97263,9,"ENSG00000115355.18",1,6,"VVVUVMVVV",1,7,0.78343685300207,109,115,133,136,148,154,198,201,"ATGAGGA","CTCC","GTGAAGA","CTGA",2.54967969928866,18,12,44,83,1.44130573316963,4.6097925987735,7.74354001078178,101,"ENSG00000079974.19"
"4262","ENSG00000099991.18_147346",147338,147346,9,"ENSG00000099991.18",1,7,"UVVVVVMVV",1,7,0.787991718426501,116,122,133,136,172,178,187,190,"TTGCTGA","AGGA","GTGATGG","CTGA",2.45647534266856,11,36,9,65,1.9897668462243,4.59156728267033,7.74353415637634,101,"ENSG00000079974.19"
"24854","ENSG00000178234.13_53543",53535,53543,9,"ENSG00000178234.13",1,2,"UMVVVUVVV",2,6,0.708902691511387,115,121,133,136,138,144,152,155,"ATTAGGA","CTGA","CTCATGC","CTGA",2.52214453117549,12,2,8,31,2.81723734531405,4.90788355495434,7.74349432099988,101,"ENSG00000079974.19"
"3912","ENSG00000090863.12_40762",40754,40762,9,"ENSG00000090863.12",1,1,"MVVVVUVVV",1,7,0.82815734989648,109,115,133,136,141,147,157,160,"ACGATGA","CTGG","GGGACAA","CTGT",2.26621842058856,18,5,10,42,2.61520177498464,4.4308311447271,7.74346054431302,101,"ENSG00000079974.19"
"36382","ENSG00000240405.7_327696",327688,327696,9,"ENSG00000240405.7",1,1,"MVVVUVVVV",1,7,0.795859213250517,46,52,65,68,92,98,133,136,"ATGATGA","CTAA","ATGAGGA","CCGA",2.55668085952035,13,24,35,81,1.19539453714921,4.55998340015455,7.74342025315662,101,"ENSG00000079974.19"
"21225","ENSG00000166840.14_60414",60406,60414,9,"ENSG00000166840.14",1,1,"MVVUVVVVV",1,7,0.786749482401656,112,118,133,136,142,148,157,160,"GTGATGA","ATTA","ATGACTA","CTCA",2.31732821701369,15,6,9,39,2.93671406819146,4.59639221207069,7.74339014167731,101,"ENSG00000079974.19"
"44575","ENSG00000283072.3_53163",53155,53163,9,"ENSG00000283072.3",1,5,"VVUVMVVVV",1,7,0.770186335403727,91,97,103,106,111,117,133,136,"ATCAGGA","TTGA","CTGAATA","CTGA",2.45558104925426,6,5,16,36,2.27999430220081,4.66263365764064,7.74337899925555,101,"ENSG00000079974.19"
"23486","ENSG00000173068.19_142717",142709,142717,9,"ENSG00000173068.19",1,8,"VVVVUVVMV",1,7,0.773913043478261,95,101,108,111,116,122,133,136,"ATGATAG","CTGT","AAGGTGC","CTGA",2.37079933056735,7,5,11,32,2.78555061077569,4.64771987030617,7.74337204421921,101,"ENSG00000079974.19"
"31507","ENSG00000223930.9_123809",123801,123809,9,"ENSG00000223930.9",1,1,"MVVVVUVVV",1,7,0.82815734989648,114,120,133,136,143,149,161,164,"TTGGTGA","GTGC","GTGAGGA","ATGA",2.21175940727024,13,7,12,41,2.97784358213778,4.43072657431819,7.74335597390411,101,"ENSG00000079974.19"
"27731","ENSG00000187240.17_222362",222354,222362,9,"ENSG00000187240.17",1,7,"UVVVVVMVV",1,7,0.787991718426501,76,82,93,96,109,115,133,136,"ATGTTGG","CAGA","GTTACAA","CTGA",2.40900813809323,11,13,18,51,2.30549175894195,4.59138650322421,7.74335337693021,101,"ENSG00000079974.19"
"15875","ENSG00000149972.12_834642",834634,834642,9,"ENSG00000149972.12",1,1,"MVVVVUVVV",1,7,0.82815734989648,107,113,133,136,141,147,156,159,"ATGGTGG","GAGA","ATCTAGA","CTGA",2.29347020022919,20,5,9,43,2.43283348718246,4.43065870551093,7.74328810509685,101,"ENSG00000079974.19"
"8712","ENSG00000120440.15_16254",16246,16254,9,"ENSG00000120440.15",1,8,"VVVVVUVMV",1,7,0.806211180124224,107,113,133,136,143,149,158,161,"AGGATGA","GTGA","GTCCTGA","CTGC",2.33680360464378,20,7,9,45,2.49500504206971,4.51842393492373,7.74326865542062,101,"ENSG00000079974.19"
"15137","ENSG00000147145.14_7901",7893,7901,9,"ENSG00000147145.14",1,8,"UVVVVVVMV",1,7,0.786749482401656,70,76,92,95,112,118,133,136,"GTGCTGA","CTGC","GGGACCA","CTGA",2.44529186765863,16,17,15,57,2.08310214693543,4.59626198283158,7.7432599124382,101,"ENSG00000079974.19"
"6667","ENSG00000111269.3_21659",21651,21659,9,"ENSG00000111269.3",1,8,"VVVVVVUMV",1,7,0.770186335403727,112,118,133,136,145,151,179,182,"ATGATGC","TTAA","GTTTTGA","CTGA",2.49232274104301,15,9,28,61,2.0345561333471,4.66251026840846,7.74325561002336,101,"ENSG00000079974.19"
"1138","ENSG00000048052.24_630263",630255,630263,9,"ENSG00000048052.24",1,2,"VMVVVUVVV",1,7,0.806211180124223,113,119,133,136,150,156,182,185,"GGGAAGA","GTGA","CTGGTGA","CTGA",2.43757615452757,14,14,26,63,1.82302394780024,4.51838291116267,7.74322763165957,101,"ENSG00000079974.19"
"6047","ENSG00000107862.7_37029",37021,37029,9,"ENSG00000107862.7",1,8,"VVUVVVVMV",1,7,0.767701863354037,112,118,133,136,158,164,203,206,"ATTATGA","ATGA","GTGAATA","CTGA",2.63275281855937,15,22,39,85,1.13796887518463,4.67241358306177,7.74322103647792,101,"ENSG00000079974.19"
"13317","ENSG00000140945.17_621048",621040,621048,9,"ENSG00000140945.17",1,1,"MVVVVUVVV",1,7,0.82815734989648,107,113,133,136,147,153,179,182,"CTGTTGA","GAGA","AAGATGA","CTGA",2.42402235171024,20,11,26,66,1.56179568097013,4.43048617309293,7.74311557267885,101,"ENSG00000079974.19"
"42009","ENSG00000260314.3_14137",14129,14137,9,"ENSG00000260314.3",1,3,"VVMVUVVVV",1,7,0.772670807453416,114,120,133,136,149,155,182,185,"GTTATGA","TGGA","GTGTTGA","CTGA",2.50745974647375,13,13,27,62,1.89332074898588,4.65242976470272,7.74311299451639,101,"ENSG00000079974.19"
"23842","ENSG00000174456.16_39530",39522,39530,9,"ENSG00000174456.16",1,1,"MVVVUVVVV",1,7,0.795859213250517,36,42,57,60,77,83,133,136,"ATGAGGA","CTGA","GTGCTGA","CAGA",2.53478124242172,15,17,50,91,1.34008644574664,4.55965701547287,7.74309386847494,101,"ENSG00000079974.19"
"47453","ENSG00000288271.1_67610",67602,67610,9,"ENSG00000288271.1",1,7,"UVVVVVMVV",1,7,0.787991718426501,113,119,133,136,138,144,155,158,"TTGATAA","GAGA","TTGATAG","CTGA",2.36799002704259,14,2,11,36,2.57747349206256,4.59101841808662,7.74298529179263,101,"ENSG00000079974.19"
"34858","ENSG00000234297.2_853",845,853,9,"ENSG00000234297.2",1,1,"MVVVVVUVV",1,7,0.792132505175983,111,117,133,136,159,165,179,182,"ATGATCA","GAGA","CTGCTCA","CTGA",2.46228957977104,16,23,14,62,1.88232629504512,4.57439754004635,7.74292756075029,101,"ENSG00000079974.19"
"7818","ENSG00000115828.17_17661",17653,17661,9,"ENSG00000115828.17",1,8,"UVVVVVVMV",1,7,0.786749482401656,100,106,133,136,142,148,158,161,"TTGGTGT","CTAA","ATGAAGA","CTGA",2.4444981934386,27,6,10,52,2.08672106610521,4.5958439222573,7.74284185186392,101,"ENSG00000079974.19"
"37277","ENSG00000246560.3_6396",6388,6396,9,"ENSG00000246560.3",1,7,"VVVVVUMVV",1,7,0.807453416149068,109,115,133,136,148,154,164,167,"ATGTTGA","TTGA","ATGGTGG","CTGT",2.3428086400369,18,12,10,49,2.43337726510027,4.51302538300323,7.7428390475995,101,"ENSG00000079974.19"
"22270","ENSG00000170142.12_18717",18709,18717,9,"ENSG00000170142.12",1,1,"MVVVVUVVV",1,7,0.82815734989648,113,119,133,136,157,163,176,179,"CTGAAGA","ATGC","CTAATAA","CTGA",2.33990268703815,14,21,13,57,2.12138720220059,4.43018461228041,7.74281401186633,101,"ENSG00000079974.19"
"44912","ENSG00000284418.3_542218",542210,542218,9,"ENSG00000284418.3",1,2,"VMVVVUVVV",1,7,0.806211180124223,86,92,102,105,115,121,133,136,"TTTATTA","CTAA","GATATGA","CTGA",2.29081893196117,10,10,12,41,2.79974786452966,4.51796851940103,7.74281323989793,101,"ENSG00000079974.19"
"39401","ENSG00000253554.7_228268",228260,228268,9,"ENSG00000253554.7",1,3,"UVMVVVVVV",1,7,0.785507246376811,89,95,133,136,164,170,179,182,"CTGATGA","CTGT","GTGGGTA","CTGA",2.59917097364656,38,28,9,84,1.07501329569641,4.60070494666837,7.74273393217561,101,"ENSG00000079974.19"
"33017","ENSG00000228538.7_2608",2600,2608,9,"ENSG00000228538.7",1,8,"VVVVUUVMV",2,6,0.696066252587992,41,47,61,64,93,99,133,136,"ATGATGA","CTTA","GTGATAA","CTGA",2.81173309965159,14,29,34,86,1.08880284148998,4.95842254312515,7.74268755347711,101,"ENSG00000079974.19"
"41436","ENSG00000259040.5_150375",150367,150375,9,"ENSG00000259040.5",1,1,"MVVVUUVVV",2,6,0.718012422360248,106,112,133,136,147,153,169,172,"CTGATGA","GTGA","GTGCAGG","CTGA",2.62182175333739,21,11,16,57,2.00341292320107,4.87055615302925,7.74260584247024,101,"ENSG00000079974.19"
"12384","ENSG00000138032.21_62594",62586,62594,9,"ENSG00000138032.21",1,8,"VVVVVUVMV",1,7,0.806211180124224,87,93,133,136,186,192,208,211,"ATGCTGA","CTGC","GTGACAA","CTGA",2.59648830712915,40,50,16,115,0.760918696221469,4.51771018593729,7.74255490643418,101,"ENSG00000079974.19"
"45391","ENSG00000285542.1_61712",61704,61712,9,"ENSG00000285542.1",1,8,"VVVVVUVMV",1,7,0.806211180124224,87,93,133,136,186,192,208,211,"ATGCTGA","CTGC","GTGACAA","CTGA",2.59648830712915,40,50,16,115,0.760918696221469,4.51771018593729,7.74255490643418,101,"ENSG00000079974.19"
"38059","ENSG00000249464.8_193730",193722,193730,9,"ENSG00000249464.8",1,1,"MVVVVUVVV",1,7,0.82815734989648,93,99,133,136,144,150,159,162,"ATGATGA","CTAT","ATGGTAA","ATGA",2.35818784097883,34,8,9,60,1.99735274408851,4.42965125432018,7.7422806539061,101,"ENSG00000079974.19"
"28575","ENSG00000196150.14_23911",23903,23911,9,"ENSG00000196150.14",1,8,"VVVVVVUMV",1,7,0.770186335403727,96,102,133,136,140,146,164,167,"GTGATGC","ATGA","CTGAGAA","CTGA",2.57101247685916,31,4,18,62,1.50587241761006,4.66148889916779,7.74223424078269,101,"ENSG00000079974.19"
"25435","ENSG00000181409.14_30738",30730,30738,9,"ENSG00000181409.14",1,8,"VVUVVVVMV",1,7,0.767701863354037,79,85,99,102,113,119,133,136,"GTGTTGA","CTGA","GTGCTCA","CTGG",2.40201629823189,14,11,14,48,2.67218893375837,4.67140773049275,7.7422151839089,101,"ENSG00000079974.19"
"2063","ENSG00000069667.16_527454",527446,527454,9,"ENSG00000069667.16",1,5,"VVUVMVVVV",1,7,0.770186335403727,63,69,84,87,103,109,133,136,"TTTATGA","CTTA","TTGAAGA","CTGA",2.54008894756019,15,16,24,64,1.71192312029696,4.66146235934123,7.74220770095613,101,"ENSG00000079974.19"
"24307","ENSG00000175779.5_27172",27164,27172,9,"ENSG00000175779.5",1,6,"VVUVVMVVV",1,7,0.786335403726708,102,108,133,136,153,159,186,189,"ATGTTGA","CTCA","ATGATGG","CTGA",2.63757706135022,25,17,27,78,0.803493284431954,4.59683509002502,7.74217670493185,101,"ENSG00000079974.19"
"46061","ENSG00000286152.1_118893",118885,118893,9,"ENSG00000286152.1",1,8,"VVUVVVVMV",1,7,0.767701863354037,100,106,133,136,152,158,170,173,"ATGATGA","CAGC","GAGAGAA","CTGA",2.57041847072354,27,16,12,64,1.54933959703583,4.67136568379819,7.74217313721434,101,"ENSG00000079974.19"
"11992","ENSG00000136828.19_45216",45208,45216,9,"ENSG00000136828.19",0,NA,"VVUVVUVVV",2,7,0.805797101449275,108,114,133,136,145,151,160,163,"GGGAAGA","CACA","CTGAGGA","CTGA",2.3318453846463,19,9,9,46,2.5301595398526,4.51894885937365,7.74213726517075,101,"ENSG00000079974.19"
"38302","ENSG00000249917.3_107355",107347,107355,9,"ENSG00000249917.3",1,3,"UVMVVVVVV",1,7,0.785507246376811,115,121,133,136,144,150,185,188,"TTAATGA","ATAA","ATGAAGA","CTGA",2.45409249047362,12,8,35,64,2.03980550552228,4.60010552716993,7.74213451267718,101,"ENSG00000079974.19"
"2147","ENSG00000070731.11_19304",19296,19304,9,"ENSG00000070731.11",0,NA,"VVUVVUVVV",2,7,0.805797101449275,106,112,133,136,181,187,207,210,"ATAAAGA","CTCA","GTGATGA","CTGA",2.57202501715712,21,45,20,95,0.928884530756355,4.51892949461762,7.74211790041472,101,"ENSG00000079974.19"
"44942","ENSG00000284526.1_2892",2884,2892,9,"ENSG00000284526.1",0,NA,"VVUVVUVVV",2,7,0.805797101449275,106,112,133,136,181,187,207,210,"ATAAAGA","CTCA","GTGATGA","CTGA",2.57202501715712,21,45,20,95,0.928884530756355,4.51892949461762,7.74211790041472,101,"ENSG00000079974.19"
"33052","ENSG00000228566.2_693381",693373,693381,9,"ENSG00000228566.2",1,7,"UVVVVVMVV",1,7,0.787991718426501,114,120,133,136,146,152,166,169,"GGTATGA","AAGA","CTGATTA","CTGA",2.33868960062826,13,10,14,46,2.76930580185127,4.59014245150992,7.74210932521592,101,"ENSG00000079974.19"
"12029","ENSG00000136895.19_79641",79633,79641,9,"ENSG00000136895.19",0,NA,"VVVVUVUVV",2,7,0.775983436853002,114,120,133,136,149,155,200,203,"ATGAAGA","TTGG","CTGATGC","CTGA",2.52831722991563,13,13,45,80,1.69713711172097,4.63814632778962,7.74208007520163,101,"ENSG00000079974.19"
"16690","ENSG00000152092.16_171080",171072,171080,9,"ENSG00000152092.16",1,6,"UVVVVMVVV",1,7,0.805383022774327,90,96,108,111,114,120,133,136,"ATAATGA","TTGA","TAGATCA","CAGA",2.30747269336208,12,3,13,37,2.69900917873968,4.52054011695505,7.74207220805235,101,"ENSG00000079974.19"
"36332","ENSG00000239941.1_11442",11434,11442,9,"ENSG00000239941.1",1,5,"VVVVMVUVV",1,7,0.772670807453416,108,114,133,136,170,176,189,192,"TTGAGGA","CTGA","TTAATAA","CTGA",2.56281530736806,19,34,13,75,1.52008131810487,4.65137917513965,7.74206240495331,101,"ENSG00000079974.19"
"31365","ENSG00000223561.8_71993",71985,71993,9,"ENSG00000223561.8",1,2,"UMVVVUVVV",2,6,0.708902691511387,111,117,133,136,146,152,199,202,"GTGAGGA","CTGA","GTGTGGA","CTGA",2.68272210990101,16,10,47,82,1.74090069718983,4.90642869079914,7.74203945684469,101,"ENSG00000079974.19"
"17992","ENSG00000155974.14_375083",375075,375083,9,"ENSG00000155974.14",1,3,"UVMVVVVVV",1,7,0.785507246376811,74,80,96,99,114,120,133,136,"GTGATGA","ATGA","CAGATGG","TTGA",2.41335332199531,16,15,13,53,2.31100742416479,4.60000739270004,7.74203637820729,101,"ENSG00000079974.19"
"32958","ENSG00000228340.8_36495",36487,36495,9,"ENSG00000228340.8",1,1,"MVVVVUVVV",1,7,0.82815734989648,61,67,85,88,112,118,133,136,"ATGATGA","CAGA","ATATTTA","CTAA",2.41311068885576,18,24,15,66,1.63013014564407,4.42938368450395,7.74201308408987,101,"ENSG00000079974.19"
"18088","ENSG00000156113.24_198103",198095,198103,9,"ENSG00000156113.24",1,6,"VVVVVMUVV",1,7,0.788819875776397,103,109,133,136,144,150,159,162,"TTGATGT","CTTA","GCTCTGA","CTGA",2.42139777712017,24,8,9,50,2.20403840239568,4.58667256246587,7.74195206557146,101,"ENSG00000079974.19"
"14650","ENSG00000145623.13_8744",8736,8744,9,"ENSG00000145623.13",1,1,"MVVVVUVVV",1,7,0.82815734989648,89,95,108,111,114,120,133,136,"TTTATAA","TTGA","ATAGTAA","CTGA",2.25625702295202,13,3,13,38,2.67544884834434,4.42929058367279,7.74191998325871,101,"ENSG00000079974.19"
"45740","ENSG00000285856.1_2118",2110,2118,9,"ENSG00000285856.1",1,6,"VVVUVMVVV",1,7,0.78343685300207,115,121,133,136,141,147,163,166,"CTGATGG","CAAA","ATGAGCC","CTGA",2.35872857256256,12,5,16,42,2.70755614894998,4.60810332484176,7.74185073685004,101,"ENSG00000079974.19"
"38631","ENSG00000250682.6_20452",20444,20452,9,"ENSG00000250682.6",1,2,"VMUVVVVVV",1,7,0.767701863354037,66,72,87,90,99,105,133,136,"ATCATTA","CTGA","GTTAGAA","CTGA",2.4973565440882,15,9,28,61,2.0345561333471,4.67089994015043,7.74170739356658,101,"ENSG00000079974.19"
"28775","ENSG00000196482.18_272864",272856,272864,9,"ENSG00000196482.18",1,7,"VVVVUVMVV",1,7,0.775155279503105,101,107,133,136,140,146,161,164,"GTGATGA","CATA","TAGATCA","CTGA",2.51636573706772,26,4,15,54,1.78853430681745,4.64107647181723,7.74169758982965,101,"ENSG00000079974.19"
"14134","ENSG00000144452.15_205389",205381,205389,9,"ENSG00000144452.15",1,1,"MVVVVVUVV",1,7,0.792132505175983,105,111,133,136,139,145,156,159,"TTAATGA","CTGC","GTTAAGT","CTGA",2.43943364749422,22,3,11,45,2.02970278583208,4.57314844228172,7.74167846298565,101,"ENSG00000079974.19"
"8155","ENSG00000117036.12_13470",13462,13470,9,"ENSG00000117036.12",1,8,"VVVUVVVMV",1,7,0.764803312629399,108,114,133,136,143,149,161,164,"GTGAGGA","CAGT","GAGAAGA","CTGA",2.4288009288639,19,7,12,47,2.53766267098616,4.68241721585304,7.74163046637064,101,"ENSG00000079974.19"
"783","ENSG00000033170.17_7399",7391,7399,9,"ENSG00000033170.17",1,6,"UVVVVMVVV",1,7,0.805383022774327,109,115,133,136,155,161,209,212,"TTGATGA","CACA","TTGATAA","CTGA",2.56309353690936,18,19,48,94,0.992993057382888,4.52007082586132,7.74160291695863,101,"ENSG00000079974.19"
"7661","ENSG00000115290.11_481",473,481,9,"ENSG00000115290.11",1,2,"VMUVVVVVV",1,7,0.767701863354037,70,76,91,94,100,106,133,136,"GTGAGGA","GTGA","GTGCCCA","CTGA",2.48793682085727,15,6,27,57,2.09684269601269,4.67077204209862,7.74157949551477,101,"ENSG00000079974.19"
"33414","ENSG00000229656.9_9639",9631,9639,9,"ENSG00000229656.9",1,6,"VVVUVMVVV",1,7,0.78343685300207,116,122,133,136,152,158,191,194,"TTGATGG","TTGA","CTGGAGA","CTGA",2.53378234290854,11,16,33,69,1.53936708783186,4.60781234347219,7.74155975548047,101,"ENSG00000079974.19"
"28493","ENSG00000189337.17_582432",582424,582432,9,"ENSG00000189337.17",1,2,"UMVVVUVVV",2,6,0.708902691511387,115,121,133,136,165,171,181,184,"GTGATGA","CTTA","CTTTTGA","CTGA",2.63435422774864,12,29,10,60,2.06137581640621,4.90593433368261,7.74154509972816,101,"ENSG00000079974.19"
"10012","ENSG00000128815.20_159427",159419,159427,9,"ENSG00000128815.20",1,8,"VVVVVUVMV",1,7,0.806211180124224,47,53,71,74,81,87,133,136,"TTGATGT","CTGG","AGGAAGG","CTGA",2.45917039407379,18,7,46,80,1.67229192406444,4.51669030447243,7.74153502496933,101,"ENSG00000079974.19"
"18421","ENSG00000157388.20_250009",250001,250009,9,"ENSG00000157388.20",0,NA,"VVUUVVVVV",2,7,0.764389233954451,109,115,133,136,148,154,172,175,"TTGAGGA","CAGA","ATGCTGG","CTGA",2.50014776263309,18,12,18,57,2.06825326117393,4.68397625301529,7.7415331888331,101,"ENSG00000079974.19"
"24518","ENSG00000176769.9_42666",42658,42666,9,"ENSG00000176769.9",1,7,"VVVVVUMVV",1,7,0.807453416149068,110,116,133,136,154,160,174,177,"GTGAAGA","ATTA","GTCATGC","CTGA",2.40716520829851,17,18,14,58,1.99909665908728,4.51171617860266,7.74152984319893,101,"ENSG00000079974.19"
"25130","ENSG00000179603.18_492998",492990,492998,9,"ENSG00000179603.18",1,5,"VVVUMVVVV",1,7,0.767287784679089,115,121,133,136,144,150,196,199,"GGGATGC","TTGA","ATGAGGA","CTGA",2.50449958670491,12,8,46,75,1.99271678985944,4.67234517530638,7.74149631402273,101,"ENSG00000079974.19"
"47167","ENSG00000287722.1_539363",539355,539363,9,"ENSG00000287722.1",0,NA,"UVVVVUVVV",2,7,0.824844720496894,116,122,133,136,162,168,196,199,"ATGATAA","CGGA","GTGATGA","CTGG",2.47717528880049,11,26,28,74,1.25367817517695,4.44204502512838,7.74142390711596,101,"ENSG00000079974.19"
"34841","ENSG00000234264.1_33365",33357,33365,9,"ENSG00000234264.1",1,1,"MVVVUVVVV",1,7,0.795859213250517,46,52,62,65,71,77,133,136,"ATAATGA","ATCA","AAGATAA","CTGA",2.44924743984779,10,6,56,81,1.90362893542357,4.55798630026887,7.74142315327094,101,"ENSG00000079974.19"
"12067","ENSG00000137073.24_2671",2663,2671,9,"ENSG00000137073.24",0,NA,"UVVVVUVVV",2,7,0.824844720496894,116,122,133,136,143,149,161,164,"AATATGT","CAAA","TTGAAGG","CTGA",2.21857742768091,11,7,12,39,2.97765803553128,4.44204355501767,7.74142243700524,101,"ENSG00000079974.19"
"14971","ENSG00000146416.19_83815",83807,83815,9,"ENSG00000146416.19",1,5,"UVVVMUVVV",2,6,0.711387163561077,91,97,133,136,146,152,162,165,"GTGATTA","CTGA","GTCAGGA","CTGA",2.651883082359,36,10,10,65,1.90425597122277,4.89586913007069,7.741417784315,101,"ENSG00000079974.19"
"9631","ENSG00000125888.15_29208",29200,29208,9,"ENSG00000125888.15",1,1,"MVVVVUVVV",1,7,0.82815734989648,106,112,133,136,143,149,193,196,"ACGAGGA","CTGG","ATGGGGA","CTGA",2.44442992362805,21,7,44,81,1.41888991401327,4.42877235121673,7.74140175080265,101,"ENSG00000079974.19"
"40562","ENSG00000257022.1_28882",28874,28882,9,"ENSG00000257022.1",1,6,"UVVVVMVVV",1,7,0.805383022774327,97,103,111,114,116,122,133,136,"ATTATGA","GTGA","CTAATGT","CTTA",2.3195748626444,8,2,11,30,2.6154655359637,4.51982448839825,7.74135657949556,101,"ENSG00000079974.19"
"201","ENSG00000006530.18_22965",22957,22965,9,"ENSG00000006530.18",1,2,"VMVVVUVVV",1,7,0.806211180124223,107,113,133,136,145,151,198,201,"CTTATGA","TTGA","CTGGTGG","CTGA",2.49302931261996,20,9,47,85,1.44575052593495,4.51648648585033,7.74133120634723,101,"ENSG00000079974.19"
"5589","ENSG00000105894.13_86562",86554,86562,9,"ENSG00000105894.13",0,NA,"UVVVVUVVV",2,7,0.824844720496894,47,53,67,70,75,81,133,136,"ATGATCA","CTGA","ATAAGAA","CTGG",2.38063768382002,14,5,52,80,1.89687089575649,4.44194719697249,7.74132607896007,101,"ENSG00000079974.19"
"11560","ENSG00000135333.15_120890",120882,120890,9,"ENSG00000135333.15",0,NA,"UVVVVUVVV",2,7,0.824844720496894,89,95,133,136,144,150,159,162,"TTGATAA","TTGG","TTGTGGA","CTGA",2.3668610820776,38,8,9,64,1.98821282742193,4.44182167698482,7.7412005589724,101,"ENSG00000079974.19"
"12214","ENSG00000137672.13_256402",256394,256402,9,"ENSG00000137672.13",1,6,"UVVVVMVVV",1,7,0.805383022774327,52,58,67,70,75,81,133,136,"GAGATGA","CTGA","GTGAAGT","CTCA",2.44636822195595,9,5,52,75,1.76921311352854,4.51958364830872,7.74111573940603,101,"ENSG00000079974.19"
"10142","ENSG00000129521.15_425240",425232,425240,9,"ENSG00000129521.15",1,5,"UVVVMVVVV",1,7,0.789233954451346,109,115,133,136,145,151,183,186,"AGCATGA","CAGA","AAGATGA","CTGA",2.49440010866296,18,9,32,68,1.70729928736748,4.58415833628013,7.74109415408551,101,"ENSG00000079974.19"
"21709","ENSG00000168724.18_17423",17415,17423,9,"ENSG00000168724.18",1,5,"UVVVMUVVV",2,6,0.711387163561077,110,116,133,136,143,149,160,163,"ATGATTC","CAGA","TTGATGT","CTGA",2.52485081342559,17,7,11,44,2.74945851448307,4.89544931766341,7.74099797190772,101,"ENSG00000079974.19"
"25896","ENSG00000183049.14_74296",74288,74296,9,"ENSG00000183049.14",1,8,"VVUVVVVMV",1,7,0.767701863354037,73,79,91,94,107,113,133,136,"CTGACTA","CTGA","GTGGTGC","CTGA",2.47049134305442,12,13,20,54,2.21079633214276,4.67018465479305,7.7409921082092,101,"ENSG00000079974.19"
"7591","ENSG00000115020.17_30389",30381,30389,9,"ENSG00000115020.17",1,1,"MVVVVVUVV",1,7,0.792132505175983,114,120,133,136,138,144,152,155,"AGAATGA","AGGA","ATAAGGA","CTGA",2.32984009547712,13,2,8,32,2.75757226228217,4.57245989136573,7.74098991206967,101,"ENSG00000079974.19"
"18476","ENSG00000157445.15_795587",795579,795587,9,"ENSG00000157445.15",1,1,"MVUVVVVVV",1,7,0.789648033126294,85,91,105,108,113,119,133,136,"ATGCTGA","TTGA","CTGGTGC","CTTA",2.33178680404373,14,5,14,42,2.78412916957926,4.5823436324677,7.74093576497288,101,"ENSG00000079974.19"
"10218","ENSG00000130021.15_122317",122309,122317,9,"ENSG00000130021.15",0,NA,"UVVVVVUVV",2,7,0.788819875776397,57,63,95,98,109,115,133,136,"CTGATGA","CTGA","CTGAAGT","CTAA",2.52718257326916,32,11,18,70,1.49455447945992,4.58560957531357,7.74088907841916,101,"ENSG00000079974.19"
"46317","ENSG00000286481.2_231057",231049,231057,9,"ENSG00000286481.2",1,6,"UVVVVMVVV",1,7,0.805383022774327,112,118,133,136,143,149,181,184,"AGGAAGT","CTGG","ATGAAGA","CTGA",2.41163557317315,15,7,32,63,1.99981892545814,4.51934735331978,7.74087944441709,101,"ENSG00000079974.19"
"7072","ENSG00000112699.11_243648",243640,243648,9,"ENSG00000112699.11",1,1,"MVUVVVVVV",1,7,0.789648033126294,85,91,133,136,146,152,168,171,"TTGATGA","TTGG","GTGAATG","CTGA",2.50072038465823,42,10,16,77,1.65743761874106,4.58222671244899,7.74081884495417,101,"ENSG00000079974.19"
"15624","ENSG00000148948.8_157778",157770,157778,9,"ENSG00000148948.8",1,1,"MVUVVVVVV",1,7,0.789648033126294,89,95,108,111,116,122,133,136,"AGGATCA","CTGA","ATTAGGA","ATGA",2.30333420299017,13,5,11,38,2.9726827964902,4.5820610374395,7.74065316994467,101,"ENSG00000079974.19"
"79","ENSG00000004766.17_13032",13024,13032,9,"ENSG00000004766.17",0,NA,"VVUVVVUVV",2,7,0.769772256728778,86,92,133,136,145,151,204,207,"TTGATGA","CTGG","GTGCTGT","CTGA",2.65399369081796,41,9,53,112,0.952860042902924,4.66153782875567,7.74062685567078,101,"ENSG00000079974.19"
"2598","ENSG00000076356.7_86425",86417,86425,9,"ENSG00000076356.7",0,NA,"VVVVVUUVV",2,7,0.808281573498965,115,121,133,136,153,159,177,180,"AGGATGG","TGGA","GTGATCT","CTGA",2.39484256418914,12,17,18,56,2.06434576807288,4.50749071566679,7.74061700966264,101,"ENSG00000079974.19"
"4137","ENSG00000095637.23_54736",54728,54736,9,"ENSG00000095637.23",1,1,"MVUVVVVVV",1,7,0.789648033126294,112,118,133,136,148,154,175,178,"ATGAAGC","CTGG","TTTAAGA","CTGA",2.42886721024423,15,12,21,57,2.13562207950242,4.58201753694933,7.7406096694545,101,"ENSG00000079974.19"
"4773","ENSG00000101871.17_134276",134268,134276,9,"ENSG00000101871.17",1,7,"UVVVVVMVV",1,7,0.787991718426501,82,88,99,102,114,120,133,136,"ATAAGGG","CAGA","TTAATGA","CTGA",2.35331347245017,11,12,13,45,2.66580334278561,4.58863995644669,7.74060683015269,101,"ENSG00000079974.19"
"2772","ENSG00000078142.14_53395",53387,53395,9,"ENSG00000078142.14",1,2,"UMVVVVVVV",1,7,0.786749482401656,106,112,133,136,143,149,164,167,"ATGGTGA","CATA","GGGAAGT","CTGA",2.42206618433927,21,7,15,52,2.22717570314514,4.59357089968506,7.74056882929169,101,"ENSG00000079974.19"
"6357","ENSG00000109472.14_124084",124076,124084,9,"ENSG00000109472.14",1,3,"VVMVVVUVV",1,7,0.768944099378882,113,119,133,136,148,154,168,171,"AGGATGA","AAGA","ATTTTTA","CTGA",2.40850127451104,14,12,14,49,2.60230465969489,4.66474495577545,7.74052135329098,101,"ENSG00000079974.19"
"32877","ENSG00000228209.1_521",513,521,9,"ENSG00000228209.1",1,8,"VVUVVVVMV",1,7,0.767701863354037,62,68,98,101,115,121,133,136,"ATGATGA","CTGA","ACAATGA","CTCA",2.55812620656371,30,14,12,65,1.62440810804283,4.66964570461688,7.74045315803303,101,"ENSG00000079974.19"
"30916","ENSG00000214719.13_83947",83939,83947,9,"ENSG00000214719.13",1,1,"MVVVUVVVV",1,7,0.795859213250517,98,104,133,136,143,149,159,162,"CTCATGA","CCTA","ATGATCA","CTGA",2.42540929465705,29,7,10,55,2.05858733227853,4.55699565749805,7.74043251050012,101,"ENSG00000079974.19"
"32685","ENSG00000227564.3_867",859,867,9,"ENSG00000227564.3",0,NA,"VVVVUVUVV",2,7,0.775983436853002,67,73,97,100,106,112,133,136,"ATAATTA","TTGA","ATGAAGA","CTGA",2.53257803565492,24,6,21,60,1.66209847541985,4.63648801161316,7.74042175902517,101,"ENSG00000079974.19"
"11100","ENSG00000133958.14_112183",112175,112183,9,"ENSG00000133958.14",0,NA,"VVVVVUUVV",2,7,0.808281573498965,83,89,133,136,147,153,177,180,"GTGATGT","TTGA","ATGTTAG","CTGA",2.53195695762558,44,11,24,88,1.14930241883514,4.50725386741809,7.74038016141395,101,"ENSG00000079974.19"
"41162","ENSG00000258609.3_15352",15344,15352,9,"ENSG00000258609.3",1,2,"VMVVVVUVV",1,7,0.770186335403727,65,71,79,82,95,101,133,136,"CTGACGA","CTGG","GTGATGG","CTGA",2.56843780810038,8,13,32,62,1.51562015988013,4.65963472013733,7.74038006175224,101,"ENSG00000079974.19"
"35388","ENSG00000235903.11_81446",81438,81446,9,"ENSG00000235903.11",1,8,"UVVVVUVMV",2,6,0.708902691511387,109,115,133,136,141,147,157,160,"ATGATTA","TTGA","TTCATTA","CTGA",2.55056635080493,18,5,10,42,2.61520177498464,4.90474436175438,7.74035512779993,101,"ENSG00000079974.19"
"28134","ENSG00000188177.14_23226",23218,23226,9,"ENSG00000188177.14",1,8,"UVVVVVVMV",1,7,0.786749482401656,115,121,133,136,142,148,168,171,"ACAATAA","ATGA","ATGAAGA","CTGA",2.38054298478417,12,6,20,47,2.50314091347921,4.59335686967675,7.74035479928337,101,"ENSG00000079974.19"
"3264","ENSG00000082805.21_285003",284995,285003,9,"ENSG00000082805.21",1,1,"MVVVVUVVV",1,7,0.82815734989648,98,104,133,136,143,149,176,179,"ATGAAGA","CTGA","GTTAGGA","GTGA",2.46731044688327,29,7,27,72,1.2621644775476,4.42772519752568,7.7403545971116,101,"ENSG00000079974.19"
"1084","ENSG00000047617.17_18648",18640,18648,9,"ENSG00000047617.17",1,7,"VVVVUUMVV",2,6,0.697308488612836,82,88,99,102,109,115,133,136,"CTGATTA","CAGA","ATGAGGA","CTGA",2.57813388434054,11,7,18,45,2.61688134685066,4.9511101439469,7.74034409839824,101,"ENSG00000079974.19"
"23517","ENSG00000173120.15_51964",51956,51964,9,"ENSG00000173120.15",0,NA,"VVVVVUUVV",2,7,0.808281573498965,115,121,133,136,184,190,206,209,"AGGAAGA","CTAA","GTCAGGA","CTGA",2.44032320202163,12,48,16,85,1.76004468185261,4.50721650716588,7.74034280116173,101,"ENSG00000079974.19"
"13109","ENSG00000140262.18_341710",341702,341710,9,"ENSG00000140262.18",1,1,"MVUVVVVVV",1,7,0.789648033126294,115,121,133,136,145,151,159,162,"CTGATGA","ATCA","CAGATGA","CTTA",2.30043304834418,12,9,8,38,2.99071377040895,4.58173352317587,7.74032565568104,101,"ENSG00000079974.19"
"13401","ENSG00000141367.13_62635",62627,62635,9,"ENSG00000141367.13",1,1,"MVVVUVVVV",1,7,0.795859213250517,113,119,133,136,144,150,158,161,"CAGATGG","TCGA","ATGTGGA","CTGA",2.28779415846751,14,8,8,39,2.97548754499619,4.55686215036156,7.74029900336363,101,"ENSG00000079974.19"
"42683","ENSG00000265737.1_8999",8991,8999,9,"ENSG00000265737.1",1,8,"UVVVVVVMV",1,7,0.786749482401656,114,120,133,136,157,163,178,181,"GTGATTT","TTAA","GTGATGA","CTGA",2.44830517681329,13,21,15,58,2.05107120124471,4.59327642833333,7.74027435793995,101,"ENSG00000079974.19"
"10713","ENSG00000132549.20_146321",146313,146321,9,"ENSG00000132549.20",0,NA,"VVVUUVVVV",2,7,0.770600414078675,116,122,133,136,150,156,164,167,"CTGATTA","ATGA","AAGGTTA","CTGA",2.40542961718227,11,14,8,42,2.59516639846677,4.65784096158714,7.74024261790184,101,"ENSG00000079974.19"
"34226","ENSG00000232234.4_144888",144880,144888,9,"ENSG00000232234.4",1,1,"MVVUVVVVV",1,7,0.786749482401656,39,45,58,61,74,80,133,136,"TTGATCA","TTGA","CTGTAGA","CTGA",2.50229154106223,13,13,53,88,1.69098433940505,4.59323198662165,7.74022991622827,101,"ENSG00000079974.19"
"45194","ENSG00000285216.1_89437",89429,89437,9,"ENSG00000285216.1",1,1,"MVVUVVVVV",1,7,0.786749482401656,39,45,58,61,74,80,133,136,"TTGATCA","TTGA","CTGTAGA","CTGA",2.50229154106223,13,13,53,88,1.69098433940505,4.59323198662165,7.74022991622827,101,"ENSG00000079974.19"
"30591","ENSG00000205929.11_18628",18620,18628,9,"ENSG00000205929.11",0,NA,"VVUVUVVVV",2,7,0.773498964803312,60,66,75,78,88,94,133,136,"GTGATTA","GTGA","TTGTTGT","CTGA",2.52382076628824,9,10,39,67,1.75936134063039,4.64620827897132,7.74020413818457,101,"ENSG00000079974.19"
"16354","ENSG00000151388.11_121242",121234,121242,9,"ENSG00000151388.11",1,8,"VVVVVUVMV",1,7,0.806211180124224,107,113,133,136,146,152,162,165,"AGGAGGA","GGGA","GTGCTGG","CTGA",2.35071186122655,20,10,10,49,2.3897470895827,4.51528987443992,7.74013459493681,101,"ENSG00000079974.19"
"16306","ENSG00000151320.11_57767",57759,57767,9,"ENSG00000151320.11",1,1,"MVUVVVVVV",1,7,0.789648033126294,105,111,133,136,168,174,187,190,"GTGATGC","TTGA","TTGGTGT","CTGA",2.55513800961971,22,32,13,76,1.29140094456783,4.58141358550814,7.74000571801331,101,"ENSG00000079974.19"
"15215","ENSG00000147394.20_31728",31720,31728,9,"ENSG00000147394.20",1,8,"VVVVVUVMV",1,7,0.806211180124224,82,88,133,136,149,155,164,167,"GTGATGT","CTGC","ACTATGC","CTGA",2.45514060356815,45,13,9,76,1.69301796143115,4.5151554963047,7.74000021680159,101,"ENSG00000079974.19"
"1795","ENSG00000066032.19_660466",660458,660466,9,"ENSG00000066032.19",1,8,"VVVVVUVMV",1,7,0.806211180124224,86,92,98,101,109,115,133,136,"ATCATGA","GTGA","TTGATCA","TTGA",2.38894033360104,6,8,18,41,2.13430795615861,4.51514421170805,7.73998893220494,101,"ENSG00000079974.19"
"25070","ENSG00000179397.18_158047",158039,158047,9,"ENSG00000179397.18",1,8,"VVVVUVVMV",1,7,0.773913043478261,89,95,133,136,145,151,161,164,"AGGATGA","CTGG","ATTCTTA","CTGA",2.49354634774447,38,9,10,66,1.9535159738637,4.64428957304004,7.73994174695309,101,"ENSG00000079974.19"
"22491","ENSG00000170624.14_664555",664547,664555,9,"ENSG00000170624.14",1,8,"VVVVVUVMV",1,7,0.806211180124224,90,96,107,110,114,120,133,136,"ATGACCA","TAGA","TTCGTGA","CTGA",2.28746107122855,11,4,13,37,2.81054232819474,4.51507070076294,7.73991542125983,101,"ENSG00000079974.19"
"5050","ENSG00000102837.7_21859",21851,21859,9,"ENSG00000102837.7",1,8,"UVVVVVVMV",1,7,0.786749482401656,115,121,133,136,176,182,193,196,"AAGATGC","CAGA","ATAACGA","CTGA",2.45673339510748,12,40,11,72,1.99330434252316,4.59288174414326,7.73987967374988,101,"ENSG00000079974.19"
"34492","ENSG00000233184.9_1106",1098,1106,9,"ENSG00000233184.9",1,2,"UMVVVVVVV",1,7,0.786749482401656,87,93,133,136,146,152,162,165,"GTGATGA","ATGC","GACTTGA","CTGA",2.47075762895961,40,10,10,69,1.89960571304342,4.5928308098602,7.73982873946683,101,"ENSG00000079974.19"
"38349","ENSG00000250039.4_256412",256404,256412,9,"ENSG00000250039.4",1,6,"VVVVVMUVV",1,7,0.788819875776397,94,100,133,136,146,152,168,171,"ATAATGT","CTTA","GTGATCT","CTGA",2.49968162289255,33,10,16,68,1.6736451613253,4.58454732848557,7.73982683159116,101,"ENSG00000079974.19"
"42884","ENSG00000267272.5_20672",20664,20672,9,"ENSG00000267272.5",0,NA,"VVVVVUUVV",2,7,0.808281573498965,113,119,133,136,157,163,176,179,"TTAATGA","TTGT","ATGCTGT","CTGA",2.38580717606033,14,21,13,57,2.12138720220059,4.50669209398403,7.73981838797989,101,"ENSG00000079974.19"
"42989","ENSG00000267561.2_157428",157420,157428,9,"ENSG00000267561.2",0,NA,"VVVVVUUVV",2,7,0.808281573498965,113,119,133,136,157,163,176,179,"TTAATGA","TTGT","ATGCTGT","CTGA",2.38580717606033,14,21,13,57,2.12138720220059,4.50669209398403,7.73981838797989,101,"ENSG00000079974.19"
"38209","ENSG00000249787.2_113949",113941,113949,9,"ENSG00000249787.2",1,1,"MVVVVUVVV",1,7,0.82815734989648,82,88,133,136,144,150,174,177,"ATTATGA","CACA","GAGATTA","CTGA",2.46118965260869,45,8,24,86,1.30073561902706,4.42716665910457,7.73979605869049,101,"ENSG00000079974.19"
"39507","ENSG00000253693.1_133644",133636,133644,9,"ENSG00000253693.1",1,2,"VMVVVVUVV",1,7,0.770186335403727,79,85,101,104,107,113,133,136,"AGGATGT","CTGC","ATGATAG","CTGA",2.48686416066441,16,3,20,48,2.05701608870231,4.65902762328293,7.73977296489783,101,"ENSG00000079974.19"
"32089","ENSG00000225885.7_112962",112954,112962,9,"ENSG00000225885.7",1,8,"VVVVVVUMV",1,7,0.770186335403727,99,105,133,136,173,179,192,195,"ATGAAGA","CTTA","ATGATAA","CTGA",2.64381791912173,28,37,13,87,1.01061230311221,4.65901627431427,7.73976161592918,101,"ENSG00000079974.19"
"642","ENSG00000021776.11_79609",79601,79609,9,"ENSG00000021776.11",1,8,"VVVVVUVMV",1,7,0.806211180124224,115,121,133,136,137,143,153,156,"TTAAAGA","ATGA","ATACTGA","CTGA",2.32155726123422,12,1,10,32,2.58240265434145,4.5148627656424,7.73970748613929,101,"ENSG00000079974.19"
"11030","ENSG00000133640.20_97220",97212,97220,9,"ENSG00000133640.20",1,8,"VVVVVUVMV",1,7,0.806211180124224,107,113,133,136,143,149,158,161,"GTGGTGA","ATGA","CTGCTGA","GTGA",2.33466476222877,20,7,9,45,2.49500504206971,4.51485919756537,7.73970391806226,101,"ENSG00000079974.19"
"12016","ENSG00000136867.11_1431",1423,1431,9,"ENSG00000136867.11",1,1,"MVVVVUVVV",1,7,0.82815734989648,84,90,133,136,144,150,193,196,"GTGCTGA","TTGA","GTGAGTC","CTGA",2.50648322171607,43,8,43,103,0.99836723697288,4.42706384543667,7.73969324502259,101,"ENSG00000079974.19"
"37381","ENSG00000247982.7_4694",4686,4694,9,"ENSG00000247982.7",0,NA,"VVVVVUUVV",2,7,0.808281573498965,116,122,133,136,163,169,188,191,"ATGATAG","CTTA","ATGATCG","CTGA",2.45824552598053,11,27,19,66,1.63767430939117,4.50649445398201,7.73962074797787,101,"ENSG00000079974.19"
"24226","ENSG00000175497.17_635322",635314,635322,9,"ENSG00000175497.17",1,3,"VVMVVVUVV",1,7,0.768944099378882,105,111,133,136,180,186,195,198,"ATTATGA","TTGA","CTGATTT","CTGA",2.59745267564424,22,44,9,84,1.338903881707,4.66381376316714,7.73959016068267,101,"ENSG00000079974.19"
"18652","ENSG00000158019.21_109317",109309,109317,9,"ENSG00000158019.21",0,NA,"UVVVVUVVV",2,7,0.824844720496894,115,121,133,136,170,176,187,190,"CTGATAA","GTGC","AAGAAGA","CTGA",2.36260252026932,12,34,11,66,2.01001365984868,4.4401742820777,7.73955316406528,101,"ENSG00000079974.19"
"18537","ENSG00000157613.11_21897",21889,21897,9,"ENSG00000157613.11",1,1,"MVVVUVVVV",1,7,0.795859213250517,114,120,133,136,164,170,225,228,"ATGAAGG","CTGA","TTGACAA","CTGA",2.57318289973106,13,28,55,105,1.06976589039119,4.55607963881624,7.73951649181831,101,"ENSG00000079974.19"
"13216","ENSG00000140577.17_5381",5373,5381,9,"ENSG00000140577.17",1,8,"VVVVVUVMV",1,7,0.806211180124224,101,107,133,136,145,151,170,173,"TTGAAGA","AGGA","ATGAAGA","CTGA",2.45987070830589,26,9,19,63,1.65943611440457,4.5146435424443,7.73948826294119,101,"ENSG00000079974.19"
"8984","ENSG00000121957.15_29885",29877,29885,9,"ENSG00000121957.15",1,7,"VVVUVVMVV",1,7,0.766045548654244,73,79,99,102,115,121,133,136,"ATGATGG","CTGA","GTTATGC","CTCA",2.48376820574355,20,13,12,54,2.14265810864857,4.67527820340139,7.73946039801837,101,"ENSG00000079974.19"
"18281","ENSG00000156860.16_4739",4731,4739,9,"ENSG00000156860.16",1,7,"VVVUVVMVV",1,7,0.766045548654244,109,115,133,136,139,145,170,173,"ATGCTGA","CTGG","TTGGTGT","CTGA",2.55910733260018,18,3,25,55,1.64031386247782,4.67525735328642,7.7394395479034,101,"ENSG00000079974.19"
"23615","ENSG00000173406.16_435803",435795,435803,9,"ENSG00000173406.16",1,2,"UMVVVVVVV",1,7,0.786749482401656,106,112,133,136,139,145,164,167,"ATGAAGA","CACA","GTGAGAA","CTGA",2.50243024703162,21,3,19,52,1.68624469237357,4.59227825147942,7.73927618108605,101,"ENSG00000079974.19"
"14211","ENSG00000144619.15_363670",363662,363670,9,"ENSG00000144619.15",1,1,"MVVUVVVVV",1,7,0.786749482401656,105,111,133,136,157,163,181,184,"GTGATGA","GTGG","ATGATAT","CTGA",2.57362533944231,22,21,18,70,1.21147308886698,4.59224383795392,7.73924176756055,101,"ENSG00000079974.19"
"38807","ENSG00000251034.2_4597",4589,4597,9,"ENSG00000251034.2",1,8,"VVVUVVVMV",1,7,0.764803312629399,107,113,133,136,146,152,163,166,"AGGATGA","CTGA","GGGGTGA","CAGA",2.45174454040566,20,10,11,50,2.37511342598283,4.68001925717181,7.73923250768941,101,"ENSG00000079974.19"
"45374","ENSG00000285534.1_136889",136881,136889,9,"ENSG00000285534.1",1,1,"MVVUVVVVV",1,7,0.786749482401656,86,92,103,106,114,120,133,136,"AGGATAA","ATGT","TTGCAGA","CTGA",2.31962006955243,11,8,13,41,2.90473314802163,4.59221673625946,7.73921466586609,101,"ENSG00000079974.19"
"669","ENSG00000023228.14_13005",12997,13005,9,"ENSG00000023228.14",1,2,"UMVVVVVVV",1,7,0.786749482401656,109,115,133,136,152,158,171,174,"ATGATTA","TTGC","GTGTATA","CTGA",2.44420979869587,18,16,13,56,2.07412148528812,4.59221336914849,7.73921129875511,101,"ENSG00000079974.19"
"6377","ENSG00000109667.12_219417",219409,219417,9,"ENSG00000109667.12",1,2,"VMUVVVVVV",1,7,0.767701863354037,55,61,105,108,116,122,133,136,"ATGTTGA","CTGT","GAGTTTA","CTGA",2.50511788518407,44,8,11,72,1.9727332887414,4.66837979749213,7.73918725090828,101,"ENSG00000079974.19"
"30072","ENSG00000203506.5_7168",7160,7168,9,"ENSG00000203506.5",0,NA,"VVUVVUVVV",2,7,0.805797101449275,107,113,133,136,179,185,202,205,"ATGCTGG","ATGA","TTGAGGA","CTGA",2.53078396544372,20,43,17,89,1.1920110732488,4.51597604405174,7.73916444984884,101,"ENSG00000079974.19"
"25831","ENSG00000182923.20_65403",65395,65403,9,"ENSG00000182923.20",0,NA,"UVVVVVUVV",2,7,0.788819875776397,110,116,133,136,151,157,168,171,"ATGATGA","CACA","GTGGAGA","TTGA",2.40607781173136,17,15,11,52,2.29488134099878,4.58385002146863,7.73912952457422,101,"ENSG00000079974.19"
"47585","ENSG00000288700.2_65381",65373,65381,9,"ENSG00000288700.2",0,NA,"UVVVVVUVV",2,7,0.788819875776397,110,116,133,136,151,157,168,171,"ATGATGA","CACA","GTGGAGA","TTGA",2.40607781173136,17,15,11,52,2.29488134099878,4.58385002146863,7.73912952457422,101,"ENSG00000079974.19"
"17256","ENSG00000153707.19_718690",718682,718690,9,"ENSG00000153707.19",1,1,"MVVVVVUVV",1,7,0.792132505175983,112,118,133,136,140,146,158,161,"TTAATGC","TTTA","ATGAGGA","CTGA",2.33159423483158,15,4,12,40,2.73842218679623,4.57059593808503,7.73912595878896,101,"ENSG00000079974.19"
"10385","ENSG00000130755.13_7212",7204,7212,9,"ENSG00000130755.13",1,1,"MVVVVUVVV",1,7,0.82815734989648,103,109,133,136,182,188,206,209,"ATGAAGA","CTGG","GGGAGGC","CTGA",2.52745202256184,24,46,18,97,0.856248273527407,4.42648210598492,7.73911150557084,101,"ENSG00000079974.19"
"16408","ENSG00000151474.23_22972",22964,22972,9,"ENSG00000151474.23",1,2,"UMVVVVVVV",1,7,0.786749482401656,106,112,133,136,146,152,165,168,"AAGATGA","CTGA","GTGCTCT","ATGA",2.4211348834342,21,10,13,53,2.22730030358685,4.59204988162037,7.739047811227,101,"ENSG00000079974.19"
"12712","ENSG00000138795.10_6155",6147,6155,9,"ENSG00000138795.10",1,3,"UVMVVVVVV",1,7,0.785507246376811,115,121,133,136,172,178,190,193,"ATGTAGA","CTGG","TTGGTGA","CTGA",2.46199921972372,12,36,12,69,1.97457071651641,4.59697471200197,7.73900369750922,101,"ENSG00000079974.19"
"38626","ENSG00000250646.1_2523",2515,2523,9,"ENSG00000250646.1",1,1,"MVVVVVUVV",1,7,0.792132505175983,116,122,133,136,180,186,211,214,"GTTATGA","ATGA","ATGAGTA","CTGA",2.55461381152128,11,44,25,89,1.25112687738329,4.57047140521462,7.73900142591855,101,"ENSG00000079974.19"
"45180","ENSG00000285216.1_232980",232972,232980,9,"ENSG00000285216.1",0,NA,"UVVVUVVVV",2,7,0.792546583850932,109,115,133,136,148,154,166,169,"CTGTTGA","ATCA","ATGAGAA","CTGA",2.38266364318945,18,12,12,51,2.39073842822428,4.56879067903849,7.73897701444221,101,"ENSG00000079974.19"
"34799","ENSG00000234162.3_83300",83292,83300,9,"ENSG00000234162.3",1,1,"MVVVVVUVV",1,7,0.792132505175983,111,117,133,136,173,179,190,193,"ATGAAGA","CAGC","ATAAAGA","CTGA",2.46669247938287,16,37,11,73,1.83712310719107,4.57043490910255,7.73896492980648,101,"ENSG00000079974.19"
"32462","ENSG00000227036.10_198183",198175,198183,9,"ENSG00000227036.10",1,1,"MVVVVUVVV",1,7,0.82815734989648,98,104,133,136,148,154,181,184,"ACGATGT","TTGA","ATGATAC","CTGA",2.50159148717984,29,12,27,77,1.02804389113069,4.4263301180824,7.73895951766832,101,"ENSG00000079974.19"
"47880","ENSG00000289571.2_6894",6886,6894,9,"ENSG00000289571.2",0,NA,"UVVVVVUVV",2,7,0.788819875776397,109,115,133,136,162,168,184,187,"CTGCTGA","CTGT","GTGAGGT","CTGA",2.52076583288477,18,26,16,69,1.52921396059202,4.58357987828928,7.73885938139487,101,"ENSG00000079974.19"
"11507","ENSG00000135218.19_242545",242537,242545,9,"ENSG00000135218.19",1,6,"UVVVVMVVV",1,7,0.805383022774327,99,105,133,136,146,152,164,167,"GTGATGG","CTTT","GTAATTA","CTGA",2.42026286089662,28,10,12,59,1.93422290438583,4.51732716092415,7.73885925202146,101,"ENSG00000079974.19"
"994","ENSG00000042813.8_94099",94091,94099,9,"ENSG00000042813.8",1,1,"MVVVVUVVV",1,7,0.82815734989648,109,115,133,136,141,147,189,192,"AGGATGG","GAGA","TTGGTGA","CTGA",2.41400344518904,18,5,42,74,1.6115156787608,4.42621799500526,7.73884739459118,101,"ENSG00000079974.19"
"24784","ENSG00000178031.18_169295",169287,169295,9,"ENSG00000178031.18",0,NA,"UVUVVVVVV",2,7,0.786335403726708,29,35,43,46,75,81,133,136,"AGGCTGA","CTGA","GTGTTGA","CTGA",2.63700373362071,8,29,52,98,0.793981151471811,4.59350151056913,7.73884312547596,101,"ENSG00000079974.19"
"25812","ENSG00000182836.10_89615",89607,89615,9,"ENSG00000182836.10",1,1,"MVUVVVVVV",1,7,0.789648033126294,98,104,133,136,148,154,163,166,"ATGATGT","ATCA","GTGGGTA","CTGA",2.47469286365904,29,12,9,59,1.82303732728708,4.58024743792017,7.73883957042534,101,"ENSG00000079974.19"
"10146","ENSG00000129521.15_497808",497800,497808,9,"ENSG00000129521.15",1,2,"UMVVVVVVV",1,7,0.786749482401656,110,116,133,136,147,153,163,166,"GAGATTA","TTGA","GTGAGCT","CTGA",2.36617323106204,17,11,10,47,2.59283814094333,4.5918315870059,7.73882951661252,101,"ENSG00000079974.19"
"26958","ENSG00000185345.24_599860",599852,599860,9,"ENSG00000185345.24",1,6,"VVVUVMVVV",1,7,0.78343685300207,89,95,108,111,116,122,133,136,"ATCATGC","GTGA","GTGAGGA","CTCA",2.31714123556914,13,5,11,38,2.9726827964902,4.60507275840445,7.73882017041273,101,"ENSG00000079974.19"
"22624","ENSG00000170962.13_77687",77679,77687,9,"ENSG00000170962.13",1,8,"UVVVVVVMV",1,7,0.786749482401656,111,117,133,136,149,155,183,186,"ATGAGGA","TTGT","GTGATAC","CTGA",2.49910444474751,16,13,28,66,1.70656095491703,4.59181431330844,7.73881224291506,101,"ENSG00000079974.19"
"7877","ENSG00000115942.9_24540",24532,24540,9,"ENSG00000115942.9",1,2,"UMVVVVVVV",1,7,0.786749482401656,110,116,133,136,142,148,165,168,"AAGATGA","TTGA","TTGATCA","CTGT",2.38942287071076,17,6,17,49,2.43761531228374,4.59177527925554,7.73877320886216,101,"ENSG00000079974.19"
"11229","ENSG00000134297.8_70359",70351,70359,9,"ENSG00000134297.8",1,3,"VVMUVVVVV",1,7,0.763561076604555,114,120,133,136,146,152,169,172,"ATGTTGA","CTTG","ATAATTA","CTGA",2.4217995269322,13,10,17,49,2.59264543972174,4.68449390481743,7.73873821123565,101,"ENSG00000079974.19"
"22869","ENSG00000171587.15_73047",73039,73047,9,"ENSG00000171587.15",1,6,"VVVVVMUVV",1,7,0.788819875776397,113,119,133,136,146,152,165,168,"ATGATGT","CTGT","GTGCTCT","CTGG",2.3322507696564,14,10,13,46,2.78535128930058,4.58342243841915,7.73870194152474,101,"ENSG00000079974.19"
"4394","ENSG00000100422.14_44803",44795,44803,9,"ENSG00000100422.14",1,8,"VVVVVUVMV",1,7,0.806211180124224,55,61,75,78,113,119,133,136,"GTGATGA","CAGA","AGGAGGA","CTGT",2.43001873780223,14,35,14,72,1.85513815566072,4.51381576858556,7.73866048908245,101,"ENSG00000079974.19"
"11720","ENSG00000135905.21_61853",61845,61853,9,"ENSG00000135905.21",1,3,"UVMVVVVVV",1,7,0.785507246376811,60,66,78,81,97,103,133,136,"ATAATGA","CTGA","CTGATGG","CTCA",2.51564464817045,12,16,30,67,1.61538939448782,4.59658842890604,7.73861741441329,101,"ENSG00000079974.19"
"24697","ENSG00000177570.15_362476",362468,362476,9,"ENSG00000177570.15",0,NA,"UVVVVVUVV",2,7,0.788819875776397,85,91,133,136,146,152,182,185,"ATCATGA","CTGG","ATGCAGA","CTGA",2.59614760372875,42,10,30,91,1.02556637806755,4.58330426739814,7.73858377050373,101,"ENSG00000079974.19"
"22540","ENSG00000170745.12_415240",415232,415240,9,"ENSG00000170745.12",1,8,"VVVVUVVMV",1,7,0.773913043478261,93,99,133,136,156,162,172,175,"ATGAGGA","CAGA","ATGGTCA","CTGA",2.5921969505825,34,20,10,73,1.29012882960383,4.6428604583718,7.73851263228484,101,"ENSG00000079974.19"
"15588","ENSG00000148843.15_35087",35079,35087,9,"ENSG00000148843.15",1,7,"VVVVUVMVV",1,7,0.775155279503105,78,84,103,106,116,122,133,136,"ATGCTAA","CAGA","ATTTTGA","CTGA",2.4134126065172,19,10,11,49,2.4620212489147,4.637859656424,7.73848077443643,101,"ENSG00000079974.19"
"25001","ENSG00000179088.16_78480",78472,78480,9,"ENSG00000179088.16",1,1,"MVVVVVUVV",1,7,0.792132505175983,114,120,133,136,141,147,160,163,"ATGAGGT","GTGT","GGGAATA","CTGA",2.31006646241663,13,5,13,40,2.87932552744932,4.56994215255671,7.73847217326064,101,"ENSG00000079974.19"
"29132","ENSG00000197299.13_55322",55314,55322,9,"ENSG00000197299.13",1,8,"VVVVVUVMV",1,7,0.806211180124224,114,120,133,136,143,149,165,168,"TTGCAGA","GTGA","ATGTAAA","CTGA",2.2941256071206,13,7,16,45,2.7601645656331,4.51358381994261,7.7384285404395,101,"ENSG00000079974.19"
"9907","ENSG00000128487.19_170929",170921,170929,9,"ENSG00000128487.19",0,NA,"VVVUVUVVV",2,7,0.802898550724638,88,94,133,136,168,174,186,189,"ATGAAGA","GTGA","TGGAAGA","CTGA",2.56677588177775,39,32,12,92,0.995430326950073,4.52681738470044,7.73841158759899,101,"ENSG00000079974.19"
"15242","ENSG00000147481.17_52691",52683,52691,9,"ENSG00000147481.17",1,8,"VVVUVVVMV",1,7,0.764803312629399,116,122,133,136,163,169,192,195,"ATCATGA","CTAA","GTGCTGC","CTGA",2.59428558448172,11,27,23,70,1.42110348901275,4.67908517972273,7.73829843024032,101,"ENSG00000079974.19"
"29650","ENSG00000198551.10_43261",43253,43261,9,"ENSG00000198551.10",1,5,"VVVUMVVVV",1,7,0.767287784679089,44,50,62,65,75,81,133,136,"CTGATTT","CTGA","GTGATCC","CTGA",2.51650178097999,12,10,52,83,1.89989150216516,4.66914251050794,7.7382936492243,101,"ENSG00000079974.19"
"34839","ENSG00000234264.1_10011",10003,10011,9,"ENSG00000234264.1",1,3,"VVMVVVUVV",1,7,0.768944099378882,54,60,67,70,84,90,133,136,"AAGATGA","ATGA","GTGGTTA","CTGA",2.61065448080736,7,14,43,73,1.24570382155383,4.66251675673406,7.73829315424958,101,"ENSG00000079974.19"
"32674","ENSG00000227531.1_14422",14414,14422,9,"ENSG00000227531.1",1,8,"UVVVVVVMV",1,7,0.786749482401656,77,83,98,101,116,122,133,136,"CAGTTGA","CTGA","ATATAGA","CTGA",2.38729877548685,15,15,11,50,2.44984611702836,4.59129282173517,7.7382907513418,101,"ENSG00000079974.19"
"19431","ENSG00000162971.11_18539",18531,18539,9,"ENSG00000162971.11",1,2,"UMVVVVVVV",1,7,0.786749482401656,109,115,133,136,151,157,172,175,"ATGCTTA","ATGA","GTGCTTA","CTGA",2.44918432593124,18,15,15,57,2.0372625340438,4.59128951006302,7.73828743966964,101,"ENSG00000079974.19"
"12754","ENSG00000138835.24_1964",1956,1964,9,"ENSG00000138835.24",0,NA,"VVVVUUVVV",2,7,0.812008281573499,100,106,133,136,145,151,164,167,"ATGGTTA","CTTG","TTGATGA","CTGA",2.39829869723871,27,9,13,58,1.97233942761932,4.49024935230267,7.73828247859667,101,"ENSG00000079974.19"
"33398","ENSG00000229618.3_78803",78795,78803,9,"ENSG00000229618.3",1,1,"MVUVVVVVV",1,7,0.789648033126294,111,117,133,136,187,193,221,224,"GTGAAGA","CAGA","GTCATGA","CTGA",2.59583907850789,16,51,28,104,1.01315983087262,4.57968842189797,7.73828055440315,101,"ENSG00000079974.19"
"37935","ENSG00000249231.8_96333",96325,96333,9,"ENSG00000249231.8",1,1,"MVVVVUVVV",1,7,0.82815734989648,115,121,133,136,156,162,172,175,"GTGATGC","CTCA","GTGCTGC","CTTA",2.31358886336546,12,20,10,51,2.27861959164014,4.42563633685247,7.73826573643839,101,"ENSG00000079974.19"
"3915","ENSG00000090905.19_148778",148770,148778,9,"ENSG00000090905.19",1,6,"VVVVVMUVV",1,7,0.788819875776397,114,120,133,136,146,152,165,168,"GTAATAA","CTCA","CTTATTA","CTGA",2.32692837455474,13,10,13,45,2.8189809746876,4.58295920126314,7.73823870436873,101,"ENSG00000079974.19"
"14386","ENSG00000144821.11_30402",30394,30402,9,"ENSG00000144821.11",1,8,"VVVUVVVMV",1,7,0.764803312629399,115,121,133,136,145,151,165,168,"ATTTTGA","CTGG","GTAAAGT","CTGA",2.38275186854403,12,9,14,44,2.83078849053812,4.67895023687458,7.73816348739218,101,"ENSG00000079974.19"
"19590","ENSG00000163382.13_7372",7364,7372,9,"ENSG00000163382.13",0,NA,"UVVVVUVVV",2,7,0.824844720496894,114,120,133,136,141,147,156,159,"AAGAAGA","CCCA","GCCATCA","CTGA",2.20901756618421,13,5,9,36,3.02827255804952,4.43876408315273,7.7381429651403,101,"ENSG00000079974.19"
"32057","ENSG00000225742.6_13198",13190,13198,9,"ENSG00000225742.6",1,1,"MVUVVVVVV",1,7,0.789648033126294,111,117,133,136,153,159,212,215,"ATGGTGT","CTGT","GTGATGT","CTGA",2.55761626394391,16,17,53,95,1.26725880684198,4.57950847495035,7.73810060745553,101,"ENSG00000079974.19"
"19378","ENSG00000162843.18_3505",3497,3505,9,"ENSG00000162843.18",1,2,"UMVVVVVVV",1,7,0.786749482401656,66,72,86,89,93,99,133,136,"TTGATGC","CTCA","TTCAAGA","CTGA",2.47481140446186,14,4,34,61,1.86519558123538,4.59098456941194,7.73798249901856,101,"ENSG00000079974.19"
"18489","ENSG00000157483.9_162643",162635,162643,9,"ENSG00000157483.9",1,8,"VVVUVVVMV",1,7,0.764803312629399,108,114,133,136,147,153,185,188,"ATGATGA","ATAA","GTGTTCT","CTGA",2.58186648005953,19,11,32,71,1.50230996467743,4.67868829126858,7.73790154178618,101,"ENSG00000079974.19"
"44250","ENSG00000280143.1_2730",2722,2730,9,"ENSG00000280143.1",1,1,"MVUVVVVVV",1,7,0.789648033126294,110,116,133,136,143,149,171,174,"AGGATGG","TTGA","GTTTCGA","CTGA",2.42316608091613,17,7,22,55,2.16261779838923,4.57926458445752,7.7378567169627,101,"ENSG00000079974.19"
"34524","ENSG00000233290.4_509164",509156,509164,9,"ENSG00000233290.4",1,1,"MVVVVUVVV",1,7,0.82815734989648,111,117,133,136,145,151,160,163,"ATGATGC","ATGC","ATCATGT","CAGA",2.23521167889244,16,9,9,43,2.79948611067674,4.42522432582326,7.73785372540918,101,"ENSG00000079974.19"
"843","ENSG00000037749.13_111193",111185,111193,9,"ENSG00000037749.13",0,NA,"VVVVVUUVV",2,7,0.808281573498965,110,116,133,136,145,151,203,206,"ATTAGGA","CACA","ATGATGA","CTGA",2.44671293170995,17,9,52,87,1.70711697251268,4.50463412931141,7.73776042330727,101,"ENSG00000079974.19"
"2074","ENSG00000069869.17_82186",82178,82186,9,"ENSG00000069869.17",1,1,"MVVVVUVVV",1,7,0.82815734989648,91,97,104,107,115,121,133,136,"GTGATGT","TAGA","ATGAAAA","GTGA",2.25611977003347,7,8,12,36,2.65900959511257,4.42495201550059,7.73758141508651,101,"ENSG00000079974.19"
"12457","ENSG00000138311.18_15916",15908,15916,9,"ENSG00000138311.18",1,1,"MVVVVVUVV",1,7,0.792132505175983,113,119,133,136,157,163,172,175,"CAGATGT","CTGA","ATTCTTA","CTGA",2.41122220049972,14,21,9,53,2.2010604195607,4.56896877238971,7.73749879309365,101,"ENSG00000079974.19"
"8319","ENSG00000118217.7_28589",28581,28589,9,"ENSG00000118217.7",1,7,"UVVVVVMVV",1,7,0.787991718426501,108,114,133,136,147,153,174,177,"ATGAAGA","TAGA","TTGGTAA","CTGA",2.47045140100787,19,11,21,60,1.87220942082152,4.58547135688517,7.73743823059117,101,"ENSG00000079974.19"
"36626","ENSG00000242317.1_3608",3600,3608,9,"ENSG00000242317.1",1,7,"UVVVVVMVV",1,7,0.787991718426501,90,96,133,136,147,153,162,165,"CTGATGA","CACA","GTAAAGG","CTGA",2.47555044291558,37,11,9,66,1.83797412087526,4.58541093507811,7.73737780878411,101,"ENSG00000079974.19"
"5491","ENSG00000105220.17_30673",30665,30673,9,"ENSG00000105220.17",1,6,"UVVVVMVVV",1,7,0.805383022774327,99,105,133,136,169,175,193,196,"CTGAGGA","ATGA","GTGAGGA","CTGA",2.59800850958914,28,33,18,88,0.743277613991913,4.51583358614655,7.73736567724385,101,"ENSG00000079974.19"
"20819","ENSG00000165730.16_33295",33287,33295,9,"ENSG00000165730.16",0,NA,"VVUVVUVVV",2,7,0.805797101449275,109,115,133,136,160,166,181,184,"ATGAAGT","TTGG","GTGAGGA","CTGA",2.46398379803633,18,24,15,66,1.63013014564407,4.5141721998049,7.737360605602,101,"ENSG00000079974.19"
"17565","ENSG00000154447.15_95316",95308,95316,9,"ENSG00000154447.15",0,NA,"UVVVVUVVV",2,7,0.824844720496894,105,111,133,136,148,154,200,203,"ATGAAGA","CAGG","GTGTTGG","CTGA",2.49645677512417,22,12,46,89,1.10886141661525,4.43797664602742,7.737355528015,101,"ENSG00000079974.19"
"17927","ENSG00000155849.16_355872",355864,355872,9,"ENSG00000155849.16",1,1,"MVVVVUVVV",1,7,0.82815734989648,108,114,133,136,180,186,196,199,"AGGATGT","CCAA","TTGAGGA","CTGA",2.41781194590271,19,44,10,82,1.58005646137471,4.4247006918482,7.73733009143412,101,"ENSG00000079974.19"
"47240","ENSG00000287899.1_8148",8140,8148,9,"ENSG00000287899.1",1,8,"VVVUVVVMV",1,7,0.764803312629399,68,74,88,91,114,120,133,136,"CTGATGG","CTGG","CTAAAGA","CTGA",2.49842705546348,14,23,13,59,2.05609443837184,4.6780687020321,7.7372819525497,101,"ENSG00000079974.19"
"10047","ENSG00000128918.15_290693",290685,290693,9,"ENSG00000128918.15",1,2,"VMVVVVUVV",1,7,0.770186335403727,63,69,82,85,106,112,133,136,"ATCATGG","CTTA","ATGAGGA","CTGA",2.53976022919822,13,21,21,64,1.6942854182121,4.65650506988339,7.73725041149829,101,"ENSG00000079974.19"
"39870","ENSG00000254367.5_54943",54935,54943,9,"ENSG00000254367.5",1,6,"UVVVVMVVV",1,7,0.805383022774327,112,118,133,136,152,158,167,170,"AGAATGA","TTGG","ATGGAGA","CTGA",2.34973405075906,15,16,9,49,2.39794220169756,4.51570896835615,7.73724105945346,101,"ENSG00000079974.19"
"36308","ENSG00000239839.7_2040",2032,2040,9,"ENSG00000239839.7",1,5,"VVVVMVUVV",1,7,0.772670807453416,116,122,133,136,142,148,159,162,"ATTCTGT","CTGC","GTGTTTA","CTGA",2.33440112732408,11,6,11,37,3.02323689980693,4.64647777049187,7.73716100030553,101,"ENSG00000079974.19"
"11148","ENSG00000134057.15_6506",6498,6506,9,"ENSG00000134057.15",1,1,"MVVVVVUVV",1,7,0.792132505175983,115,121,133,136,186,192,208,211,"AGGCTTA","CTGA","GTGGTGA","CTGA",2.47724541761239,12,50,16,87,1.75954377377388,4.56862830613079,7.73715832683472,101,"ENSG00000079974.19"
"31082","ENSG00000215483.12_317534",317526,317534,9,"ENSG00000215483.12",1,6,"UVVVVMVVV",1,7,0.805383022774327,112,118,133,136,140,146,164,167,"TTAATGA","CTTT","ATAAAGA","CTGA",2.35123587916895,15,4,18,46,2.38742097017111,4.51558170782436,7.73711379892166,101,"ENSG00000079974.19"
"37613","ENSG00000248538.10_122098",122090,122098,9,"ENSG00000248538.10",1,1,"MVVUVVVVV",1,7,0.786749482401656,102,108,133,136,153,159,180,183,"TTGAAGA","ATGA","GTGAAGA","CTGA",2.5950354412491,25,17,21,72,1.06020309467961,4.5901098424184,7.73710777202503,101,"ENSG00000079974.19"
"1897","ENSG00000067208.16_50704",50696,50704,9,"ENSG00000067208.16",0,NA,"UVVVVVUVV",2,7,0.788819875776397,84,90,103,106,113,119,133,136,"ATTATGA","ATGA","ATGAAAT","CTAA",2.31714591701497,13,7,14,43,2.87935588587557,4.5817488331605,7.73702833626609,101,"ENSG00000079974.19"
"30007","ENSG00000198947.18_544524",544516,544524,9,"ENSG00000198947.18",1,3,"VVMVVUVVV",1,7,0.804968944099379,113,119,133,136,148,154,169,172,"ATTATTC","TTGA","ATGTTAA","CTGA",2.32812981758858,14,12,15,50,2.54760906120203,4.51711862794814,7.73699440434566,101,"ENSG00000079974.19"
"2840","ENSG00000078328.23_531469",531461,531469,9,"ENSG00000078328.23",0,NA,"VVVVUVUVV",2,7,0.775983436853002,114,120,133,136,172,178,189,192,"ATTAAGG","CTGA","GTGAGGT","CTGA",2.48015888153503,13,36,11,69,1.99775143607185,4.63303599490968,7.73696974232169,101,"ENSG00000079974.19"
"15241","ENSG00000147481.17_50930",50922,50930,9,"ENSG00000147481.17",1,8,"VVVUVVVMV",1,7,0.764803312629399,116,122,133,136,163,169,192,195,"ATCATGA","CTAA","GTGGTGC","CTGA",2.59344098988713,11,27,23,70,1.42110348901275,4.67767752206507,7.73689077258267,101,"ENSG00000079974.19"
"3953","ENSG00000091262.17_10584",10576,10584,9,"ENSG00000091262.17",0,NA,"UVVUVVVVV",2,7,0.78343685300207,92,98,133,136,142,148,160,163,"GTGGTGA","CAGA","GTAATCT","CTGA",2.46927178035229,35,6,12,62,1.95046119691526,4.60306826648263,7.73681567849091,101,"ENSG00000079974.19"
"40453","ENSG00000256340.11_10438",10430,10438,9,"ENSG00000256340.11",0,NA,"UVVUVVVVV",2,7,0.78343685300207,92,98,133,136,142,148,160,163,"GTGGTGA","CAGA","GTAATCT","CTGA",2.46927178035229,35,6,12,62,1.95046119691526,4.60306826648263,7.73681567849091,101,"ENSG00000079974.19"
"48387","ENSG00000291057.1_10552",10544,10552,9,"ENSG00000291057.1",0,NA,"UVVUVVVVV",2,7,0.78343685300207,92,98,133,136,142,148,160,163,"GTGGTGA","CAGA","GTAATCT","CTGA",2.46927178035229,35,6,12,62,1.95046119691526,4.60306826648263,7.73681567849091,101,"ENSG00000079974.19"
"31947","ENSG00000225427.2_37129",37121,37129,9,"ENSG00000225427.2",0,NA,"VVUVVVUVV",2,7,0.769772256728778,85,91,99,102,111,117,133,136,"AAGATGT","ATGA","AAGAAAA","CTGA",2.42596631919833,8,9,16,42,2.45764469612324,4.65768837269469,7.7367773996098,101,"ENSG00000079974.19"
"5435","ENSG00000104643.10_31803",31795,31803,9,"ENSG00000104643.10",1,3,"VVMVVUVVV",1,7,0.804968944099379,72,78,99,102,114,120,133,136,"ATGATGT","CTGT","GTGGTGT","CTGT",2.39589700517764,21,12,13,55,2.09481370195028,4.51686510078363,7.73674087718114,101,"ENSG00000079974.19"
"44482","ENSG00000282564.3_114485",114477,114485,9,"ENSG00000282564.3",1,6,"UVVVVMVVV",1,7,0.805383022774327,111,117,133,136,148,154,163,166,"ATGTTGC","CAAA","AGGTTGA","CTGA",2.31815137530532,16,12,9,46,2.6064885571107,4.51520776478653,7.73673985588384,101,"ENSG00000079974.19"
"21585","ENSG00000168405.18_255415",255407,255415,9,"ENSG00000168405.18",1,3,"VVMVUVVVV",1,7,0.772670807453416,75,81,97,100,107,113,133,136,"ATCATGG","GTGA","GTGTCTA","CTGA",2.43442427293532,16,7,20,52,2.35457706427138,4.64601805429338,7.73670128410704,101,"ENSG00000079974.19"
"21093","ENSG00000166435.17_31698",31690,31698,9,"ENSG00000166435.17",0,NA,"VVVVUUVVV",2,7,0.812008281573499,115,121,133,136,151,157,183,186,"ATGATGG","CCAA","ATCTAGA","CTGA",2.42464201609288,12,15,26,62,1.79030620285865,4.48864657753612,7.73667970383012,101,"ENSG00000079974.19"
"40993","ENSG00000258292.1_1388",1380,1388,9,"ENSG00000258292.1",1,5,"VVVVMUVVV",1,7,0.808695652173913,114,120,133,136,138,144,163,166,"ATCATGT","CTGG","ATTCTGC","CTGA",2.38485471238999,13,2,19,43,2.10851934476693,4.50188769017505,7.7366702988707,101,"ENSG00000079974.19"
"10949","ENSG00000133195.12_205176",205168,205176,9,"ENSG00000133195.12",1,7,"VVVVVUMVV",1,7,0.807453416149068,100,106,133,136,142,148,157,160,"GTTATGA","ATAA","GTGCAGT","CTGA",2.39127777914973,27,6,9,51,2.08556137820232,4.50685330980013,7.73666697439641,101,"ENSG00000079974.19"
"48555","ENSG00000291286.1_21952",21944,21952,9,"ENSG00000291286.1",1,1,"MVVVVVUVV",1,7,0.792132505175983,116,122,133,136,148,154,189,192,"AAGATGA","GTGC","CTGCAGA","CTGA",2.47182701911538,11,12,35,67,1.79368048993213,4.56813182100867,7.7366618417126,101,"ENSG00000079974.19"
"17626","ENSG00000154654.15_177237",177229,177237,9,"ENSG00000154654.15",1,2,"VMVVVUVVV",1,7,0.806211180124223,110,116,133,136,164,170,180,183,"GTGAGGA","TTAA","ATGAGAA","CTGA",2.43283574434271,17,28,10,64,1.828308879702,4.51180346049668,7.73664818099358,101,"ENSG00000079974.19"
"2869","ENSG00000078725.13_212184",212176,212184,9,"ENSG00000078725.13",1,7,"VVUVVVMVV",1,7,0.768944099378882,113,119,133,136,161,167,188,191,"ATGATGG","CTTC","ATGAGGA","CTGA",2.56429557374941,14,25,21,69,1.54810682425398,4.66085266231251,7.73662905982803,101,"ENSG00000079974.19"
"15174","ENSG00000147246.10_262019",262011,262019,9,"ENSG00000147246.10",1,2,"UMVVVVVVV",1,7,0.786749482401656,113,119,133,136,157,163,177,180,"TGGATGA","CTAA","GTGACTC","CTGA",2.44270946487235,14,21,14,58,2.07361057290378,4.58958508467985,7.73658301428648,101,"ENSG00000079974.19"
"9778","ENSG00000127249.15_157678",157670,157678,9,"ENSG00000127249.15",1,2,"VMVVVUVVV",1,7,0.806211180124223,104,110,133,136,145,151,160,163,"CTGATGT","TTTA","TAGCTGA","CTGA",2.37357124183152,23,9,9,50,2.22297941841496,4.51169692432295,7.73654164481984,101,"ENSG00000079974.19"
"26721","ENSG00000184985.16_157016",157008,157016,9,"ENSG00000184985.16",1,1,"MVVVVUVVV",1,7,0.82815734989648,115,121,133,136,145,151,163,166,"GTGATGT","CAGT","GTCAGGA","CTGC",2.21539450745863,12,9,12,42,2.92620981779387,4.42387663354618,7.7365060331321,101,"ENSG00000079974.19"
"38198","ENSG00000249781.7_108661",108653,108661,9,"ENSG00000249781.7",1,2,"VMVVVUVVV",1,7,0.806211180124223,48,54,68,71,83,89,133,136,"ATGATGT","GTGT","AAGTAGA","CTGA",2.44616480493699,14,12,44,79,1.73883486496284,4.51165005780236,7.73649477829925,101,"ENSG00000079974.19"
"46394","ENSG00000286556.1_17473",17465,17473,9,"ENSG00000286556.1",1,2,"VMVVVUVVV",1,7,0.806211180124223,48,54,68,71,83,89,133,136,"ATGATGT","GTGT","AAGTAGA","CTGA",2.44616480493699,14,12,44,79,1.73883486496284,4.51165005780236,7.73649477829925,101,"ENSG00000079974.19"
"42971","ENSG00000267476.1_52381",52373,52381,9,"ENSG00000267476.1",1,6,"VVVVUMVVV",1,7,0.792546583850932,114,120,133,136,159,165,173,176,"ATGATTT","TTGA","GTTCTAA","CTGA",2.41739845946617,13,23,8,53,2.14902858689836,4.5662545791682,7.73644091457193,101,"ENSG00000079974.19"
"9894","ENSG00000128059.8_30967",30959,30967,9,"ENSG00000128059.8",1,2,"UMVVVVVVV",1,7,0.786749482401656,101,107,133,136,152,158,177,180,"ATCATGA","CTTA","GAGATAA","CTGA",2.57399998677513,26,16,19,70,1.19752284788829,4.58938068993062,7.73637861953725,101,"ENSG00000079974.19"
"45393","ENSG00000285544.1_45748",45740,45748,9,"ENSG00000285544.1",0,NA,"UVVVVUVVV",2,7,0.824844720496894,103,109,133,136,140,146,159,162,"GGCATGA","CTGT","TTGATAG","CTGA",2.3658000100577,24,4,13,50,1.97566553983795,4.43691640172233,7.73629528370991,101,"ENSG00000079974.19"
"25502","ENSG00000181995.12_7477",7469,7477,9,"ENSG00000181995.12",0,NA,"UVVVVUVVV",2,7,0.824844720496894,98,104,133,136,140,146,161,164,"ATGATGA","GGGA","GTGGGGA","CAGA",2.40511875214433,29,4,15,57,1.71343136559937,4.43688909497373,7.7362679769613,101,"ENSG00000079974.19"
"1486","ENSG00000058063.16_35855",35847,35855,9,"ENSG00000058063.16",1,2,"UMVVVVVVV",1,7,0.786749482401656,97,103,133,136,172,178,186,189,"GTGTTGA","CTGA","ATGTGAA","CTGA",2.59753994688054,30,36,8,83,1.04012497677302,4.58926448899416,7.73626241860079,101,"ENSG00000079974.19"
"5761","ENSG00000106571.15_160446",160438,160446,9,"ENSG00000106571.15",1,1,"MVVVVVUVV",1,7,0.792132505175983,92,98,133,136,142,148,183,186,"ATGAGGA","CTGG","GTCATGT","CTGA",2.58376210381459,35,6,35,85,1.04552388295017,4.56765114376185,7.73618116446578,101,"ENSG00000079974.19"
"16214","ENSG00000151150.22_24454",24446,24454,9,"ENSG00000151150.22",1,6,"VVUVVMVVV",1,7,0.786335403726708,84,90,106,109,114,120,133,136,"TTGTTGT","CAGA","ATGAATT","CTGA",2.34936527584143,16,5,13,43,2.70086535882246,4.59082513277466,7.73616674768149,101,"ENSG00000079974.19"
"31960","ENSG00000225465.10_4100",4092,4100,9,"ENSG00000225465.10",1,1,"MVVVVUVVV",1,7,0.82815734989648,73,79,93,96,107,113,133,136,"ATGATGA","CTGG","CTGAAGA","GTCA",2.30679336139286,14,11,20,54,2.31548075654835,4.42352579145852,7.73615519104444,101,"ENSG00000079974.19"
"45622","ENSG00000285744.1_106769",106761,106769,9,"ENSG00000285744.1",1,1,"MVVVUVVVV",1,7,0.795859213250517,116,122,133,136,152,158,167,170,"GAAATGA","GTAA","GTGAAGA","CTGA",2.36137224369181,11,16,9,45,2.46809179391878,4.55264335463272,7.73608020763479,101,"ENSG00000079974.19"
"32813","ENSG00000228010.6_16490",16482,16490,9,"ENSG00000228010.6",1,6,"VVVVUMVVV",1,7,0.792546583850932,1,7,19,22,71,77,133,136,"CTGATGA","CAGA","GGGCTGT","CTGA",2.58924355170021,12,49,56,126,1.00186864314837,4.56587308028744,7.73605941569116,101,"ENSG00000079974.19"
"37283","ENSG00000246662.6_171833",171825,171833,9,"ENSG00000246662.6",1,5,"VVVVMUVVV",1,7,0.808695652173913,105,111,133,136,148,154,196,199,"ATGGTGA","CTGT","TGGATGG","CTGA",2.53326726339078,22,12,42,85,1.1166261003676,4.50126863074321,7.73605123943886,101,"ENSG00000079974.19"
"22956","ENSG00000171798.19_34343",34335,34343,9,"ENSG00000171798.19",1,5,"UVVVMVVVV",1,7,0.789233954451346,88,94,133,136,143,149,159,162,"ATTATCA","CTCA","GTGATTT","CTGA",2.44714690819071,39,7,10,65,2.00201088235568,4.57908090090677,7.73601671871215,101,"ENSG00000079974.19"
"14761","ENSG00000145819.18_386309",386301,386309,9,"ENSG00000145819.18",1,6,"VVVVVMUVV",1,7,0.788819875776397,107,113,133,136,182,188,205,208,"ATCAGGA","CTCA","GTGATGA","CTGA",2.56990786825098,20,46,17,92,1.19013076266755,4.58071247108519,7.73599197419078,101,"ENSG00000079974.19"
"33210","ENSG00000229009.8_909",901,909,9,"ENSG00000229009.8",1,7,"VVVVVUMVV",1,7,0.807453416149068,109,115,133,136,150,156,206,209,"AAGATGA","CTGC","ATTAGAA","CTGA",2.50994001086182,18,14,50,91,1.29163403527439,4.50614186025496,7.73595552485124,101,"ENSG00000079974.19"
"9653","ENSG00000125997.5_5257",5249,5257,9,"ENSG00000125997.5",0,NA,"VVVVVUUVV",2,7,0.808281573498965,114,120,133,136,145,151,164,167,"TTTATGT","GAGA","TTGGGGA","CTGA",2.27058985252086,13,9,13,44,2.87402150436547,4.50282179695946,7.73594809095532,101,"ENSG00000079974.19"
"4723","ENSG00000101773.19_43884",43876,43884,9,"ENSG00000101773.19",1,8,"UVVVVVVMV",1,7,0.786749482401656,83,89,100,103,112,118,133,136,"ATGAGGA","CTTA","CTGAGAA","ATGA",2.34069267218915,11,9,15,44,2.75117389582503,4.58894792760483,7.73594585721146,101,"ENSG00000079974.19"
"23679","ENSG00000173517.11_209164",209156,209164,9,"ENSG00000173517.11",1,2,"VMVVVUVVV",1,7,0.806211180124223,83,89,133,136,146,152,163,166,"TTGCTGA","CTGG","TTCCTGA","CTGA",2.42398382032644,44,10,11,74,1.88431722706912,4.51105234064468,7.73589706114157,101,"ENSG00000079974.19"
"9144","ENSG00000122870.12_28426",28418,28426,9,"ENSG00000122870.12",1,2,"VMVVVUVVV",1,7,0.806211180124223,88,94,106,109,114,120,133,136,"ATAATGA","GTGA","ATCTTGT","CTAA",2.27229516993752,12,5,13,39,2.89554315851381,4.51104440619099,7.73588912668789,101,"ENSG00000079974.19"
"9929","ENSG00000128512.24_4600",4592,4600,9,"ENSG00000128512.24",1,6,"UVVVVMVVV",1,7,0.805383022774327,109,115,133,136,146,152,160,163,"ATGATGA","TTGG","GGGAACA","GTGA",2.32596817299375,18,10,8,45,2.55073918822407,4.51429841871227,7.73583050980958,101,"ENSG00000079974.19"
"15952","ENSG00000150394.14_325515",325507,325515,9,"ENSG00000150394.14",1,2,"UMVVVVVVV",1,7,0.786749482401656,107,113,133,136,185,191,199,202,"ATAATGA","TTGG","CTGATGC","CTGA",2.53255152772791,20,49,8,86,1.47160036161716,4.58881930328414,7.73581723289076,101,"ENSG00000079974.19"
"35543","ENSG00000236283.5_178244",178236,178244,9,"ENSG00000236283.5",1,1,"MVVVUVVVV",1,7,0.795859213250517,109,115,133,136,143,149,198,201,"ATAATGA","CCAA","ATGAATA","CTGA",2.48101170176302,18,7,49,83,1.66942353901602,4.55237538769237,7.73581224069444,101,"ENSG00000079974.19"
"27281","ENSG00000185842.16_244542",244534,244542,9,"ENSG00000185842.16",1,7,"UVVVVVMVV",1,7,0.787991718426501,112,118,133,136,146,152,180,183,"ATAATGA","TTGT","TTCAAGA","CTGA",2.45294082346921,15,10,28,62,1.98218905062996,4.5837819684395,7.73574884214551,101,"ENSG00000079974.19"
"1193","ENSG00000049192.15_15503",15495,15503,9,"ENSG00000049192.15",1,8,"UVVVVVVMV",1,7,0.786749482401656,106,112,133,136,155,161,177,180,"GTGATAA","TTGA","AGGAGGA","CTGA",2.52957635719452,21,19,16,65,1.49106318402378,4.58872639133015,7.73572432093678,101,"ENSG00000079974.19"
"25914","ENSG00000183098.11_186786",186778,186786,9,"ENSG00000183098.11",1,6,"UVVVVMVVV",1,7,0.805383022774327,116,122,133,136,186,192,205,208,"GAGATGA","GAGA","TTGGAGA","CTGA",2.42428580323516,11,50,13,83,1.89477243298779,4.51416944697221,7.73570153806952,101,"ENSG00000079974.19"
"38421","ENSG00000250149.2_147107",147099,147107,9,"ENSG00000250149.2",1,2,"UMVVVVVVV",1,7,0.786749482401656,106,112,133,136,139,145,155,158,"AAGATGG","TTGA","GAGAAAA","CTGA",2.4346956613964,21,3,10,43,2.12304135006302,4.58858643984308,7.73558436944971,101,"ENSG00000079974.19"
"10791","ENSG00000132849.22_236525",236517,236525,9,"ENSG00000132849.22",1,8,"VVUVVVVMV",1,7,0.767701863354037,65,71,84,87,92,98,133,136,"ATGATGA","CTGT","ATGGAGA","TTGA",2.50182672084072,13,5,35,62,1.98008864057137,4.66473336154405,7.7355408149602,101,"ENSG00000079974.19"
"21501","ENSG00000168038.11_568431",568423,568431,9,"ENSG00000168038.11",1,6,"VVVVVMUVV",1,7,0.788819875776397,112,118,133,136,144,150,162,165,"GTTATGA","CTGC","ATAATGA","ATGA",2.31870387825527,15,8,12,44,2.86287027441583,4.58022403236275,7.73550353546834,101,"ENSG00000079974.19"
"41014","ENSG00000258394.1_103264",103256,103264,9,"ENSG00000258394.1",1,8,"VVVVVUVMV",1,7,0.806211180124224,93,99,133,136,141,147,167,170,"ATGGTGA","GAGA","GAGAGGA","CTGA",2.48733833618448,34,5,20,68,1.45998410005734,4.51055991865513,7.73540463915203,101,"ENSG00000079974.19"
"41325","ENSG00000258850.1_53674",53666,53674,9,"ENSG00000258850.1",1,8,"VVVVVUVMV",1,7,0.806211180124224,93,99,133,136,141,147,167,170,"ATGGTGA","GAGA","GAGAGGA","CTGA",2.48733833618448,34,5,20,68,1.45998410005734,4.51055991865513,7.73540463915203,101,"ENSG00000079974.19"
"20100","ENSG00000164300.17_50797",50789,50797,9,"ENSG00000164300.17",1,8,"VVVVVUVMV",1,7,0.806211180124224,106,112,133,136,140,146,154,157,"GTGAAGT","CTGT","ATGGAAA","CTGA",2.36955806857494,21,4,8,42,2.24513148273467,4.51054631830856,7.73539103880546,101,"ENSG00000079974.19"
"48066","ENSG00000290344.1_30167",30159,30167,9,"ENSG00000290344.1",1,8,"VVVVUVVMV",1,7,0.773913043478261,83,89,133,136,142,148,194,197,"ATGATGT","CTCA","CTGAAGT","CTGA",2.63531805393066,44,6,46,105,0.990161955407348,4.63973724540294,7.73538941931598,101,"ENSG00000079974.19"
"22230","ENSG00000169994.20_5747",5739,5747,9,"ENSG00000169994.20",1,6,"VVVVVMUVV",1,7,0.788819875776397,82,88,96,99,104,110,133,136,"AGGATGA","CTGA","GTGTAAA","GTGA",2.44396220449833,8,5,23,45,2.02730106274115,4.58009560651583,7.73537510962142,101,"ENSG00000079974.19"
"21412","ENSG00000167447.13_4244",4236,4244,9,"ENSG00000167447.13",1,2,"UMVVVVVVV",1,7,0.786749482401656,55,61,69,72,78,84,133,136,"CTGATGC","CAGA","CTAATGC","CTGA",2.49530400965287,8,6,49,72,1.71796292048911,4.58833074621039,7.73532867581701,101,"ENSG00000079974.19"
"42626","ENSG00000265303.1_16078",16070,16078,9,"ENSG00000265303.1",1,2,"UMVVVVVVV",1,7,0.786749482401656,55,61,69,72,78,84,133,136,"CTGATGC","CAGA","CTAATGC","CTGA",2.49530400965287,8,6,49,72,1.71796292048911,4.58833074621039,7.73532867581701,101,"ENSG00000079974.19"
"25631","ENSG00000182247.10_36809",36801,36809,9,"ENSG00000182247.10",1,1,"MVVVVUVVV",1,7,0.82815734989648,104,110,133,136,146,152,162,165,"TTGATGA","CAGT","TTGATGT","CAGA",2.32786529703664,23,10,10,52,2.17147996650124,4.42264548668638,7.7352748862723,101,"ENSG00000079974.19"
"10904","ENSG00000133103.17_116267",116259,116267,9,"ENSG00000133103.17",1,8,"VVVVVVUMV",1,7,0.770186335403727,82,88,100,103,115,121,133,136,"CTAATGC","CTGG","GTGCTGG","CTGA",2.38315449638358,12,12,12,45,2.73009128503269,4.65444698189748,7.73519232351238,101,"ENSG00000079974.19"
"45643","ENSG00000285769.4_94130",94122,94130,9,"ENSG00000285769.4",1,8,"VVVVVUVMV",1,7,0.806211180124224,69,75,103,106,114,120,133,136,"GAGAGGA","CAGA","CTGAAGT","CTGA",2.40864842543421,28,8,13,58,1.98371592085377,4.51034302260379,7.73518774310068,101,"ENSG00000079974.19"
"6661","ENSG00000111249.14_68468",68460,68468,9,"ENSG00000111249.14",1,2,"VMVVVUVVV",1,7,0.806211180124223,30,36,47,50,83,89,133,136,"ATGATGA","CTCA","GTGCTGA","CTCA",2.55423039507637,11,33,44,97,1.01311803324378,4.51033016677157,7.73517488726846,101,"ENSG00000079974.19"
"27452","ENSG00000186188.11_33435",33427,33435,9,"ENSG00000186188.11",1,8,"VVVVVUVMV",1,7,0.806211180124224,105,111,133,136,165,171,181,184,"GTGATGT","TGGA","GTGGGGA","CTGA",2.49645438684454,22,29,10,70,1.39828095993322,4.51032755139087,7.73517227188777,101,"ENSG00000079974.19"
"37818","ENSG00000248905.10_372219",372211,372219,9,"ENSG00000248905.10",1,6,"UVVVVMUVV",2,6,0.691511387163561,58,64,79,82,116,122,133,136,"ATGCTGA","CTGA","GTAATAA","CTGA",2.69355431869767,15,34,11,69,1.91934991567498,4.96909467674819,7.73514022540243,101,"ENSG00000079974.19"
"3132","ENSG00000081479.15_136020",136012,136020,9,"ENSG00000081479.15",0,NA,"VVVUVVUVV",2,7,0.766873706004141,115,121,133,136,175,181,193,196,"ATCCTGA","ATGA","ATGTTGA","CTGA",2.50550006960364,12,39,12,72,1.96724247873783,4.66764406902385,7.73513889304042,101,"ENSG00000079974.19"
"20972","ENSG00000166111.10_72713",72705,72713,9,"ENSG00000166111.10",1,3,"VVMVVVUVV",1,7,0.768944099378882,66,72,103,106,116,122,133,136,"CTGATGA","CTGA","TTGAAAA","CTGT",2.50820935898344,31,10,11,61,1.91603217552942,4.65935697552142,7.73513337303695,101,"ENSG00000079974.19"
"41633","ENSG00000259390.4_5667",5659,5667,9,"ENSG00000259390.4",0,NA,"UVVVVUVVV",2,7,0.824844720496894,108,114,133,136,147,153,163,166,"ATAAAGA","GAGA","CTTATTA","CTGA",2.29946461648736,19,11,10,49,2.41310472045169,4.43571720759186,7.73509608957944,101,"ENSG00000079974.19"
"39560","ENSG00000253807.6_32163",32155,32163,9,"ENSG00000253807.6",1,2,"UMVVVVVVV",1,7,0.786749482401656,81,87,106,109,116,122,133,136,"AAGATGA","CTGA","ATTTTCA","CTCA",2.36783493169674,19,7,11,46,2.56672208124723,4.58807207313971,7.73507000274634,101,"ENSG00000079974.19"
"4701","ENSG00000101745.17_137262",137254,137262,9,"ENSG00000101745.17",1,5,"UVVVMVVVV",1,7,0.789233954451346,105,111,133,136,144,150,170,173,"GTAATAA","CTGG","GTGAAGA","CTGA",2.47087044318783,22,8,20,59,1.84004208535595,4.57812792665204,7.73506374445742,101,"ENSG00000079974.19"
"35479","ENSG00000236123.1_4995",4987,4995,9,"ENSG00000236123.1",0,NA,"UVVVVUVVV",2,7,0.824844720496894,112,118,133,136,169,175,191,194,"ACCATGA","CTAA","ATCATAA","CTGA",2.40681151240329,15,33,16,73,1.6971834372361,4.43564837998118,7.73502726196876,101,"ENSG00000079974.19"
"24517","ENSG00000176769.9_17861",17853,17861,9,"ENSG00000176769.9",1,2,"UMVVVVVVV",1,7,0.786749482401656,105,111,133,136,143,149,165,168,"ATAATGA","CAAA","CTCATAA","CTGA",2.4384405401759,22,7,16,54,2.0956278756075,4.58797453586171,7.73497246546834,101,"ENSG00000079974.19"
"32076","ENSG00000225811.1_68175",68167,68175,9,"ENSG00000225811.1",1,5,"UVVVMVVVV",1,7,0.789233954451346,114,120,133,136,149,155,164,167,"TTGATAA","CTAC","ATGCTTA","CTGA",2.34223676282719,13,13,9,44,2.69709426529491,4.57800150436904,7.73493732217442,101,"ENSG00000079974.19"
"3011","ENSG00000080224.18_924098",924090,924098,9,"ENSG00000080224.18",1,5,"VVVVMUUVV",2,6,0.694824016563147,44,50,61,64,78,84,133,136,"AAGATGA","CTGA","GTGATTT","CTGA",2.73327291432223,11,14,49,83,1.60067968603928,4.95562477871353,7.73492084496612,101,"ENSG00000079974.19"
"28317","ENSG00000188649.15_64613",64605,64613,9,"ENSG00000188649.15",0,NA,"VVVVUUVVV",2,7,0.812008281573499,115,121,133,136,141,147,173,176,"ATGGAGA","GTGA","ATTAAAA","CTGA",2.36688799768689,12,5,26,52,2.1682450082525,4.48687458154127,7.73490770783527,101,"ENSG00000079974.19"
"20993","ENSG00000166173.11_9351",9343,9351,9,"ENSG00000166173.11",0,NA,"VVVVUUVVV",2,7,0.812008281573499,34,40,84,87,95,101,133,136,"GTGATGA","CTGA","CTTAAGA","CTTA",2.53051205473797,44,8,32,93,1.07741007962919,4.48687261113725,7.73490573743125,101,"ENSG00000079974.19"
"7040","ENSG00000112541.19_50237",50229,50237,9,"ENSG00000112541.19",1,2,"VMVVUVVVV",1,7,0.773913043478261,17,23,35,38,81,87,133,136,"GTGATGT","CTGA","GGGGGGA","CTGA",2.63202080432585,12,43,46,110,1.01017113187417,4.63924412351163,7.73489629742467,101,"ENSG00000079974.19"
"24640","ENSG00000177294.7_17850",17842,17850,9,"ENSG00000177294.7",1,2,"VMVVVUVVV",1,7,0.806211180124223,108,114,133,136,176,182,190,193,"CTGCTGA","CTGC","AGGAAGA","CTGA",2.47137237653731,19,40,8,76,1.56437780222049,4.51004841145063,7.73489313194752,101,"ENSG00000079974.19"
"74","ENSG00000004455.18_68671",68663,68671,9,"ENSG00000004455.18",1,8,"VVUVVVVMV",1,7,0.767701863354037,57,63,72,75,84,90,133,136,"ATGATGA","GTGA","GTGAACA","CTTA",2.52873063759719,9,9,43,70,1.79798684138197,4.66404777300748,7.73485522642362,101,"ENSG00000079974.19"
"15143","ENSG00000147180.17_11783",11775,11783,9,"ENSG00000147180.17",1,7,"VVVUVVMVV",1,7,0.766045548654244,115,121,133,136,147,153,164,167,"ATGATGA","CTTC","TTAATGA","GTGA",2.37734203982053,12,11,11,43,2.83341122144213,4.67058953839475,7.73477173301172,101,"ENSG00000079974.19"
"37515","ENSG00000248360.7_249423",249415,249423,9,"ENSG00000248360.7",1,3,"UVMVVVVVV",1,7,0.785507246376811,116,122,133,136,172,178,191,194,"GTGATTA","CTGC","GTGGCCA","CTGA",2.46909071943913,11,36,13,69,1.91028277426934,4.59272189263256,7.7347508781398,101,"ENSG00000079974.19"
"1153","ENSG00000048342.18_3420",3412,3420,9,"ENSG00000048342.18",1,5,"UVVVMVVVV",1,7,0.789233954451346,113,119,133,136,176,182,223,226,"ATGTTGA","CTGT","GTGTTGG","CTGA",2.59844558788677,14,40,41,104,0.988152652378427,4.57778080957255,7.73471662737794,101,"ENSG00000079974.19"
"27155","ENSG00000185658.14_95024",95016,95024,9,"ENSG00000185658.14",0,NA,"VVUVUVVVV",2,7,0.773498964803312,116,122,133,136,148,154,170,173,"ATGAGGT","CTCA","ATGTCCA","CTGA",2.40927038708598,11,12,16,48,2.50101977283424,4.64070558835185,7.7347014475651,101,"ENSG00000079974.19"
"8425","ENSG00000118873.17_2219",2211,2219,9,"ENSG00000118873.17",1,3,"VVMVVVUVV",1,7,0.768944099378882,111,117,133,136,143,149,205,208,"ATTATGT","CTGA","AAGCTGT","CTGA",2.51958511749223,16,7,56,88,1.83843225566438,4.65891659306981,7.73469299058534,101,"ENSG00000079974.19"
"14502","ENSG00000145216.17_80191",80183,80191,9,"ENSG00000145216.17",0,NA,"UVVVVUVVV",2,7,0.824844720496894,83,89,101,104,110,116,133,136,"AAGATTA","GTGA","CTGATGT","TTGA",2.25762047722384,12,6,17,44,2.69027341612019,4.43526914940312,7.73464803139069,101,"ENSG00000079974.19"
"44466","ENSG00000282278.1_79921",79913,79921,9,"ENSG00000282278.1",0,NA,"UVVVVUVVV",2,7,0.824844720496894,83,89,101,104,110,116,133,136,"AAGATTA","GTGA","CTGATGT","TTGA",2.25762047722384,12,6,17,44,2.69027341612019,4.43526914940312,7.73464803139069,101,"ENSG00000079974.19"
"14257","ENSG00000144642.22_379351",379343,379351,9,"ENSG00000144642.22",0,NA,"UVVVVVUVV",2,7,0.788819875776397,112,118,133,136,144,150,159,162,"ATGATAA","TTGT","ATGAAGA","GTGA",2.30971100399226,15,8,9,41,2.91891028477788,4.57924591118156,7.73452541428715,101,"ENSG00000079974.19"
"44800","ENSG00000283563.1_604964",604956,604964,9,"ENSG00000283563.1",0,NA,"UVVVVVUVV",2,7,0.788819875776397,112,118,133,136,144,150,159,162,"ATGATAA","TTGT","ATGAAGA","GTGA",2.30971100399226,15,8,9,41,2.91891028477788,4.57924591118156,7.73452541428715,101,"ENSG00000079974.19"
"28531","ENSG00000196090.13_394464",394456,394464,9,"ENSG00000196090.13",1,6,"VVVVVMUVV",1,7,0.788819875776397,111,117,133,136,171,177,187,190,"TTAATGA","ATTA","GTGAGGA","CTGA",2.4688575684427,16,35,10,70,1.85774482383722,4.57919882003047,7.73447832313606,101,"ENSG00000079974.19"
"12959","ENSG00000139697.14_46816",46808,46816,9,"ENSG00000139697.14",0,NA,"VVVUVUVVV",2,7,0.802898550724638,45,51,74,77,114,120,133,136,"ATGATGG","CTGA","GTGAAAA","ATGA",2.53284518450803,23,37,13,82,1.20562447116556,4.5228147586381,7.73440896153665,101,"ENSG00000079974.19"
"13240","ENSG00000140718.21_86452",86444,86452,9,"ENSG00000140718.21",1,8,"UVVVVVVMV",1,7,0.786749482401656,116,122,133,136,145,151,161,164,"ATTAGGA","GAGA","TTTAGGA","CTGA",2.30692142712651,11,9,10,39,2.9701612525466,4.58740935834751,7.73440728795413,101,"ENSG00000079974.19"
"47770","ENSG00000289242.1_65484",65476,65484,9,"ENSG00000289242.1",0,NA,"VVVUVUVVV",2,7,0.802898550724638,116,122,133,136,141,147,184,187,"GTGAAGA","AGGA","CTGGAGA","CTGA",2.42226061894695,11,5,37,62,1.94279869025539,4.5228007041421,7.73439490704065,101,"ENSG00000079974.19"
"10982","ENSG00000133401.16_208535",208527,208535,9,"ENSG00000133401.16",0,NA,"VVVVVUUVV",2,7,0.808281573498965,109,115,133,136,169,175,193,196,"GAGATGA","TTGA","ATGCAGG","CTGA",2.50101600652982,18,33,18,78,1.33161200465482,4.50126301204673,7.73438930604259,101,"ENSG00000079974.19"
"36958","ENSG00000243914.1_395",387,395,9,"ENSG00000243914.1",0,NA,"VVVVVUUVV",2,7,0.808281573498965,109,115,133,136,169,175,193,196,"GAGATGA","TTGA","ATGCAGG","CTGA",2.50101600652982,18,33,18,78,1.33161200465482,4.50126301204673,7.73438930604259,101,"ENSG00000079974.19"
"3747","ENSG00000088808.18_40502",40494,40502,9,"ENSG00000088808.18",1,5,"VVVVMUUVV",2,6,0.694824016563147,93,99,106,109,114,120,133,136,"CTGTTGA","CAGA","ATGAAGA","CTGA",2.57868939751073,7,5,13,34,2.62904279243274,4.95507636062607,7.73437242687866,101,"ENSG00000079974.19"
"35544","ENSG00000236283.5_189233",189225,189233,9,"ENSG00000236283.5",1,2,"VMVVVVUVV",1,7,0.770186335403727,116,122,133,136,140,146,166,169,"ATGTTCA","TTGT","ATGATGA","CTGA",2.44151942500652,11,4,20,44,2.33766630361409,4.65361561758106,7.73436095919597,101,"ENSG00000079974.19"
"44383","ENSG00000281566.4_161887",161879,161887,9,"ENSG00000281566.4",1,8,"VVVUVVVMV",1,7,0.764803312629399,113,119,133,136,145,151,165,168,"GTGGTGT","CTGC","AGGATGC","CTGA",2.38658717893674,14,9,14,46,2.78995296156916,4.67513353862019,7.73434678913779,101,"ENSG00000079974.19"
"30258","ENSG00000204398.5_36408",36400,36408,9,"ENSG00000204398.5",1,1,"MVVVUVVVV",1,7,0.795859213250517,74,80,107,110,114,120,133,136,"GCGATGA","CTGA","GTGAAGT","GTGA",2.45153822397228,27,4,13,53,1.85970337170632,4.55082288288039,7.73425973588246,101,"ENSG00000079974.19"
"31130","ENSG00000215881.3_28600",28592,28600,9,"ENSG00000215881.3",1,1,"MVVVUVVVV",1,7,0.795859213250517,74,80,107,110,114,120,133,136,"GCGATGA","CTGA","GTGAAGT","GTGA",2.45153822397228,27,4,13,53,1.85970337170632,4.55082288288039,7.73425973588246,101,"ENSG00000079974.19"
"3218","ENSG00000082397.18_4637",4629,4637,9,"ENSG00000082397.18",1,7,"VVVVVUMVV",1,7,0.807453416149068,101,107,133,136,155,161,171,174,"ATAATGA","GCGA","CTGAATA","CTGA",2.48419082346921,26,19,10,64,1.45629812342438,4.50439256997144,7.73420623456771,101,"ENSG00000079974.19"
"35061","ENSG00000234818.1_13428",13420,13428,9,"ENSG00000234818.1",0,NA,"UVVUVVVVV",2,7,0.78343685300207,109,115,133,136,143,149,160,163,"ATAATGC","TTGC","ATGACAA","CTGA",2.36155039264197,18,7,11,45,2.65814522852365,4.60045362820087,7.73420104020915,101,"ENSG00000079974.19"
"48156","ENSG00000290551.1_102215",102207,102215,9,"ENSG00000290551.1",1,2,"UMVVVVVVV",1,7,0.786749482401656,111,117,133,136,141,147,156,159,"TTGAGAA","CTGG","CTGAATA","CTGA",2.33040428896021,16,5,9,39,2.81278283517189,4.58720285705999,7.73420078666661,101,"ENSG00000079974.19"
"23859","ENSG00000174469.23_1650963",1650955,1650963,9,"ENSG00000174469.23",1,8,"UVVVVVVMV",1,7,0.786749482401656,52,58,73,76,81,87,133,136,"TTATTGA","CTGA","GTGACAA","CTGA",2.47526982919758,15,5,46,75,1.84686550427026,4.58716609139687,7.73416402100349,101,"ENSG00000079974.19"
"33950","ENSG00000231607.15_20581",20573,20581,9,"ENSG00000231607.15",1,1,"MVVVVUVVV",1,7,0.82815734989648,114,120,133,136,140,146,154,157,"AATAGGA","ATGA","ACAAAGA","CTGA",2.20585644441529,13,4,8,34,2.98024488749675,4.421488629233,7.73411802881892,101,"ENSG00000079974.19"
"24014","ENSG00000174844.15_38248",38240,38248,9,"ENSG00000174844.15",0,NA,"UVVVVVUVV",2,7,0.788819875776397,67,73,106,109,114,120,133,136,"ATGTTGT","CAGA","CTAAAGA","CTGA",2.46717459892598,33,5,13,60,1.86746595943053,4.57882415473426,7.73410365783985,101,"ENSG00000079974.19"
"31892","ENSG00000225190.12_47818",47810,47818,9,"ENSG00000225190.12",1,1,"MVVVVUVVV",1,7,0.82815734989648,112,118,133,136,184,190,198,201,"ATGAGAA","CAGA","AGGAGCA","CTGA",2.36923291827214,15,48,8,80,1.89097236379856,4.42146462140321,7.73409402098913,101,"ENSG00000079974.19"
"19971","ENSG00000164096.13_399",391,399,9,"ENSG00000164096.13",1,8,"VVVVVUVMV",1,7,0.806211180124224,111,117,133,136,151,157,174,177,"ATGAGGA","CTCT","ATGTTTC","CTGA",2.39214747996044,16,15,17,57,2.0893254008163,4.50924381680481,7.73408853730171,101,"ENSG00000079974.19"
"14807","ENSG00000145934.17_1256978",1256970,1256978,9,"ENSG00000145934.17",1,8,"VVUVVVVMV",1,7,0.767701863354037,116,122,133,136,139,145,162,165,"AGCATGT","CTGA","CAGAAGA","CTGA",2.43699097827538,11,3,17,40,2.40641515234946,4.66325541854633,7.73406287196248,101,"ENSG00000079974.19"
"27493","ENSG00000186314.12_175934",175926,175934,9,"ENSG00000186314.12",1,6,"VVVVVMUVV",1,7,0.788819875776397,105,111,133,136,145,151,177,180,"TTGTTGA","CTGT","TTGTTGA","CTGA",2.51864302155897,22,9,26,66,1.52394483786692,4.57872457873169,7.73400408183728,101,"ENSG00000079974.19"
"32063","ENSG00000225746.13_94647",94639,94647,9,"ENSG00000225746.13",1,2,"VMVVUVVVV",1,7,0.773913043478261,115,121,133,136,146,152,162,165,"TTGGTGA","CTAT","TTGAAAA","CTGA",2.34460501604279,12,10,10,41,2.92251211305717,4.63830305500228,7.73395522891533,101,"ENSG00000079974.19"
"7131","ENSG00000112902.12_480199",480191,480199,9,"ENSG00000112902.12",1,8,"VVVVVUVMV",1,7,0.806211180124224,81,87,101,104,113,119,133,136,"CTTATAA","TTGA","GTAATAG","CTGA",2.28695717220149,14,9,14,46,2.78995296156916,4.50908352739477,7.73392824789166,101,"ENSG00000079974.19"
"294","ENSG00000007402.12_30660",30652,30660,9,"ENSG00000007402.12",1,8,"VVVVVVUMV",1,7,0.770186335403727,113,119,133,136,144,150,182,185,"AGGATGC","CTGG","GTGATAC","CTGA",2.48575545434578,14,8,32,63,2.04088035654689,4.65314584637969,7.7338911879946,101,"ENSG00000079974.19"
"8705","ENSG00000120332.17_55516",55508,55516,9,"ENSG00000120332.17",1,3,"VVMVUVVVV",1,7,0.772670807453416,112,118,133,136,186,192,210,213,"GTGATGA","ATGT","TTGACGG","CTGA",2.55393486909086,15,50,18,92,1.54642330851572,4.64316394228036,7.73384717209402,101,"ENSG00000079974.19"
"48360","ENSG00000291034.1_316776",316768,316776,9,"ENSG00000291034.1",1,8,"VVVVVVUMV",1,7,0.770186335403727,52,58,70,73,88,94,133,136,"ATGAAGT","CTGC","ATGAAGA","CTGA",2.55497591656286,12,15,39,75,1.57890459029732,4.65301934184577,7.73376468346068,101,"ENSG00000079974.19"
"16728","ENSG00000152208.13_1437677",1437669,1437677,9,"ENSG00000152208.13",1,7,"UVVVVVMVV",1,7,0.787991718426501,113,119,133,136,175,181,195,198,"TTGATGA","TTGG","GGGAGGC","CTGA",2.47242646573932,14,39,14,76,1.84429889251617,4.58178549936124,7.73375237306724,101,"ENSG00000079974.19"
"44257","ENSG00000280182.1_1955",1947,1955,9,"ENSG00000280182.1",1,8,"VVVVVUVMV",1,7,0.806211180124224,70,76,94,97,106,112,133,136,"ATGATGT","GTGA","ATGGTGT","CTGG",2.39375290069858,18,9,21,57,2.07722428708957,4.50889423960336,7.73373896010026,101,"ENSG00000079974.19"
"4848","ENSG00000102053.13_7062",7054,7062,9,"ENSG00000102053.13",1,8,"VVVVUVVMV",1,7,0.773913043478261,73,79,97,100,115,121,133,136,"ATAATGA","CTGA","GTTACGA","CTAA",2.45610072925153,18,15,12,54,2.17832182835012,4.63808167250675,7.73373384641979,101,"ENSG00000079974.19"
"2082","ENSG00000070010.19_28528",28520,28528,9,"ENSG00000070010.19",1,8,"VVVVVUVMV",1,7,0.806211180124224,114,120,133,136,137,143,151,154,"GTAAAAA","CTAA","GTGAGGA","CTGA",2.31333986503256,13,1,8,31,2.6131738857098,4.50885991314839,7.73370463364528,101,"ENSG00000079974.19"
"39739","ENSG00000254163.1_5278",5270,5278,9,"ENSG00000254163.1",1,1,"MVVUVVVVV",1,7,0.786749482401656,91,97,104,107,115,121,133,136,"ATGATGA","CTGA","GGGATAA","CAAA",2.3531611969112,7,8,12,36,2.65900959511257,4.58668772696347,7.7336856565701,101,"ENSG00000079974.19"
"7120","ENSG00000112893.10_58750",58742,58750,9,"ENSG00000112893.10",1,2,"VMVVUVVVV",1,7,0.773913043478261,112,118,133,136,146,152,191,194,"CTAATGA","ATGA","TTGAAGG","CTGA",2.50792596939192,15,10,39,73,1.83260437414484,4.63802770918941,7.73367988310246,101,"ENSG00000079974.19"
"7475","ENSG00000114423.23_161413",161405,161413,9,"ENSG00000114423.23",1,8,"VVVVVUVMV",1,7,0.806211180124224,108,114,133,136,140,146,155,158,"GGGATTA","CAGA","GGGTGGA","CTGA",2.3396750876822,19,4,9,41,2.43739490963409,4.50880720687886,7.73365192737575,101,"ENSG00000079974.19"
"8100","ENSG00000116783.15_302103",302095,302103,9,"ENSG00000116783.15",1,1,"MVVVVUVVV",1,7,0.82815734989648,99,105,133,136,147,153,170,173,"AAGATGC","TTAA","CTGATGT","CTGA",2.41098416887875,28,11,17,65,1.61067602648479,4.42097595475245,7.73360535433837,101,"ENSG00000079974.19"
"41423","ENSG00000259030.8_339255",339247,339255,9,"ENSG00000259030.8",1,1,"MVVVVUVVV",1,7,0.82815734989648,99,105,133,136,147,153,170,173,"AAGATGC","TTAA","CTGATGT","CTGA",2.41098416887875,28,11,17,65,1.61067602648479,4.42097595475245,7.73360535433837,101,"ENSG00000079974.19"
"12947","ENSG00000139668.9_40183",40175,40183,9,"ENSG00000139668.9",1,5,"VVVVMVUVV",1,7,0.772670807453416,95,101,133,136,145,151,165,168,"ATCATGA","CTGT","ATACAGA","CTGA",2.5089355481187,32,9,14,64,1.84531165640768,4.64288716096642,7.73357039078009,101,"ENSG00000079974.19"
"34149","ENSG00000231971.6_7018",7010,7018,9,"ENSG00000231971.6",1,1,"MVVVVVUVV",1,7,0.792132505175983,114,120,133,136,147,153,165,168,"ATTATGG","CTGA","TTGTTTA","CTAA",2.31979824160157,13,11,12,45,2.79479972865154,4.56503033483216,7.7335603555361,101,"ENSG00000079974.19"
"28140","ENSG00000188185.13_27040",27032,27040,9,"ENSG00000188185.13",1,7,"VVVUVVMVV",1,7,0.766045548654244,82,88,133,136,147,153,172,175,"GCGATGA","CTGC","CTGAGGA","CTGA",2.59002361201767,45,11,19,84,1.41064782079261,4.6693679752276,7.73355016984458,101,"ENSG00000079974.19"
"46823","ENSG00000287231.1_8025",8017,8025,9,"ENSG00000287231.1",1,8,"VVUVVVVMV",1,7,0.767701863354037,85,91,133,136,154,160,171,174,"ATTATGA","CTAA","ATGAACA","CTGA",2.59372440889188,42,18,11,80,1.35925361489783,4.66268741854425,7.7334948719604,101,"ENSG00000079974.19"
"28430","ENSG00000189108.13_336130",336122,336130,9,"ENSG00000189108.13",1,8,"UVVVVVVMV",1,7,0.786749482401656,62,68,98,101,111,117,133,136,"CTGAGGA","TTGA","TTGAGCA","CTGA",2.49682998829563,30,10,16,65,1.7002871692283,4.58645510613313,7.73345303573975,101,"ENSG00000079974.19"
"29277","ENSG00000197584.13_75325",75317,75325,9,"ENSG00000197584.13",1,7,"UVVVVVMVV",1,7,0.787991718426501,91,97,133,136,148,154,166,169,"GTGATGA","TTGA","AAGATGA","ATGA",2.48938884510334,36,12,12,69,1.7299971707584,4.58148070119517,7.73344757490117,101,"ENSG00000079974.19"
"22007","ENSG00000169604.21_146082",146074,146082,9,"ENSG00000169604.21",1,1,"MVVVVVUVV",1,7,0.792132505175983,109,115,133,136,148,154,162,165,"ATGAGAA","CTTA","AAAATGA","CTGA",2.37665721130735,18,12,8,47,2.41512840328347,4.56487745299979,7.73340747370373,101,"ENSG00000079974.19"
"21048","ENSG00000166323.13_76859",76851,76859,9,"ENSG00000166323.13",1,2,"UMVVVVVVV",1,7,0.786749482401656,54,60,69,72,86,92,133,136,"ATAATGA","ATGA","GAGCTGC","CTGA",2.53042365674053,9,14,41,73,1.47582996305662,4.58633025199837,7.73332818160499,101,"ENSG00000079974.19"
"34295","ENSG00000232555.2_187005",186997,187005,9,"ENSG00000232555.2",1,2,"VMVVVUVVV",1,7,0.806211180124223,110,116,133,136,144,150,159,162,"ATAATCA","GCGA","ATGAAAT","CTGA",2.2921933721541,17,8,9,43,2.7526408765568,4.50848250606269,7.73332722655959,101,"ENSG00000079974.19"
"7434","ENSG00000114166.8_74038",74030,74038,9,"ENSG00000114166.8",0,NA,"UVVVUVVVV",2,7,0.792546583850932,112,118,133,136,185,191,224,227,"GTGAGGA","CTTA","ATGATGG","CTGA",2.58989439874179,15,49,33,106,0.986568695284953,4.56313283839089,7.73331917379461,101,"ENSG00000079974.19"
"36295","ENSG00000239605.11_86948",86940,86948,9,"ENSG00000239605.11",1,8,"VVVVUVVMV",1,7,0.773913043478261,112,118,133,136,141,147,158,161,"ATGAACA","TAGA","GTGGTGC","CTGA",2.35362286861168,15,5,11,40,2.85983504323997,4.63766354182946,7.7333157157425,101,"ENSG00000079974.19"
"43704","ENSG00000273269.3_108151",108143,108151,9,"ENSG00000273269.3",1,8,"VVVVUVVMV",1,7,0.773913043478261,112,118,133,136,141,147,158,161,"ATGAACA","TAGA","GTGGTGC","CTGA",2.35362286861168,15,5,11,40,2.85983504323997,4.63766354182946,7.7333157157425,101,"ENSG00000079974.19"
"18379","ENSG00000157168.20_504435",504427,504435,9,"ENSG00000157168.20",0,NA,"VVVVUVUVV",2,7,0.775983436853002,113,119,133,136,139,145,153,156,"GTGATGA","GTGA","GCAAGGA","CTGG",2.35587637959385,14,3,8,34,2.81163651498766,4.62936976140333,7.73330350881534,101,"ENSG00000079974.19"
"7087","ENSG00000112701.18_5054",5046,5054,9,"ENSG00000112701.18",1,2,"UMVVVVVVV",1,7,0.786749482401656,114,120,133,136,151,157,165,168,"GTGAGGA","ATAA","ATGTAAA","CTGA",2.37142980617676,13,15,8,45,2.53562321786192,4.58628881476008,7.7332867443667,101,"ENSG00000079974.19"
"19667","ENSG00000163590.14_207784",207776,207784,9,"ENSG00000163590.14",1,8,"VVVVVVUMV",1,7,0.770186335403727,110,116,133,136,138,144,153,156,"TTGTTGA","GTGA","AACATGA","CTGA",2.43783096341197,17,2,9,37,2.35770501516269,4.65247785947728,7.73322320109219,101,"ENSG00000079974.19"
"31718","ENSG00000224533.4_74348",74340,74348,9,"ENSG00000224533.4",1,2,"VMVVVUVVV",1,7,0.806211180124223,76,82,94,97,103,109,133,136,"AAGATGA","CTGT","CAGATGA","CTAA",2.36028061971893,12,6,24,51,2.29825570695427,4.50836495960346,7.73320968010035,101,"ENSG00000079974.19"
"27260","ENSG00000185774.16_935141",935133,935141,9,"ENSG00000185774.16",1,1,"MVUVVVVVV",1,7,0.789648033126294,116,122,133,136,145,151,166,169,"ATCTTGT","ATGA","TTGAGGC","CTGA",2.33207505672908,11,9,15,44,2.75117389582503,4.57458523517139,7.73317736767657,101,"ENSG00000079974.19"
"27622","ENSG00000186867.11_24504",24496,24504,9,"ENSG00000186867.11",0,NA,"VVVVVUUVV",2,7,0.808281573498965,95,101,133,136,168,174,187,190,"ATCATGA","CTTT","GTGAAGA","CTGA",2.5533544585811,32,32,13,86,0.977805424895789,4.50004212052579,7.73316841452165,101,"ENSG00000079974.19"
"7751","ENSG00000115548.17_10053",10045,10053,9,"ENSG00000115548.17",1,1,"MVVVVVUVV",1,7,0.792132505175983,91,97,107,110,116,122,133,136,"CTGATCA","CTGA","CCCATGA","CTGC",2.2900294752359,10,6,11,36,2.99145553752933,4.56457967644216,7.73310969714609,101,"ENSG00000079974.19"
"18577","ENSG00000157680.16_358433",358425,358433,9,"ENSG00000157680.16",1,2,"UMVVVVVVV",1,7,0.786749482401656,85,91,105,108,113,119,133,136,"ATGATGG","CTCA","GTGAACG","CTTA",2.33402900622533,14,5,14,42,2.78412916957926,4.5860806361037,7.73307856571032,101,"ENSG00000079974.19"
"6313","ENSG00000109339.24_224337",224329,224337,9,"ENSG00000109339.24",1,2,"VMVVUVVVV",1,7,0.773913043478261,56,62,75,78,83,89,133,136,"CTTGTGA","CTGA","TTGCTGA","CTGA",2.49202284279693,13,5,44,71,1.93613275129511,4.63740459248532,7.73305676639836,101,"ENSG00000079974.19"
"47428","ENSG00000288102.1_118946",118938,118946,9,"ENSG00000288102.1",1,2,"VMVVVUVVV",1,7,0.806211180124223,113,119,133,136,145,151,159,162,"ATTATCA","AAGA","AAGTGGA","CTGA",2.2657567414282,14,9,8,40,2.92774994011655,4.50819872074281,7.7330434412397,101,"ENSG00000079974.19"
"13193","ENSG00000140538.17_324239",324231,324239,9,"ENSG00000140538.17",1,1,"MVVVUVVVV",1,7,0.795859213250517,116,122,133,136,145,151,166,169,"ATGATGA","CCAA","TTCATCA","TTGA",2.31708037405589,11,9,15,44,2.75117389582503,4.54959409738274,7.73303095038481,101,"ENSG00000079974.19"
"18291","ENSG00000156920.11_99829",99821,99829,9,"ENSG00000156920.11",1,8,"VVVVUVVMV",1,7,0.773913043478261,102,108,133,136,140,146,159,162,"GTGATGA","AGGA","GTTCTCA","CTGA",2.49304742109843,25,4,13,51,1.92912014379699,4.6373590711133,7.73301124502635,101,"ENSG00000079974.19"
"3804","ENSG00000089123.16_210766",210758,210766,9,"ENSG00000089123.16",0,NA,"VVVVUUVVV",2,7,0.812008281573499,89,95,106,109,116,122,133,136,"ATGAAGT","CTGC","GTGGTCA","GTGA",2.23792113857059,11,7,11,38,3.0203974279366,4.48496792126846,7.73300104756245,101,"ENSG00000079974.19"
"29199","ENSG00000197415.12_9320",9312,9320,9,"ENSG00000197415.12",1,2,"VMVUVVVVV",1,7,0.764803312629399,115,121,133,136,144,150,161,164,"ATAATGA","CTCA","CAGATGA","CTGT",2.3534175142893,12,8,11,40,3.00568632882915,4.67378410602278,7.73299735654038,101,"ENSG00000079974.19"
"17019","ENSG00000152953.13_445833",445825,445833,9,"ENSG00000152953.13",1,8,"UVVVVVVMV",1,7,0.786749482401656,114,120,133,136,184,190,204,207,"GTGCTGA","CAAA","ATGATAA","CTGA",2.47133741022874,13,48,14,84,1.86833592762377,4.5859796656205,7.73297759522713,101,"ENSG00000079974.19"
"15546","ENSG00000148655.15_698431",698423,698431,9,"ENSG00000148655.15",1,5,"VVVVMUVVV",1,7,0.808695652173913,105,111,133,136,141,147,163,166,"TTGAGGA","CTTA","ATATTAA","CTGA",2.39481867728992,22,5,16,52,2.02729689820086,4.49818868670009,7.73297129539574,101,"ENSG00000079974.19"
"1974","ENSG00000068654.17_11855",11847,11855,9,"ENSG00000068654.17",1,2,"VMVVUUVVV",2,6,0.696066252587992,87,93,133,136,147,153,180,183,"ATGATGA","ATGA","ATGTTGA","CTGA",2.81319237729594,40,11,27,87,1.04015738644571,4.94869330877133,7.7329583191233,101,"ENSG00000079974.19"
"46594","ENSG00000286863.2_455844",455836,455844,9,"ENSG00000286863.2",1,1,"MVVVUVVVV",1,7,0.795859213250517,110,116,133,136,161,167,183,186,"TTGGTGA","TAGA","GTGAAGA","CTGA",2.48409842841637,17,25,16,67,1.63741853710988,4.54951868163808,7.73295553464015,101,"ENSG00000079974.19"
"7771","ENSG00000115616.3_75570",75562,75570,9,"ENSG00000115616.3",1,1,"MVVVUVVVV",1,7,0.795859213250517,111,117,133,136,146,152,170,173,"TTGGAGA","CTTA","GTTATGA","CTGA",2.37384030654091,16,10,18,53,2.37232817465647,4.54948255456563,7.7329194075677,101,"ENSG00000079974.19"
"15997","ENSG00000150556.17_88418",88410,88418,9,"ENSG00000150556.17",0,NA,"UVVVVVUVV",2,7,0.788819875776397,115,121,133,136,154,160,175,178,"TTGATAA","CGGA","GTCATCT","CTGA",2.41806529004026,12,18,15,54,2.19009893408361,4.57763355025466,7.73291305336025,101,"ENSG00000079974.19"
"30334","ENSG00000204634.13_160550",160542,160550,9,"ENSG00000204634.13",1,1,"MVVVVVUVV",1,7,0.792132505175983,115,121,133,136,148,154,173,176,"AGGATGT","CACA","GTGATTC","CTGA",2.38729924844305,12,12,19,52,2.34157108327794,4.56422485155791,7.73275487226184,101,"ENSG00000079974.19"
"25899","ENSG00000183066.14_11123",11115,11123,9,"ENSG00000183066.14",1,8,"UVVVVVVMV",1,7,0.786749482401656,102,108,133,136,146,152,166,169,"ATGATGT","TTGT","GTAGGGA","CTGA",2.46022746349667,25,10,14,58,1.94130498919253,4.58570535312592,7.73270328273255,101,"ENSG00000079974.19"
"17525","ENSG00000154310.17_137940",137932,137940,9,"ENSG00000154310.17",0,NA,"UVUVVVVVV",2,7,0.786335403726708,101,107,133,136,151,157,168,171,"ATGATGT","CTGA","ATGTTAA","CTGT",2.50142429012842,26,15,11,61,1.67317226263981,4.58733354920732,7.73267516411415,101,"ENSG00000079974.19"
"12853","ENSG00000139220.17_191625",191617,191625,9,"ENSG00000139220.17",1,7,"VVVVVUMVV",1,7,0.807453416149068,23,29,65,68,78,84,133,136,"ATGATTA","CAGA","TTAAGGA","CTGA",2.56558089601347,36,10,49,104,0.907457139733905,4.50283244495592,7.7326461095522,101,"ENSG00000079974.19"
"16768","ENSG00000152217.20_234467",234459,234467,9,"ENSG00000152217.20",1,1,"MVVVUUVVV",2,6,0.718012422360248,107,113,133,136,149,155,169,172,"ATGATGG","GTGA","CTGGTTA","CTGA",2.60796819662259,20,13,14,56,2.05587729183541,4.86058298399651,7.7326326734375,101,"ENSG00000079974.19"
"1496","ENSG00000058091.17_410764",410756,410764,9,"ENSG00000058091.17",0,NA,"UVUVVVVVV",2,7,0.786335403726708,80,86,99,102,109,115,133,136,"ATGAGAA","CTGT","AGGAATA","CTGA",2.35720088075903,13,7,18,47,2.63444819381204,4.5872801830514,7.73262179795823,101,"ENSG00000079974.19"
"43970","ENSG00000276241.1_13168",13160,13168,9,"ENSG00000276241.1",1,7,"VVVVVUMVV",1,7,0.807453416149068,110,116,133,136,145,151,163,166,"CTGAAGA","GAGA","AAGCTAA","CTGA",2.30171200104553,17,9,12,47,2.66640863594683,4.50278882739592,7.73260249199219,101,"ENSG00000079974.19"
"16234","ENSG00000151208.17_80433",80425,80433,9,"ENSG00000151208.17",0,NA,"VVUVVUVVV",2,7,0.805797101449275,114,120,133,136,147,153,164,167,"CAGATGT","TTGG","GTCAGGA","CTGA",2.281863394729,13,11,11,44,2.82518629178893,4.50940223082889,7.73259063662599,101,"ENSG00000079974.19"
"21789","ENSG00000168959.15_171393",171385,171393,9,"ENSG00000168959.15",1,8,"UVVVVVVMV",1,7,0.786749482401656,71,77,89,92,104,110,133,136,"GTGAAGA","CTGC","AAGTTCA","CTGA",2.43263993599867,12,12,23,56,2.12470436630239,4.58557598490672,7.73257391451334,101,"ENSG00000079974.19"
"29842","ENSG00000198795.11_168860",168852,168860,9,"ENSG00000198795.11",1,1,"MVVVUVVVV",1,7,0.795859213250517,114,120,133,136,140,146,154,157,"AGCATGT","CTGA","GTGATTA","CTGT",2.28230951109391,13,4,8,34,2.98024488749675,4.54891040703071,7.73234726003278,101,"ENSG00000079974.19"
"36556","ENSG00000241743.4_44248",44240,44248,9,"ENSG00000241743.4",1,5,"UVVVMVVVV",1,7,0.789233954451346,109,115,133,136,143,149,162,165,"ATGAGCA","TTTA","ATTATGA","CTGA",2.35696872938612,18,7,13,47,2.58824341368252,4.57534206906417,7.73227788686955,101,"ENSG00000079974.19"
"25197","ENSG00000179915.25_495089",495081,495089,9,"ENSG00000179915.25",1,8,"VVVUVVVMV",1,7,0.764803312629399,107,113,133,136,175,181,190,193,"GTAATGA","CTGA","AGGCAGA","CTGA",2.57912605619028,20,39,9,77,1.49803564935794,4.67305233932328,7.73226558984088,101,"ENSG00000079974.19"
"4298","ENSG00000100095.19_160930",160922,160930,9,"ENSG00000100095.19",1,3,"VVMUVVVVV",1,7,0.763561076604555,106,112,133,136,145,151,201,204,"AAGATGA","TTGA","TTGAAAA","CTGA",2.60238136491926,21,9,50,89,1.36285868278968,4.67801694556285,7.73226125198107,101,"ENSG00000079974.19"
"6196","ENSG00000108599.15_52461",52453,52461,9,"ENSG00000108599.15",1,5,"UVVVMVVVV",1,7,0.789233954451346,106,112,133,136,152,158,167,170,"TTGATTA","TTGA","ATGAGAT","CTGA",2.460628649342,21,16,9,55,1.89710215308345,4.57532328717419,7.73225910497958,101,"ENSG00000079974.19"
"34254","ENSG00000232295.7_79817",79809,79817,9,"ENSG00000232295.7",0,NA,"VVVVUVUVV",2,7,0.775983436853002,95,101,109,112,116,122,133,136,"AAGATGA","CTGT","CTGAAGT","ATGA",2.35530354442936,8,4,11,32,2.8112293139677,4.62831323587419,7.7322469832862,101,"ENSG00000079974.19"
"15391","ENSG00000148123.15_15697",15689,15697,9,"ENSG00000148123.15",1,7,"UVVVVVMVV",1,7,0.787991718426501,88,94,101,104,112,118,133,136,"GTGGTGG","CTGT","GTGAGAT","CTGA",2.37908106634335,7,8,15,39,2.46028092755748,4.58020534246162,7.73217221616762,101,"ENSG00000079974.19"
"43824","ENSG00000274090.1_16474",16466,16474,9,"ENSG00000274090.1",1,5,"VVVVMUVVV",1,7,0.808695652173913,96,102,133,136,140,146,158,161,"GTTATGT","CTAA","CTGAAGG","CTGA",2.42422494294746,31,4,12,56,1.82789698629505,4.49734915148619,7.73213176018184,101,"ENSG00000079974.19"
"2353","ENSG00000073712.15_72960",72952,72960,9,"ENSG00000073712.15",1,3,"VVMVVUVVV",1,7,0.804968944099379,97,103,133,136,149,155,167,170,"ATGTTGA","CCAA","TTGAGGG","CTGA",2.45297288975059,30,13,12,64,1.69575856413984,4.51222779061927,7.73210356701678,101,"ENSG00000079974.19"
"20724","ENSG00000165416.15_35122",35114,35122,9,"ENSG00000165416.15",1,8,"UVVVVVVMV",1,7,0.786749482401656,72,78,93,96,108,114,133,136,"CTGATGT","TTGA","CTGATGA","CTAA",2.41346097036526,15,12,19,55,2.25064480788892,4.585096152581,7.73209408218762,101,"ENSG00000079974.19"
"8077","ENSG00000116729.14_26336",26328,26336,9,"ENSG00000116729.14",1,7,"UVVVVVMVV",1,7,0.787991718426501,116,122,133,136,184,190,201,204,"TTGCTGA","CTTA","TTGATTG","CTGA",2.45377877094038,11,48,11,79,1.96191570376687,4.58011021084235,7.73207708454836,101,"ENSG00000079974.19"
"42075","ENSG00000260658.7_180319",180311,180319,9,"ENSG00000260658.7",1,1,"MVVVVUUVV",2,6,0.714285714285714,110,116,133,136,160,166,178,181,"GTGATGA","ATGA","TTTATAA","CTGA",2.64594864052812,17,24,12,62,1.85972263535704,4.87484505971947,7.73198791686232,101,"ENSG00000079974.19"
"733","ENSG00000029534.22_164681",164673,164681,9,"ENSG00000029534.22",1,1,"MVVVVVUVV",1,7,0.792132505175983,114,120,133,136,142,148,159,162,"TTCCTGA","CTTA","CTTATGG","CTGA",2.28656930671257,13,6,11,39,3.01000559323771,4.56345024283038,7.73198026353431,101,"ENSG00000079974.19"
"30674","ENSG00000206432.4_11427",11419,11427,9,"ENSG00000206432.4",1,1,"MVVVVUVVV",1,7,0.82815734989648,95,101,133,136,155,161,171,174,"ATCATGA","CAAA","GTGAAAG","CTGA",2.44969236407107,32,19,10,70,1.34611741441008,4.41934996038764,7.73197935997357,101,"ENSG00000079974.19"
"21267","ENSG00000166948.10_31494",31486,31494,9,"ENSG00000166948.10",1,8,"VVVUVVVMV",1,7,0.764803312629399,115,121,133,136,147,153,185,188,"ATCAAGA","CTGG","GTGATGG","CTGA",2.51480336914484,12,11,32,64,1.92560045462626,4.6727390622313,7.7319523127489,101,"ENSG00000079974.19"
"21847","ENSG00000169122.12_31028",31020,31028,9,"ENSG00000169122.12",1,2,"UMVVVVVVV",1,7,0.786749482401656,102,108,133,136,170,176,189,192,"GTGATGA","CAGG","ATGAGAA","CTGA",2.58369916483215,25,34,13,81,1.11502745215121,4.58492213775806,7.73192006736468,101,"ENSG00000079974.19"
"14217","ENSG00000144619.15_536156",536148,536156,9,"ENSG00000144619.15",1,1,"MVVVVUVVV",1,7,0.82815734989648,51,57,72,75,105,111,133,136,"ATGATTA","TTGA","GTGAAGA","CTGG",2.4462589183725,15,30,22,76,1.36816596414701,4.41913968832425,7.73176908791017,101,"ENSG00000079974.19"
"26141","ENSG00000183506.17_37788",37780,37788,9,"ENSG00000183506.17",1,2,"VMVUVVVVV",1,7,0.764803312629399,90,96,107,110,116,122,133,136,"ATGTGGA","TTGA","AAGGTCA","CTGA",2.34998973767098,11,6,11,37,3.02323689980693,4.6724587877367,7.73167203825429,101,"ENSG00000079974.19"
"36593","ENSG00000241973.11_144973",144965,144973,9,"ENSG00000241973.11",1,2,"VMVUVVVVV",1,7,0.764803312629399,90,96,107,110,116,122,133,136,"ATGTGGA","TTGA","AAGGTCA","CTGA",2.34998973767098,11,6,11,37,3.02323689980693,4.6724587877367,7.73167203825429,101,"ENSG00000079974.19"
"43863","ENSG00000274602.6_8410",8402,8410,9,"ENSG00000274602.6",1,2,"VMVUVVVVV",1,7,0.764803312629399,90,96,107,110,116,122,133,136,"ATGTGGA","TTGA","AAGGTCA","CTGA",2.34998973767098,11,6,11,37,3.02323689980693,4.6724587877367,7.73167203825429,101,"ENSG00000079974.19"
"48102","ENSG00000290425.1_37580",37572,37580,9,"ENSG00000290425.1",1,2,"VMVUVVVVV",1,7,0.764803312629399,90,96,107,110,116,122,133,136,"ATGTGGA","TTGA","AAGGTCA","CTGA",2.34998973767098,11,6,11,37,3.02323689980693,4.6724587877367,7.73167203825429,101,"ENSG00000079974.19"
"33063","ENSG00000228592.2_37788",37780,37788,9,"ENSG00000228592.2",1,2,"VMVVVUVVV",1,7,0.806211180124223,89,95,133,136,144,150,170,173,"CTGATAA","CAGA","CTGGTCA","CTGA",2.47818830317363,38,8,20,75,1.50603798938007,4.50682333596773,7.73166805646462,101,"ENSG00000079974.19"
"38013","ENSG00000249341.1_40281",40273,40281,9,"ENSG00000249341.1",1,8,"VVUVVVVMV",1,7,0.767701863354037,113,119,133,136,161,167,188,191,"ATGATGG","CTTC","ATGAGGA","CTGA",2.56429557374941,14,25,21,69,1.54810682425398,4.66085266231251,7.73166011572865,101,"ENSG00000079974.19"
"44453","ENSG00000282278.1_321650",321642,321650,9,"ENSG00000282278.1",1,8,"VVUVVVVMV",1,7,0.767701863354037,113,119,133,136,161,167,188,191,"ATGATGG","CTTC","ATGAGGA","CTGA",2.56429557374941,14,25,21,69,1.54810682425398,4.66085266231251,7.73166011572865,101,"ENSG00000079974.19"
"27576","ENSG00000186509.4_74016",74008,74016,9,"ENSG00000186509.4",1,2,"UMVVVVVVV",1,7,0.786749482401656,84,90,101,104,113,119,133,136,"AAGATGA","TTGA","GTGTAAA","CAGA",2.32942649040188,11,9,14,43,2.80912572351533,4.58465891488197,7.73165684448859,101,"ENSG00000079974.19"
"29348","ENSG00000197826.12_143867",143859,143867,9,"ENSG00000197826.12",1,7,"UVVVVVMVV",1,7,0.787991718426501,106,112,133,136,150,156,177,180,"ATGAGGA","CAAA","CTGATAA","CTGA",2.52387781010285,21,14,21,65,1.49289476678857,4.57968670853523,7.73165358224123,101,"ENSG00000079974.19"
"6441","ENSG00000109906.15_42508",42500,42508,9,"ENSG00000109906.15",1,1,"MVVVVUVVV",1,7,0.82815734989648,69,75,88,91,96,102,133,136,"GTGAAGG","CTGA","CTGAAGA","CTGT",2.34627458767367,13,5,31,58,2.03422360623748,4.41901354768216,7.73164294726808,101,"ENSG00000079974.19"
"22677","ENSG00000171094.18_5639",5631,5639,9,"ENSG00000171094.18",0,NA,"VVVVUVUVV",2,7,0.775983436853002,114,120,133,136,145,151,169,172,"TTGAAGT","CTTA","TTAATGA","CTGA",2.38904002902274,13,9,18,49,2.58346073828107,4.62759856627484,7.73153231368684,101,"ENSG00000079974.19"
"47479","ENSG00000288553.1_39458",39450,39458,9,"ENSG00000288553.1",0,NA,"VVVVUVUVV",2,7,0.775983436853002,114,120,133,136,145,151,169,172,"TTGAAGT","CTTA","TTAATGA","CTGA",2.38904002902274,13,9,18,49,2.58346073828107,4.62759856627484,7.73153231368684,101,"ENSG00000079974.19"
"48551","ENSG00000291281.1_3926",3918,3926,9,"ENSG00000291281.1",1,2,"UMVVVVVVV",1,7,0.786749482401656,92,98,104,107,115,121,133,136,"ATCAAGA","CAGA","ATCTTGG","CTGA",2.36614362131817,6,8,12,35,2.56378345847004,4.58451856681445,7.73151649642108,101,"ENSG00000079974.19"
"10677","ENSG00000132323.9_8848",8840,8848,9,"ENSG00000132323.9",1,8,"VVVVUVVMV",1,7,0.773913043478261,80,86,98,101,113,119,133,136,"GTGATGA","CTAA","GTGTTTT","CAGA",2.38548562661353,12,12,14,47,2.64013717591965,4.63584367166913,7.73149584558217,101,"ENSG00000079974.19"
"42751","ENSG00000266357.6_83581",83573,83581,9,"ENSG00000266357.6",1,8,"VVVVVUVMV",1,7,0.806211180124224,100,106,133,136,149,155,175,178,"CTGATGA","ATGC","CTCAAGA","CTGA",2.50697327297342,27,13,20,69,1.31321856439862,4.50659342938869,7.73143814988558,101,"ENSG00000079974.19"
"30628","ENSG00000206120.11_177755",177747,177755,9,"ENSG00000206120.11",0,NA,"UVVVVVUVV",2,7,0.788819875776397,82,88,133,136,153,159,184,187,"TTGATGC","TTGA","CTGATGA","CTGA",2.64046769357325,45,17,25,96,0.701497748846248,4.5761539265003,7.73143342960589,101,"ENSG00000079974.19"
"22922","ENSG00000171724.3_79863",79855,79863,9,"ENSG00000171724.3",1,6,"VVVUVMVVV",1,7,0.78343685300207,112,118,133,136,147,153,170,173,"CTGATAG","CTGT","GTGAGCA","CTGA",2.39222056213766,15,11,17,52,2.44247399365069,4.59765276864211,7.73140018065039,101,"ENSG00000079974.19"
"28019","ENSG00000187957.8_290631",290623,290631,9,"ENSG00000187957.8",1,2,"VMVUVVVVV",1,7,0.764803312629399,112,118,133,136,169,175,183,186,"GTGATAA","ATGA","ACGATGG","CTGA",2.51546771632587,15,33,8,65,1.9187750879075,4.67213996585332,7.73135321637092,101,"ENSG00000079974.19"
"11082","ENSG00000133816.18_258607",258599,258607,9,"ENSG00000133816.18",1,8,"VVVVVUVMV",1,7,0.806211180124224,46,52,64,67,71,77,133,136,"AGGGTGA","TTGA","GTGAACT","CTGA",2.42812606251028,12,4,56,81,1.83843389476585,4.50648524454194,7.73132996503883,101,"ENSG00000079974.19"
"31583","ENSG00000224177.8_18279",18271,18279,9,"ENSG00000224177.8",1,8,"VVVUVVVMV",1,7,0.764803312629399,56,62,75,78,116,122,133,136,"GTGAGGA","CTGG","GTGTGGT","CTGA",2.5043562048846,13,38,11,71,1.99242100978447,4.67203226058712,7.73124551110472,101,"ENSG00000079974.19"
"27964","ENSG00000187720.15_454346",454338,454346,9,"ENSG00000187720.15",1,1,"MVVVVVUVV",1,7,0.792132505175983,106,112,133,136,146,152,162,165,"GTGCTGA","CAGA","TTGATGA","CTAA",2.39127937889372,21,10,10,50,2.30875419617235,4.56265418053262,7.73118420123655,101,"ENSG00000079974.19"
"13236","ENSG00000140718.21_403758",403750,403758,9,"ENSG00000140718.21",1,1,"MVVVVVUVV",1,7,0.792132505175983,110,116,133,136,141,147,156,159,"AAGATGG","CAGC","CAGATGT","CTGA",2.32984014098237,17,5,9,40,2.7181999961723,4.56261690068035,7.73114692138428,101,"ENSG00000079974.19"
"16124","ENSG00000150764.14_66726",66718,66726,9,"ENSG00000150764.14",1,7,"UVVVVVMVV",1,7,0.787991718426501,112,118,133,136,186,192,213,216,"ATGATGA","CAGG","ATTCTGT","CTGA",2.54190573943781,15,50,21,95,1.37067761682003,4.57917896993469,7.7311458436407,101,"ENSG00000079974.19"
"14494","ENSG00000145147.20_22550",22542,22550,9,"ENSG00000145147.20",1,6,"VVVVVMUVV",1,7,0.788819875776397,58,64,73,76,105,111,133,136,"TTGATAT","CTGA","GTCATGA","CTGA",2.54970740191497,9,29,22,69,1.30513320313632,4.57579563730903,7.73107514041462,101,"ENSG00000079974.19"
"31469","ENSG00000223786.1_7012",7004,7012,9,"ENSG00000223786.1",0,NA,"VVVVVUUVV",2,7,0.808281573498965,108,114,133,136,141,147,180,183,"TTGATGA","CTGT","GTGATAA","CTGT",2.46108665451293,19,5,33,66,1.58420942517434,4.49786344714846,7.73098974114432,101,"ENSG00000079974.19"
"12341","ENSG00000137872.17_68740",68732,68740,9,"ENSG00000137872.17",0,NA,"UVVVVVUVV",2,7,0.788819875776397,115,121,133,136,144,150,164,167,"TTGGTGT","CTGC","ATGGGAA","CTGA",2.31482226829568,12,8,14,43,2.87053339400649,4.57567046232776,7.73094996543335,101,"ENSG00000079974.19"
"20343","ENSG00000164692.19_34448",34440,34448,9,"ENSG00000164692.19",1,8,"VVUVVVVMV",1,7,0.767701863354037,104,110,133,136,152,158,170,173,"ATGAGGA","GTCA","ATGATGT","CTGA",2.53810907046208,23,16,12,60,1.71968372240862,4.66010271470563,7.73091016812177,101,"ENSG00000079974.19"
"15702","ENSG00000149256.16_38676",38668,38676,9,"ENSG00000149256.16",1,3,"UVMVVVVVV",1,7,0.785507246376811,110,116,133,136,147,153,166,169,"ATGAAAA","GTTA","ATGTTGA","CTGA",2.37682873290277,17,11,13,50,2.50997852237021,4.58887585209717,7.73090483760441,101,"ENSG00000079974.19"
"46659","ENSG00000286995.2_18808",18800,18808,9,"ENSG00000286995.2",1,1,"MVUVVVVVV",1,7,0.789648033126294,103,109,133,136,152,158,169,172,"AGAATGA","ATGA","GTGCAGA","CTGA",2.48949807166357,24,16,11,60,1.69240345212962,4.57226431580501,7.73085644831019,101,"ENSG00000079974.19"
"44439","ENSG00000282218.1_147521",147513,147521,9,"ENSG00000282218.1",1,8,"VVVUVVVMV",1,7,0.764803312629399,113,119,133,136,145,151,160,163,"CTGCAGA","CAGA","GTGGTGG","CTGA",2.36234890608423,14,9,9,41,2.93727423392056,4.67156673528719,7.73077998580479,101,"ENSG00000079974.19"
"29783","ENSG00000198729.5_19926",19918,19926,9,"ENSG00000198729.5",1,6,"VVVVVMUVV",1,7,0.788819875776397,64,70,89,92,99,105,133,136,"TTGAGGA","CTGA","ATGATGA","CTGG",2.48257882088157,19,7,28,63,1.75133110588598,4.57546414460745,7.73074364771304,101,"ENSG00000079974.19"
"23855","ENSG00000174469.23_1554146",1554138,1554146,9,"ENSG00000174469.23",1,8,"VVVVVVUMV",1,7,0.770186335403727,48,54,62,65,71,77,133,136,"GTTATTA","CTGA","GTGAAAA","CTGA",2.53267663173053,8,6,56,79,1.71543758355161,4.64998711543879,7.73073245705369,101,"ENSG00000079974.19"
"40258","ENSG00000255393.2_52370",52362,52370,9,"ENSG00000255393.2",1,2,"VMVVVUVVV",1,7,0.806211180124223,110,116,133,136,142,148,157,160,"AAGATTA","CTCT","ATCAGGA","CTGA",2.28926042079471,17,6,9,41,2.76159694676467,4.50583327134903,7.73067799184592,101,"ENSG00000079974.19"
"30898","ENSG00000214575.10_10122",10114,10122,9,"ENSG00000214575.10",1,6,"UVVVVMVVV",1,7,0.805383022774327,112,118,133,136,153,159,179,182,"ATGAGAA","CTTT","ATGATGA","CTGA",2.42737992635657,15,17,20,61,1.8539850533776,4.50912947393869,7.73066156503599,101,"ENSG00000079974.19"
"22852","ENSG00000171533.12_8939",8931,8939,9,"ENSG00000171533.12",1,8,"VVVVVUVMV",1,7,0.806211180124224,114,120,133,136,146,152,202,205,"GTGAGGA","AGGA","GTCATGG","CTGA",2.41902678128077,13,10,50,82,1.89627705481037,4.50578056583722,7.73062528633411,101,"ENSG00000079974.19"
"36147","ENSG00000237986.4_33973",33965,33973,9,"ENSG00000237986.4",1,1,"MVVVUVVVV",1,7,0.795859213250517,77,83,96,99,111,117,133,136,"GATATGA","CTGT","GTGGGGT","CTGA",2.3501636852184,13,12,16,50,2.52076293860985,4.54713021001646,7.73056706301853,101,"ENSG00000079974.19"
"5448","ENSG00000104723.21_97909",97901,97909,9,"ENSG00000104723.21",0,NA,"UVVVVVUVV",2,7,0.788819875776397,115,121,133,136,143,149,157,160,"TTGATTT","TTGA","AAAATGG","CTGA",2.28269724448972,12,7,8,36,3.08286607336289,4.57521192582359,7.73049142892918,101,"ENSG00000079974.19"
"15574","ENSG00000148737.18_175567",175559,175567,9,"ENSG00000148737.18",1,8,"UVVVVVVMV",1,7,0.786749482401656,38,44,59,62,113,119,133,136,"AAGATAA","CTGA","AAGAGAA","CTGA",2.48285955768754,15,51,14,89,1.78151904364369,4.58347902372349,7.73047695333011,101,"ENSG00000079974.19"
"10169","ENSG00000129636.13_308742",308734,308742,9,"ENSG00000129636.13",1,8,"UVVVVVVMV",1,7,0.786749482401656,115,121,133,136,139,145,153,156,"ATGATGA","GTGT","ATAAAAA","ATGA",2.30942439511745,12,3,8,32,2.93775089458213,4.58347838217461,7.73047631178124,101,"ENSG00000079974.19"
"43384","ENSG00000271774.1_203917",203909,203917,9,"ENSG00000271774.1",0,NA,"UVVUVVVVV",2,7,0.78343685300207,114,120,133,136,154,160,178,181,"ATGATGT","TTAA","GTAAGCA","CTGA",2.45731736472456,13,18,18,58,2.00442701066667,4.59663569387427,7.73038310588255,101,"ENSG00000079974.19"
"19401","ENSG00000162889.11_47780",47772,47780,9,"ENSG00000162889.11",1,8,"VVVVVUVMV",1,7,0.806211180124224,112,118,133,136,143,149,162,165,"CTGAAGA","CGGG","AGGCTGC","CTGA",2.27772879145922,15,7,13,44,2.83729252071384,4.50553778261049,7.73038250310739,101,"ENSG00000079974.19"
"2991","ENSG00000080224.18_119392",119384,119392,9,"ENSG00000080224.18",1,8,"VVUVVVVMV",1,7,0.767701863354037,19,25,56,59,71,77,133,136,"ATGATGA","ATGA","ATTTGGA","CTGA",2.67594575567432,31,12,56,108,0.79854873824018,4.65954677735058,7.73035423076673,101,"ENSG00000079974.19"
"166","ENSG00000005889.16_33949",33941,33949,9,"ENSG00000005889.16",0,NA,"VVVVUUVVV",2,7,0.812008281573499,110,116,133,136,138,144,154,157,"GGGATGG","AAGA","TTTATGA","CTGA",2.33835223962576,17,2,10,38,2.34002972362185,4.48226116361507,7.73029428990906,101,"ENSG00000079974.19"
"23096","ENSG00000172260.15_551438",551430,551438,9,"ENSG00000172260.15",1,7,"VVVVVUMVV",1,7,0.807453416149068,92,98,133,136,141,147,179,182,"ATGATAA","CTAA","TTTAAGA","CTGA",2.54571007045323,35,5,32,81,1.03049630903907,4.50047419468181,7.73028785927809,101,"ENSG00000079974.19"
"28463","ENSG00000189223.15_5895",5887,5895,9,"ENSG00000189223.15",1,8,"VVVVVUVMV",1,7,0.806211180124224,111,117,133,136,140,146,172,175,"CTGATGT","CAGC","GGGATGC","CTGA",2.41644208122536,16,4,26,55,1.91203683255299,4.50541267684718,7.73025739734408,101,"ENSG00000079974.19"
"16794","ENSG00000152270.9_4218",4210,4218,9,"ENSG00000152270.9",1,8,"VVVVUVVMV",1,7,0.773913043478261,87,93,104,107,114,120,133,136,"GTGCTGT","CTGC","GGGTTAA","CTGA",2.34168478713068,11,7,13,40,2.92704015889572,4.63456801827506,7.7302201921881,101,"ENSG00000079974.19"
"1553","ENSG00000060709.16_30800",30792,30800,9,"ENSG00000060709.16",0,NA,"VVVVUUVVV",2,7,0.812008281573499,116,122,133,136,141,147,166,169,"CTGACGT","CAGA","ATCATTT","CTGA",2.31574868244846,11,5,19,44,2.49023833375704,4.48214072085336,7.73017384714735,101,"ENSG00000079974.19"
"45372","ENSG00000285534.1_104451",104443,104451,9,"ENSG00000285534.1",1,2,"UMVVVUVVV",2,6,0.708902691511387,116,122,133,136,144,150,166,169,"TTGATGA","GTTA","GGGAAGA","CTGA",2.52743240644222,11,8,16,44,2.72866022066996,4.89455239923786,7.73016316528341,101,"ENSG00000079974.19"
"38836","ENSG00000251138.7_307253",307245,307253,9,"ENSG00000251138.7",1,5,"VVVVMUVVV",1,7,0.808695652173913,88,94,133,136,161,167,178,181,"CTGAGGA","ATGA","GTGGGGA","CTGA",2.53044094202157,39,25,11,84,1.11179679680378,4.4953507692369,7.73013337793255,101,"ENSG00000079974.19"
"21926","ENSG00000169306.10_405475",405467,405475,9,"ENSG00000169306.10",1,6,"VVVVVMUVV",1,7,0.788819875776397,78,84,102,105,112,118,133,136,"ATGCTAA","TTGA","AGGAAAA","CTGA",2.37221562887623,18,7,15,49,2.48463851197134,4.57485234278655,7.73013184589214,101,"ENSG00000079974.19"
"692","ENSG00000025293.17_93864",93856,93864,9,"ENSG00000025293.17",1,2,"UMVVVVVVV",1,7,0.786749482401656,116,122,133,136,148,154,164,167,"GTGATGA","CAAA","GTGGTGG","TTGA",2.33615061083609,11,12,10,42,2.75804318249551,4.58309514701736,7.73009307662398,101,"ENSG00000079974.19"
"5608","ENSG00000105983.23_112401",112393,112401,9,"ENSG00000105983.23",0,NA,"VVVVVUUVV",2,7,0.808281573498965,110,116,133,136,140,146,156,159,"GTGAAGG","CAGG","CTGAGGG","CTGA",2.30426382131998,17,4,10,40,2.6258528981385,4.49690292673458,7.73002922073044,101,"ENSG00000079974.19"
"42208","ENSG00000261115.7_393087",393079,393087,9,"ENSG00000261115.7",1,2,"UMVVVVVVV",1,7,0.786749482401656,112,118,133,136,142,148,162,165,"TTGAGGA","TAGA","ATGCTCT","CTGA",2.33378324025714,15,6,14,44,2.77333864836149,4.58297339585228,7.7299713254589,101,"ENSG00000079974.19"
"12923","ENSG00000139517.9_66753",66745,66753,9,"ENSG00000139517.9",1,2,"VMVVVUVVV",1,7,0.806211180124223,92,98,133,136,144,150,192,195,"AGGATCA","CTGA","AAGAAGA","CTGA",2.55170534198631,35,8,42,94,1.00903757765034,4.50510163105643,7.72994635155332,101,"ENSG00000079974.19"
"26124","ENSG00000183454.18_240969",240961,240969,9,"ENSG00000183454.18",1,2,"UMVVVVVVV",1,7,0.786749482401656,84,90,133,136,139,145,155,158,"ATGAGGA","GAGA","CTGAGGG","CTGA",2.49454003991715,43,3,10,65,1.70129094689785,4.5828894699197,7.72988739952633,101,"ENSG00000079974.19"
"23010","ENSG00000171914.17_453277",453269,453277,9,"ENSG00000171914.17",1,7,"UVVVVVMVV",1,7,0.787991718426501,82,88,133,136,157,163,173,176,"GTGATGC","GTGA","CTGGGGA","CTGA",2.56092332403299,45,21,10,85,1.23862873956777,4.57786272494694,7.72982959865294,101,"ENSG00000079974.19"
"44140","ENSG00000278766.2_1478",1470,1478,9,"ENSG00000278766.2",0,NA,"UVVVVUVVV",2,7,0.824844720496894,95,101,133,136,158,164,176,179,"ATGTTTA","CTGC","CTGATGT","CTGA",2.48051003174721,32,22,12,75,1.18500467505729,4.43043455500967,7.72981343699724,101,"ENSG00000079974.19"
"20689","ENSG00000165325.15_102796",102788,102796,9,"ENSG00000165325.15",0,NA,"UVVVVVUVV",2,7,0.788819875776397,113,119,133,136,143,149,160,163,"ATGATGG","AAGA","ATGAGGT","CTGG",2.29863304795703,14,7,11,41,2.97383677531519,4.57451427375718,7.72979377686277,101,"ENSG00000079974.19"
"39540","ENSG00000253773.5_189340",189332,189340,9,"ENSG00000253773.5",1,8,"VVVUVVVMV",1,7,0.764803312629399,96,102,111,114,116,122,133,136,"ATGATGC","CTCC","AGGACGT","CTGA",2.40349390516708,9,2,11,31,2.65896743063402,4.67056503293698,7.72977828345457,101,"ENSG00000079974.19"
"2273","ENSG00000072422.17_122848",122840,122848,9,"ENSG00000072422.17",1,2,"UMVVVVVVV",1,7,0.786749482401656,84,90,104,107,114,120,133,136,"CTGATAA","CTGA","GTGGTTG","ATGA",2.31528876296652,14,7,13,43,2.89540137332488,4.58266494827541,7.72966287788204,101,"ENSG00000079974.19"
"19881","ENSG00000163873.10_142577",142569,142577,9,"ENSG00000163873.10",1,1,"MVUVVVVVV",1,7,0.789648033126294,112,118,133,136,143,149,157,160,"TTGCTGA","TTCA","ATTAAGT","CTGA",2.3024441212093,15,7,8,39,2.93442611390744,4.57101339715902,7.7296055296642,101,"ENSG00000079974.19"
"14766","ENSG00000145832.16_24056",24048,24056,9,"ENSG00000145832.16",1,8,"UVVVVVVMV",1,7,0.786749482401656,114,120,133,136,143,149,162,165,"ATCATAA","CACA","GTAATGC","CTGA",2.30973274183411,13,7,13,42,2.93215203790703,4.58259257920028,7.72959050880691,101,"ENSG00000079974.19"
"38448","ENSG00000250167.2_24056",24048,24056,9,"ENSG00000250167.2",1,8,"UVVVVVVMV",1,7,0.786749482401656,114,120,133,136,143,149,162,165,"ATCATAA","CACA","GTAATGC","CTGA",2.30973274183411,13,7,13,42,2.93215203790703,4.58259257920028,7.72959050880691,101,"ENSG00000079974.19"
"4958","ENSG00000102466.16_560174",560166,560174,9,"ENSG00000102466.16",1,1,"MVVUVVVVV",1,7,0.786749482401656,114,120,133,136,164,170,185,188,"GTTATTA","CAGA","ATGAGGA","CTGA",2.46663070861718,13,28,15,65,1.88605842936351,4.58256578836951,7.72956371797614,101,"ENSG00000079974.19"
"6922","ENSG00000112249.14_44460",44452,44460,9,"ENSG00000112249.14",1,5,"UVVVMVVVV",1,7,0.789233954451346,94,100,133,136,184,190,200,203,"ATGAAGA","ATGA","CTGATAG","CTGA",2.59080084541473,33,48,10,100,1.01830638316881,4.57257800481676,7.72951382262214,101,"ENSG00000079974.19"
"46804","ENSG00000287209.2_9756",9748,9756,9,"ENSG00000287209.2",1,8,"VVVVVUVMV",1,7,0.806211180124224,87,93,133,136,152,158,171,174,"ATGAAGA","AAGA","CTGGAGA","CTGA",2.4913934358149,40,16,13,78,1.40922108383297,4.50462766398307,7.72947238447996,101,"ENSG00000079974.19"
"28102","ENSG00000188107.15_968165",968157,968165,9,"ENSG00000188107.15",1,8,"UVVVVVVMV",1,7,0.786749482401656,36,42,61,64,90,96,133,136,"ATGATGA","CTGA","GTGAAAA","CTGT",2.64177123552124,19,26,37,91,0.717820203283574,4.58240711002295,7.72940503962958,101,"ENSG00000079974.19"
"759","ENSG00000032742.18_109236",109228,109236,9,"ENSG00000032742.18",0,NA,"VVVVVUUVV",2,7,0.808281573498965,102,108,133,136,146,152,197,200,"CTGAGGA","CTTA","CTGATAA","CTGA",2.53616071843127,25,10,45,89,1.07736974129619,4.49627696604284,7.7294032600387,101,"ENSG00000079974.19"
"35909","ENSG00000237461.3_73841",73833,73841,9,"ENSG00000237461.3",1,2,"VMVVVUVVV",1,7,0.806211180124223,77,83,98,101,112,118,133,136,"AGAATGA","GTGA","CTGATGA","CAGA",2.31836282810381,15,11,15,50,2.56243358186305,4.50454644230544,7.72939116280233,101,"ENSG00000079974.19"
"40156","ENSG00000255145.3_160525",160517,160525,9,"ENSG00000255145.3",1,2,"VMVVVUVVV",1,7,0.806211180124223,77,83,98,101,112,118,133,136,"AGAATGA","GTGA","CTGATGA","CAGA",2.31836282810381,15,11,15,50,2.56243358186305,4.50454644230544,7.72939116280233,101,"ENSG00000079974.19"
"21312","ENSG00000167081.18_16371",16363,16371,9,"ENSG00000167081.18",1,8,"VVVVVUVMV",1,7,0.806211180124224,84,90,133,136,146,152,161,164,"ATGATGT","ATGA","GTGAGCA","CTGT",2.4180795052622,43,10,9,71,1.89729945969074,4.50445737369302,7.72930209418991,101,"ENSG00000079974.19"
"45813","ENSG00000285939.2_191359",191351,191359,9,"ENSG00000285939.2",1,5,"VVVVMUVVV",1,7,0.808695652173913,112,118,133,136,144,150,160,163,"GTGATTA","CAGA","GTGCAAA","CAGA",2.25967282526881,15,8,10,42,2.91350402497271,4.4944973816912,7.72927999038685,101,"ENSG00000079974.19"
"47494","ENSG00000288583.1_49570",49562,49570,9,"ENSG00000288583.1",1,5,"UVVVMVVVV",1,7,0.789233954451346,94,100,133,136,183,189,198,201,"ATGAAGA","ATGA","CTGATAG","CTGA",2.59080084541473,33,47,9,98,1.01729032608985,4.57232399054702,7.7292598083524,101,"ENSG00000079974.19"
"8453","ENSG00000118965.16_19482",19474,19482,9,"ENSG00000118965.16",1,8,"VVUVVVVMV",1,7,0.767701863354037,116,122,133,136,154,160,171,174,"AAGATGG","TTGT","GTGATGG","CTGA",2.44487783590507,11,18,11,49,2.33454197024237,4.65843188573571,7.72923933915186,101,"ENSG00000079974.19"
"4923","ENSG00000102452.18_135694",135686,135694,9,"ENSG00000102452.18",1,1,"MVVVVUVVV",1,7,0.82815734989648,95,101,133,136,141,147,168,171,"AGGATGA","CTAC","CTGGTCA","CTGA",2.43769264125325,32,5,21,67,1.41514940567242,4.41660842017352,7.72923781975944,101,"ENSG00000079974.19"
"42246","ENSG00000261272.1_24080",24072,24080,9,"ENSG00000261272.1",1,1,"MVVUVVVVV",1,7,0.786749482401656,114,120,133,136,146,152,164,167,"AGGATGG","GAGA","GTTTGGA","CTGA",2.32025344518904,13,10,12,44,2.86058706384062,4.58223584127522,7.72923377088184,101,"ENSG00000079974.19"
"12834","ENSG00000139173.10_51377",51369,51377,9,"ENSG00000139173.10",1,7,"UVVVVVMVV",1,7,0.787991718426501,110,116,133,136,151,157,178,181,"ATGATTA","AAGA","CTGCTGT","CTGA",2.48096921925536,17,15,21,62,1.76910354922159,4.57722458606433,7.72919145977033,101,"ENSG00000079974.19"
"24424","ENSG00000176225.15_149713",149705,149713,9,"ENSG00000176225.15",1,1,"MVUVVVVVV",1,7,0.789648033126294,116,122,133,136,141,147,156,159,"AGGATGG","GTGT","AAGGGGA","CTGA",2.2816166779462,11,5,9,34,3.07159814051807,4.57059399837318,7.72918613087836,101,"ENSG00000079974.19"
"25047","ENSG00000179242.16_442380",442372,442380,9,"ENSG00000179242.16",1,2,"UMVVVVVVV",1,7,0.786749482401656,75,81,99,102,114,120,133,136,"ATAATGA","CTGA","GGGATAG","CTAA",2.39655681033261,18,12,13,52,2.35161283170159,4.58216455847975,7.72916248808638,101,"ENSG00000079974.19"
"32019","ENSG00000225678.3_2473",2465,2473,9,"ENSG00000225678.3",1,7,"VVVVVUMVV",1,7,0.807453416149068,49,55,64,67,85,91,133,136,"ATGATGT","CTGA","ATGAACA","CAGA",2.51617453144116,9,18,42,78,1.22274668512425,4.49931089034966,7.72912455494594,101,"ENSG00000079974.19"
"48258","ENSG00000290773.1_982",974,982,9,"ENSG00000290773.1",1,7,"VVVVVUMVV",1,7,0.807453416149068,49,55,64,67,85,91,133,136,"ATGATGT","CTGA","ATGAACA","CAGA",2.51617453144116,9,18,42,78,1.22274668512425,4.49931089034966,7.72912455494594,101,"ENSG00000079974.19"
"26374","ENSG00000184005.11_49530",49522,49530,9,"ENSG00000184005.11",0,NA,"VVVUVUVVV",2,7,0.802898550724638,109,115,133,136,160,166,191,194,"CTGATGA","GTGA","GTGATGA","GTGA",2.54758792129106,18,24,25,76,1.08612691403638,4.51751159732752,7.72910580022607,101,"ENSG00000079974.19"
"34845","ENSG00000234265.2_56754",56746,56754,9,"ENSG00000234265.2",1,6,"VVVVUMVVV",1,7,0.792546583850932,114,120,133,136,144,150,167,170,"CTGGAGA","ATGA","CTGACTA","CTGA",2.33294230100229,13,8,17,47,2.68264508947955,4.55889844070704,7.72908477611076,101,"ENSG00000079974.19"
"10133","ENSG00000129521.15_204787",204779,204787,9,"ENSG00000129521.15",1,1,"MVVVVUVVV",1,7,0.82815734989648,112,118,133,136,152,158,176,179,"CTGCTGC","GTGA","ATCATAA","CTGA",2.34474734079853,15,16,18,58,2.03415962115625,4.41645213995327,7.72908153953919,101,"ENSG00000079974.19"
"10386","ENSG00000130758.8_8258",8250,8258,9,"ENSG00000130758.8",0,NA,"VVVVUUVVV",2,7,0.812008281573499,115,121,133,136,147,153,163,166,"CTAATGA","ATGA","CTGAATA","CTCA",2.26073123000968,12,11,10,42,2.85263932279037,4.48104521404706,7.72907834034106,101,"ENSG00000079974.19"
"6400","ENSG00000109685.19_84223",84215,84223,9,"ENSG00000109685.19",1,5,"UVVVMVVVV",1,7,0.789233954451346,101,107,133,136,139,145,158,161,"CTGATGT","TAGA","GTGAAGC","CTGA",2.48016721906658,26,3,13,51,1.7540700742182,4.57212955033219,7.72906536813757,101,"ENSG00000079974.19"
"37698","ENSG00000248685.6_182767",182759,182767,9,"ENSG00000248685.6",1,1,"MVVVUUVVV",2,6,0.718012422360248,115,121,133,136,173,179,189,192,"ATAATGA","CTAA","GTGAGTA","CTGA",2.61217227410006,12,37,10,68,2.01356284532824,4.8570111681655,7.72906085760649,101,"ENSG00000079974.19"
"46891","ENSG00000287320.1_28145",28137,28145,9,"ENSG00000287320.1",1,1,"MVVVUUVVV",2,6,0.718012422360248,115,121,133,136,173,179,189,192,"ATAATGA","CTAA","GTGAGTA","CTGA",2.61217227410006,12,37,10,68,2.01356284532824,4.8570111681655,7.72906085760649,101,"ENSG00000079974.19"
"32843","ENSG00000228065.13_143669",143661,143669,9,"ENSG00000228065.13",1,2,"VMVVVVUVV",1,7,0.770186335403727,106,112,133,136,145,151,160,163,"GTGATGC","CTGA","CTGAGAA","GTGA",2.43485315940878,21,9,9,48,2.36084837431416,4.64830069259317,7.72904603420808,101,"ENSG00000079974.19"
"42627","ENSG00000265334.1_21142",21134,21142,9,"ENSG00000265334.1",1,3,"UVMVVVVVV",1,7,0.785507246376811,109,115,133,136,174,180,214,217,"TTGAAGA","CAGA","GTGATGA","CTGA",2.64105051921818,18,38,34,99,0.741052147730984,4.58701390229638,7.72904288780363,101,"ENSG00000079974.19"
"810","ENSG00000035141.8_3688",3680,3688,9,"ENSG00000035141.8",1,1,"MVVVVUVVV",1,7,0.82815734989648,101,107,133,136,185,191,203,206,"TTGTTGA","CAGA","CTGACGC","CTGA",2.48591154555857,26,49,12,96,1.09278176939356,4.41638135161267,7.72901075119859,101,"ENSG00000079974.19"
"14508","ENSG00000145242.14_251009",251001,251009,9,"ENSG00000145242.14",1,2,"UMVVVVVVV",1,7,0.786749482401656,115,121,133,136,138,144,166,169,"ATGAACA","CAGA","ATGCAGA","CTGA",2.45833198558222,12,2,22,45,1.93900944638323,4.58197233756617,7.7289702671728,101,"ENSG00000079974.19"
"4917","ENSG00000102409.10_1292",1284,1292,9,"ENSG00000102409.10",1,1,"MVVVVUVVV",1,7,0.82815734989648,115,121,133,136,180,186,208,211,"GAGATGA","TTGT","ATGAGGC","CTGA",2.43814074860606,12,44,22,87,1.41101715397787,4.4163222028379,7.72895160242382,101,"ENSG00000079974.19"
"13225","ENSG00000140650.13_57250",57242,57250,9,"ENSG00000140650.13",1,6,"VVUVVMVVV",1,7,0.786335403726708,57,63,83,86,114,120,133,136,"ATGGTGG","CTGA","GTAAGGC","CTGA",2.52769668265655,20,28,13,70,1.4828504681794,4.58354042147242,7.72888203637926,101,"ENSG00000079974.19"
"22055","ENSG00000169760.18_318179",318171,318179,9,"ENSG00000169760.18",1,8,"VVUVVVVMV",1,7,0.767701863354037,115,121,133,136,165,171,219,222,"ATGGTGA","CTGT","TTGAAGA","CTGA",2.63504091203943,12,29,48,98,1.06533913929115,4.65806963822184,7.72887709163799,101,"ENSG00000079974.19"
"32178","ENSG00000226258.7_98057",98049,98057,9,"ENSG00000226258.7",1,2,"VMUVVVVVV",1,7,0.767701863354037,110,116,133,136,139,145,155,158,"ATGAGAA","CTTA","AAGAAGA","CTGA",2.41973153563168,17,3,10,39,2.50064968307193,4.65804831348745,7.7288557669036,101,"ENSG00000079974.19"
"1001","ENSG00000042832.12_42470",42462,42470,9,"ENSG00000042832.12",1,3,"UVMVVVVVV",1,7,0.785507246376811,111,117,133,136,153,159,168,171,"ATGCAGA","CTGG","GAGCTGA","CTGA",2.41230701693519,16,17,9,51,2.26511878675418,4.58679139158052,7.72882037708777,101,"ENSG00000079974.19"
"19320","ENSG00000162733.19_91283",91275,91283,9,"ENSG00000162733.19",1,8,"UVVVVVVMV",1,7,0.786749482401656,97,103,133,136,146,152,171,174,"CTGATGA","TTTA","TTGAGTA","CTGA",2.52151953857569,30,10,19,68,1.51705266757405,4.58179573118633,7.72879366079296,101,"ENSG00000079974.19"
"2636","ENSG00000077092.20_260378",260370,260378,9,"ENSG00000077092.20",1,8,"UVVVVVVMV",1,7,0.786749482401656,115,121,133,136,151,157,183,186,"ATGGTGA","CAGG","ATGGAGA","CTGA",2.48053136886046,12,15,26,62,1.79030620285865,4.58179549881543,7.72879342842205,101,"ENSG00000079974.19"
"34010","ENSG00000231721.8_183759",183751,183759,9,"ENSG00000231721.8",1,8,"VVVUVVVMV",1,7,0.764803312629399,86,92,133,136,154,160,168,171,"ATGATGG","GGGA","GTGATGT","CTGA",2.59864805827398,41,18,8,76,1.35392035595715,4.66956018611259,7.72877343663019,101,"ENSG00000079974.19"
"13970","ENSG00000144130.12_12978",12970,12978,9,"ENSG00000144130.12",1,7,"UVVVVVMVV",1,7,0.787991718426501,78,84,101,104,114,120,133,136,"ATCATCA","CTTA","GAGATAG","CTGA",2.36004307600056,17,10,13,49,2.5735287144331,4.57678730527587,7.72875417898188,101,"ENSG00000079974.19"
"47623","ENSG00000288723.1_37380",37372,37380,9,"ENSG00000288723.1",1,1,"MVVVUVVVV",1,7,0.795859213250517,84,90,103,106,112,118,133,136,"ATGATGT","CTAA","ATAAAGG","CGGA",2.30584284269896,13,6,15,43,2.80890812931346,4.54529843682663,7.7287352898287,101,"ENSG00000079974.19"
"13650","ENSG00000143028.9_8199",8191,8199,9,"ENSG00000143028.9",1,3,"UVMVVVVVV",1,7,0.785507246376811,83,89,133,136,143,149,166,169,"AGGATGA","AGGA","GAGAAGA","CTGA",2.49732165387037,44,7,17,77,1.6979516206687,4.58669066161779,7.72871964712504,101,"ENSG00000079974.19"
"35548","ENSG00000236283.5_219568",219560,219568,9,"ENSG00000236283.5",1,8,"UVVVVVVMV",1,7,0.786749482401656,115,121,133,136,160,166,182,185,"ATGTGGA","CTGC","ATAATGA","CTGA",2.46320716739733,12,24,16,61,1.90534764626567,4.58168219056196,7.72868012016859,101,"ENSG00000079974.19"
"24240","ENSG00000175497.17_944774",944766,944774,9,"ENSG00000175497.17",1,1,"MVVUVUVVV",2,6,0.708902691511387,115,121,133,136,170,176,210,213,"ATGATGA","ATGA","CTTATGA","CTGA",2.7726518367554,12,34,34,89,1.08789192848408,4.89305937671336,7.72867014275891,101,"ENSG00000079974.19"
"20554","ENSG00000165078.13_62938",62930,62938,9,"ENSG00000165078.13",1,2,"UMVVVVVVV",1,7,0.786749482401656,104,110,133,136,150,156,174,177,"TTGAAGA","CTGT","AAGATGA","CTGA",2.51922118440778,23,14,18,64,1.53185496809259,4.58166571603611,7.72866364564274,101,"ENSG00000079974.19"
"8707","ENSG00000120332.17_79628",79620,79628,9,"ENSG00000120332.17",1,8,"VVVVUVVMV",1,7,0.773913043478261,102,108,133,136,146,152,167,170,"CTAATGC","CAGA","CTGATGA","CTGA",2.49674137017853,25,10,15,59,1.8870394890275,4.63299548922109,7.72864766313413,101,"ENSG00000079974.19"
"21268","ENSG00000166948.10_9322",9314,9322,9,"ENSG00000166948.10",0,NA,"VVVUVUVVV",2,7,0.802898550724638,72,78,98,101,109,115,133,136,"GCGATGA","CTGA","CTGGTGG","TTGA",2.39326119694526,20,8,18,55,2.11309340710084,4.51704201335064,7.72863621624919,101,"ENSG00000079974.19"
"20668","ENSG00000165288.11_120000",119992,120000,9,"ENSG00000165288.11",1,2,"UMVVVVVVV",1,7,0.786749482401656,113,119,133,136,162,168,177,180,"TTGAAAA","CTGA","GGGATCA","CTGA",2.43894659921036,14,26,9,58,2.06683197752049,4.58161899306406,7.72861692267068,101,"ENSG00000079974.19"
"17502","ENSG00000154240.17_499213",499205,499213,9,"ENSG00000154240.17",1,7,"VVVVUVMVV",1,7,0.775155279503105,86,92,104,107,113,119,133,136,"ATAATCA","ATGT","ATGAAGG","CTGA",2.34480770425842,12,6,14,41,2.87948946421436,4.62788520648428,7.7285063244967,101,"ENSG00000079974.19"
"4119","ENSG00000095564.15_14909",14901,14909,9,"ENSG00000095564.15",0,NA,"UVVVVUVVV",2,7,0.824844720496894,106,112,133,136,150,156,200,203,"TTGATTA","TTGA","ATGTTGC","CTGA",2.50116918988254,21,14,44,88,1.0417250032878,4.42904656729285,7.72842544928043,101,"ENSG00000079974.19"
"30311","ENSG00000204446.4_8400",8392,8400,9,"ENSG00000204446.4",1,2,"VMVVVVUVV",1,7,0.770186335403727,114,120,133,136,144,150,182,185,"ATGAAGA","ATTA","GGGAGGA","CTGA",2.47770286398524,13,8,32,62,2.07259957744687,4.64765466767046,7.72840000928536,101,"ENSG00000079974.19"
"3069","ENSG00000080709.16_126292",126284,126292,9,"ENSG00000080709.16",1,2,"UMVVVUVVV",2,6,0.708902691511387,86,92,101,104,115,121,133,136,"ATTATCA","CTGA","TTGATCT","CTGA",2.53761366562399,9,11,12,41,2.65358613555105,4.89275264326107,7.72836340930662,101,"ENSG00000079974.19"
"36100","ENSG00000237880.2_239134",239126,239134,9,"ENSG00000237880.2",1,8,"VVVVVUVMV",1,7,0.806211180124224,85,91,100,103,115,121,133,136,"ATGAGGT","CTGA","CTTATGC","CAGA",2.31546470243431,9,12,12,42,2.57758639327252,4.50350443570865,7.72834915620555,101,"ENSG00000079974.19"
"930","ENSG00000040933.16_103111",103103,103111,9,"ENSG00000040933.16",0,NA,"VVVUVVUVV",2,7,0.766873706004141,115,121,133,136,145,151,165,168,"ATGGTCA","CTGG","ATGGAGC","CTGA",2.37189402984789,12,9,14,44,2.83078849053812,4.66085383904768,7.72834866306424,101,"ENSG00000079974.19"
"34177","ENSG00000232053.7_131055",131047,131055,9,"ENSG00000232053.7",1,1,"MVVVVVUVV",1,7,0.792132505175983,110,116,133,136,144,150,163,166,"ATTATGG","CAAA","TTGATTG","CTGA",2.33634413360702,17,8,13,47,2.66352836419091,4.55978898039276,7.72831900109669,101,"ENSG00000079974.19"
"44095","ENSG00000277851.2_59427",59419,59427,9,"ENSG00000277851.2",1,8,"VVVVVUVMV",1,7,0.806211180124224,85,91,101,104,115,121,133,136,"CTGATTA","TCGA","ATTGTAA","CTGA",2.29260065868685,10,11,12,42,2.72987507426285,4.50346986637713,7.72831458687402,101,"ENSG00000079974.19"
"36957","ENSG00000243903.1_5849",5841,5849,9,"ENSG00000243903.1",1,1,"MVVUVVVVV",1,7,0.786749482401656,115,121,133,136,140,146,160,163,"GTTAAGA","TTGG","ATGATGG","CTGA",2.33561704251934,12,4,14,39,2.75407800779817,4.58121457281511,7.72821250242174,101,"ENSG00000079974.19"
"17014","ENSG00000152953.13_259967",259959,259967,9,"ENSG00000152953.13",1,2,"VMVVVUVVV",1,7,0.806211180124223,113,119,133,136,139,145,182,185,"ATAATAA","ATGA","TTGAAAA","CTGA",2.44681773253827,14,3,37,63,1.70131418301206,4.50335809998347,7.72820282048036,101,"ENSG00000079974.19"
"37240","ENSG00000246228.7_50587",50579,50587,9,"ENSG00000246228.7",1,6,"VVVUVMVVV",1,7,0.78343685300207,109,115,133,136,149,155,168,171,"ATGATAA","GTTA","TAGATCA","CTGA",2.41467634586506,18,13,13,53,2.27979116489424,4.59440836766533,7.72815577967361,101,"ENSG00000079974.19"
"26254","ENSG00000183722.9_183387",183379,183387,9,"ENSG00000183722.9",1,8,"VVVUVVVMV",1,7,0.764803312629399,105,111,133,136,144,150,166,169,"GTGATGT","GTGG","GTGAATA","CTGA",2.48902163729273,22,8,16,55,2.08222190840102,4.66892487258814,7.72813812310574,101,"ENSG00000079974.19"
"26901","ENSG00000185261.16_433480",433472,433480,9,"ENSG00000185261.16",1,2,"UMVVVUVVV",2,6,0.708902691511387,114,120,133,136,164,170,179,182,"ATGATGA","GTGC","ATGCTGT","CTGA",2.62537842911748,13,28,9,59,2.06757467596241,4.8925243841864,7.72813515023195,101,"ENSG00000079974.19"
"45389","ENSG00000285541.1_3444",3436,3444,9,"ENSG00000285541.1",1,2,"UMVVVVVVV",1,7,0.786749482401656,111,117,133,136,161,167,189,192,"CTGATAA","ATGA","TTGATGC","CTGA",2.54323741439373,16,25,22,72,1.3694089504244,4.58108126159566,7.72807919120228,101,"ENSG00000079974.19"
"25532","ENSG00000182093.16_20799",20791,20799,9,"ENSG00000182093.16",1,2,"UMVVVVVVV",1,7,0.786749482401656,45,51,63,66,111,117,133,136,"ATGATGA","CTTA","CTGAGGC","CTGG",2.48445269424619,12,45,16,82,1.76130372536612,4.58108042175184,7.72807835135847,101,"ENSG00000079974.19"
"45704","ENSG00000285815.1_18165",18157,18165,9,"ENSG00000285815.1",1,2,"UMVVVVVVV",1,7,0.786749482401656,45,51,63,66,111,117,133,136,"ATGATGA","CTTA","CTGAGGC","CTGG",2.48445269424619,12,45,16,82,1.76130372536612,4.58108042175184,7.72807835135847,101,"ENSG00000079974.19"
"18746","ENSG00000158321.19_567193",567185,567193,9,"ENSG00000158321.19",1,1,"MVVVVVUVV",1,7,0.792132505175983,114,120,133,136,138,144,155,158,"ATTATGT","TTGG","GTGACAT","CTGA",2.33997293334312,13,2,11,35,2.63827653205076,4.55952402191789,7.72805404262183,101,"ENSG00000079974.19"
"37592","ENSG00000248515.2_127104",127096,127104,9,"ENSG00000248515.2",1,8,"UVVVVVVMV",1,7,0.786749482401656,115,121,133,136,147,153,164,167,"ATAATGT","TTAA","TAGATTA","CTGA",2.32361959011509,12,11,11,43,2.83341122144213,4.58105212221901,7.72805005182564,101,"ENSG00000079974.19"
"19127","ENSG00000161847.14_8773",8765,8773,9,"ENSG00000161847.14",1,5,"VVUVMUVVV",2,6,0.692339544513457,116,122,133,136,138,144,182,185,"CTGATGA","TTGA","GTGATGT","CTGA",2.74568170919437,11,2,38,60,1.53022206541593,4.9586916983446,7.72804987639843,101,"ENSG00000079974.19"
"7139","ENSG00000112964.14_125592",125584,125592,9,"ENSG00000112964.14",1,1,"MVVUVVVVV",1,7,0.786749482401656,108,114,133,136,149,155,171,174,"ATTAAGA","GTGA","ATGTTTA","CTGA",2.44419105277091,19,13,16,57,2.02950428784816,4.58102782658022,7.72802575618684,101,"ENSG00000079974.19"
"39375","ENSG00000253535.5_266623",266615,266623,9,"ENSG00000253535.5",1,1,"MVVVVUVVV",1,7,0.82815734989648,108,114,133,136,150,156,169,172,"GTGATAA","CATA","AAGATTT","CTGA",2.33140846151411,19,14,13,55,2.11879408501578,4.41537929044413,7.72800869003005,101,"ENSG00000079974.19"
"18194","ENSG00000156475.19_354128",354120,354128,9,"ENSG00000156475.19",1,2,"VMVVVVUVV",1,7,0.770186335403727,87,93,106,109,112,118,133,136,"ATGGTGG","ATGA","AAGAAGC","CTGA",2.40634514103357,13,3,15,40,2.54671263256553,4.64725339319733,7.72799873481224,101,"ENSG00000079974.19"
"47866","ENSG00000289526.2_19094",19086,19094,9,"ENSG00000289526.2",1,2,"VMVVVVUVV",1,7,0.770186335403727,87,93,106,109,112,118,133,136,"ATGGTGG","ATGA","AAGAAGC","CTGA",2.40634514103357,13,3,15,40,2.54671263256553,4.64725339319733,7.72799873481224,101,"ENSG00000079974.19"
"36740","ENSG00000242808.12_529269",529261,529269,9,"ENSG00000242808.12",1,6,"VVUVVMVVV",1,7,0.786335403726708,111,117,133,136,187,193,205,208,"ATCATGT","CTGT","CTGAGGC","CTGA",2.48007508921237,16,51,12,88,1.7966332383831,4.58261679161639,7.72795840652322,101,"ENSG00000079974.19"
"42565","ENSG00000264388.1_57",49,57,9,"ENSG00000264388.1",1,1,"MVVVVUVVV",1,7,0.82815734989648,9,15,29,32,37,43,59,62,"GTGAGGA","CTAA","AAGATAA","CAGA",2.24980958139047,14,5,16,44,2.66258055471462,4.41532777432943,7.72795717391535,101,"ENSG00000079974.19"
"11131","ENSG00000134020.8_69641",69633,69641,9,"ENSG00000134020.8",1,8,"VVVVVUVMV",1,7,0.806211180124224,112,118,133,136,147,153,164,167,"ATGAGAA","GTAA","TTGTTTA","CTGA",2.29168454699724,15,11,11,46,2.73446683986213,4.50309095496093,7.72793567545782,101,"ENSG00000079974.19"
"18024","ENSG00000156011.18_425861",425853,425861,9,"ENSG00000156011.18",1,1,"MVVVVUVVV",1,7,0.82815734989648,111,117,133,136,140,146,166,169,"CAGATGG","GCGA","GAGATGA","CTGA",2.32018420261052,16,4,20,49,2.19326110438874,4.41528894711472,7.72791834670064,101,"ENSG00000079974.19"
"3781","ENSG00000089053.13_80209",80201,80209,9,"ENSG00000089053.13",1,2,"VMVVUVVVV",1,7,0.773913043478261,47,53,68,71,113,119,133,136,"ATGATGG","CTGA","GTGTTTA","TTGA",2.51145884280919,15,42,14,80,1.78575571429401,4.63220366658881,7.72785584050186,101,"ENSG00000079974.19"
"24526","ENSG00000176771.18_271467",271459,271467,9,"ENSG00000176771.18",1,8,"UVVVVVVMV",1,7,0.786749482401656,69,75,86,89,107,113,133,136,"ATCATTT","CTGA","GTGACAA","CTGA",2.46891838247916,11,18,20,58,1.86395289218285,4.58085219384432,7.72785012345094,101,"ENSG00000079974.19"
"21553","ENSG00000168310.12_15002",14994,15002,9,"ENSG00000168310.12",1,8,"UVVVVVVMV",1,7,0.786749482401656,115,121,133,136,143,149,162,165,"AGCATGT","CTGT","ATTTTGA","CTGA",2.30697045008136,12,7,13,41,2.94344333656671,4.58081158427727,7.72780951388389,101,"ENSG00000079974.19"
"19269","ENSG00000162636.16_20390",20382,20390,9,"ENSG00000162636.16",1,7,"VVVVVUMVV",1,7,0.807453416149068,110,116,133,136,162,168,181,184,"GTGAGGA","GAGA","CTGAACA","CTGA",2.43202603287906,17,26,13,65,1.77843814634299,4.49798625805084,7.72779992264711,101,"ENSG00000079974.19"
"37208","ENSG00000245904.6_47522",47514,47522,9,"ENSG00000245904.6",1,6,"UVVVVMVVV",1,7,0.805383022774327,94,100,133,136,149,155,175,178,"ATGATGG","AGGA","CTGAAAA","CTGA",2.51963248137042,33,13,20,75,1.22749481303466,4.50626117220936,7.72779326330667,101,"ENSG00000079974.19"
"48253","ENSG00000290770.1_124572",124564,124572,9,"ENSG00000290770.1",1,1,"MVVVVUVVV",1,7,0.82815734989648,99,105,133,136,152,158,185,188,"ATGATGC","ATAA","GTGTAGA","CTGA",2.5335350461203,28,16,27,80,0.770235642095539,4.41511732072439,7.72774672031031,101,"ENSG00000079974.19"
"25701","ENSG00000182606.17_184509",184501,184509,9,"ENSG00000182606.17",0,NA,"VVVVUVUVV",2,7,0.775983436853002,115,121,133,136,137,143,152,155,"TTGGTGA","ATCA","GTGACTA","CTGA",2.37884598025482,12,1,9,31,2.63618269851883,4.6237889750544,7.72772272246641,101,"ENSG00000079974.19"
"25043","ENSG00000179242.16_418360",418352,418360,9,"ENSG00000179242.16",1,8,"UVVVVVVMV",1,7,0.786749482401656,115,121,133,136,151,157,166,169,"AGGATGC","CAAA","ATGGGGA","CTGA",2.36463805252594,12,15,9,45,2.55863203067095,4.5807214285443,7.72771935815092,101,"ENSG00000079974.19"
"21971","ENSG00000169435.14_9880",9872,9880,9,"ENSG00000169435.14",0,NA,"UVVUVVVVV",2,7,0.78343685300207,107,113,133,136,144,150,158,161,"ATGCTGA","CTAG","GAGCGGA","CTGA",2.38690305698539,20,8,8,45,2.4631737373916,4.59396519599022,7.7277126079985,101,"ENSG00000079974.19"
"9637","ENSG00000125952.20_92156",92148,92156,9,"ENSG00000125952.20",1,7,"VVVVUVMVV",1,7,0.775155279503105,59,65,79,82,110,116,133,136,"GTGTTTA","CTGA","GTGGGGA","CTGA",2.51590663087223,14,28,17,68,1.73486866845078,4.62689488523307,7.7275160032455,101,"ENSG00000079974.19"
"26906","ENSG00000185274.12_201879",201871,201879,9,"ENSG00000185274.12",0,NA,"UVVVVUVVV",2,7,0.824844720496894,111,117,133,136,187,193,205,208,"ATGAGGG","CTGG","GAAAAGA","CTGA",2.38736018407551,16,51,12,88,1.7966332383831,4.42809194972162,7.7274708317092,101,"ENSG00000079974.19"
"2523","ENSG00000075420.13_246920",246912,246920,9,"ENSG00000075420.13",1,2,"VMVVVVUVV",1,7,0.770186335403727,83,89,133,136,140,146,157,160,"GTGGTGA","CAGA","TTGATTC","CTGA",2.5144575911631,44,4,11,68,1.82384417629809,4.64672369601302,7.72746903762793,101,"ENSG00000079974.19"
"14843","ENSG00000145949.12_33886",33878,33886,9,"ENSG00000145949.12",1,7,"VVUVVVMVV",1,7,0.768944099378882,44,50,63,66,109,115,133,136,"ATGATCA","GTGA","ATGCAGG","CTGA",2.54564969207358,13,43,18,83,1.63568985210803,4.65167194981631,7.72744834733184,101,"ENSG00000079974.19"
"30228","ENSG00000204209.13_3380",3372,3380,9,"ENSG00000204209.13",1,8,"VVVVVUVMV",1,7,0.806211180124224,79,85,103,106,108,114,133,136,"ATGCTGA","CTGA","GAGCTGA","CTGT",2.43625460827296,18,2,19,48,1.76870469934444,4.5026005219577,7.7274452424546,101,"ENSG00000079974.19"
"22362","ENSG00000170396.9_179917",179909,179917,9,"ENSG00000170396.9",1,6,"UVVVVMVVV",1,7,0.805383022774327,88,94,133,136,141,147,163,166,"GTGATGA","GTTA","AAAATAA","CTGA",2.44970407384004,39,5,16,69,1.69204588258917,4.50585159371402,7.72738368481133,101,"ENSG00000079974.19"
"13258","ENSG00000140836.17_273876",273868,273876,9,"ENSG00000140836.17",1,1,"MVVVVUVVV",1,7,0.82815734989648,82,88,104,107,115,121,133,136,"ATTATGA","CTGA","TTAATGA","GTGG",2.23054620381169,16,8,12,45,2.7886146674117,4.41473067320573,7.72736007279165,101,"ENSG00000079974.19"
"3373","ENSG00000083067.25_602279",602271,602279,9,"ENSG00000083067.25",0,NA,"UVVVUVVVV",2,7,0.792546583850932,110,116,133,136,144,150,196,199,"ATGTTAA","TTGA","GTGCAGA","CTGA",2.47216121004314,17,8,46,80,1.74757687457283,4.55716290204844,7.72734923745216,101,"ENSG00000079974.19"
"35126","ENSG00000235050.6_24861",24853,24861,9,"ENSG00000235050.6",1,5,"VVVVMVUVV",1,7,0.772670807453416,110,116,133,136,147,153,163,166,"GTGATGA","CTGT","CTTATGT","CTGC",2.39307115974858,17,11,10,47,2.59283814094333,4.63666146815013,7.72734469796379,101,"ENSG00000079974.19"
"43625","ENSG00000272908.1_1840",1832,1840,9,"ENSG00000272908.1",1,7,"VVUVVVMVV",1,7,0.768944099378882,116,122,133,136,168,174,183,186,"CTGATGT","CCGG","ATGAGGA","CTGA",2.48962213314837,11,32,9,61,2.00861964288673,4.65152513263564,7.72730153015116,101,"ENSG00000079974.19"
"22158","ENSG00000169908.12_4900",4892,4900,9,"ENSG00000169908.12",0,NA,"VVVUVVUVV",2,7,0.766873706004141,114,120,133,136,144,150,182,185,"ATCATGA","ATCA","GTGGTGG","CTGA",2.4849925069862,13,8,32,62,2.07259957744687,4.65980407267206,7.72729889668862,101,"ENSG00000079974.19"
"6104","ENSG00000108018.16_18767",18759,18767,9,"ENSG00000108018.16",1,6,"UVVVVMUVV",2,6,0.691511387163561,112,118,133,136,138,144,154,157,"ATGATGA","CAGT","ATAGTGA","CTGA",2.59616327842235,15,2,10,36,2.53725453224883,4.9612524304328,7.72729797908704,101,"ENSG00000079974.19"
"13709","ENSG00000143228.13_52373",52365,52373,9,"ENSG00000143228.13",1,8,"UVVVVVVMV",1,7,0.786749482401656,93,99,133,136,143,149,183,186,"ATGATGG","CTGG","GTGTGGC","CTGA",2.58680312119046,34,7,34,84,1.07573622380122,4.58027259126775,7.72727052087437,101,"ENSG00000079974.19"
"28785","ENSG00000196482.18_541501",541493,541501,9,"ENSG00000196482.18",1,8,"VVVVUVVMV",1,7,0.773913043478261,62,68,80,83,116,122,133,136,"ATGAAGT","CTCA","GAGAGGA","CTGA",2.47669341394134,12,33,11,65,2.01507542576278,4.6315912130096,7.72724338692264,101,"ENSG00000079974.19"
"42485","ENSG00000263655.1_73334",73326,73334,9,"ENSG00000263655.1",1,8,"VVVVUVVMV",1,7,0.773913043478261,112,118,133,136,141,147,156,159,"AGGAGGA","GTGT","TTCATGA","CTGA",2.3440317416514,15,5,9,38,2.89939127144395,4.63156738727999,7.72721956119303,101,"ENSG00000079974.19"
"16259","ENSG00000151240.17_340792",340784,340792,9,"ENSG00000151240.17",0,NA,"VVVVUVUVV",2,7,0.775983436853002,108,114,133,136,148,154,179,182,"AGGATGA","CAGC","CTGTTGA","CTGA",2.53160437213306,19,12,25,65,1.61572777389687,4.62327256369599,7.727206311108,101,"ENSG00000079974.19"
"9250","ENSG00000123411.15_26143",26135,26143,9,"ENSG00000123411.15",1,1,"MVVUVVVVV",1,7,0.786749482401656,114,120,133,136,151,157,168,171,"AGGAGGA","AGGA","GTGGAGA","CTGA",2.36755777080947,13,15,11,48,2.53706209726462,4.58019514233194,7.72719307193856,101,"ENSG00000079974.19"
"11469","ENSG00000135049.16_63461",63453,63461,9,"ENSG00000135049.16",1,2,"UMVVVVVVV",1,7,0.786749482401656,116,122,133,136,159,165,176,179,"ATGATTT","TTAA","ATGATAA","CTGA",2.42804891358111,11,23,11,54,2.13375658766859,4.580187336219,7.72718526582562,101,"ENSG00000079974.19"
"4436","ENSG00000100592.16_163451",163443,163451,9,"ENSG00000100592.16",1,8,"VVUVVVVMV",1,7,0.767701863354037,112,118,133,136,144,150,167,170,"ATGATGT","CAGA","GTCAAGA","CTAA",2.4045205002197,15,8,17,49,2.59492865029695,4.65626632960707,7.72707378302322,101,"ENSG00000079974.19"
"33929","ENSG00000231527.7_224706",224698,224706,9,"ENSG00000231527.7",1,8,"VVVVVUVMV",1,7,0.806211180124224,85,91,103,106,112,118,133,136,"ATTATGA","CTTA","GAGAGGC","CAGA",2.27852447720845,12,6,15,42,2.81847126751759,4.50215861222681,7.72700333272371,101,"ENSG00000079974.19"
"6396","ENSG00000109685.19_1832",1824,1832,9,"ENSG00000109685.19",0,NA,"VVVUVVUVV",2,7,0.766873706004141,67,73,89,92,100,106,133,136,"CTGATGG","CTTA","ATTTTGA","CTGA",2.49148214121256,16,8,27,60,2.02807359894886,4.65948863509148,7.72698345910805,101,"ENSG00000079974.19"
"36249","ENSG00000239354.1_134",126,134,9,"ENSG00000239354.1",1,8,"VVVVUVVMV",1,7,0.773913043478261,101,107,133,136,148,154,164,167,"GTGAAGA","CTGC","AGGCTGA","CTGA",2.49387304410678,26,12,10,57,1.89940838808625,4.63130717053286,7.72695934444591,101,"ENSG00000079974.19"
"43369","ENSG00000271584.2_73880",73872,73880,9,"ENSG00000271584.2",1,8,"VVVVUVVMV",1,7,0.773913043478261,101,107,133,136,148,154,164,167,"GTGAAGA","CTGC","AGGCTGA","CTGA",2.49387304410678,26,12,10,57,1.89940838808625,4.63130717053286,7.72695934444591,101,"ENSG00000079974.19"
"23892","ENSG00000174469.23_962515",962507,962515,9,"ENSG00000174469.23",1,7,"VVVVVUMVV",1,7,0.807453416149068,83,89,97,100,115,121,133,136,"TTGATAA","CTGA","CTGAAGC","CAGA",2.36051163495258,8,15,12,44,2.25170591514295,4.49711253704003,7.7269262016363,101,"ENSG00000079974.19"
"41264","ENSG00000258754.8_291146",291138,291146,9,"ENSG00000258754.8",1,6,"VVUVVMVVV",1,7,0.786335403726708,109,115,133,136,184,190,205,208,"TAGATGA","ATGA","GTGGGGA","CTGA",2.52620664420929,18,48,15,90,1.48483097393587,4.58155215049946,7.72689376540629,101,"ENSG00000079974.19"
"3508","ENSG00000085276.19_45777",45769,45777,9,"ENSG00000085276.19",1,8,"VVVVVUVMV",1,7,0.806211180124224,115,121,133,136,180,186,203,206,"ATGAAGG","TGGA","ATGAAGA","CTGA",2.4460624281957,12,44,17,82,1.70101568903763,4.50202463591891,7.7268693564158,101,"ENSG00000079974.19"
"36722","ENSG00000242795.2_5953",5945,5953,9,"ENSG00000242795.2",1,8,"VVVVVUVMV",1,7,0.806211180124224,115,121,133,136,180,186,203,206,"ATGAAGG","TGGA","ATGAAGA","CTGA",2.4460624281957,12,44,17,82,1.70101568903763,4.50202463591891,7.7268693564158,101,"ENSG00000079974.19"
"7108","ENSG00000112812.16_1255",1247,1255,9,"ENSG00000112812.16",0,NA,"VVUVUVVVV",2,7,0.773498964803312,113,119,133,136,152,158,205,208,"GTGATGA","ATGT","GGGATGC","CTGA",2.56111392314491,14,16,47,86,1.45734921500275,4.6328605089922,7.72685636820545,101,"ENSG00000079974.19"
"25889","ENSG00000183049.14_308732",308724,308732,9,"ENSG00000183049.14",1,1,"MVVVUVVVV",1,7,0.795859213250517,108,114,133,136,139,145,153,156,"AGGATGA","AGGA","GTGATGA","CAGA",2.380616779353,19,3,8,39,2.3026674007635,4.54336148244587,7.72679833544794,101,"ENSG00000079974.19"
"4469","ENSG00000100629.17_252020",252012,252020,9,"ENSG00000100629.17",1,8,"UVVVVVVMV",1,7,0.786749482401656,95,101,133,136,144,150,162,165,"ATTATGA","CCCA","TTGGAGA","CTGA",2.45266284122283,32,8,12,61,1.96806025754488,4.57978646642427,7.7267843960309,101,"ENSG00000079974.19"
"18880","ENSG00000159128.16_8176",8168,8176,9,"ENSG00000159128.16",1,7,"VVVUVVMVV",1,7,0.766045548654244,37,43,88,91,115,121,133,136,"AAGATGT","CTGA","GTGAGTA","CTGA",2.63177732028076,45,24,12,90,1.10504730566914,4.66255736021855,7.72673955483553,101,"ENSG00000079974.19"
"47165","ENSG00000287722.1_491478",491470,491478,9,"ENSG00000287722.1",1,8,"UVVVVVVMV",1,7,0.786749482401656,116,122,133,136,150,156,175,178,"AAGATGT","TGGA","TTGTTGA","CTGA",2.42188657847513,11,14,19,53,2.17304229459415,4.57973820444041,7.72673613404704,101,"ENSG00000079974.19"
"20609","ENSG00000165164.14_269073",269065,269073,9,"ENSG00000165164.14",1,5,"VVVVMUVVV",1,7,0.808695652173913,102,108,133,136,140,146,158,161,"ATGGTTA","CTGG","TTGCTGG","CTGA",2.39991019218171,25,4,12,50,1.96834484308874,4.49193653107504,7.72671913977069,101,"ENSG00000079974.19"
"19694","ENSG00000163618.18_134870",134862,134870,9,"ENSG00000163618.18",1,1,"MVVUVVVVV",1,7,0.786749482401656,98,104,110,113,116,122,133,136,"ATGATGA","TTGT","AGGCTGA","ATGA",2.35558164827173,6,3,11,29,2.61485576578733,4.57968335523305,7.72668128483967,101,"ENSG00000079974.19"
"39566","ENSG00000253819.3_40743",40735,40743,9,"ENSG00000253819.3",1,1,"MVVVVUVVV",1,7,0.82815734989648,114,120,133,136,164,170,191,194,"ATGGTGA","GTGA","GTGGTGA","ATGA",2.41903339057196,13,28,21,71,1.52929105516639,4.41404508141153,7.72667448099745,101,"ENSG00000079974.19"
"18574","ENSG00000157680.16_213256",213248,213256,9,"ENSG00000157680.16",1,7,"VVVVVUMVV",1,7,0.807453416149068,116,122,133,136,146,152,166,169,"CAGAAGA","CTGG","GTAAAAA","CTGA",2.28510224953546,11,10,14,44,2.7530661077662,4.49677027616732,7.7265839407636,101,"ENSG00000079974.19"
"40921","ENSG00000258084.6_10731",10723,10731,9,"ENSG00000258084.6",1,5,"VVUVMVVVV",1,7,0.770186335403727,115,121,133,136,147,153,166,169,"CTGATGG","CTGA","CTTAAGA","CAGA",2.37343268055711,12,11,13,45,2.76039948308047,4.64582100503196,7.72656634664687,101,"ENSG00000079974.19"
"24504","ENSG00000176641.11_53376",53368,53376,9,"ENSG00000176641.11",1,8,"VVUVVVVMV",1,7,0.767701863354037,82,88,99,102,113,119,133,136,"ATGGTGC","CTGT","GTAGGGA","CTGA",2.39034123485696,11,11,14,45,2.68727877257712,4.65572175123921,7.72652920465536,101,"ENSG00000079974.19"
"29710","ENSG00000198626.18_371936",371928,371936,9,"ENSG00000198626.18",1,2,"VMUVVVVVV",1,7,0.767701863354037,73,79,98,101,115,121,133,136,"ACGATGA","CTGA","GTGGTCA","CTTA",2.46974117888682,19,14,12,54,2.15777780592425,4.65567974962577,7.72648720304191,101,"ENSG00000079974.19"
"29565","ENSG00000198265.12_834",826,834,9,"ENSG00000198265.12",0,NA,"UVVVVUVVV",2,7,0.824844720496894,115,121,133,136,144,150,163,166,"AAGATGG","ATGA","GTCCTGA","CTGC",2.21776366145438,12,8,13,42,2.92332954603795,4.42710515560013,7.72648403758771,101,"ENSG00000079974.19"
"18259","ENSG00000156687.11_509246",509238,509246,9,"ENSG00000156687.11",1,6,"VVVVUMVVV",1,7,0.792546583850932,106,112,133,136,144,150,176,179,"GTGCTTA","CTGG","ATGATGA","CTGA",2.4888620365808,21,8,26,64,1.63276955813133,4.55629578383417,7.72648211923789,101,"ENSG00000079974.19"
"47187","ENSG00000287789.1_5296",5288,5296,9,"ENSG00000287789.1",1,2,"UMVVVVVVV",1,7,0.786749482401656,67,73,87,90,97,103,133,136,"AACATGC","CTGA","ATGTTTA","CTGA",2.43411715129032,14,7,30,60,2.09046304889758,4.57947768104159,7.72647561064821,101,"ENSG00000079974.19"
"42712","ENSG00000266010.4_2117",2109,2117,9,"ENSG00000266010.4",1,2,"VMVVVUVVV",1,7,0.806211180124223,114,120,133,136,147,153,187,190,"AGGCTGA","CTGG","CTGGCGA","CTGA",2.41683039617187,13,11,34,67,1.89427083753611,4.50161836967047,7.72646309016737,101,"ENSG00000079974.19"
"24783","ENSG00000178031.18_155767",155759,155767,9,"ENSG00000178031.18",1,7,"UVVVVVMVV",1,7,0.787991718426501,116,122,133,136,185,191,203,206,"ATATTGA","TTGA","ATGCTGT","CTGA",2.45458625152781,11,49,12,81,1.9339283015469,4.57445916126641,7.72642603497242,101,"ENSG00000079974.19"
"38339","ENSG00000250026.6_2186",2178,2186,9,"ENSG00000250026.6",1,8,"UVVVVVVMV",1,7,0.786749482401656,114,120,133,136,170,176,223,226,"ATGATTA","ATTA","ATGATGA","CTGA",2.5939678366149,13,34,47,103,1.02459233884328,4.57942781240231,7.72642574200894,101,"ENSG00000079974.19"
"48552","ENSG00000291282.1_2353",2345,2353,9,"ENSG00000291282.1",1,8,"UVVVVVVMV",1,7,0.786749482401656,114,120,133,136,170,176,223,226,"ATGATTA","ATTA","ATGATGA","CTGA",2.5939678366149,13,34,47,103,1.02459233884328,4.57942781240231,7.72642574200894,101,"ENSG00000079974.19"
"28592","ENSG00000196208.14_75166",75158,75166,9,"ENSG00000196208.14",1,8,"VVVVVUVMV",1,7,0.806211180124224,25,31,61,64,74,80,133,136,"TTGATGT","CTTA","GTGAAAA","CTGA",2.55948899333638,30,10,53,102,0.943040249678794,4.50157505131367,7.72641977181057,101,"ENSG00000079974.19"
"20580","ENSG00000165105.10_58814",58806,58814,9,"ENSG00000165105.10",1,7,"UVVVVVMVV",1,7,0.787991718426501,115,121,133,136,144,150,189,192,"TCTATGA","CTGA","ATCATGT","CTGA",2.4429088028572,12,8,39,68,2.01168404562679,4.57443568283536,7.72640255654136,101,"ENSG00000079974.19"
"30097","ENSG00000203666.13_70743",70735,70743,9,"ENSG00000203666.13",1,8,"UVVVVVVMV",1,7,0.786749482401656,97,103,110,113,115,121,133,136,"ATCAAGA","CTAA","ATGTTAT","CTGA",2.37738391746538,7,2,12,30,2.46837397632796,4.57940002319095,7.72639795279758,101,"ENSG00000079974.19"
"15967","ENSG00000150471.17_512944",512936,512944,9,"ENSG00000150471.17",1,5,"VVVVMVUVV",1,7,0.772670807453416,61,67,77,80,112,118,133,136,"GTAATGA","CTCA","GTTATGC","CTGA",2.51568632578403,10,32,15,66,1.771610685933,4.63571321445663,7.72639644427029,101,"ENSG00000079974.19"
"24071","ENSG00000175065.12_33446",33438,33446,9,"ENSG00000175065.12",1,5,"UVVVMVVVV",1,7,0.789233954451346,49,55,67,70,109,115,133,136,"ATGATGA","CAGA","ATGCTCA","CTTA",2.49488554406812,12,39,18,78,1.64526895194887,4.56945981143408,7.72639562923946,101,"ENSG00000079974.19"
"11236","ENSG00000134324.12_141706",141698,141706,9,"ENSG00000134324.12",1,1,"MVVVVUVVV",1,7,0.82815734989648,89,95,133,136,171,177,187,190,"TTGGTGA","TTGA","GGGATGT","CTGA",2.49482340558377,38,35,10,92,1.02290841077551,4.41376611200017,7.72639551158609,101,"ENSG00000079974.19"
"35238","ENSG00000235448.3_93542",93534,93542,9,"ENSG00000235448.3",1,3,"VVMUVVVVV",1,7,0.763561076604555,113,119,133,136,170,176,184,187,"GATATGA","CTGA","TTGAAGT","CTGA",2.50805583503405,14,34,8,65,1.96812813265224,4.67212509155314,7.72636939797136,101,"ENSG00000079974.19"
"47848","ENSG00000289487.1_5635",5627,5635,9,"ENSG00000289487.1",1,5,"VVUVMVVVV",1,7,0.770186335403727,109,115,133,136,143,149,204,207,"AGGATGA","CTAA","ATGGAAA","CTGA",2.53729243660555,18,7,55,89,1.66707049757899,4.64558835207066,7.72633369368557,101,"ENSG00000079974.19"
"39018","ENSG00000251488.1_124622",124614,124622,9,"ENSG00000251488.1",1,8,"VVVVVVUMV",1,7,0.770186335403727,112,118,133,136,146,152,168,171,"GTGATGA","TTGA","GTAAAGT","CAGA",2.40230510958211,15,10,16,50,2.56698142449996,4.6455872054285,7.72633254704341,101,"ENSG00000079974.19"
"42388","ENSG00000262031.1_231",223,231,9,"ENSG00000262031.1",1,1,"MVVVVUVVV",1,7,0.82815734989648,110,116,133,136,139,145,156,159,"AAGATGT","TTCA","ATTTTTA","CTGA",2.27697306749857,17,3,11,40,2.47476708886333,4.41364688471344,7.72627628429936,101,"ENSG00000079974.19"
"38713","ENSG00000250919.1_5614",5606,5614,9,"ENSG00000250919.1",0,NA,"VVVVVUUVV",2,7,0.808281573498965,97,103,133,136,151,157,172,175,"CTCATGA","CTGG","ATGGTGC","CTGA",2.48370059205583,30,15,15,69,1.4144878022269,4.49312293731644,7.72624923131229,101,"ENSG00000079974.19"
"43340","ENSG00000271395.2_211831",211823,211831,9,"ENSG00000271395.2",0,NA,"UVVVVVUVV",2,7,0.788819875776397,87,93,105,108,110,116,133,136,"TTTATGT","CAGA","ATGTTGT","CTGA",2.40414203345649,12,2,17,40,2.2561242167255,4.57093444327552,7.72621394638111,101,"ENSG00000079974.19"
"41963","ENSG00000260192.3_355644",355636,355644,9,"ENSG00000260192.3",1,8,"VVUVVVVMV",1,7,0.767701863354037,85,91,102,105,115,121,133,136,"CTGATGA","ATGA","TAGATGC","TTGA",2.36595410114425,11,10,12,42,2.84848743502195,4.6553786939959,7.72618614741205,101,"ENSG00000079974.19"
"8135","ENSG00000116991.12_190974",190966,190974,9,"ENSG00000116991.12",1,1,"MVVVVUVVV",1,7,0.82815734989648,112,118,133,136,140,146,163,166,"TTGAAGA","CTTG","GCGATCC","CTGA",2.2804974207505,15,4,17,45,2.45088251671669,4.41354966376335,7.72617906334927,101,"ENSG00000079974.19"
"23643","ENSG00000173467.9_2809",2801,2809,9,"ENSG00000173467.9",1,2,"VMVVUVVVV",1,7,0.773913043478261,111,117,133,136,142,148,178,181,"AGGATGA","ATAA","CTGAAGG","CTGA",2.48604224633392,16,6,30,61,1.94827494019458,4.63047247893852,7.72612465285156,101,"ENSG00000079974.19"
"34499","ENSG00000233219.1_2231",2223,2231,9,"ENSG00000233219.1",1,1,"MVVUVVVVV",1,7,0.786749482401656,113,119,133,136,143,149,161,164,"AGAAGGA","GTGA","TTGAAGG","CTGA",2.30657071145217,14,7,12,42,2.93936475710007,4.57912570836197,7.7261236379686,101,"ENSG00000079974.19"
"16419","ENSG00000151474.23_456572",456564,456572,9,"ENSG00000151474.23",1,2,"VMVVVVUVV",1,7,0.770186335403727,112,118,133,136,144,150,159,162,"ATTAAGA","AAGA","ATGATTT","CTGA",2.34938293113237,15,8,9,41,2.91891028477788,4.64536578974842,7.72611113136333,101,"ENSG00000079974.19"
"6069","ENSG00000107890.17_62931",62923,62931,9,"ENSG00000107890.17",1,3,"UVMVVVVVV",1,7,0.785507246376811,111,117,133,136,172,178,193,196,"ATGATGA","TTGA","ATTAAGA","TTGA",2.49968880773989,16,36,15,76,1.67137441672354,4.5839916170807,7.72602060258794,101,"ENSG00000079974.19"
"44331","ENSG00000280953.2_89549",89541,89549,9,"ENSG00000280953.2",1,1,"MVVUVVVVV",1,7,0.786749482401656,115,121,133,136,146,152,180,183,"ATGAAGA","CCCA","TTGCTGC","CTGA",2.43647100321333,12,10,28,59,2.07286194308518,4.57900049112685,7.72599842073347,101,"ENSG00000079974.19"
"9275","ENSG00000123612.16_28272",28264,28272,9,"ENSG00000123612.16",1,2,"UMVVVVVVV",1,7,0.786749482401656,68,74,89,92,111,117,133,136,"ATTATCT","CTGA","CTGTGGA","CTGA",2.44878699050144,15,19,16,59,1.990725346775,4.57899298752948,7.72599091713611,101,"ENSG00000079974.19"
"21982","ENSG00000169439.12_111562",111554,111562,9,"ENSG00000169439.12",1,1,"MVVVVVUVV",1,7,0.792132505175983,113,119,133,136,148,154,163,166,"CTAATGA","CTCT","CAGATAA","CTGA",2.32390846863084,14,12,9,44,2.73707024608165,4.55744834257181,7.72597836327574,101,"ENSG00000079974.19"
"38690","ENSG00000250891.3_442269",442261,442269,9,"ENSG00000250891.3",1,3,"UVMVVVVVV",1,7,0.785507246376811,100,106,133,136,149,155,164,167,"ATGATGC","GTCA","TTGGGGA","CTGA",2.48102800607024,27,13,9,58,1.79541218854876,4.58389972392092,7.72592870942817,101,"ENSG00000079974.19"
"6388","ENSG00000109670.17_204148",204140,204148,9,"ENSG00000109670.17",0,NA,"VVVVUUVVV",2,7,0.812008281573499,71,77,91,94,103,109,133,136,"ATGATGT","GTGA","TTCATGG","TTGA",2.35245825784144,14,9,24,56,2.22830231433488,4.47783934165278,7.72587246794678,101,"ENSG00000079974.19"
"10344","ENSG00000130559.19_7915",7907,7915,9,"ENSG00000130559.19",1,8,"UVVVVVVMV",1,7,0.786749482401656,45,51,71,74,79,85,133,136,"GTGATGT","CTGG","CTCATGG","CTGA",2.53346908849863,20,5,48,82,1.42566972332939,4.5788659116634,7.72586384127003,101,"ENSG00000079974.19"
"10363","ENSG00000130638.17_98563",98555,98563,9,"ENSG00000130638.17",1,5,"UVVVMVVVV",1,7,0.789233954451346,110,116,133,136,176,182,192,195,"ATGAGGA","CTGT","GTGATGA","CTAA",2.47697355206554,17,40,10,76,1.76236008452892,4.56887927457479,7.72581509238017,101,"ENSG00000079974.19"
"11259","ENSG00000134369.16_20376",20368,20376,9,"ENSG00000134369.16",0,NA,"VVVVUVUVV",2,7,0.775983436853002,114,120,133,136,142,148,200,203,"TTGATGG","TTGT","ATGATGG","CTGA",2.47597465255235,13,6,52,80,1.98093989173191,4.62185939385356,7.72579314126557,101,"ENSG00000079974.19"
"31328","ENSG00000223396.4_40800",40792,40800,9,"ENSG00000223396.4",0,NA,"VVVVUVUVV",2,7,0.775983436853002,114,120,133,136,142,148,200,203,"TTGATGG","TTGT","ATGATGG","CTGA",2.47597465255235,13,6,52,80,1.98093989173191,4.62185939385356,7.72579314126557,101,"ENSG00000079974.19"
"38232","ENSG00000249815.2_152204",152196,152204,9,"ENSG00000249815.2",1,8,"UVVVVVVMV",1,7,0.786749482401656,77,83,100,103,116,122,133,136,"ATAAGGA","CTTA","GTCTAGA","CTGA",2.38188630684608,17,13,11,50,2.43568753671309,4.57873239558841,7.72573032519504,101,"ENSG00000079974.19"
"18657","ENSG00000158019.21_199785",199777,199785,9,"ENSG00000158019.21",1,1,"MVVVUVVVV",1,7,0.795859213250517,116,122,133,136,152,158,169,172,"CTTATGA","TTAA","ATAATGG","CTGA",2.35756490187003,11,16,11,47,2.45199101991455,4.54227259142869,7.72570944443076,101,"ENSG00000079974.19"
"3778","ENSG00000089048.15_67454",67446,67454,9,"ENSG00000089048.15",1,2,"VMVVUVVVV",1,7,0.773913043478261,108,114,133,136,150,156,167,170,"ATGAGGA","CTTC","TTGTGGA","CTGA",2.45019036718434,19,14,11,53,2.18557171655287,4.63004354111211,7.72569571502516,101,"ENSG00000079974.19"
"39500","ENSG00000253667.2_2381",2373,2381,9,"ENSG00000253667.2",1,2,"VMVVUVVVV",1,7,0.773913043478261,108,114,133,136,150,156,167,170,"ATGAGGA","CTTC","TTGTGGA","CTGA",2.45019036718434,19,14,11,53,2.18557171655287,4.63004354111211,7.72569571502516,101,"ENSG00000079974.19"
"11147","ENSG00000134046.12_64814",64806,64814,9,"ENSG00000134046.12",1,8,"VVVVUVVMV",1,7,0.773913043478261,89,95,133,136,145,151,161,164,"AGGAAGA","CTGA","ATCTTGT","CTGA",2.48499369385264,38,9,10,66,1.9535159738637,4.63003514988699,7.72568732380003,101,"ENSG00000079974.19"
"2754","ENSG00000078081.8_30174",30166,30174,9,"ENSG00000078081.8",1,2,"VMVVUVVVV",1,7,0.773913043478261,84,90,133,136,137,143,157,160,"ATGCTGA","CAGA","GTTAGGA","CTGA",2.5983698820708,43,1,14,67,1.19750822001515,4.62999352512179,7.72564569903484,101,"ENSG00000079974.19"
"17541","ENSG00000154359.13_3433",3425,3433,9,"ENSG00000154359.13",1,8,"VVUVVVVMV",1,7,0.767701863354037,110,116,133,136,178,184,239,242,"ATTATGT","CTGA","ATGAGGA","CTGA",2.67879119857331,17,42,55,123,0.760729635764443,4.65483440656329,7.72564185997944,101,"ENSG00000079974.19"
"1057","ENSG00000047249.18_89001",88993,89001,9,"ENSG00000047249.18",0,NA,"VVVUVUVVV",2,7,0.802898550724638,101,107,133,136,143,149,161,164,"ATTATGT","CTGT","AGGCTGT","CTGA",2.39463215686577,26,7,12,54,2.09172892926365,4.51398582709219,7.72558002999074,101,"ENSG00000079974.19"
"26044","ENSG00000183230.18_1453396",1453388,1453396,9,"ENSG00000183230.18",0,NA,"UVVVVUVVV",2,7,0.824844720496894,113,119,133,136,138,144,169,172,"ATGTTGC","GTAA","GTCATGA","CTGA",2.39127011748304,14,2,25,50,1.76294619759591,4.42618674520404,7.72556562719162,101,"ENSG00000079974.19"
"7467","ENSG00000114374.13_152850",152842,152850,9,"ENSG00000114374.13",1,5,"UVVVMVVVV",1,7,0.789233954451346,84,90,133,136,142,148,157,160,"AGGATGA","GGGA","ATGTAGG","CTGA",2.44373587942258,43,6,9,67,1.98287866777957,4.56861279931586,7.72554861712125,101,"ENSG00000079974.19"
"42369","ENSG00000261807.2_88434",88426,88434,9,"ENSG00000261807.2",1,2,"VMVVVUVVV",1,7,0.806211180124223,115,121,133,136,160,166,179,182,"ATGATCA","ATCA","AAGCAGA","CTGA",2.39052546584485,12,24,13,58,2.0659488557264,4.50069632367302,7.72554104416991,101,"ENSG00000079974.19"
"37944","ENSG00000249252.5_15486",15478,15486,9,"ENSG00000249252.5",1,8,"VVVVUVVMV",1,7,0.773913043478261,82,88,103,106,112,118,133,136,"ACAATGA","CTGA","TTGAAGA","CTGT",2.37043046991441,15,6,15,45,2.71640590674244,4.62981892654297,7.72547110045601,101,"ENSG00000079974.19"
"38988","ENSG00000251379.1_7604",7596,7604,9,"ENSG00000251379.1",1,8,"VVVVUVVMV",1,7,0.773913043478261,82,88,103,106,112,118,133,136,"ACAATGA","CTGA","TTGAAGA","CTGT",2.37043046991441,15,6,15,45,2.71640590674244,4.62981892654297,7.72547110045601,101,"ENSG00000079974.19"
"24887","ENSG00000178568.15_1095742",1095734,1095742,9,"ENSG00000178568.15",1,1,"MVVVVUVVV",1,7,0.82815734989648,112,118,133,136,138,144,156,159,"AGGATGA","ATGA","AGGATAG","ATGA",2.27980781538501,15,2,12,38,2.45259901227958,4.41282944537824,7.72545884496416,101,"ENSG00000079974.19"
"42028","ENSG00000260372.7_15644",15636,15644,9,"ENSG00000260372.7",1,1,"MVVVVUVVV",1,7,0.82815734989648,57,63,73,76,80,86,133,136,"GTGCTGA","CTGA","TTGAGCA","CAGA",2.38342327498004,10,4,47,70,1.76181443677411,4.41282573416026,7.72545513374618,101,"ENSG00000079974.19"
"27550","ENSG00000186479.5_90023",90015,90023,9,"ENSG00000186479.5",1,2,"UMVVVUVVV",2,6,0.708902691511387,90,96,133,136,149,155,165,168,"ATGATGA","CTTA","GGGAAAA","CTGA",2.67913174830024,37,13,10,69,1.6983949141083,4.88981830902748,7.72542907507302,101,"ENSG00000079974.19"
"23784","ENSG00000174125.8_31009",31001,31009,9,"ENSG00000174125.8",1,1,"MVUVVVVVV",1,7,0.789648033126294,70,76,90,93,112,118,133,136,"AGGATGA","CTGA","TTATTGA","GTGA",2.42453652882265,14,19,15,57,2.10372513630046,4.56682549877954,7.72541763128471,101,"ENSG00000079974.19"
"23787","ENSG00000174130.13_31009",31001,31009,9,"ENSG00000174130.13",1,1,"MVUVVVVVV",1,7,0.789648033126294,70,76,90,93,112,118,133,136,"AGGATGA","CTGA","TTATTGA","GTGA",2.42453652882265,14,19,15,57,2.10372513630046,4.56682549877954,7.72541763128471,101,"ENSG00000079974.19"
"24263","ENSG00000175600.16_471265",471257,471265,9,"ENSG00000175600.16",1,8,"VVVVUUVMV",2,6,0.696066252587992,112,118,133,136,161,167,177,180,"AGGATGA","TTGA","CTGATAA","CTGA",2.65968624389845,15,25,10,59,2.03333013577129,4.94114294044024,7.7254079507922,101,"ENSG00000079974.19"
"25797","ENSG00000182771.19_300034",300026,300034,9,"ENSG00000182771.19",1,8,"VVVUVVVMV",1,7,0.764803312629399,114,120,133,136,177,183,200,203,"CTGATGA","CACA","GTGTTGC","CTGA",2.54480719967233,13,41,17,80,1.69927899099768,4.66616508053664,7.72537833105424,101,"ENSG00000079974.19"
"18683","ENSG00000158104.11_13945",13937,13945,9,"ENSG00000158104.11",0,NA,"VVVVVUUVV",2,7,0.808281573498965,23,29,57,60,71,77,133,136,"AAGATGA","ATGA","TTCATGG","CTGA",2.5582896159425,28,11,56,104,0.913682378825317,4.49223662127715,7.72536291527301,101,"ENSG00000079974.19"
"9304","ENSG00000123983.15_57194",57186,57194,9,"ENSG00000123983.15",1,2,"VMVUVVVVV",1,7,0.764803312629399,113,119,133,136,152,158,180,183,"ATCATTA","CTTA","GTGAGGA","CTGA",2.52066058968573,14,16,22,61,1.8601102417863,4.66612854325613,7.72534179377373,101,"ENSG00000079974.19"
"41894","ENSG00000259925.1_2448",2440,2448,9,"ENSG00000259925.1",1,8,"VVVVVUVMV",1,7,0.806211180124224,112,118,133,136,146,152,204,207,"ATGTTAA","CAGA","AGGAGGA","CTGA",2.42889872822465,15,10,52,86,1.80922795653734,4.50047153617542,7.72531625667231,101,"ENSG00000079974.19"
"9013","ENSG00000122126.18_9066",9058,9066,9,"ENSG00000122126.18",1,1,"MVVVUUVVV",2,6,0.718012422360248,36,42,58,61,106,112,133,136,"ATAATGA","CTGA","CTGTAGA","CTGA",2.71680898214728,16,45,21,91,1.30085710622121,4.85322924680078,7.72527893624177,101,"ENSG00000079974.19"
"19094","ENSG00000161082.13_47358",47350,47358,9,"ENSG00000161082.13",1,1,"MVVVVUVVV",1,7,0.82815734989648,111,117,133,136,152,158,175,178,"ATGTTGA","GTGA","CTGAAGC","CTGT",2.34394868417992,16,16,17,58,2.02412924527066,4.41261345161752,7.72524285120344,101,"ENSG00000079974.19"
"41681","ENSG00000259520.6_39080",39072,39080,9,"ENSG00000259520.6",1,8,"VVVVVUVMV",1,7,0.806211180124224,112,118,133,136,146,152,205,208,"ATGTTAA","CAGA","AGGAGGA","CTGA",2.42889872822465,15,10,53,87,1.80889703122316,4.50038880484687,7.72523352534376,101,"ENSG00000079974.19"
"46497","ENSG00000286747.1_2721",2713,2721,9,"ENSG00000286747.1",1,8,"VVVVVUVMV",1,7,0.806211180124224,112,118,133,136,146,152,205,208,"ATGTTAA","CAGA","AGGAGGA","CTGA",2.42889872822465,15,10,53,87,1.80889703122316,4.50038880484687,7.72523352534376,101,"ENSG00000079974.19"
"24831","ENSG00000178127.13_1875",1867,1875,9,"ENSG00000178127.13",1,1,"MVVVVUVVV",1,7,0.82815734989648,104,110,133,136,148,154,172,175,"ATGATGA","AAGA","TTGTAGA","TTGA",2.39630789240653,23,12,18,62,1.67490087176021,4.41257170528427,7.72520110487019,101,"ENSG00000079974.19"
"42620","ENSG00000265257.5_1769",1761,1769,9,"ENSG00000265257.5",1,1,"MVVVVUVVV",1,7,0.82815734989648,104,110,133,136,148,154,172,175,"ATGATGA","AAGA","TTGTAGA","TTGA",2.39630789240653,23,12,18,62,1.67490087176021,4.41257170528427,7.72520110487019,101,"ENSG00000079974.19"
"1735","ENSG00000065802.12_5331",5323,5331,9,"ENSG00000065802.12",1,3,"VVMVVVUVV",1,7,0.768944099378882,115,121,133,136,153,159,168,171,"TTGATAA","GTGA","ATTAGGT","CTGA",2.4251677069127,12,17,9,47,2.4296781435354,4.64936571407168,7.72514211158721,101,"ENSG00000079974.19"
"10643","ENSG00000132170.24_146316",146308,146316,9,"ENSG00000132170.24",1,8,"VVUVVVVMV",1,7,0.767701863354037,113,119,133,136,145,151,160,163,"ATCCTGG","CTGC","CTGATCA","CTGA",2.3519647610001,14,9,9,41,2.93727423392056,4.65425982681364,7.72506728022979,101,"ENSG00000079974.19"
"13233","ENSG00000140718.21_330491",330483,330491,9,"ENSG00000140718.21",1,8,"VVVVVVUMV",1,7,0.770186335403727,111,117,133,136,149,155,166,169,"GGGATGT","TTGT","GTGATGT","CTGA",2.40873043894919,16,13,11,49,2.51902144510395,4.64430609285797,7.72505143447288,101,"ENSG00000079974.19"
"13162","ENSG00000140455.17_81984",81976,81984,9,"ENSG00000140455.17",1,8,"VVVVVUVMV",1,7,0.806211180124224,102,108,133,136,146,152,178,181,"ATGATGT","CCCA","CTGCAGA","CTGA",2.50415748159362,25,10,26,70,1.30632361093577,4.50017670538997,7.72502142588687,101,"ENSG00000079974.19"
"10027","ENSG00000128849.11_23703",23695,23703,9,"ENSG00000128849.11",1,2,"VMVUVVVVV",1,7,0.764803312629399,79,85,97,100,110,116,133,136,"ATGGACA","CTGA","TTCATGA","CTGA",2.40979407865876,12,10,17,48,2.59782127016637,4.66577878197286,7.72499203249045,101,"ENSG00000079974.19"
"12818","ENSG00000139173.10_116643",116635,116643,9,"ENSG00000139173.10",1,1,"MVVVVVUVV",1,7,0.792132505175983,114,120,133,136,170,176,186,189,"ATAAAGA","ATGA","AAGATGG","CTGA",2.43092063837283,13,34,10,66,2.01967862299279,4.55645405303625,7.72498407374018,101,"ENSG00000079974.19"
"3625","ENSG00000087053.20_31261",31253,31261,9,"ENSG00000087053.20",1,2,"UMVVVVVVV",1,7,0.786749482401656,116,122,133,136,142,148,171,174,"CAGATGA","CAGC","ATGTAGA","CTGA",2.39901464364311,11,6,23,49,2.31850031136609,4.5779828172467,7.72498074685333,101,"ENSG00000079974.19"
"16592","ENSG00000151834.16_95369",95361,95369,9,"ENSG00000151834.16",1,1,"MVVVVUVVV",1,7,0.82815734989648,116,122,133,136,147,153,165,168,"AAGATGA","GAGA","CTGTTAA","CTCA",2.23031453035047,11,11,12,43,2.78034280521069,4.41227658522012,7.72490598480604,101,"ENSG00000079974.19"
"47276","ENSG00000287918.2_81301",81293,81301,9,"ENSG00000287918.2",1,6,"VVVVVMUVV",1,7,0.788819875776397,71,77,100,103,111,117,133,136,"TTGAGGG","CTGA","GTGCCCA","CTGA",2.43904852276412,23,8,16,56,2.01817622917652,4.56962492856766,7.72490443167325,101,"ENSG00000079974.19"
"41444","ENSG00000259048.1_66928",66920,66928,9,"ENSG00000259048.1",1,8,"VVVVVUVMV",1,7,0.806211180124224,98,104,133,136,144,150,162,165,"AGGAGGA","TTTA","CTGAAGA","CTGA",2.39951019021887,29,8,12,58,2.00325988070702,4.49999862054154,7.72484334103843,101,"ENSG00000079974.19"
"12564","ENSG00000138646.9_11803",11795,11803,9,"ENSG00000138646.9",1,6,"UVVVVMVVV",1,7,0.805383022774327,67,73,94,97,111,117,133,136,"AGGATCT","CTGA","TTGATTG","CTGA",2.43331785605295,21,14,16,60,1.79110384691944,4.50330572181811,7.72483781291542,101,"ENSG00000079974.19"
"33392","ENSG00000229618.3_471677",471669,471677,9,"ENSG00000229618.3",1,2,"VMUVVVVVV",1,7,0.767701863354037,75,81,92,95,114,120,133,136,"TTGATCA","CAGA","GTGGGAA","CTGA",2.45987365383834,11,19,13,52,2.2169553654535,4.65402826442727,7.72483571784341,101,"ENSG00000079974.19"
"14776","ENSG00000145864.14_136492",136484,136492,9,"ENSG00000145864.14",1,1,"MVVVVVUVV",1,7,0.792132505175983,116,122,133,136,140,146,155,158,"CAGAGGA","CTAA","ATGTTTT","CTGA",2.28085098721685,11,4,9,33,3.01944027565145,4.55627838094095,7.72480840164488,101,"ENSG00000079974.19"
"9061","ENSG00000122507.21_245221",245213,245221,9,"ENSG00000122507.21",1,3,"UVMVVVVVV",1,7,0.785507246376811,99,105,133,136,148,154,166,169,"GTAATTA","CTGT","TTGATGA","CTGA",2.47938099577172,28,12,12,61,1.80186392266171,4.58276764028496,7.7247966257922,101,"ENSG00000079974.19"
"39750","ENSG00000254180.2_330801",330793,330801,9,"ENSG00000254180.2",0,NA,"VVVUVVUVV",2,7,0.766873706004141,56,62,72,75,82,88,133,136,"AGGGTGA","CTGA","GTGGTTC","CTGA",2.5053858551565,10,7,45,71,1.92662543992343,4.65729945190835,7.72479427592492,101,"ENSG00000079974.19"
"26681","ENSG00000184903.10_121257",121249,121257,9,"ENSG00000184903.10",1,7,"VVVVVUMVV",1,7,0.807453416149068,110,116,133,136,138,144,162,165,"GTGAGGA","TAGA","AGGCTGA","CTGA",2.40892652927658,17,2,18,46,1.92040652038281,4.49497917889,7.72479284348628,101,"ENSG00000079974.19"
"31192","ENSG00000218336.9_567354",567346,567354,9,"ENSG00000218336.9",0,NA,"UVVVVVUVV",2,7,0.788819875776397,91,97,133,136,144,150,158,161,"ATGACGA","GTGT","GTGAGTT","CTGA",2.44576247511952,36,8,8,61,1.97284317829051,4.56948158643849,7.72476108954408,101,"ENSG00000079974.19"
"7423","ENSG00000114124.3_48642",48634,48642,9,"ENSG00000114124.3",1,2,"VMVVVVUVV",1,7,0.770186335403727,50,56,86,89,97,103,133,136,"GTGCTGA","CTGA","GTGCAGC","CTGA",2.61288152787579,30,8,30,77,1.15683156025171,4.64401043652258,7.72475577813749,101,"ENSG00000079974.19"
"29201","ENSG00000197416.5_40262",40254,40262,9,"ENSG00000197416.5",1,8,"UVVVVVVMV",1,7,0.786749482401656,110,116,133,136,144,150,204,207,"AAGATGT","TTGA","ATTAGGA","CTGA",2.48526077087779,17,8,54,88,1.74257000639654,4.57774378639545,7.72474171600208,101,"ENSG00000079974.19"
"8","ENSG00000000971.17_86332",86324,86332,9,"ENSG00000000971.17",1,8,"VVUVVVVMV",1,7,0.767701863354037,91,97,133,136,151,157,174,177,"ATGAAGA","CTTA","CTCATGA","CTGA",2.60369967587849,36,15,17,77,1.25756170301116,4.65388988555027,7.72469733896642,101,"ENSG00000079974.19"
"47911","ENSG00000289697.1_86234",86226,86234,9,"ENSG00000289697.1",1,8,"VVUVVVVMV",1,7,0.767701863354037,91,97,133,136,151,157,174,177,"ATGAAGA","CTTA","CTCATGA","CTGA",2.60369967587849,36,15,17,77,1.25756170301116,4.65388988555027,7.72469733896642,101,"ENSG00000079974.19"
"20601","ENSG00000165152.9_18687",18679,18687,9,"ENSG00000165152.9",1,6,"UVVVVMVVV",1,7,0.805383022774327,83,89,133,136,142,148,156,159,"TTGAGGA","ATGA","GAAATGG","CTGA",2.407257684664,44,6,8,67,1.96425965237848,4.50316105420129,7.7246931452986,101,"ENSG00000079974.19"
"12605","ENSG00000138685.17_55591",55583,55591,9,"ENSG00000138685.17",1,7,"UVVVVVMVV",1,7,0.787991718426501,102,108,133,136,153,159,169,172,"ATGATAA","ATGA","ATCTTCA","CTGA",2.50365739903964,25,17,10,61,1.59983341181072,4.57272068468541,7.72468755839141,101,"ENSG00000079974.19"
"7214","ENSG00000113318.11_206612",206604,206612,9,"ENSG00000113318.11",1,1,"MVUVVVVVV",1,7,0.789648033126294,111,117,133,136,142,148,161,164,"ATGATGT","CTGC","GTTAGGT","CTGG",2.32719852952515,16,6,13,44,2.74952189876665,4.56604469056692,7.7246368230721,101,"ENSG00000079974.19"
"25182","ENSG00000179915.25_1258922",1258914,1258922,9,"ENSG00000179915.25",1,8,"UVVVVUVMV",2,6,0.708902691511387,107,113,133,136,145,151,169,172,"GTGAAGA","CTGT","GTGAAGA","CTGA",2.62181379775154,20,9,18,56,2.07700935120833,4.88894200072131,7.72455276676686,101,"ENSG00000079974.19"
"10365","ENSG00000130649.10_28153",28145,28153,9,"ENSG00000130649.10",1,5,"VVVUMVVVV",1,7,0.767287784679089,84,90,103,106,116,122,133,136,"AGAGTGA","CTGA","TAGATCA","CTGA",2.3594414589254,13,10,11,43,2.89199271304926,4.65540060980465,7.72455174852101,101,"ENSG00000079974.19"
"29341","ENSG00000197798.9_49981",49973,49981,9,"ENSG00000197798.9",1,8,"UVVVVVVMV",1,7,0.786749482401656,105,111,133,136,142,148,180,183,"GTGATCA","CTGC","GTGGTGG","CTGA",2.53482455710531,22,6,32,69,1.4112030314327,4.57750835303369,7.72450628264032,101,"ENSG00000079974.19"
"18583","ENSG00000157703.16_68350",68342,68350,9,"ENSG00000157703.16",1,8,"VVVVVUVMV",1,7,0.806211180124224,113,119,133,136,143,149,182,185,"ATGATTA","ATTA","ATAGAGA","CTGA",2.39379891769598,14,7,33,63,2.0397922736348,4.49961293123533,7.72445765173222,101,"ENSG00000079974.19"
"15585","ENSG00000148840.11_5810",5802,5810,9,"ENSG00000148840.11",1,6,"UVVVVMVVV",1,7,0.805383022774327,116,122,133,136,144,150,166,169,"GGGATTA","TAGA","CTGTGGA","CTGA",2.2923984031441,11,8,16,44,2.72866022066996,4.50282906040765,7.72436115150496,101,"ENSG00000079974.19"
"18461","ENSG00000157445.15_349340",349332,349340,9,"ENSG00000157445.15",1,5,"UVVVMVVVV",1,7,0.789233954451346,94,100,133,136,180,186,195,198,"AGGAAGA","CTGA","CAGATGA","CTGA",2.58761193709588,33,44,9,95,1.01882988359022,4.56739403272402,7.72432985052941,101,"ENSG00000079974.19"
"27692","ENSG00000187147.18_121000",120992,121000,9,"ENSG00000187147.18",1,8,"VVVVVVUMV",1,7,0.770186335403727,110,116,133,136,147,153,169,172,"GTGATGC","CATA","CTGGTGT","CTGA",2.4338282220474,17,11,16,53,2.34877699722068,4.64357461938418,7.72431996099908,101,"ENSG00000079974.19"
"37921","ENSG00000249207.2_30775",30767,30775,9,"ENSG00000249207.2",1,3,"VVMUVVVVV",1,7,0.763561076604555,114,120,133,136,146,152,163,166,"ACAATGA","GTCA","CTGATTA","CTGA",2.36823826899725,13,10,11,43,2.89199271304926,4.67006195992439,7.72430626634261,101,"ENSG00000079974.19"
"8555","ENSG00000119535.19_2788",2780,2788,9,"ENSG00000119535.19",1,2,"VMVVVUVVV",1,7,0.806211180124223,95,101,133,136,187,193,202,205,"AAGATGA","CTGC","GTGACCT","CTGA",2.54625757842939,32,51,9,101,1.02274648481191,4.49944925191862,7.72429397241552,101,"ENSG00000079974.19"
"32551","ENSG00000227165.10_34827",34819,34827,9,"ENSG00000227165.10",0,NA,"UVVVUVVVV",2,7,0.792546583850932,55,61,75,78,114,120,133,136,"ATGATAA","CATA","CTTAAGA","CTGA",2.44755422530896,14,36,13,72,1.89939081541321,4.5541047460349,7.72429108143863,101,"ENSG00000079974.19"
"2422","ENSG00000074416.16_7659",7651,7659,9,"ENSG00000074416.16",1,7,"UVVVVVMVV",1,7,0.787991718426501,86,92,106,109,115,121,133,136,"GTGCTGT","CTGA","TTAATGA","CAGA",2.30388714039803,14,6,12,41,2.92993519723474,4.57229569997208,7.72426257367808,101,"ENSG00000079974.19"
"39899","ENSG00000254401.2_116348",116340,116348,9,"ENSG00000254401.2",0,NA,"UVVVVVUVV",2,7,0.788819875776397,111,117,133,136,186,192,215,218,"ATGTTGA","CTAA","ATCAGGA","CTGA",2.56175170533087,16,50,23,98,1.19749501511646,4.56895992933057,7.72423943243616,101,"ENSG00000079974.19"
"40082","ENSG00000254957.1_1749",1741,1749,9,"ENSG00000254957.1",0,NA,"UVVVVVUVV",2,7,0.788819875776397,111,117,133,136,186,192,215,218,"ATGTTGA","CTAA","ATCAGGA","CTGA",2.56175170533087,16,50,23,98,1.19749501511646,4.56895992933057,7.72423943243616,101,"ENSG00000079974.19"
"25707","ENSG00000182621.18_272589",272581,272589,9,"ENSG00000182621.18",1,8,"UVVVVVVMV",1,7,0.786749482401656,75,81,87,90,100,106,133,136,"AAGATCA","CTGA","ATGGAGG","CTGA",2.50791397652063,6,10,27,52,1.58950453408204,4.57723276105489,7.72423069066152,101,"ENSG00000079974.19"
"4426","ENSG00000100554.12_50850",50842,50850,9,"ENSG00000100554.12",1,8,"VVUVVVVMV",1,7,0.767701863354037,116,122,133,136,147,153,169,172,"ATTAAGA","CTTA","CTAAGGA","CTGA",2.40636822525002,11,11,16,47,2.57119737585519,4.65341305271383,7.72422050612998,101,"ENSG00000079974.19"
"36536","ENSG00000241684.8_357535",357527,357535,9,"ENSG00000241684.8",0,NA,"UVVUVVVVV",2,7,0.78343685300207,113,119,133,136,152,158,203,206,"ATGATTA","CTTG","GTGATGG","CTGA",2.53526428403228,14,16,45,84,1.45991785914853,4.59041993817426,7.72416735018254,101,"ENSG00000079974.19"
"2418","ENSG00000074416.16_302783",302775,302783,9,"ENSG00000074416.16",1,8,"VVVVVUVMV",1,7,0.806211180124224,81,87,95,98,107,113,133,136,"ATAATGA","CTGA","ATTCTAA","CTGG",2.36925830647161,8,9,20,46,2.20222668176071,4.49932051455953,7.72416523505642,101,"ENSG00000079974.19"
"34721","ENSG00000233891.8_307483",307475,307483,9,"ENSG00000233891.8",1,1,"MVVVVUVVV",1,7,0.82815734989648,99,105,133,136,139,145,154,157,"ATGATGA","ATCA","GGGAAGA","CTCA",2.38009169129124,28,3,9,49,1.77867659918131,4.41148863528072,7.72411803486664,101,"ENSG00000079974.19"
"43497","ENSG00000271955.2_674287",674279,674287,9,"ENSG00000271955.2",1,1,"MVVVVUVVV",1,7,0.82815734989648,99,105,133,136,139,145,154,157,"ATGATGA","ATCA","GGGAAGA","CTCA",2.38009169129124,28,3,9,49,1.77867659918131,4.41148863528072,7.72411803486664,101,"ENSG00000079974.19"
"4360","ENSG00000100320.24_85919",85911,85919,9,"ENSG00000100320.24",1,2,"VMVVUVVVV",1,7,0.773913043478261,76,82,100,103,112,118,133,136,"GTGAGGA","TTGG","GTTATAA","CTGA",2.41189370953569,18,9,15,51,2.43450289211067,4.62844857225381,7.72410074616686,101,"ENSG00000079974.19"
"21571","ENSG00000168386.19_230508",230500,230508,9,"ENSG00000168386.19",1,6,"UVVVVMVVV",1,7,0.805383022774327,111,117,133,136,145,151,189,192,"CAGATGA","CTGT","GTTAGTA","CTGA",2.42872767175257,16,9,38,72,1.81870475278025,4.50255564111601,7.72408773221332,101,"ENSG00000079974.19"
"42594","ENSG00000264859.6_14499",14491,14499,9,"ENSG00000264859.6",1,1,"MVUVVUVVV",2,6,0.711801242236025,49,55,80,83,91,97,133,136,"ATGATGG","CTGA","GTCAGGA","CTGA",2.74574335053119,25,8,36,78,1.20253561895158,4.87687282228989,7.72407779123398,101,"ENSG00000079974.19"
"7078","ENSG00000112699.11_421251",421243,421251,9,"ENSG00000112699.11",0,NA,"UVVVVUVVV",2,7,0.824844720496894,115,121,133,136,138,144,155,158,"ATGATGT","TAGA","GTGCACA","CTGG",2.25308720371248,12,2,11,34,2.67787429758514,4.42461391391709,7.72399279590467,101,"ENSG00000079974.19"
"40754","ENSG00000257545.5_164515",164507,164515,9,"ENSG00000257545.5",1,8,"VVVVVUVMV",1,7,0.806211180124224,76,82,101,104,115,121,133,136,"ATGAGGA","CAGA","AGGAAGA","CTGG",2.34388613977169,19,11,12,51,2.3704658835757,4.49909337051341,7.72393809101031,101,"ENSG00000079974.19"
"39110","ENSG00000251635.2_3079",3071,3079,9,"ENSG00000251635.2",1,5,"VVUVMVVVV",1,7,0.770186335403727,115,121,133,136,142,148,156,159,"CTAATGA","CAGG","GTAGGGA","CTGA",2.32152108829054,12,6,8,35,3.09576072844806,4.64314199592959,7.72388733754449,101,"ENSG00000079974.19"
"774","ENSG00000033122.21_91398",91390,91398,9,"ENSG00000033122.21",1,1,"MVVVVVUVV",1,7,0.792132505175983,112,118,133,136,185,191,208,211,"ATGAGGA","TTAA","TAGATGA","CTGA",2.49197137300242,15,49,17,90,1.60819831903101,4.55533520142845,7.72386522213239,101,"ENSG00000079974.19"
"30970","ENSG00000214954.9_81546",81538,81546,9,"ENSG00000214954.9",1,1,"MVVVVUUVV",2,6,0.714285714285714,87,93,103,106,113,119,133,136,"ATGAAGA","CTAA","GGCAGGA","CTGA",2.4964514898013,10,7,14,40,2.82377627591641,4.86669655198127,7.72383940912412,101,"ENSG00000079974.19"
"12219","ENSG00000137672.13_56711",56703,56711,9,"ENSG00000137672.13",1,1,"MVVUVVVVV",1,7,0.786749482401656,85,91,133,136,144,150,197,200,"ATGATGT","CTGG","TTGCTCA","CTGA",2.59724998742862,42,8,47,106,0.992191310721176,4.57679780672799,7.72379573633461,101,"ENSG00000079974.19"
"28361","ENSG00000188859.7_31236",31228,31236,9,"ENSG00000188859.7",1,7,"UVVVVVMVV",1,7,0.787991718426501,116,122,133,136,147,153,176,179,"GTGTTGA","CTAT","GTGTTGT","CTGA",2.41778135928794,11,11,23,54,2.16867267065999,4.57180376647824,7.72377064018424,101,"ENSG00000079974.19"
"8496","ENSG00000119185.13_6528",6520,6528,9,"ENSG00000119185.13",1,8,"VVVVUUVMV",2,6,0.696066252587992,76,82,92,95,99,105,133,136,"AGGATGT","CTGA","ATGATGG","CTGA",2.67387949655725,10,4,28,51,1.93206412016227,4.93948185763598,7.72374686798795,101,"ENSG00000079974.19"
"16998","ENSG00000152952.13_122204",122196,122204,9,"ENSG00000152952.13",1,8,"VVUVVVVMV",1,7,0.767701863354037,115,121,133,136,150,156,176,179,"GTTATGA","TTAA","GTCATGA","CTGA",2.47084250109947,12,14,20,55,2.13939343160491,4.652919193067,7.72372664648315,101,"ENSG00000079974.19"
"30516","ENSG00000205464.13_107260",107252,107260,9,"ENSG00000205464.13",1,7,"UVVVVVMVV",1,7,0.787991718426501,88,94,106,109,112,118,133,136,"ATGTTGG","CTGT","GGAATCA","CTGA",2.35854704652607,12,3,15,39,2.56293026363002,4.57164431011762,7.72361118382363,101,"ENSG00000079974.19"
"12946","ENSG00000139668.9_24922",24914,24922,9,"ENSG00000139668.9",1,1,"MVVVVVUVV",1,7,0.792132505175983,87,93,106,109,111,117,133,136,"GTCATGT","CTCA","AAGATTA","CTGA",2.38616890698908,13,2,16,40,2.31250035129535,4.55507326613898,7.72360328684291,101,"ENSG00000079974.19"
"41259","ENSG00000258754.8_170632",170624,170632,9,"ENSG00000258754.8",1,8,"VVVUVVVMV",1,7,0.764803312629399,110,116,133,136,141,147,167,170,"GTGACGA","GTGT","TTGAGGA","CTGA",2.46813022483819,17,5,20,51,2.2033348791655,4.66438409452169,7.72359734503928,101,"ENSG00000079974.19"
"14418","ENSG00000144893.13_153328",153320,153328,9,"ENSG00000144893.13",1,3,"UVMVVVVVV",1,7,0.785507246376811,116,122,133,136,169,175,193,196,"ATGATGT","CAGG","CTGTTCA","CTGA",2.50291014539635,11,33,18,71,1.64003307330496,4.58152517732015,7.72355416282739,101,"ENSG00000079974.19"
"47849","ENSG00000289487.1_63233",63225,63233,9,"ENSG00000289487.1",1,8,"UVVVVVVMV",1,7,0.786749482401656,97,103,133,136,144,150,158,161,"TTGATGA","TTTA","AGGATTT","CTGA",2.44436668662353,30,8,8,55,2.01038079103026,4.57653967546345,7.72353760507007,101,"ENSG00000079974.19"
"17162","ENSG00000153283.13_4388",4380,4388,9,"ENSG00000153283.13",1,8,"VVVVVUVMV",1,7,0.806211180124224,116,122,133,136,185,191,209,212,"GTGCTGA","GTGT","TTGATGT","CTGA",2.45741692685425,11,49,18,87,1.61195478044383,4.49868357320137,7.72352829369827,101,"ENSG00000079974.19"
"39896","ENSG00000254394.2_853807",853799,853807,9,"ENSG00000254394.2",1,3,"UVMVVUVVV",2,6,0.707660455486542,52,58,101,104,111,117,133,136,"ATGAAGA","CAGA","ATGATGT","CTGA",2.67186659905949,43,7,16,75,1.75899935595406,4.892860837421,7.72350265936717,101,"ENSG00000079974.19"
"28673","ENSG00000196341.3_5232",5224,5232,9,"ENSG00000196341.3",1,8,"VVVVVUVMV",1,7,0.806211180124224,116,122,133,136,147,153,163,166,"AGGATGT","TTAA","AGTAGGA","CTGA",2.27407759045841,11,11,10,41,2.83404292477404,4.49864004862419,7.72348476912109,101,"ENSG00000079974.19"
"12531","ENSG00000138472.11_39598",39590,39598,9,"ENSG00000138472.11",1,1,"MVVVVUVVV",1,7,0.82815734989648,102,108,133,136,149,155,186,189,"GTGATTA","CTGG","GTGAATT","CTGA",2.50054420436962,25,13,31,78,0.97311725885069,4.41085298866204,7.72348238824796,101,"ENSG00000079974.19"
"22978","ENSG00000171848.16_74409",74401,74409,9,"ENSG00000171848.16",1,8,"VVUVVVVMV",1,7,0.767701863354037,104,110,133,136,142,148,165,168,"ATTCTGA","CTTA","GTGGTGA","CTGA",2.49841204880187,23,6,17,55,1.9544658100281,4.65263653384348,7.72344398725962,101,"ENSG00000079974.19"
"38627","ENSG00000250657.1_2436",2428,2436,9,"ENSG00000250657.1",1,2,"UMVVVUVVV",2,6,0.708902691511387,98,104,133,136,141,147,155,158,"ATGATAA","CTGG","CTGATGT","CTGA",2.63709911672729,29,5,8,51,1.97067132949739,4.88783302691982,7.72344379296537,101,"ENSG00000079974.19"
"9446","ENSG00000124749.17_212566",212558,212566,9,"ENSG00000124749.17",1,2,"VMVVVVUVV",1,7,0.770186335403727,51,57,68,71,78,84,133,136,"GTTATGA","CTGT","GTGACAG","CTGA",2.48893468981509,11,7,49,76,1.9778445971578,4.6426856323146,7.72343097392951,101,"ENSG00000079974.19"
"22751","ENSG00000171316.14_78916",78908,78916,9,"ENSG00000171316.14",1,1,"MVVUVVVVV",1,7,0.786749482401656,101,107,133,136,184,190,202,205,"GGGATGA","GTGA","AAGATGA","CTGA",2.58184268640878,26,48,12,95,1.09305775325626,4.5763355823287,7.72333351193532,101,"ENSG00000079974.19"
"44049","ENSG00000277199.1_3566",3558,3566,9,"ENSG00000277199.1",1,1,"MVVVVVUVV",1,7,0.792132505175983,107,113,133,136,174,180,192,195,"ATGATGA","ACGA","ATGATGA","ATGA",2.51389715244925,20,38,12,79,1.45948071534437,4.55469876625151,7.72322878695544,101,"ENSG00000079974.19"
"3383","ENSG00000083067.25_862172",862164,862172,9,"ENSG00000083067.25",1,2,"VMVVVVUVV",1,7,0.770186335403727,92,98,133,136,147,153,172,175,"AAGATGA","CAGA","ATAATCA","CTGA",2.57263239661428,35,11,19,74,1.41901683933452,4.64247487085743,7.72322021247234,101,"ENSG00000079974.19"
"23634","ENSG00000173418.12_2629",2621,2629,9,"ENSG00000173418.12",1,2,"VMVVVUVVV",1,7,0.806211180124223,106,112,133,136,153,159,168,171,"TTGATTA","CTGA","ATGATGC","TTGA",2.42353636669864,21,17,9,56,1.83655757366134,4.4983666712464,7.72321139174329,101,"ENSG00000079974.19"
"20748","ENSG00000165521.16_150070",150062,150070,9,"ENSG00000165521.16",1,2,"VMVVUUVVV",2,6,0.696066252587992,66,72,87,90,111,117,133,136,"GTGATGA","CTGC","ATGTTGC","CTGA",2.67741322463664,15,21,16,61,1.90635845431256,4.93894498797254,7.7232099983245,101,"ENSG00000079974.19"
"36350","ENSG00000240086.7_64251",64243,64251,9,"ENSG00000240086.7",0,NA,"UVVVVUVVV",2,7,0.824844720496894,100,106,133,136,150,156,165,168,"AAGATGA","AGGA","GACATGT","CTGA",2.39567555867496,27,14,9,59,1.72405416122039,4.4238061380967,7.72318502008428,101,"ENSG00000079974.19"
"4337","ENSG00000100227.19_6073",6065,6073,9,"ENSG00000100227.19",1,7,"VVVVVUMVV",1,7,0.807453416149068,70,76,92,95,108,114,133,136,"GTGATTA","CTGA","CTGTTCA","CTGG",2.37992362289954,16,13,19,57,2.10731587576855,4.49336834044137,7.72318200503765,101,"ENSG00000079974.19"
"47856","ENSG00000289517.1_18799",18791,18799,9,"ENSG00000289517.1",1,7,"VVVVVUMVV",1,7,0.807453416149068,70,76,92,95,108,114,133,136,"GTGATTA","CTGA","CTGTTCA","CTGG",2.37992362289954,16,13,19,57,2.10731587576855,4.49336834044137,7.72318200503765,101,"ENSG00000079974.19"
"6476","ENSG00000110079.19_48617",48609,48617,9,"ENSG00000110079.19",1,2,"UMVVVVVVV",1,7,0.786749482401656,79,85,93,96,108,114,133,136,"CTGATGA","CTTA","TTGATGC","TTGA",2.43459617485125,8,12,19,48,2.07409410358573,4.57618381731518,7.72318174692181,101,"ENSG00000079974.19"
"41004","ENSG00000258312.1_34327",34319,34327,9,"ENSG00000258312.1",1,5,"VVUVMVVVV",1,7,0.770186335403727,53,59,68,71,87,93,133,136,"ATAATTA","CTGA","GTGGGGA","CTGA",2.5836553958687,9,16,40,74,1.34537494199305,4.64243606194609,7.723181403561,101,"ENSG00000079974.19"
"8624","ENSG00000119900.9_6898",6890,6898,9,"ENSG00000119900.9",1,5,"VVVVMUVVV",1,7,0.808695652173913,45,51,60,63,73,79,133,136,"ATGAGGA","CTGG","GTGAAGA","CTTA",2.43270032775281,9,10,54,82,1.73538715656385,4.48834733539564,7.7231299440913,101,"ENSG00000079974.19"
"34663","ENSG00000233723.11_461649",461641,461649,9,"ENSG00000233723.11",1,6,"UVVVVMVVV",1,7,0.805383022774327,77,83,96,99,109,115,133,136,"ATGTTGA","ATGA","TTGTTCA","CTTA",2.32133996055821,13,10,18,50,2.53065735172939,4.50156427219602,7.72309636329333,101,"ENSG00000079974.19"
"37358","ENSG00000247699.2_5963",5955,5963,9,"ENSG00000247699.2",1,7,"UVVVVVMVV",1,7,0.787991718426501,115,121,133,136,147,153,208,211,"AAGATAA","CTGT","AGGATGA","CTGA",2.46728159706108,12,11,55,87,1.83596711478872,4.57112777379898,7.72309464750498,101,"ENSG00000079974.19"
"28758","ENSG00000196455.8_53926",53918,53926,9,"ENSG00000196455.8",1,3,"UVMVVVVVV",1,7,0.785507246376811,84,90,98,101,111,117,133,136,"ATGCTGA","CTGG","ATGGTGA","GTGA",2.38858971677006,8,10,16,43,2.40024687182319,4.58104457923924,7.72307356474649,101,"ENSG00000079974.19"
"22394","ENSG00000170464.10_21893",21885,21893,9,"ENSG00000170464.10",1,2,"VMVVVUVVV",1,7,0.806211180124223,84,90,133,136,170,176,189,192,"TTGCTGA","CCGA","GTGCTGA","CTGA",2.55733780165445,43,34,13,99,0.943794096817676,4.4981781936285,7.7230229141254,101,"ENSG00000079974.19"
"18678","ENSG00000158089.15_29421",29413,29421,9,"ENSG00000158089.15",1,7,"VVVVVUMVV",1,7,0.807453416149068,113,119,133,136,166,172,181,184,"GTGCTGA","ATCA","GTAATTA","CTGA",2.39388417476549,14,30,9,62,2.0135576275009,4.4931963648177,7.72301002941398,101,"ENSG00000079974.19"
"28071","ENSG00000188107.15_167045",167037,167045,9,"ENSG00000188107.15",1,8,"VVVVVUVMV",1,7,0.806211180124224,110,116,133,136,138,144,159,162,"ATGATGG","TTGA","CTGGGGA","CTAA",2.38243746715139,17,2,15,43,2.10970862370361,4.49815626784489,7.72300098834178,101,"ENSG00000079974.19"
"30570","ENSG00000205822.11_139561",139553,139561,9,"ENSG00000205822.11",1,3,"VVMUVVVVV",1,7,0.763561076604555,94,100,133,136,138,144,158,161,"ATGATGA","CTTT","GTGAAAT","CTGA",2.58922946334946,33,2,14,58,1.41347541511196,4.66875129269375,7.72299559911197,101,"ENSG00000079974.19"
"11064","ENSG00000133805.16_191333",191325,191333,9,"ENSG00000133805.16",1,3,"VVMUVVVVV",1,7,0.763561076604555,114,120,133,136,144,150,196,199,"CTGACGT","TTGA","TTGATGA","CTGA",2.50301454264532,13,8,46,76,1.98818609070155,4.66873742708426,7.72298173350248,101,"ENSG00000079974.19"
"42225","ENSG00000261190.5_39710",39702,39710,9,"ENSG00000261190.5",1,2,"VMVVVUVVV",1,7,0.806211180124223,63,69,84,87,107,113,133,136,"ATTGTGA","CTGC","GTGATTG","CTGA",2.44321465371215,15,20,20,64,1.70388423872738,4.49799548253543,7.72284020303232,101,"ENSG00000079974.19"
"41166","ENSG00000258629.1_932",924,932,9,"ENSG00000258629.1",1,8,"VVVVUUVMV",2,6,0.696066252587992,107,113,133,136,182,188,197,200,"GTGATGA","CTGT","CTGAGGA","CTGA",2.73947559990302,20,46,9,84,1.49110693759466,4.9385694009037,7.72283441125566,101,"ENSG00000079974.19"
"1852","ENSG00000066651.20_174031",174023,174031,9,"ENSG00000066651.20",1,1,"MVVVUVVVV",1,7,0.795859213250517,106,112,133,136,149,155,163,166,"GAGATGA","CAGC","AGGAAGA","CTGA",2.41094089152119,21,13,8,51,2.08458244839738,4.53938043130133,7.7228172843034,101,"ENSG00000079974.19"
"30115","ENSG00000203721.8_47195",47187,47195,9,"ENSG00000203721.8",1,6,"UVVVVMVVV",1,7,0.805383022774327,88,94,133,136,178,184,200,203,"ATGAGGA","GTGA","TTGAGCA","CTGA",2.58592380086833,39,42,16,106,0.765607771564854,4.50127494433844,7.72280703543575,101,"ENSG00000079974.19"
"20885","ENSG00000165966.16_270310",270302,270310,9,"ENSG00000165966.16",0,NA,"VVVUUVVVV",2,7,0.770600414078675,115,121,133,136,155,161,169,172,"CAGATGA","TTGC","TTGAGGA","CTGA",2.43847644978592,12,19,8,48,2.30488947430928,4.64034978488719,7.72275144120189,101,"ENSG00000079974.19"
"70","ENSG00000003987.14_113809",113801,113809,9,"ENSG00000003987.14",1,8,"UVVVVVVMV",1,7,0.786749482401656,114,120,133,136,141,147,156,159,"ATGAAAA","CCCA","TTGATTT","CTGA",2.29120967360567,13,5,9,36,3.02827255804952,4.57575092885517,7.72274885846179,101,"ENSG00000079974.19"
"25981","ENSG00000183117.20_1917112",1917104,1917112,9,"ENSG00000183117.20",1,3,"VVMVVVUVV",1,7,0.768944099378882,114,120,133,136,143,149,162,165,"GTAAAGA","CTGT","TTTAAGA","CTGA",2.34833561773666,13,7,13,42,2.93215203790703,4.64693070570453,7.72270710322005,101,"ENSG00000079974.19"
"40214","ENSG00000255248.11_463352",463344,463352,9,"ENSG00000255248.11",1,8,"VVVVVUVMV",1,7,0.806211180124224,114,120,133,136,143,149,166,169,"GTGTTTA","GTGA","ATAGTGT","CTGA",2.29409431480146,13,7,17,46,2.69734627205426,4.49782709268267,7.72267181317956,101,"ENSG00000079974.19"
"45114","ENSG00000285051.2_139074",139066,139074,9,"ENSG00000285051.2",0,NA,"UVUVVVVVV",2,7,0.786335403726708,87,93,133,136,139,145,153,156,"GTGATGT","AAGA","ATGAATA","CTGA",2.49403212337331,40,3,8,60,1.68241684717531,4.57732441741601,7.72266603232284,101,"ENSG00000079974.19"
"45197","ENSG00000285218.1_168845",168837,168845,9,"ENSG00000285218.1",0,NA,"UVUVVVVVV",2,7,0.786335403726708,87,93,133,136,139,145,153,156,"GTGATGT","AAGA","ATGAATA","CTGA",2.49403212337331,40,3,8,60,1.68241684717531,4.57732441741601,7.72266603232284,101,"ENSG00000079974.19"
"7121","ENSG00000112902.12_169731",169723,169731,9,"ENSG00000112902.12",1,5,"VVVVMVUVV",1,7,0.772670807453416,26,32,46,49,71,77,133,136,"AGGATGA","CTGC","GTGTTTA","CTGA",2.60398475470588,14,22,56,101,1.16802259556725,4.63198024006827,7.72266346988193,101,"ENSG00000079974.19"
"14793","ENSG00000145919.11_2224",2216,2224,9,"ENSG00000145919.11",1,3,"UVMVVVVVV",1,7,0.785507246376811,88,94,133,136,142,148,168,171,"CTGATAA","ATGA","CTCATGA","CTGA",2.52296714412346,39,6,20,74,1.50229187735699,4.58051820954502,7.72254719505226,101,"ENSG00000079974.19"
"45966","ENSG00000286084.3_117201",117193,117201,9,"ENSG00000286084.3",1,6,"UVVVVMVVV",1,7,0.805383022774327,110,116,133,136,146,152,172,175,"GTGAGGA","AGGA","GTGGTTG","CTGA",2.37510786236186,17,10,20,56,2.16961579642561,4.50091705304283,7.72244914414014,101,"ENSG00000079974.19"
"31046","ENSG00000215386.15_112986",112978,112986,9,"ENSG00000215386.15",1,2,"VMVVUUVVV",2,6,0.696066252587992,112,118,133,136,146,152,199,202,"ATGAAGA","CTGA","TTGTTGG","CTGA",2.69103752217284,15,10,47,81,1.81248115938145,4.9381828268001,7.72244783715207,101,"ENSG00000079974.19"
"27111","ENSG00000185565.12_5221",5213,5221,9,"ENSG00000185565.12",0,NA,"VVVUVUVVV",2,7,0.802898550724638,108,114,133,136,142,148,159,162,"AAGAAGA","AGGA","CTGATCT","CTGA",2.32362186463159,19,6,11,45,2.55244338173121,4.51081395315212,7.72240815605067,101,"ENSG00000079974.19"
"17383","ENSG00000154001.14_78255",78247,78255,9,"ENSG00000154001.14",0,NA,"VVVVVUUVV",2,7,0.808281573498965,109,115,133,136,148,154,170,173,"ATGATGA","CTTT","ATGATTT","CTCA",2.36483877802127,18,12,16,55,2.19076444481377,4.48908907457223,7.72221536856809,101,"ENSG00000079974.19"
"19057","ENSG00000160633.13_13139",13131,13139,9,"ENSG00000160633.13",1,2,"VMVVVUUVV",2,6,0.692339544513457,111,117,133,136,143,149,166,169,"GTGGTCA","CTGA","TTGATGA","CTGA",2.59120876566404,16,7,17,49,2.53670137874385,4.9528566207927,7.72221479884653,101,"ENSG00000079974.19"
"43847","ENSG00000274386.6_16585",16577,16585,9,"ENSG00000274386.6",1,2,"UMVVVVVVV",1,7,0.786749482401656,112,118,133,136,141,147,156,159,"ATGATGA","TTAA","ATTAAAA","TTGA",2.31017034293591,15,5,9,38,2.89939127144395,4.57513172275417,7.72212965236079,101,"ENSG00000079974.19"
"5186","ENSG00000103657.14_219654",219646,219654,9,"ENSG00000103657.14",1,8,"VVVVVUVMV",1,7,0.806211180124224,92,98,133,136,177,183,194,197,"GTGAGGT","CTGA","ATGGTGT","CTGA",2.54828732667035,35,41,11,96,1.00050064768758,4.49727070637249,7.72211542686938,101,"ENSG00000079974.19"
"35931","ENSG00000237499.7_2981",2973,2981,9,"ENSG00000237499.7",1,1,"MVVUVVVVV",1,7,0.786749482401656,104,110,133,136,142,148,180,183,"GTCATGA","GTGA","CTGAGGG","CTGA",2.54297434779847,23,6,32,70,1.34719071759001,4.57508825906162,7.72208618866824,101,"ENSG00000079974.19"
"2196","ENSG00000071205.12_277401",277393,277401,9,"ENSG00000071205.12",1,6,"UVVVVMVVV",1,7,0.805383022774327,114,120,133,136,142,148,158,161,"TTTATAA","TTGA","AAAATGT","CTGA",2.2444326986277,13,6,10,38,3.03922922923171,4.50052847168743,7.72206056278474,101,"ENSG00000079974.19"
"40478","ENSG00000256538.2_20183",20175,20183,9,"ENSG00000256538.2",1,7,"UVVVVVMVV",1,7,0.787991718426501,113,119,133,136,163,169,183,186,"ATGTTAA","CTGC","GTGAATA","CTGA",2.45362188301273,14,27,14,64,1.92283899595364,4.57007955400962,7.72204642771563,101,"ENSG00000079974.19"
"26017","ENSG00000183166.11_165361",165353,165361,9,"ENSG00000183166.11",1,2,"UMVVVVVVV",1,7,0.786749482401656,114,120,133,136,179,185,199,202,"ATTATGA","GTGT","AGGAAGA","CTGA",2.46434921862025,13,43,14,79,1.87096871632241,4.57499087678103,7.72198880638765,101,"ENSG00000079974.19"
"2357","ENSG00000073754.6_24781",24773,24781,9,"ENSG00000073754.6",1,1,"MVVUVVVVV",1,7,0.786749482401656,115,121,133,136,142,148,164,167,"GTGCTGA","TTAA","AGGTTGT","CTGA",2.33174516231749,12,6,16,43,2.75487448034325,4.57496055728164,7.72195848688826,101,"ENSG00000079974.19"
"7295","ENSG00000113448.20_722130",722122,722130,9,"ENSG00000113448.20",1,7,"UVVVVVMVV",1,7,0.787991718426501,113,119,133,136,147,153,163,166,"GTGAGGG","CTGC","ATTTTGC","CTGA",2.32084201643126,14,11,10,44,2.80766372855501,4.56998595952418,7.72195283323018,101,"ENSG00000079974.19"
"3701","ENSG00000088305.19_41784",41776,41784,9,"ENSG00000088305.19",1,8,"VVVUVVVMV",1,7,0.764803312629399,116,122,133,136,137,143,151,154,"ATGAGGT","GTGA","GACCTGA","CTGA",2.38941131493498,11,1,8,29,2.72142089428563,4.6627074151297,7.7219206656473,101,"ENSG00000079974.19"
"21664","ENSG00000168702.18_1214043",1214035,1214043,9,"ENSG00000168702.18",1,3,"VVMVVUVVV",1,7,0.804968944099379,107,113,133,136,147,153,161,164,"ATGATAT","TTGC","GTCATTA","CTGA",2.35509970456858,20,11,8,48,2.30744757675667,4.50202806847013,7.72190384486765,101,"ENSG00000079974.19"
"35145","ENSG00000235119.1_1713",1705,1713,9,"ENSG00000235119.1",1,1,"MVVVUVVVV",1,7,0.795859213250517,75,81,92,95,105,111,133,136,"TTTATGT","CTGG","ATGATCT","CTGA",2.38092678128316,11,10,22,52,2.28089419667938,4.53843485130845,7.72187170431052,101,"ENSG00000079974.19"
"47950","ENSG00000289744.1_18382",18374,18382,9,"ENSG00000289744.1",1,8,"VVVVVVUMV",1,7,0.770186335403727,67,73,90,93,100,106,133,136,"ATTATGT","TTGA","GAGATGC","CTGA",2.4908895140352,17,7,27,60,1.95853088288285,4.64111524411272,7.72186058572762,101,"ENSG00000079974.19"
"47952","ENSG00000289745.1_18389",18381,18389,9,"ENSG00000289745.1",1,8,"VVVVVVUMV",1,7,0.770186335403727,67,73,90,93,100,106,133,136,"ATTATGT","TTGA","GAGATGC","CTGA",2.4908895140352,17,7,27,60,1.95853088288285,4.64111524411272,7.72186058572762,101,"ENSG00000079974.19"
"2489","ENSG00000075234.17_25758",25750,25758,9,"ENSG00000075234.17",1,5,"VVVVMVUVV",1,7,0.772670807453416,110,116,133,136,185,191,200,203,"GTGATGT","TGGA","CTGCTGA","CTGA",2.51545776522292,17,49,9,84,1.75469812507454,4.6311041399735,7.72178736978716,101,"ENSG00000079974.19"
"40032","ENSG00000254734.1_134126",134118,134126,9,"ENSG00000254734.1",1,2,"VMVVVUVVV",1,7,0.806211180124223,89,95,106,109,111,117,133,136,"ATAATTA","TAGA","ATGATCT","CTGA",2.35040035578481,11,2,16,38,2.31838895853372,4.49693116594145,7.72177588643834,101,"ENSG00000079974.19"
"28991","ENSG00000196876.19_69295",69287,69295,9,"ENSG00000196876.19",1,3,"VVMVVUVVV",1,7,0.804968944099379,108,114,133,136,143,149,166,169,"ATGATGC","TTGA","GTGAAAT","CTGT",2.35993000893579,19,7,17,52,2.27472923503579,4.5018989903186,7.72177476671611,101,"ENSG00000079974.19"
"10128","ENSG00000129515.20_60426",60418,60426,9,"ENSG00000129515.20",1,1,"MVVVVUVVV",1,7,0.82815734989648,76,82,89,92,105,111,133,136,"CTGATGA","GTGA","GTGAAAT","GTGA",2.38838184020997,7,13,22,51,1.71397164657103,4.40912931199272,7.72175871157864,101,"ENSG00000079974.19"
"4349","ENSG00000100266.19_7464",7456,7464,9,"ENSG00000100266.19",1,6,"UVVVVMVVV",1,7,0.805383022774327,116,122,133,136,141,147,156,159,"GTAGTGT","CTGC","CAGAGGA","CTGA",2.23937589081375,11,5,9,34,3.07159814051807,4.50019268648578,7.72172477758308,101,"ENSG00000079974.19"
"19425","ENSG00000162946.23_86859",86851,86859,9,"ENSG00000162946.23",1,1,"MVVUVVVVV",1,7,0.786749482401656,60,66,98,101,110,116,133,136,"TTGAAGA","CAGA","GTAACGA","CTGA",2.49409105975872,32,9,17,67,1.67158225105343,4.57471399569456,7.72171192530119,101,"ENSG00000079974.19"
"43216","ENSG00000270106.6_184996",184988,184996,9,"ENSG00000270106.6",1,1,"MVVUVVVVV",1,7,0.786749482401656,60,66,98,101,110,116,133,136,"TTGAAGA","CAGA","GTAACGA","CTGA",2.49409105975872,32,9,17,67,1.67158225105343,4.57471399569456,7.72171192530119,101,"ENSG00000079974.19"
"4440","ENSG00000100596.8_61889",61881,61889,9,"ENSG00000100596.8",1,2,"VMVVUVVVV",1,7,0.773913043478261,114,120,133,136,147,153,177,180,"TTGATGC","GTGG","ATGGTGA","CTGA",2.45395129215932,13,11,24,57,2.1445220835538,4.62604934115398,7.72170151506702,101,"ENSG00000079974.19"
"27499","ENSG00000186314.12_78036",78028,78036,9,"ENSG00000186314.12",1,6,"UVVVVMVVV",1,7,0.805383022774327,105,111,133,136,146,152,173,176,"TTGATCA","CTTA","AAGCTGA","CTGA",2.44576078471139,22,10,21,62,1.69551880872708,4.50014767670075,7.72167976779806,101,"ENSG00000079974.19"
"24711","ENSG00000177679.16_82024",82016,82024,9,"ENSG00000177679.16",1,8,"UVVVVVVMV",1,7,0.786749482401656,51,57,79,82,88,94,133,136,"ATTATGG","CTGA","TAGATTA","CTGA",2.54292203503786,22,6,39,76,1.34575902320692,4.5746431475315,7.72164107713812,101,"ENSG00000079974.19"
"1590","ENSG00000062716.13_30150",30142,30150,9,"ENSG00000062716.13",1,8,"VVVUVVVMV",1,7,0.764803312629399,111,117,133,136,180,186,196,199,"ATGATGT","CAGC","CTGAGAA","CTGA",2.52128774154694,16,44,10,79,1.84110219628912,4.66242178498385,7.72163503550144,101,"ENSG00000079974.19"
"22752","ENSG00000171316.14_80288",80280,80288,9,"ENSG00000171316.14",1,1,"MVVVVVUVV",1,7,0.792132505175983,103,109,133,136,150,156,164,167,"CTGATGT","CAGC","ATTATGA","CTGA",2.45867181095509,24,14,8,55,1.82099743135892,4.55303570943155,7.72156573013548,101,"ENSG00000079974.19"
"32137","ENSG00000226070.2_26430",26422,26430,9,"ENSG00000226070.2",1,2,"VMVVVUVVV",1,7,0.806211180124223,70,76,90,93,107,113,133,136,"ATGATGT","CAGA","CTGATTC","CAGA",2.38256104076024,14,14,20,57,2.10309024369348,4.4967076288571,7.721552349354,101,"ENSG00000079974.19"
"18319","ENSG00000157064.11_59707",59699,59707,9,"ENSG00000157064.11",1,8,"UVVVVVVMV",1,7,0.786749482401656,113,119,133,136,160,166,185,188,"ATGATGA","ATGA","CTGATAG","CTGG",2.4918241340527,14,24,19,66,1.68586078270684,4.57450541909788,7.7215033487045,101,"ENSG00000079974.19"
"3874","ENSG00000089916.18_46053",46045,46053,9,"ENSG00000089916.18",0,NA,"UVVVVUVVV",2,7,0.824844720496894,55,61,75,78,82,88,133,136,"GTGATGA","CTTA","ATGCAGC","TTGA",2.38191093624285,14,4,45,72,1.80899131038394,4.42209938800073,7.7214782699883,101,"ENSG00000079974.19"
"17526","ENSG00000154310.17_190713",190705,190713,9,"ENSG00000154310.17",0,NA,"VVVVUUVVV",2,7,0.812008281573499,84,90,103,106,111,117,133,136,"ATAATCT","CTGT","GTGGTCT","CTGA",2.27935959778587,13,5,16,43,2.69799301074586,4.47343091566291,7.72146404195691,101,"ENSG00000079974.19"
"46753","ENSG00000287144.1_47658",47650,47658,9,"ENSG00000287144.1",1,7,"VVVVVUMVV",1,7,0.807453416149068,116,122,133,136,138,144,158,161,"ATAATGT","GTGC","GTGTTTG","CTGA",2.32388438479086,11,2,14,36,2.47395934281073,4.49163047702079,7.72144414161706,101,"ENSG00000079974.19"
"11726","ENSG00000135914.6_13916",13908,13916,9,"ENSG00000135914.6",1,2,"UMVVVUVVV",2,6,0.708902691511387,115,121,133,136,147,153,171,174,"GGGATGA","CTGG","GTGGAGA","CTGA",2.56067761097665,12,11,18,50,2.47207586012226,4.88581498332498,7.72142574937053,101,"ENSG00000079974.19"
"43754","ENSG00000273415.3_12626",12618,12626,9,"ENSG00000273415.3",1,2,"VMVVVVUVV",1,7,0.770186335403727,114,120,133,136,148,154,173,176,"CTGATGG","CAGC","GTGACGC","CTGA",2.43386683660883,13,12,19,53,2.33691292363537,4.64067295859023,7.72141830020514,101,"ENSG00000079974.19"
"15120","ENSG00000147099.21_217429",217421,217429,9,"ENSG00000147099.21",1,8,"VVVUVVVMV",1,7,0.764803312629399,115,121,133,136,140,146,165,168,"ATGAACA","TTGA","GGGCTGA","CTGA",2.43402689983314,12,4,19,44,2.42189389354475,4.66218497310809,7.72139822362568,101,"ENSG00000079974.19"
"45399","ENSG00000285547.1_217171",217163,217171,9,"ENSG00000285547.1",1,8,"VVVUVVVMV",1,7,0.764803312629399,115,121,133,136,140,146,165,168,"ATGAACA","TTGA","GGGCTGA","CTGA",2.43402689983314,12,4,19,44,2.42189389354475,4.66218497310809,7.72139822362568,101,"ENSG00000079974.19"
"8417","ENSG00000118762.8_56845",56837,56845,9,"ENSG00000118762.8",1,2,"VMVUVVVVV",1,7,0.764803312629399,110,116,133,136,140,146,156,159,"TTGATTA","CAGA","ATTGTAA","CTGA",2.4034303567127,17,4,10,40,2.6258528981385,4.66218048572246,7.72139373624006,101,"ENSG00000079974.19"
"12813","ENSG00000139155.9_13431",13423,13431,9,"ENSG00000139155.9",1,1,"MVUVVVVVV",1,7,0.789648033126294,113,119,133,136,143,149,158,161,"ATGCTGA","ATGA","ATGTCAA","CTCA",2.2865789836384,14,7,9,39,3.0073188496743,4.56279468514924,7.72138681765442,101,"ENSG00000079974.19"
"17985","ENSG00000155974.14_191113",191105,191113,9,"ENSG00000155974.14",0,NA,"UVVUVVVVV",2,7,0.78343685300207,85,91,133,136,141,147,159,162,"GTGAGAA","CTGA","TTGCTTA","CTGA",2.46904861813119,42,5,12,68,1.89018260891363,4.58762668244705,7.72137409445533,101,"ENSG00000079974.19"
"19318","ENSG00000162733.19_15806",15798,15806,9,"ENSG00000162733.19",0,NA,"UVVVVUVVV",2,7,0.824844720496894,109,115,133,136,144,150,168,171,"CCGATGA","CAAA","ATAAAAA","CTGA",2.30980169049347,18,8,18,53,2.28921018425498,4.42197203021953,7.72135091220711,101,"ENSG00000079974.19"
"9202","ENSG00000123106.11_209611",209603,209611,9,"ENSG00000123106.11",1,1,"MVVUVVVVV",1,7,0.786749482401656,115,121,133,136,158,164,179,182,"AGAATGG","TTGA","GTGAAGA","CTGA",2.44149533333368,12,22,15,58,2.02075550430165,4.57434776496488,7.72134569457151,101,"ENSG00000079974.19"
"24903","ENSG00000178568.15_621657",621649,621657,9,"ENSG00000178568.15",1,6,"VVVVUMVVV",1,7,0.792546583850932,103,109,133,136,173,179,190,193,"AGGATGA","CTCA","CTTATGG","CTGA",2.54808400884111,24,37,11,81,1.21727514522707,4.55112546770862,7.72131180311235,101,"ENSG00000079974.19"
"15921","ENSG00000150275.20_431862",431854,431862,9,"ENSG00000150275.20",1,6,"UVVVVMVVV",1,7,0.805383022774327,106,112,133,136,143,149,158,161,"AGAATGA","ATTA","GTAAGGA","CTGA",2.33797103618002,21,7,9,46,2.41253869010613,4.4997530661599,7.72128515725721,101,"ENSG00000079974.19"
"16966","ENSG00000152894.15_313468",313460,313468,9,"ENSG00000152894.15",0,NA,"UVVVUVVVV",2,7,0.792546583850932,105,111,133,136,143,149,159,162,"ATGATGG","ATAA","ATGATGA","CTCA",2.37982387499227,22,7,10,48,2.33883305100123,4.55108138773743,7.72126772314116,101,"ENSG00000079974.19"
"4652","ENSG00000101464.11_102136",102128,102136,9,"ENSG00000101464.11",1,3,"VVMVVUVVV",1,7,0.804968944099379,73,79,99,102,112,118,133,136,"ATGAAGA","CTGA","ATACTGG","CTAA",2.36994075576358,20,10,15,54,2.20575139360382,4.50133910800692,7.72121488440443,101,"ENSG00000079974.19"
"21023","ENSG00000166262.16_127855",127847,127855,9,"ENSG00000166262.16",1,1,"MVVVUVVVV",1,7,0.795859213250517,92,98,109,112,115,121,133,136,"GTGAGGA","CTGA","GACATTA","TTGA",2.307812602179,11,3,12,35,2.76538674811928,4.53770102399482,7.72113787699689,101,"ENSG00000079974.19"
"41215","ENSG00000258700.6_308180",308172,308180,9,"ENSG00000258700.6",1,8,"UVVVVVVMV",1,7,0.786749482401656,115,121,133,136,148,154,172,175,"GTTATGA","ATAA","ATCCTGA","CTGA",2.38409872509568,12,12,18,51,2.40254296278273,4.57413361585515,7.72113154546177,101,"ENSG00000079974.19"
"1959","ENSG00000068305.19_138017",138009,138017,9,"ENSG00000068305.19",0,NA,"UVVVVUVVV",2,7,0.824844720496894,81,87,102,105,112,118,133,136,"TTGGTGA","TTGA","TTGAAAA","CTAA",2.24340569322856,15,7,15,46,2.73068460625846,4.42168064027889,7.72105952226646,101,"ENSG00000079974.19"
"26671","ENSG00000184838.15_189302",189294,189302,9,"ENSG00000184838.15",1,7,"VVVUVVMVV",1,7,0.766045548654244,79,85,99,102,111,117,133,136,"ATAAAGA","CAGA","GGGATAT","CTGA",2.39289855417975,14,9,16,48,2.67484456445411,4.65687539807978,7.72105759269675,101,"ENSG00000079974.19"
"25760","ENSG00000182674.6_250843",250835,250843,9,"ENSG00000182674.6",1,1,"MVVUVVVVV",1,7,0.786749482401656,90,96,133,136,152,158,178,181,"ATGATGA","TTAA","TTAAGGA","CTGA",2.59301903984711,37,16,20,82,1.0093654273903,4.57403975659275,7.72103768619938,101,"ENSG00000079974.19"
"43619","ENSG00000272886.6_12530",12522,12530,9,"ENSG00000272886.6",1,7,"VVUVVVMVV",1,7,0.768944099378882,113,119,133,136,167,173,193,196,"CTGATGA","GAGA","GTGTTTA","CTGA",2.55873191130512,14,31,20,74,1.52277779182729,4.64524763346535,7.72102403098088,101,"ENSG00000079974.19"
"38132","ENSG00000249638.1_468",460,468,9,"ENSG00000249638.1",1,1,"MVVVVUVVV",1,7,0.82815734989648,114,120,133,136,141,147,180,183,"ATAATAG","ATGA","GTGGTGC","CTGA",2.34458811009649,13,5,33,60,2.00297512683157,4.40839063186872,7.72102003145464,101,"ENSG00000079974.19"
"19006","ENSG00000160179.19_46224",46216,46224,9,"ENSG00000160179.19",1,8,"UVVVVUVMV",2,6,0.708902691511387,58,64,88,91,97,103,133,136,"CTGATGA","CAGA","ATGAGGA","CTGA",2.73198003818669,24,6,30,69,1.32842298999159,4.88540581114238,7.72101657718793,101,"ENSG00000079974.19"
"18086","ENSG00000156110.15_541826",541818,541826,9,"ENSG00000156110.15",0,NA,"VVVUVUVVV",2,7,0.802898550724638,112,118,133,136,139,145,157,160,"GGGATGA","CTGA","ATTTTTA","CTGT",2.31366948124402,15,3,12,39,2.61321897172966,4.50942054500579,7.72101474790434,101,"ENSG00000079974.19"
"7267","ENSG00000113448.20_1135191",1135183,1135191,9,"ENSG00000113448.20",1,8,"VVVVVUVMV",1,7,0.806211180124224,86,92,105,108,113,119,133,136,"ATGATTA","CAGG","TTGATGT","CTCA",2.27431079215536,13,5,14,41,2.82260799461697,4.49616998557985,7.72101470607674,101,"ENSG00000079974.19"
"40799","ENSG00000257703.6_75830",75822,75830,9,"ENSG00000257703.6",1,2,"VMUVVVVVV",1,7,0.767701863354037,44,50,93,96,114,120,133,136,"TTGATGG","CTGA","ATGAGCT","CTGA",2.59626173014934,43,18,13,83,1.29240374076912,4.65020381877452,7.72101127219067,101,"ENSG00000079974.19"
"45148","ENSG00000285108.1_19853",19845,19853,9,"ENSG00000285108.1",1,8,"VVVVVVUMV",1,7,0.770186335403727,69,75,95,98,109,115,133,136,"ATGATGG","TGGA","GTGGGGT","CTGA",2.48982220332015,20,11,18,58,1.96149797857975,4.64007816684519,7.7208235084601,101,"ENSG00000079974.19"
"45682","ENSG00000285784.1_249212",249204,249212,9,"ENSG00000285784.1",0,NA,"UVVVVUVVV",2,7,0.824844720496894,107,113,133,136,182,188,202,205,"ATGCTGA","CCCA","GTAATGG","CTGA",2.4482783402787,20,46,14,89,1.36385954053417,4.42142878559804,7.72080766758562,101,"ENSG00000079974.19"
"3976","ENSG00000091490.11_33507",33499,33507,9,"ENSG00000091490.11",1,2,"VMUVVVVVV",1,7,0.767701863354037,115,121,133,136,186,192,200,203,"CTGATCA","CTCC","GTGATGA","CTGA",2.49282006530746,12,50,8,79,1.98113500137151,4.64998385918865,7.7207913126048,101,"ENSG00000079974.19"
"36186","ENSG00000238198.2_32497",32489,32497,9,"ENSG00000238198.2",1,5,"VVVUMVVVV",1,7,0.767287784679089,116,122,133,136,142,148,165,168,"ATCATGT","TTAA","CTTATGA","CTGA",2.3906146572535,11,6,17,43,2.6686106490974,4.65151042436352,7.72066156307988,101,"ENSG00000079974.19"
"31474","ENSG00000223806.8_5083",5075,5083,9,"ENSG00000223806.8",1,5,"UVVVMVVVV",1,7,0.789233954451346,15,21,58,61,73,79,133,136,"ATGATGA","CTGA","GTCAAGA","TTGA",2.62255670849421,37,12,54,112,0.771152192908504,4.56371589571747,7.72065171352286,101,"ENSG00000079974.19"
"9921","ENSG00000128512.24_200247",200239,200247,9,"ENSG00000128512.24",1,5,"UVVVMVVVV",1,7,0.789233954451346,59,65,89,92,97,103,133,136,"GTGATGA","CTGA","TTGATAT","ATGA",2.54680066477658,24,5,30,68,1.27607225193841,4.56368583761224,7.72062165541762,101,"ENSG00000079974.19"
"34171","ENSG00000232023.3_95528",95520,95528,9,"ENSG00000232023.3",1,1,"MVVVVUVVV",1,7,0.82815734989648,87,93,133,136,184,190,200,203,"AAGATGA","TTAA","GTGATTG","CTGA",2.49436627849366,40,48,10,107,1.00284328598385,4.40798795231872,7.72061735190464,101,"ENSG00000079974.19"
"2218","ENSG00000071794.16_53080",53072,53080,9,"ENSG00000071794.16",1,3,"UVMVVVVVV",1,7,0.785507246376811,88,94,108,111,115,121,133,136,"ATGGTTT","TTGA","CTGATAG","CTGA",2.326463278078,14,4,12,39,2.80452374081856,4.57856973200131,7.72059871750856,101,"ENSG00000079974.19"
"40133","ENSG00000255079.1_1103",1095,1103,9,"ENSG00000255079.1",1,8,"VVVVUVVMV",1,7,0.773913043478261,108,114,133,136,148,154,163,166,"CTGATGG","CACA","GTGCTGG","CTGA",2.42357419885218,19,12,9,49,2.34251123797833,4.62491814091488,7.72057031482792,101,"ENSG00000079974.19"
"34950","ENSG00000234428.2_14971",14963,14971,9,"ENSG00000234428.2",1,3,"VVMVVVUVV",1,7,0.768944099378882,47,53,77,80,87,93,133,136,"ATGATTA","ATGA","ATGCTGT","CTGA",2.60106919642276,24,7,40,80,1.23850549476001,4.64474170106128,7.7205180985768,101,"ENSG00000079974.19"
"20055","ENSG00000164190.19_75676",75668,75676,9,"ENSG00000164190.19",1,2,"VMUVVVVVV",1,7,0.767701863354037,87,93,107,110,115,121,133,136,"TTGATGT","CTGA","TTTATAA","CTTA",2.35682925275815,14,5,12,40,2.88653824664236,4.64968331625751,7.72049076967366,101,"ENSG00000079974.19"
"17853","ENSG00000155530.4_27237",27229,27237,9,"ENSG00000155530.4",0,NA,"UVVVVUVVV",2,7,0.824844720496894,110,116,133,136,149,155,167,170,"CTGTTGT","CTCT","CTGATTA","CTGA",2.29150244095531,17,13,12,51,2.40768236343698,4.42109132578477,7.72047020777234,101,"ENSG00000079974.19"
"17142","ENSG00000153250.21_219708",219700,219708,9,"ENSG00000153250.21",1,3,"VVMVVUVVV",1,7,0.804968944099379,115,121,133,136,153,159,209,212,"CTAATGA","TTGA","ATTATGC","CTGA",2.48571704269301,12,17,50,88,1.430749991372,4.50054923566468,7.72042501206219,101,"ENSG00000079974.19"
"11667","ENSG00000135749.19_108194",108186,108194,9,"ENSG00000135749.19",1,5,"VVVVMUVVV",1,7,0.808695652173913,86,92,133,136,146,152,171,174,"TTGTTGA","CCGA","GGGATCA","CTGA",2.47020568011866,41,10,19,79,1.47450700454364,4.48563621800034,7.72041882669599,101,"ENSG00000079974.19"
"26880","ENSG00000185177.14_1216",1208,1216,9,"ENSG00000185177.14",1,2,"VMVVVUVVV",1,7,0.806211180124223,45,51,67,70,108,114,133,136,"ATTATGA","CTGA","GTGATTT","CAGA",2.48368326944875,16,38,19,82,1.42424552300074,4.4955334964981,7.720378216995,101,"ENSG00000079974.19"
"31640","ENSG00000224228.2_62012",62004,62012,9,"ENSG00000224228.2",1,8,"VVVUVVVMV",1,7,0.764803312629399,115,121,133,136,138,144,154,157,"CGGATGC","CTGT","ATGAGGC","CTGA",2.38660314381955,12,2,10,33,2.73361353275093,4.66107528955366,7.72028854007125,101,"ENSG00000079974.19"
"14122","ENSG00000144451.20_689904",689896,689904,9,"ENSG00000144451.20",1,3,"VVMVVUVVV",1,7,0.804968944099379,116,122,133,136,184,190,202,205,"GTGATGG","TTGA","GTGATTA","TTGA",2.41011409717894,11,48,12,80,1.93420428542241,4.50040789998717,7.72028367638468,101,"ENSG00000079974.19"
"31867","ENSG00000225096.3_217219",217211,217219,9,"ENSG00000225096.3",1,8,"VVVVUVVMV",1,7,0.773913043478261,84,90,133,136,146,152,162,165,"ATGATGG","GAGA","TAGAGGA","CTGA",2.48997970594167,43,10,10,72,1.8986537945665,4.62462962521108,7.72028179912413,101,"ENSG00000079974.19"
"47070","ENSG00000287598.1_143383",143375,143383,9,"ENSG00000287598.1",1,8,"VVVVUVVMV",1,7,0.773913043478261,84,90,133,136,146,152,162,165,"ATGATGG","GAGA","TAGAGGA","CTGA",2.48997970594167,43,10,10,72,1.8986537945665,4.62462962521108,7.72028179912413,101,"ENSG00000079974.19"
"36832","ENSG00000243193.4_672",664,672,9,"ENSG00000243193.4",0,NA,"VVUUVVVVV",2,7,0.764389233954451,47,53,96,99,107,113,133,136,"ATCATGA","CAGA","TTCAAGA","CTGA",2.57206555860478,43,8,20,80,1.50354142557726,4.66266128740228,7.72021822322009,101,"ENSG00000079974.19"
"35263","ENSG00000235495.1_31044",31036,31044,9,"ENSG00000235495.1",1,8,"VVVVVVUMV",1,7,0.770186335403727,90,96,133,136,144,150,182,185,"CTGATGA","GTGC","GTGAAGA","CTGA",2.62146182284995,37,8,32,86,1.08133760634201,4.63943743966876,7.72018278128366,101,"ENSG00000079974.19"
"1908","ENSG00000067606.17_92293",92285,92293,9,"ENSG00000067606.17",1,7,"VVVVVUMVV",1,7,0.807453416149068,66,72,85,88,115,121,133,136,"CTGATGT","CAGA","GTGACGA","ATGA",2.38802546731125,13,27,12,61,2.04125514965371,4.49035623293218,7.72016989752845,101,"ENSG00000079974.19"
"27496","ENSG00000186314.12_334834",334826,334834,9,"ENSG00000186314.12",1,8,"VVVVVUVMV",1,7,0.806211180124224,93,99,133,136,143,149,165,168,"CTGATGA","CTTT","GAGCTCA","CTGA",2.43159664086572,34,7,16,66,1.77062993538763,4.49531855195644,7.72016327245333,101,"ENSG00000079974.19"
"21296","ENSG00000166979.13_99659",99651,99659,9,"ENSG00000166979.13",1,2,"VMUVVVVVV",1,7,0.767701863354037,107,113,133,136,144,150,163,166,"GTGATTA","ATGT","GTGCTGG","CTGA",2.43007182335281,20,8,13,50,2.39688712076739,4.64934148577986,7.72014893919601,101,"ENSG00000079974.19"
"43255","ENSG00000270547.6_50053",50045,50053,9,"ENSG00000270547.6",1,8,"VVVVVUVMV",1,7,0.806211180124224,111,117,133,136,142,148,167,170,"AAGAAGA","GAGA","ATGGCGA","CTGA",2.33746571082447,16,6,19,50,2.39774590367333,4.49521266062578,7.72005738112267,101,"ENSG00000079974.19"
"30386","ENSG00000204767.4_7796",7788,7796,9,"ENSG00000204767.4",0,NA,"VVVUUVVVV",2,7,0.770600414078675,116,122,133,136,142,148,160,163,"ATTGTGT","ATGT","ATGATGA","CTGA",2.33606165007085,11,6,12,38,2.97649584985615,4.63756004591545,7.71996170223015,101,"ENSG00000079974.19"
"24978","ENSG00000178965.14_66954",66946,66954,9,"ENSG00000178965.14",1,8,"VVVUVVVMV",1,7,0.764803312629399,105,111,133,136,142,148,160,163,"TTGCCGA","CTGA","GAGAGGA","CTGA",2.45442139607851,22,6,12,49,2.28009067933204,4.66072499663052,7.71993824714812,101,"ENSG00000079974.19"
"45753","ENSG00000285876.1_147421",147413,147421,9,"ENSG00000285876.1",1,3,"VVMVVVUVV",1,7,0.768944099378882,108,114,133,136,148,154,208,211,"ATGATGG","TTTA","ATGAGGA","CTGA",2.5849463872663,19,12,54,94,1.34365278803566,4.64415717578608,7.71993357330161,101,"ENSG00000079974.19"
"45952","ENSG00000286069.2_81033",81025,81033,9,"ENSG00000286069.2",1,1,"MVVVVUVVV",1,7,0.82815734989648,47,53,70,73,106,112,133,136,"CTGTTGA","CTGT","GTGTAGG","CTGA",2.45770465729492,17,33,21,80,1.24450445402204,4.40730054233038,7.7199299419163,101,"ENSG00000079974.19"
"12757","ENSG00000138835.24_32929",32921,32929,9,"ENSG00000138835.24",1,8,"VVVUVVVMV",1,7,0.764803312629399,58,64,77,80,84,90,133,136,"ATGATGA","CTGT","GTGAGGG","CAGA",2.51974419188319,13,4,43,69,1.84452436195051,4.66070474362628,7.71991799414388,101,"ENSG00000079974.19"
"40411","ENSG00000255968.1_76665",76657,76665,9,"ENSG00000255968.1",1,8,"VVVVUVVMV",1,7,0.773913043478261,89,95,133,136,151,157,170,173,"ATGATGA","GTGC","GAGATAC","CTGA",2.55316559127964,38,15,13,75,1.47594900078514,4.62426323566235,7.71991540957539,101,"ENSG00000079974.19"
"25787","ENSG00000182752.10_176352",176344,176352,9,"ENSG00000182752.10",1,3,"VVMVVUVVV",1,7,0.804968944099379,47,53,78,81,116,122,133,136,"TTGAGGA","ATGA","CGGATGA","CTGA",2.52338944142076,25,35,11,80,1.17744954118954,4.50001145433199,7.7198872307295,101,"ENSG00000079974.19"
"19640","ENSG00000163539.18_217536",217528,217536,9,"ENSG00000163539.18",1,8,"VVVVVUVMV",1,7,0.806211180124224,77,83,97,100,108,114,133,136,"GTGAAGA","TTGA","CTTATGA","CTCA",2.31800479391711,14,8,19,50,2.52657795670927,4.4949858123725,7.7198305328694,101,"ENSG00000079974.19"
"6045","ENSG00000107829.15_46411",46403,46411,9,"ENSG00000107829.15",1,8,"VVVVVVUMV",1,7,0.770186335403727,104,110,133,136,180,186,198,201,"TTGATGA","CTGG","GGAATGA","CTGA",2.59825044757472,23,44,12,88,1.23433884566095,4.63900212403977,7.71974746565467,101,"ENSG00000079974.19"
"12381","ENSG00000138031.15_36243",36235,36243,9,"ENSG00000138031.15",1,8,"VVVVVUVMV",1,7,0.806211180124224,104,110,133,136,150,156,210,213,"AAGATGT","GTGA","ATGATGT","CTGA",2.56241432853432,23,14,54,100,0.896797922662053,4.49489002822271,7.71973474871961,101,"ENSG00000079974.19"
"3801","ENSG00000089101.19_55658",55650,55658,9,"ENSG00000089101.19",1,5,"VVVUMVVVV",1,7,0.767287784679089,113,119,133,136,143,149,162,165,"AAGAAGC","CTCA","CTGATGC","CTGA",2.35603589377121,14,7,13,43,2.89540137332488,4.6505768329499,7.71972797166626,101,"ENSG00000079974.19"
"27047","ENSG00000185483.13_110015",110007,110015,9,"ENSG00000185483.13",1,8,"VVVVVVUMV",1,7,0.770186335403727,109,115,133,136,162,168,178,181,"GTAATGA","GTGA","GTGGAGT","CTGA",2.51778671309249,18,26,10,63,1.77063893991317,4.63897092346577,7.71971626508068,101,"ENSG00000079974.19"
"42653","ENSG00000265491.5_18974",18966,18974,9,"ENSG00000265491.5",1,7,"VVVVUVMVV",1,7,0.775155279503105,63,69,81,84,109,115,133,136,"TTGATGG","TAGA","ATGAAGA","CTGA",2.50743236574113,12,25,18,64,1.76010215947368,4.6190794827703,7.71970060078273,101,"ENSG00000079974.19"
"20366","ENSG00000164741.15_82522",82514,82522,9,"ENSG00000164741.15",1,6,"UVVVVMVVV",1,7,0.805383022774327,50,56,66,69,75,81,133,136,"CTGATGC","CTGC","ACCAGGA","CTGA",2.41318594822473,10,6,52,77,1.90461342237396,4.49812993596804,7.71966202706535,101,"ENSG00000079974.19"
"23381","ENSG00000172869.15_83100",83092,83100,9,"ENSG00000172869.15",1,3,"UVMVVVVVV",1,7,0.785507246376811,92,98,133,136,140,146,156,159,"ATGTTAA","CTGA","AGGATAT","CTGA",2.46960681350016,35,4,10,58,1.84633331837641,4.57759468542771,7.71962367093495,101,"ENSG00000079974.19"
"33571","ENSG00000230417.12_257139",257131,257139,9,"ENSG00000230417.12",0,NA,"VVVVVUUVV",2,7,0.808281573498965,100,106,133,136,166,172,181,184,"CTGAGGA","ATGA","GTGCTGC","CTGA",2.51903891499455,27,30,9,75,1.15236595328094,4.48648967997781,7.71961597397367,101,"ENSG00000079974.19"
"44496","ENSG00000282863.1_257150",257142,257150,9,"ENSG00000282863.1",0,NA,"VVVVVUUVV",2,7,0.808281573498965,100,106,133,136,166,172,181,184,"CTGAGGA","ATGA","GTGCTGC","CTGA",2.51903891499455,27,30,9,75,1.15236595328094,4.48648967997781,7.71961597397367,101,"ENSG00000079974.19"
"2030","ENSG00000069188.17_8768",8760,8768,9,"ENSG00000069188.17",0,NA,"VVVVUUVVV",2,7,0.812008281573499,113,119,133,136,150,156,164,167,"TTGATGC","ATTA","GTGATGA","ATGA",2.29698452687356,14,14,8,45,2.57287265732546,4.47152570912063,7.71955883541463,101,"ENSG00000079974.19"
"2219","ENSG00000071909.19_130338",130330,130338,9,"ENSG00000071909.19",1,2,"VMVVVVUVV",1,7,0.770186335403727,81,87,96,99,106,112,133,136,"TTGATCA","CTGC","TTTATGT","CTGA",2.43814410592371,9,7,21,46,2.30067448591197,4.63874213135085,7.71948747296575,101,"ENSG00000079974.19"
"5428","ENSG00000104611.12_20875",20867,20875,9,"ENSG00000104611.12",1,7,"VVVVUVMVV",1,7,0.775155279503105,44,50,61,64,72,78,133,136,"AGGATGA","CTCA","GTGATGA","CTCA",2.47698724243185,11,8,55,83,1.96213836468618,4.61884666189129,7.71946777990371,101,"ENSG00000079974.19"
"16680","ENSG00000152061.24_610535",610527,610535,9,"ENSG00000152061.24",1,7,"UVVVVVMVV",1,7,0.787991718426501,106,112,133,136,146,152,171,174,"TTGATGT","CTTG","TTGAAGA","CTGA",2.45798119642809,21,10,19,59,1.8832701465512,4.56745286401794,7.71941973772395,101,"ENSG00000079974.19"
"1699","ENSG00000065413.20_94431",94423,94431,9,"ENSG00000065413.20",1,8,"UVVVVVVMV",1,7,0.786749482401656,89,95,133,136,141,147,156,159,"CTGATGC","CAGA","GTAGTTA","CTGA",2.45349657722043,38,5,9,61,1.93302835909224,4.57241805180712,7.71941598141374,101,"ENSG00000079974.19"
"36075","ENSG00000237844.2_386793",386785,386793,9,"ENSG00000237844.2",1,1,"MVVUVVVVV",1,7,0.786749482401656,109,115,133,136,146,152,207,210,"ATTAGAA","CTGA","TTGATGA","CTGA",2.50863995832459,18,10,55,92,1.56530124950938,4.572391909585,7.71938983919162,101,"ENSG00000079974.19"
"36220","ENSG00000238755.3_447816",447808,447816,9,"ENSG00000238755.3",1,8,"VVVUVVVMV",1,7,0.764803312629399,110,116,133,136,146,152,165,168,"CTGATAA","CTTT","GTAATGA","CTGA",2.41006841936617,17,10,13,49,2.5735287144331,4.66016287755188,7.71937612806948,101,"ENSG00000079974.19"
"7024","ENSG00000112531.17_146349",146341,146349,9,"ENSG00000112531.17",1,7,"VVVVVUMVV",1,7,0.807453416149068,110,116,133,136,143,149,158,161,"ATAATGA","GTGG","TTGAGGA","CTGT",2.2780810506354,17,7,9,42,2.77102650663001,4.48955837771651,7.71937204231278,101,"ENSG00000079974.19"
"26181","ENSG00000183621.15_86692",86684,86692,9,"ENSG00000183621.15",1,2,"VMVVUVVVV",1,7,0.773913043478261,115,121,133,136,148,154,170,173,"ATAATGA","ATTA","ATAATTT","CTGA",2.39536621585158,12,12,16,49,2.5257316390656,4.6237099361857,7.71936211009874,101,"ENSG00000079974.19"
"1911","ENSG00000067715.15_209619",209611,209619,9,"ENSG00000067715.15",1,2,"VMVVVVUVV",1,7,0.770186335403727,34,40,58,61,73,79,133,136,"ATAATGA","TTGA","ATGTGGT","CTGA",2.56818094625783,18,12,54,93,1.43316447506623,4.63859269586294,7.71933803747785,101,"ENSG00000079974.19"
"29191","ENSG00000197415.12_17749",17741,17749,9,"ENSG00000197415.12",1,8,"VVVUVVVMV",1,7,0.764803312629399,113,119,133,136,150,156,172,175,"ATGCTGA","CCAA","GTAATTA","CTGA",2.44424352479989,14,14,16,53,2.34538451555173,4.66008533688775,7.71929858740535,101,"ENSG00000079974.19"
"1271","ENSG00000050767.18_71221",71213,71221,9,"ENSG00000050767.18",1,1,"MVVVVVUVV",1,7,0.792132505175983,111,117,133,136,144,150,158,161,"ATGATAA","CTGC","AAGATGC","CAGA",2.30608602754969,16,8,8,41,2.82885170854667,4.55068963971949,7.71921966042343,101,"ENSG00000079974.19"
"9324","ENSG00000124164.16_55532",55524,55532,9,"ENSG00000124164.16",1,7,"VVVVUVMVV",1,7,0.775155279503105,111,117,133,136,176,182,194,197,"CTGATGA","CAAA","GTGAGAG","CTGA",2.50065414095028,16,40,12,77,1.8033489107989,4.61859412928353,7.71921524729595,101,"ENSG00000079974.19"
"14004","ENSG00000144229.13_450124",450116,450124,9,"ENSG00000144229.13",0,NA,"UVVVUVVVV",2,7,0.792546583850932,44,50,61,64,72,78,133,136,"ATGATGA","ATGA","GTAATAG","CAGA",2.43508547575154,11,8,55,83,1.96213836468618,4.54901038409078,7.71919671949451,101,"ENSG00000079974.19"
"2325","ENSG00000073146.16_47085",47077,47085,9,"ENSG00000073146.16",0,NA,"UVVVVUVVV",2,7,0.824844720496894,114,120,133,136,143,149,165,168,"CTCAGGA","CAGC","CTGAAGG","CTGA",2.23785621987,13,7,16,45,2.7601645656331,4.41980150785828,7.71918038984586,101,"ENSG00000079974.19"
"32044","ENSG00000225689.2_861308",861300,861308,9,"ENSG00000225689.2",0,NA,"UVVVUVVVV",2,7,0.792546583850932,89,95,133,136,141,147,162,165,"GTGATCA","GTGA","GTCATCT","CTGA",2.4666660904409,38,5,15,67,1.75151946611097,4.54899001726257,7.7191763526663,101,"ENSG00000079974.19"
"5023","ENSG00000102763.18_280969",280961,280969,9,"ENSG00000102763.18",1,8,"UVVVVVVMV",1,7,0.786749482401656,83,89,102,105,115,121,133,136,"ATGATGC","ATGA","GTTATAC","ATGA",2.31420939895517,13,10,12,44,2.86058706384062,4.57216243088543,7.71916036049206,101,"ENSG00000079974.19"
"45321","ENSG00000285407.1_226038",226030,226038,9,"ENSG00000285407.1",1,8,"UVVVVVVMV",1,7,0.786749482401656,99,105,133,136,150,156,164,167,"ATGATTA","CACA","GTGATTT","CTGA",2.49116143587749,28,14,8,59,1.68090186783065,4.57216119342014,7.71915912302677,101,"ENSG00000079974.19"
"2765","ENSG00000078124.13_125490",125482,125490,9,"ENSG00000078124.13",1,2,"UMVVVVVVV",1,7,0.786749482401656,114,120,133,136,141,147,196,199,"ATAATAG","CTTA","GTGATGA","CTGA",2.45377072434403,13,5,49,76,1.93012996571141,4.57215036533457,7.7191482949412,101,"ENSG00000079974.19"
"4326","ENSG00000100207.21_75125",75117,75125,9,"ENSG00000100207.21",1,3,"VVMVVUVVV",1,7,0.804968944099379,115,121,133,136,145,151,189,192,"GGGATGA","ATAA","GTGAAAT","CTGA",2.40241337443097,12,9,38,68,1.9809488262366,4.49925949727743,7.71913527367495,101,"ENSG00000079974.19"
"39026","ENSG00000251513.2_236392",236384,236392,9,"ENSG00000251513.2",1,8,"VVVVUVVMV",1,7,0.773913043478261,95,101,133,136,141,147,179,182,"ATGATGA","CAGC","TTGGAGA","CTGA",2.61729347072354,32,5,32,78,1.04525670277149,4.62346996023211,7.71912213414515,101,"ENSG00000079974.19"
"47194","ENSG00000287814.1_38368",38360,38368,9,"ENSG00000287814.1",1,2,"VMVVVUVVV",1,7,0.806211180124223,42,48,59,62,108,114,133,136,"ATGATGA","CTTA","ATAATAA","ATGA",2.46369979849329,11,46,19,85,1.5522060150586,4.4942178345868,7.71906255508369,101,"ENSG00000079974.19"
"26949","ENSG00000185345.24_337935",337927,337935,9,"ENSG00000185345.24",0,NA,"VVVVUUVVV",2,7,0.812008281573499,115,121,133,136,149,155,164,167,"AAGAGTA","CAGA","TTGTTTA","CTGA",2.2767757380856,12,13,9,43,2.70531919494812,4.4709560288797,7.7189891551737,101,"ENSG00000079974.19"
"24148","ENSG00000175311.7_17052",17044,17052,9,"ENSG00000175311.7",1,8,"UVVVVUVMV",2,6,0.708902691511387,80,86,94,97,106,112,133,136,"CTGATGA","CAGA","ATGCAGC","CTGA",2.60824693007858,8,9,21,47,2.14478081745664,4.8832734211618,7.71888418720735,101,"ENSG00000079974.19"
"44915","ENSG00000284418.3_601618",601610,601618,9,"ENSG00000284418.3",1,8,"VVVVUVVMV",1,7,0.773913043478261,115,121,133,136,145,151,163,166,"ATACTGC","CTGA","AGAAAGA","CTGA",2.33500483987869,12,9,12,42,2.92620981779387,4.62322718757962,7.71887936149267,101,"ENSG00000079974.19"
"2640","ENSG00000077092.20_405490",405482,405490,9,"ENSG00000077092.20",1,1,"MVVVVVUVV",1,7,0.792132505175983,74,80,106,109,114,120,133,136,"AGAATGA","GTGA","ATTATGG","CTGA",2.4325339188374,26,5,13,53,1.98433954664336,4.55030808472317,7.7188381054271,101,"ENSG00000079974.19"
"47883","ENSG00000289578.1_60162",60154,60162,9,"ENSG00000289578.1",1,8,"UVVVVVVMV",1,7,0.786749482401656,99,105,133,136,143,149,160,163,"AAGATGC","CAGA","ATGTGGC","CTGA",2.43350704375613,28,7,11,55,2.06377865485223,4.57178973663994,7.71878766624657,101,"ENSG00000079974.19"
"402","ENSG00000010932.17_10618",10610,10618,9,"ENSG00000010932.17",1,8,"VVVVVUVMV",1,7,0.806211180124224,116,122,133,136,143,149,185,188,"TTGCTGA","GTCA","GTGAAAA","CTGA",2.39353348967664,11,7,36,63,2.0188767557137,4.49394167172282,7.71878639221972,101,"ENSG00000079974.19"
"17204","ENSG00000153560.12_42961",42953,42961,9,"ENSG00000153560.12",1,5,"VVVVMUVVV",1,7,0.808695652173913,112,118,133,136,141,147,168,171,"GTGAGGT","CTAG","GAGATGA","CTGA",2.34509890279592,15,5,21,50,2.30200713064503,4.48399995398778,7.71878256268343,101,"ENSG00000079974.19"
"2589","ENSG00000076242.16_53844",53836,53844,9,"ENSG00000076242.16",1,1,"MVVVVUVVV",1,7,0.82815734989648,112,118,133,136,144,150,167,170,"GTTATGA","ATGA","GTGGTTT","TTGA",2.25445092542089,15,8,17,49,2.59492865029695,4.40615037160906,7.71877977119498,101,"ENSG00000079974.19"
"45744","ENSG00000285860.1_14603",14595,14603,9,"ENSG00000285860.1",0,NA,"UVVVVVUVV",2,7,0.788819875776397,106,112,133,136,150,156,165,168,"TAGATGA","TTCA","ATGATTA","CTGA",2.43337893305007,21,14,9,53,2.03138832541177,4.5634786364364,7.71875813954199,101,"ENSG00000079974.19"
"41311","ENSG00000258792.4_1605",1597,1605,9,"ENSG00000258792.4",1,8,"VVVVVUVMV",1,7,0.806211180124224,62,68,76,79,103,109,133,136,"GTAATGA","CTGA","CTGATGA","CTTA",2.51759130715553,8,24,24,65,1.19162092576455,4.49389074336702,7.71873546386391,101,"ENSG00000079974.19"
"41454","ENSG00000259053.1_313593",313585,313593,9,"ENSG00000259053.1",1,8,"VVVVVUVMV",1,7,0.806211180124224,62,68,76,79,103,109,133,136,"GTAATGA","CTGA","CTGATGA","CTTA",2.51759130715553,8,24,24,65,1.19162092576455,4.49389074336702,7.71873546386391,101,"ENSG00000079974.19"
"26737","ENSG00000185002.10_5901",5893,5901,9,"ENSG00000185002.10",1,8,"UVVVVVVMV",1,7,0.786749482401656,112,118,133,136,142,148,189,192,"ATGCTGA","CCAA","ATGATTG","CTGA",2.45649014642151,15,6,41,71,1.91004788328198,4.57166221485635,7.71866014446297,101,"ENSG00000079974.19"
"37259","ENSG00000246363.4_2631",2623,2631,9,"ENSG00000246363.4",1,1,"MVVVVUVVV",1,7,0.82815734989648,115,121,133,136,164,170,190,193,"ATGGTCA","CTTT","CTGATGA","CTGA",2.40511439821375,12,28,20,69,1.5899196539402,4.40600391050797,7.71863331009389,101,"ENSG00000079974.19"
"32772","ENSG00000227811.3_2102",2094,2102,9,"ENSG00000227811.3",1,2,"VMVVUVVVV",1,7,0.773913043478261,113,119,133,136,145,151,159,162,"GTAGTCA","CTGA","TTGTGGA","CTGA",2.33462247754106,14,9,8,40,2.92774994011655,4.62297494759756,7.7186271215106,101,"ENSG00000079974.19"
"29628","ENSG00000198467.16_6849",6841,6849,9,"ENSG00000198467.16",1,6,"VVUVVMVVV",1,7,0.786335403726708,115,121,133,136,161,167,177,180,"AAGATGA","ATTA","ATGACAT","CTGA",2.42534366154003,12,25,10,56,2.12403538216062,4.57324828144021,7.71858989634704,101,"ENSG00000079974.19"
"8975","ENSG00000121904.19_646528",646520,646528,9,"ENSG00000121904.19",1,5,"VVUVMVVVV",1,7,0.770186335403727,92,98,109,112,115,121,133,136,"AAGAGGA","TTGA","ATCATTG","CTGA",2.36788775212863,11,3,12,35,2.76538674811928,4.63782627391086,7.71857161552577,101,"ENSG00000079974.19"
"23925","ENSG00000174482.11_1190512",1190504,1190512,9,"ENSG00000174482.11",1,7,"VVUVVVMVV",1,7,0.768944099378882,112,118,133,136,143,149,197,200,"CTGATTA","CTAA","ATGTAGA","CTGA",2.49858026156883,15,7,48,79,1.91330667226451,4.64262710401418,7.71840350152971,101,"ENSG00000079974.19"
"19248","ENSG00000162620.16_105143",105135,105143,9,"ENSG00000162620.16",1,1,"MVVVVUVVV",1,7,0.82815734989648,93,99,133,136,145,151,166,169,"TTGATGT","CTTG","TTGTTTA","CTGA",2.37647781804971,34,9,15,67,1.7797903134941,4.40574394178971,7.71837334137563,101,"ENSG00000079974.19"
"22244","ENSG00000170017.12_33703",33695,33703,9,"ENSG00000170017.12",1,2,"VMUVVVVVV",1,7,0.767701863354037,116,122,133,136,174,180,209,212,"GAGATGA","CTCA","GTGAAGA","CTGA",2.61829890660762,11,38,29,87,1.1348479710436,4.64754350377359,7.71835095718974,101,"ENSG00000079974.19"
"22248","ENSG00000170035.16_61603",61595,61603,9,"ENSG00000170035.16",1,1,"MVVVVVUVV",1,7,0.792132505175983,70,76,96,99,109,115,133,136,"ATGTTGC","ATGA","TTTATGG","CTGA",2.42618178916724,20,10,18,57,2.02462308565636,4.54979208669282,7.71832210739675,101,"ENSG00000079974.19"
"39691","ENSG00000254101.8_1174267",1174259,1174267,9,"ENSG00000254101.8",0,NA,"UVVVVUVVV",2,7,0.824844720496894,43,49,60,63,105,111,133,136,"ATTATGA","TTGA","GTGATGT","CAGA",2.4431633416674,11,42,22,84,1.38733494906219,4.41877264004455,7.71815152203213,101,"ENSG00000079974.19"
"21640","ENSG00000168658.19_88294",88286,88294,9,"ENSG00000168658.19",1,8,"UVVVVVVMV",1,7,0.786749482401656,112,118,133,136,145,151,161,164,"ATTCTGT","CTGG","GTATTGA","CTGA",2.31180055820052,15,9,10,43,2.87242091295343,4.57110615857255,7.71810408817918,101,"ENSG00000079974.19"
"39780","ENSG00000254186.3_860268",860260,860268,9,"ENSG00000254186.3",0,NA,"VVUVVUVVV",2,7,0.805797101449275,112,118,133,136,145,151,178,181,"GTAAAGA","CAGA","TTGGAGA","CTGA",2.3873946822768,15,9,27,60,2.06360338855589,4.49489198426697,7.71808039006407,101,"ENSG00000079974.19"
"15085","ENSG00000147036.12_37813",37805,37813,9,"ENSG00000147036.12",0,NA,"UVUVVVVVV",2,7,0.786335403726708,116,122,133,136,144,150,180,183,"CTGATGT","CTGA","ATGAGGG","ATGA",2.43042274177595,11,8,30,58,2.08801447155862,4.57270818751624,7.71804980242308,101,"ENSG00000079974.19"
"38521","ENSG00000250349.3_260052",260044,260052,9,"ENSG00000250349.3",0,NA,"UVUVVVVVV",2,7,0.786335403726708,116,122,133,136,144,150,180,183,"CTGATGT","CTGA","ATGAGGG","ATGA",2.43042274177595,11,8,30,58,2.08801447155862,4.57270818751624,7.71804980242308,101,"ENSG00000079974.19"
"45377","ENSG00000285534.1_206575",206567,206575,9,"ENSG00000285534.1",1,5,"VVVUMVVVV",1,7,0.767287784679089,79,85,99,102,114,120,133,136,"ACAATGA","CTGC","TTCTTGA","CTGA",2.3917283579598,14,12,13,48,2.65071350396686,4.64889230592472,7.71804344464107,101,"ENSG00000079974.19"
"6578","ENSG00000110799.14_58865",58857,58865,9,"ENSG00000110799.14",1,8,"VVVVVUVMV",1,7,0.806211180124224,115,121,133,136,159,165,189,192,"CTGAGGA","ATGG","GTGAGGA","CTGA",2.47285206403219,12,23,24,68,1.48707150118622,4.49318798201688,7.71803270251377,101,"ENSG00000079974.19"
"35133","ENSG00000235066.7_48843",48835,48843,9,"ENSG00000235066.7",1,1,"MVVUVVVVV",1,7,0.786749482401656,109,115,133,136,165,171,221,224,"ATGATGA","TTGT","ATGTTGG","CTGA",2.63309130078138,18,29,50,106,0.730167867439955,4.57102746816229,7.71802539776892,101,"ENSG00000079974.19"
"42430","ENSG00000262879.7_31609",31601,31609,9,"ENSG00000262879.7",1,8,"VVVVVUVMV",1,7,0.806211180124224,69,75,104,107,115,121,133,136,"AGGATGA","CTGA","GTTATCC","GTGA",2.39539801530914,29,8,12,58,2.00325988070702,4.49314499569199,7.71798971618888,101,"ENSG00000079974.19"
"36089","ENSG00000237877.8_296972",296964,296972,9,"ENSG00000237877.8",1,8,"UVVVVVVMV",1,7,0.786749482401656,112,118,133,136,146,152,208,211,"ATAATGA","ATGT","TTGCAGA","CTGA",2.47134907449245,15,10,56,90,1.80824346978007,4.57097599159909,7.71797392120572,101,"ENSG00000079974.19"
"15926","ENSG00000150275.20_652858",652850,652858,9,"ENSG00000150275.20",0,NA,"UVVVVUVVV",2,7,0.824844720496894,112,118,133,136,146,152,195,198,"AAGCTCA","CTCA","CTGATGA","CTGA",2.37831572697421,15,10,43,77,1.8188645972803,4.41857569427709,7.71795457626466,101,"ENSG00000079974.19"
"23054","ENSG00000172159.16_109902",109894,109902,9,"ENSG00000172159.16",1,2,"VMVUVVVVV",1,7,0.764803312629399,106,112,133,136,177,183,193,196,"ATGATGA","CCCA","ATAATTA","CTGA",2.58284902158103,21,41,10,81,1.41582574912809,4.65870480658374,7.71791805710134,101,"ENSG00000079974.19"
"7398","ENSG00000113966.11_22784",22776,22784,9,"ENSG00000113966.11",1,6,"UVVVVMVVV",1,7,0.805383022774327,52,58,75,78,109,115,133,136,"ATGAAGA","CTGA","ATGAAAA","ATGA",2.48278462641995,17,31,18,75,1.43353461979388,4.49635803231505,7.71789012341236,101,"ENSG00000079974.19"
"32374","ENSG00000226864.3_23341",23333,23341,9,"ENSG00000226864.3",1,8,"VVVVUVVMV",1,7,0.773913043478261,115,121,133,136,186,192,239,242,"ATGATGA","TGGA","GAGATCA","CTGA",2.62245723116734,12,50,47,118,1.00588140852206,4.62223240407608,7.71788457798912,101,"ENSG00000079974.19"
"11951","ENSG00000136682.16_52607",52599,52607,9,"ENSG00000136682.16",1,2,"UMVVVVVVV",1,7,0.786749482401656,86,92,104,107,115,121,133,136,"ATGATCA","ATGA","ATGGAAA","CTCA",2.29714207849048,12,8,12,41,2.9690210902687,4.57082540338465,7.71782333299127,101,"ENSG00000079974.19"
"15348","ENSG00000147996.17_59382",59374,59382,9,"ENSG00000147996.17",1,2,"UMVVVVVVV",1,7,0.786749482401656,86,92,104,107,115,121,133,136,"ATGATCA","ATGA","ATGGAAA","CTCA",2.29714207849048,12,8,12,41,2.9690210902687,4.57082540338465,7.71782333299127,101,"ENSG00000079974.19"
"30994","ENSG00000215126.11_62062",62054,62062,9,"ENSG00000215126.11",1,2,"UMVVVVVVV",1,7,0.786749482401656,86,92,104,107,115,121,133,136,"ATGATCA","ATGA","ATGGAAA","CTCA",2.29714207849048,12,8,12,41,2.9690210902687,4.57082540338465,7.71782333299127,101,"ENSG00000079974.19"
"32777","ENSG00000227835.9_32707",32699,32707,9,"ENSG00000227835.9",1,1,"MVVUVVVVV",1,7,0.786749482401656,85,91,133,136,153,159,171,174,"CTGATTA","CTTA","CTGATGG","CTGA",2.53446020440278,42,17,12,80,1.38689645782308,4.57082445512707,7.71782238473369,101,"ENSG00000079974.19"
"8797","ENSG00000120693.14_71248",71240,71248,9,"ENSG00000120693.14",1,3,"UVMVVVVVV",1,7,0.785507246376811,114,120,133,136,149,155,207,210,"GTCATGA","ATCA","GTGTTGA","CTGA",2.49173525670487,13,13,52,87,1.69131526471915,4.57572091068791,7.71774989619515,101,"ENSG00000079974.19"
"35675","ENSG00000236711.2_529",521,529,9,"ENSG00000236711.2",1,3,"UVMVVVVVV",1,7,0.785507246376811,114,120,133,136,149,155,207,210,"GTCATGA","ATCA","GTGTTGA","CTGA",2.49173525670487,13,13,52,87,1.69131526471915,4.57572091068791,7.71774989619515,101,"ENSG00000079974.19"
"23411","ENSG00000172922.11_3281",3273,3281,9,"ENSG00000172922.11",0,NA,"VVUVUVVVV",2,7,0.773498964803312,113,119,133,136,150,156,165,168,"GTGATGG","GGGA","GGGTTGG","CTGA",2.38579621339805,14,14,9,46,2.5894393111255,4.62368685011147,7.71768270932472,101,"ENSG00000079974.19"
"9086","ENSG00000122584.13_136914",136906,136914,9,"ENSG00000122584.13",0,NA,"UVVVVUVVV",2,7,0.824844720496894,88,94,133,136,179,185,195,198,"ATAATGA","ATGT","GTGTTGG","CTGA",2.50006529070866,39,43,10,101,1.00611160838936,4.41830338661178,7.71768226859936,101,"ENSG00000079974.19"
"19922","ENSG00000164023.15_85944",85936,85944,9,"ENSG00000164023.15",1,8,"UVVVVVVMV",1,7,0.786749482401656,115,121,133,136,153,159,175,178,"ATCATCA","TTCA","GTGAAGA","CTGA",2.41436721005326,12,17,16,54,2.18688884759407,4.57066756198728,7.71766549159391,101,"ENSG00000079974.19"
"34393","ENSG00000232947.1_4545",4537,4545,9,"ENSG00000232947.1",1,7,"VVVVVUMVV",1,7,0.807453416149068,115,121,133,136,145,151,169,172,"GTGACGG","TTGC","ATGTTGG","CTGA",2.3043873721762,12,9,18,48,2.5886365687257,4.48780476247509,7.71761842707137,101,"ENSG00000079974.19"
"1576","ENSG00000061936.10_53485",53477,53485,9,"ENSG00000061936.10",1,8,"VVVVVUVMV",1,7,0.806211180124224,115,121,133,136,139,145,160,163,"ATGATGA","AAGA","GCCAAGA","CTGC",2.31121498700113,12,3,15,39,2.56293026363002,4.49275754424271,7.71760226473961,101,"ENSG00000079974.19"
"34302","ENSG00000232606.3_34161",34153,34161,9,"ENSG00000232606.3",1,7,"VVVUVVMVV",1,7,0.766045548654244,113,119,133,136,149,155,165,168,"AATATGA","ATGC","CTGAAGA","CTGA",2.39269282942119,14,13,10,46,2.66214377518045,4.65335732616376,7.71753952078073,101,"ENSG00000079974.19"
"40670","ENSG00000257275.6_26109",26101,26109,9,"ENSG00000257275.6",1,8,"VVVVUVVMV",1,7,0.773913043478261,114,120,133,136,172,178,211,214,"TTGATGA","CTTT","TTGATGA","CTGA",2.60993365377842,13,36,33,91,1.08798692055065,4.62188615310169,7.71753832701474,101,"ENSG00000079974.19"
"34007","ENSG00000231718.1_59270",59262,59270,9,"ENSG00000231718.1",1,5,"VVVUMVVVV",1,7,0.767287784679089,116,122,133,136,142,148,165,168,"ATCATGT","TTCA","CTTATGA","CTGA",2.38873731057015,11,6,17,43,2.6686106490974,4.6483815132246,7.71753265194095,101,"ENSG00000079974.19"
"14070","ENSG00000144339.12_230898",230890,230898,9,"ENSG00000144339.12",1,8,"VVVUVVVMV",1,7,0.764803312629399,44,50,66,69,74,80,133,136,"ATGATAA","CAGA","GTCGTGT","CTGA",2.52940220673845,16,5,53,83,1.77054488651399,4.65830656619258,7.71751981671018,101,"ENSG00000079974.19"
"46847","ENSG00000287290.1_67859",67851,67859,9,"ENSG00000287290.1",1,8,"VVVVVVUMV",1,7,0.770186335403727,84,90,105,108,114,120,133,136,"GTGATAA","AGGA","AGGAAGT","CTGA",2.3583435239232,15,6,13,43,2.82479659184204,4.63677168783252,7.71751702944742,101,"ENSG00000079974.19"
"20160","ENSG00000164330.17_79409",79401,79409,9,"ENSG00000164330.17",1,1,"MVVUVVVVV",1,7,0.786749482401656,112,118,133,136,161,167,179,182,"GGGAGGA","CAGA","GTGAAGT","CTGA",2.44357154765664,15,25,12,61,1.9914154065736,4.57047309773781,7.71747102734443,101,"ENSG00000079974.19"
"14637","ENSG00000145526.12_938000",937992,938000,9,"ENSG00000145526.12",1,2,"VMVVVUVVV",1,7,0.806211180124223,111,117,133,136,164,170,180,183,"GTCATGA","TTGC","GAGATTA","CTGA",2.40887302181667,16,28,10,63,1.91120536441756,4.49258971079883,7.71743443129573,101,"ENSG00000079974.19"
"12089","ENSG00000137177.20_18734",18726,18734,9,"ENSG00000137177.20",0,NA,"UVVVVUVVV",2,7,0.824844720496894,108,114,133,136,168,174,188,191,"TAGATGA","CTCA","GTGCTTC","CTGA",2.42829075272331,19,32,14,74,1.48343547270687,4.41801012271558,7.71738900470315,101,"ENSG00000079974.19"
"8350","ENSG00000118407.15_179230",179222,179230,9,"ENSG00000118407.15",0,NA,"VVVUUVVVV",2,7,0.770600414078675,108,114,133,136,144,150,168,171,"AGGAAGA","CAGA","TTGAGAA","CTGA",2.45104236533388,19,8,18,54,2.19961600491436,4.63497461011839,7.71737626643309,101,"ENSG00000079974.19"
"22655","ENSG00000171094.18_130390",130382,130390,9,"ENSG00000171094.18",0,NA,"UVVVVVUVV",2,7,0.788819875776397,85,91,133,136,156,162,171,174,"TTGATGG","CTGC","GTGTGGA","CTGA",2.54564842128353,42,20,9,80,1.27735165494154,4.56208528254127,7.71736478564686,101,"ENSG00000079974.19"
"47397","ENSG00000288088.1_130734",130726,130734,9,"ENSG00000288088.1",1,1,"MVVVVUVVV",1,7,0.82815734989648,83,89,103,106,113,119,133,136,"ATGAACA","TTGA","CTGAAGT","TTGA",2.21621198670573,14,7,14,44,2.84394342984433,4.40467250197063,7.71730190155655,101,"ENSG00000079974.19"
"34523","ENSG00000233290.4_478268",478260,478268,9,"ENSG00000233290.4",1,7,"VVUVVUMVV",2,6,0.691097308488613,113,119,133,136,146,152,163,166,"ATGAAGA","TTGA","GTTCAGA","CTGA",2.54325408087798,14,10,11,44,2.85658025701803,4.95290186571781,7.71729109967226,101,"ENSG00000079974.19"
"43459","ENSG00000271945.3_318411",318403,318411,9,"ENSG00000271945.3",1,1,"MVVVUVVVV",1,7,0.795859213250517,110,116,133,136,142,148,169,172,"ATGAGGC","TTTA","AAGATGA","CTGA",2.39041515216741,17,6,21,53,2.19926566457026,4.53384166975491,7.71727852275698,101,"ENSG00000079974.19"
"17504","ENSG00000154240.17_64205",64197,64205,9,"ENSG00000154240.17",1,3,"UVMVVVVVV",1,7,0.785507246376811,112,118,133,136,141,147,158,161,"CTTTTGA","CTAA","CTGATTG","CTGA",2.31616243221866,15,5,11,40,2.85983504323997,4.57522948117443,7.71725846668167,101,"ENSG00000079974.19"
"37635","ENSG00000248555.7_51337",51329,51337,9,"ENSG00000248555.7",1,8,"UVVVVVVMV",1,7,0.786749482401656,115,121,133,136,147,153,168,171,"ATAGTGA","AAGA","CTGAAAA","CTGA",2.3438817414282,12,11,15,47,2.65511872150141,4.57024924942235,7.71724717902898,101,"ENSG00000079974.19"
"6317","ENSG00000109339.24_413304",413296,413304,9,"ENSG00000109339.24",1,1,"MVUVVVVVV",1,7,0.789648033126294,21,27,46,49,98,104,133,136,"GTTATGA","CTGA","ATCATAA","CTGA",2.62613427206317,19,49,29,106,0.726960246511016,4.55863051506637,7.71722264757155,101,"ENSG00000079974.19"
"31198","ENSG00000218672.1_1181",1173,1181,9,"ENSG00000218672.1",1,1,"MVUVVVVVV",1,7,0.789648033126294,47,53,67,70,79,85,133,136,"AGGAAGA","TTGA","TTGAGCA","CTGA",2.44742984715237,14,9,48,80,1.91831743074908,4.55862910294122,7.7172212354464,101,"ENSG00000079974.19"
"27687","ENSG00000187123.15_51342",51334,51342,9,"ENSG00000187123.15",1,8,"UVVVVVVMV",1,7,0.786749482401656,108,114,133,136,144,150,165,168,"CTGATGT","AAGA","GGGAGAA","CTGA",2.38497749711685,19,8,15,51,2.38104187765839,4.57022296460934,7.71722089421597,101,"ENSG00000079974.19"
"1991","ENSG00000068781.21_179731",179723,179731,9,"ENSG00000068781.21",1,8,"UVVVVVVMV",1,7,0.786749482401656,92,98,133,136,176,182,193,196,"ATGATCA","TTGA","GTTATGG","CTGA",2.59180694522786,35,40,11,95,1.00186044156442,4.57014335243754,7.71714128204417,101,"ENSG00000079974.19"
"36648","ENSG00000242441.8_91858",91850,91858,9,"ENSG00000242441.8",1,8,"UVVVVVVMV",1,7,0.786749482401656,92,98,133,136,176,182,193,196,"ATGATCA","TTGA","GTTATGG","CTGA",2.59180694522786,35,40,11,95,1.00186044156442,4.57014335243754,7.71714128204417,101,"ENSG00000079974.19"
"43252","ENSG00000270528.1_377",369,377,9,"ENSG00000270528.1",1,2,"VMVVUVVVV",1,7,0.773913043478261,111,117,133,136,140,146,174,177,"CTGAAGA","CGGA","CTGAGAA","CTGA",2.49536834512428,16,4,28,57,1.850165634694,4.62148865054729,7.71714082446034,101,"ENSG00000079974.19"
"41137","ENSG00000258573.6_3755",3747,3755,9,"ENSG00000258573.6",1,1,"MVVVVUVVV",1,7,0.82815734989648,35,41,84,87,99,105,133,136,"ATCATGA","CTGA","TTGTTGA","CAGA",2.50155863422779,43,12,28,92,0.940921968277369,4.40449488244898,7.71712428203491,101,"ENSG00000079974.19"
"11499","ENSG00000135205.15_166649",166641,166649,9,"ENSG00000135205.15",1,6,"UVVVVMVVV",1,7,0.805383022774327,49,55,70,73,89,95,133,136,"CTGATGA","CTGA","GTGTGCA","GTGA",2.48308266979425,15,16,38,78,1.42837325832078,4.49556443090395,7.71709652200126,101,"ENSG00000079974.19"
"9331","ENSG00000124177.16_9269",9261,9269,9,"ENSG00000124177.16",0,NA,"VVVVVUUVV",2,7,0.808281573498965,115,121,133,136,137,143,153,156,"TTAAAGA","CAGT","GTGCTGA","CTGA",2.30300789209036,12,1,10,32,2.58240265434145,4.48394715040263,7.71707344439849,101,"ENSG00000079974.19"
"45799","ENSG00000285921.1_7684",7676,7684,9,"ENSG00000285921.1",1,6,"VVVVUMVVV",1,7,0.792546583850932,113,119,133,136,149,155,164,167,"GTGAAGG","TTGT","GTGTTGT","CTGA",2.32872640969057,14,13,9,45,2.66270089533493,4.54688590665136,7.71707224205508,101,"ENSG00000079974.19"
"16798","ENSG00000152284.5_126416",126408,126416,9,"ENSG00000152284.5",0,NA,"VVVUVUVVV",2,7,0.802898550724638,105,111,133,136,146,152,187,190,"ATGAACA","TTGA","ATGTTGA","CTGA",2.51004041334665,22,10,35,76,1.28830070795606,4.5054758659001,7.71707006879865,101,"ENSG00000079974.19"
"31545","ENSG00000224063.6_472871",472863,472871,9,"ENSG00000224063.6",1,5,"UVVVMVVVV",1,7,0.789233954451346,109,115,133,136,143,149,157,160,"TTGAACA","TTGA","ATGGTCA","CTGA",2.33648784701886,18,7,8,42,2.66391025144351,4.56012397455897,7.71705979236436,101,"ENSG00000079974.19"
"13523","ENSG00000141665.13_64111",64103,64111,9,"ENSG00000141665.13",1,8,"VVVUVVVMV",1,7,0.764803312629399,73,79,93,96,104,110,133,136,"AGGAAGA","CTGT","GTGGTTA","CTGA",2.44830086836131,14,8,23,54,2.30930899247617,4.6578286953879,7.7170419459055,101,"ENSG00000079974.19"
"410","ENSG00000011052.21_14794",14786,14794,9,"ENSG00000011052.21",1,8,"UVVVVVVMV",1,7,0.786749482401656,116,122,133,136,180,186,197,200,"AAAATGA","CTCA","TTTATGA","CTGA",2.44745297687407,11,44,11,75,1.9637935450315,4.57003668104799,7.71703461065462,101,"ENSG00000079974.19"
"36929","ENSG00000243678.12_2949",2941,2949,9,"ENSG00000243678.12",1,8,"UVVVVVVMV",1,7,0.786749482401656,116,122,133,136,180,186,197,200,"AAAATGA","CTCA","TTTATGA","CTGA",2.44745297687407,11,44,11,75,1.9637935450315,4.57003668104799,7.71703461065462,101,"ENSG00000079974.19"
"18002","ENSG00000155974.14_558789",558781,558789,9,"ENSG00000155974.14",1,8,"VVVVVUVMV",1,7,0.806211180124224,106,112,133,136,139,145,160,163,"TAGATGA","TAGA","GAGAAGA","CTGA",2.40585719980243,21,3,15,48,1.92961472757608,4.49216568156474,7.71701040206164,101,"ENSG00000079974.19"
"7082","ENSG00000112699.11_80947",80939,80947,9,"ENSG00000112699.11",1,7,"VVUVVVMVV",1,7,0.768944099378882,83,89,106,109,114,120,133,136,"ATGATGC","CTCA","GTGAATA","TTGA",2.39254230090548,17,5,13,44,2.61427522123416,4.64113930681768,7.71691570433321,101,"ENSG00000079974.19"
"32758","ENSG00000227757.3_121648",121640,121648,9,"ENSG00000227757.3",1,2,"VMVVVUVVV",1,7,0.806211180124223,85,91,101,104,109,115,133,136,"ACAATTA","CTGG","GTGTAGA","CTGA",2.31958906742251,10,5,18,42,2.50424206101558,4.49204229429141,7.71688701478831,101,"ENSG00000079974.19"
"10030","ENSG00000128872.10_19408",19400,19408,9,"ENSG00000128872.10",1,7,"VVVVVUMVV",1,7,0.807453416149068,116,122,133,136,143,149,160,163,"ATAATAA","GTTA","GTTCTTA","CTGA",2.23917113882315,11,7,11,38,3.0203974279366,4.48705125502274,7.71686491961901,101,"ENSG00000079974.19"
"28290","ENSG00000188641.14_2481",2473,2481,9,"ENSG00000188641.14",1,8,"VVVVVUVMV",1,7,0.806211180124224,78,84,102,105,114,120,133,136,"AAGAGGA","CTGA","TTGAAAA","ATGA",2.31459735172464,18,9,13,49,2.53725595815155,4.49197624241229,7.71682096290919,101,"ENSG00000079974.19"
"31899","ENSG00000225206.12_57352",57344,57352,9,"ENSG00000225206.12",1,8,"VVVVVUVMV",1,7,0.806211180124224,78,84,102,105,114,120,133,136,"AAGAGGA","CTGA","TTGAAAA","ATGA",2.31459735172464,18,9,13,49,2.53725595815155,4.49197624241229,7.71682096290919,101,"ENSG00000079974.19"
"15285","ENSG00000147573.17_47902",47894,47902,9,"ENSG00000147573.17",1,8,"VVVVVUVMV",1,7,0.806211180124224,14,20,30,33,74,80,133,136,"ATGATGA","CTGA","ATGACTT","CTGG",2.55616554054054,10,41,53,113,0.926612861369202,4.4919291162432,7.7167738367401,101,"ENSG00000079974.19"
"47908","ENSG00000289695.1_9625",9617,9625,9,"ENSG00000289695.1",1,8,"VVVVUVVMV",1,7,0.773913043478261,96,102,133,136,137,143,155,158,"ATGATGA","CAGG","GTGCCCA","CTGA",2.5752672259243,31,1,12,53,1.31599479674771,4.62111074239409,7.71676291630713,101,"ENSG00000079974.19"
"48266","ENSG00000290801.1_34662",34654,34662,9,"ENSG00000290801.1",0,NA,"UVVVUVVVV",2,7,0.792546583850932,113,119,133,136,141,147,175,178,"ATTATGT","TTGT","CTGCTGA","CTGA",2.41745682367901,14,5,28,56,2.06988303741837,4.54656546548628,7.71675180089001,101,"ENSG00000079974.19"
"41206","ENSG00000258690.1_15631",15623,15631,9,"ENSG00000258690.1",1,6,"VVUVVMVVV",1,7,0.786335403726708,91,97,109,112,116,122,133,136,"TAGATGA","CTGA","GAGATAT","TTGA",2.30389867811026,12,4,11,36,2.92626049687161,4.57139625440167,7.7167378693085,101,"ENSG00000079974.19"
"1560","ENSG00000060718.22_21523",21515,21523,9,"ENSG00000060718.22",1,8,"UVVVVVVMV",1,7,0.786749482401656,110,116,133,136,147,153,174,177,"ATGAAGA","TGGA","GTGGCTA","CTGA",2.43427178036721,17,11,21,58,2.05037193629452,4.56971261801898,7.7167105476256,101,"ENSG00000079974.19"
"8308","ENSG00000118094.12_6438",6430,6438,9,"ENSG00000118094.12",1,1,"MVUVVVVVV",1,7,0.789648033126294,112,118,133,136,141,147,165,168,"ATACTGA","CAGA","AAGATAC","CTGA",2.36289845881268,15,5,18,47,2.47977441635378,4.55810770210958,7.71669983461476,101,"ENSG00000079974.19"
"19684","ENSG00000163607.18_19695",19687,19695,9,"ENSG00000163607.18",1,8,"VVVVVUVMV",1,7,0.806211180124224,77,83,96,99,108,114,133,136,"TTAATGA","CTGA","GTGTTTC","CTCA",2.31675424400482,13,9,19,50,2.52224550927215,4.4918184506594,7.71666317115629,101,"ENSG00000079974.19"
"28567","ENSG00000196116.8_56371",56363,56371,9,"ENSG00000196116.8",1,5,"VVVVMUVVV",1,7,0.808695652173913,87,93,133,136,145,151,165,168,"GTGAAGA","CTTG","GTGATTG","CTGA",2.41560692598616,40,9,14,72,1.82336932788727,4.48185387528208,7.71663648397773,101,"ENSG00000079974.19"
"20544","ENSG00000165061.15_72966",72958,72966,9,"ENSG00000165061.15",1,1,"MVVUVVVVV",1,7,0.786749482401656,90,96,104,107,112,118,133,136,"AGGATGA","ATGA","CTGTGGA","CTGG",2.35799314357033,8,5,15,37,2.55853093462969,4.56962130627465,7.71661923588127,101,"ENSG00000079974.19"
"6412","ENSG00000109738.11_68726",68718,68726,9,"ENSG00000109738.11",0,NA,"VVVVUUVVV",2,7,0.812008281573499,116,122,133,136,145,151,164,167,"TTAAAGA","AGGA","ATGAAAA","CTGA",2.2518486093721,11,9,13,42,2.8619218755468,4.46856148450686,7.71659461080086,101,"ENSG00000079974.19"
"739","ENSG00000030066.14_42016",42008,42016,9,"ENSG00000030066.14",1,1,"MVVVVVUVV",1,7,0.792132505175983,81,87,104,107,116,122,133,136,"ATGAAGA","CTTA","GAGATCA","ATGA",2.32450083417965,17,9,11,46,2.6954680462079,4.54803506851805,7.71656508922199,101,"ENSG00000079974.19"
"15333","ENSG00000147862.18_161458",161450,161458,9,"ENSG00000147862.18",1,1,"MVVVVVUVV",1,7,0.792132505175983,113,119,133,136,173,179,189,192,"ATCATGA","CAGA","ATGAAGA","CTCA",2.43213433273606,14,37,10,70,1.97731387071046,4.54788568890437,7.71641570960831,101,"ENSG00000079974.19"
"11635","ENSG00000135577.5_88031",88023,88031,9,"ENSG00000135577.5",1,8,"VVVVVUVMV",1,7,0.806211180124224,116,122,133,136,144,150,168,171,"ATAGTGA","CACA","ATCAGGA","CTGA",2.30466517426655,11,8,18,46,2.60161669597259,4.49151279777072,7.71635751826762,101,"ENSG00000079974.19"
"44340","ENSG00000281016.1_59866",59858,59866,9,"ENSG00000281016.1",1,2,"VMVUVVVVV",1,7,0.764803312629399,112,118,133,136,147,153,194,197,"ATGAAGA","TTCA","ATGCTGA","CTGA",2.53006772885011,15,11,41,76,1.76135659399576,4.65711869658245,7.71633194710005,101,"ENSG00000079974.19"
"33855","ENSG00000231304.2_524888",524880,524888,9,"ENSG00000231304.2",0,NA,"VVVVUVUVV",2,7,0.775983436853002,98,104,133,136,142,148,165,168,"AAGATTA","CTGC","ATGAGGA","CTGA",2.5064316948535,29,6,17,61,1.73998392444945,4.61238213920154,7.71631588661354,101,"ENSG00000079974.19"
"18066","ENSG00000156103.16_275015",275007,275015,9,"ENSG00000156103.16",1,1,"MVVVVUVVV",1,7,0.82815734989648,109,115,133,136,148,154,209,212,"ATGAAGA","CACA","TTCATGG","CTGA",2.4272613281127,18,12,55,94,1.4329499167571,4.40367302604378,7.7163024256297,101,"ENSG00000079974.19"
"13807","ENSG00000143502.16_62677",62669,62677,9,"ENSG00000143502.16",1,8,"VVVVVVUMV",1,7,0.770186335403727,60,66,75,78,88,94,133,136,"GTGATGA","CTGA","GTGGGAA","CTTA",2.51742083852176,9,10,39,67,1.75936134063039,4.63554173269386,7.71628707430876,101,"ENSG00000079974.19"
"29126","ENSG00000197265.9_10331",10323,10331,9,"ENSG00000197265.9",1,5,"VVVVMUVVV",1,7,0.808695652173913,113,119,133,136,152,158,214,217,"TTGCTGA","CTCA","ATGACTA","CTGA",2.47092013007173,14,16,56,95,1.45311152541323,4.48147809813952,7.71626070683517,101,"ENSG00000079974.19"
"16175","ENSG00000151067.23_329294",329286,329294,9,"ENSG00000151067.23",1,2,"UMVVVVVVV",1,7,0.786749482401656,115,121,133,136,139,145,196,199,"AGAATGA","CTGG","GTGAAGT","CTGA",2.48611546502689,12,3,51,75,1.70293803449612,4.56926028366885,7.71625821327547,101,"ENSG00000079974.19"
"3183","ENSG00000082068.9_43772",43764,43772,9,"ENSG00000082068.9",0,NA,"VVVUVUVVV",2,7,0.802898550724638,108,114,133,136,145,151,160,163,"ATGAAGA","GTGT","GTGAAGA","GTGA",2.32324787288875,19,9,9,46,2.5301595398526,4.50461967311106,7.71621387600961,101,"ENSG00000079974.19"
"259","ENSG00000007047.16_44973",44965,44973,9,"ENSG00000007047.16",1,5,"VVVVMUVVV",1,7,0.808695652173913,88,94,108,111,115,121,133,136,"CTGGAGA","CTGA","TTGAAGA","GTGA",2.26815122679515,14,4,12,39,2.80452374081856,4.48138297986322,7.71616558855887,101,"ENSG00000079974.19"
"5462","ENSG00000104866.11_32865",32857,32865,9,"ENSG00000104866.11",1,5,"VVVVMUVVV",1,7,0.808695652173913,88,94,108,111,115,121,133,136,"CTGGAGA","CTGA","TTGAAGA","GTGA",2.26815122679515,14,4,12,39,2.80452374081856,4.48138297986322,7.71616558855887,101,"ENSG00000079974.19"
"40690","ENSG00000257322.7_67707",67699,67707,9,"ENSG00000257322.7",1,3,"UVMVVVVVV",1,7,0.785507246376811,89,95,101,104,114,120,133,136,"ATGAAGA","CTGA","AAGAAAA","CTAA",2.38978872873655,6,10,13,38,2.36460320210801,4.57413201508792,7.71616100059516,101,"ENSG00000079974.19"
"46970","ENSG00000287424.1_29842",29834,29842,9,"ENSG00000287424.1",1,8,"VVVVVUVMV",1,7,0.806211180124224,82,88,98,101,113,119,133,136,"ATGAGGA","CTGG","AGGATAA","CTAA",2.31038493199991,10,12,14,45,2.56253945980631,4.49127641828477,7.71612113878166,101,"ENSG00000079974.19"
"28136","ENSG00000188177.14_50015",50007,50015,9,"ENSG00000188177.14",1,1,"MVVVVVUVV",1,7,0.792132505175983,115,121,133,136,154,160,194,197,"TTGAAGC","CTGA","GTGCAGA","CTGA",2.51307244082473,12,18,34,73,1.43650157545973,4.54757946190616,7.71610948261009,101,"ENSG00000079974.19"
"20766","ENSG00000165591.7_181900",181892,181900,9,"ENSG00000165591.7",1,1,"MVVVVVUVV",1,7,0.792132505175983,91,97,133,136,148,154,163,166,"ATGAAGA","CAAA","CTGGTGT","CTGA",2.46292245857984,36,12,9,66,1.77055010944127,4.54750829166005,7.71603831236398,101,"ENSG00000079974.19"
"23753","ENSG00000173848.19_45290",45282,45290,9,"ENSG00000173848.19",1,2,"VMVUVVVVV",1,7,0.764803312629399,84,90,133,136,143,149,161,164,"ATTAAGA","ATGA","TTGATGT","CTGA",2.50031061100248,43,7,12,71,1.95851596762584,4.65681334357726,7.71602659409486,101,"ENSG00000079974.19"
"40038","ENSG00000254746.6_17559",17551,17559,9,"ENSG00000254746.6",0,NA,"UVVVVUVVV",2,7,0.824844720496894,112,118,133,136,145,151,165,168,"AGGTTGA","CAAA","GGCAGGA","CTGA",2.23983087281623,15,9,14,47,2.73419034790569,4.41659904167015,7.71597792365772,101,"ENSG00000079974.19"
"19737","ENSG00000163630.11_376843",376835,376843,9,"ENSG00000163630.11",0,NA,"UVVVVVUVV",2,7,0.788819875776397,60,66,78,81,90,96,133,136,"ATGCTTG","CTGA","GGGAAGA","CTGA",2.43832313700433,12,9,37,67,1.98729055429006,4.56069453357973,7.71597403668532,101,"ENSG00000079974.19"
"16319","ENSG00000151322.20_483421",483413,483421,9,"ENSG00000151322.20",1,8,"VVVVUVVMV",1,7,0.773913043478261,85,91,99,102,112,118,133,136,"ATGAGGA","CTGA","GAGCAGA","CTAA",2.40260218836767,8,10,15,42,2.46384365899753,4.62029789536217,7.71595006927521,101,"ENSG00000079974.19"
"6720","ENSG00000111696.12_49203",49195,49203,9,"ENSG00000111696.12",1,6,"VVVVVMUVV",1,7,0.788819875776397,68,74,104,107,116,122,133,136,"ATGATGG","CTAA","GTGATCA","CTTA",2.43936919074652,30,9,11,59,1.97989182660371,4.5605882745618,7.71586777766739,101,"ENSG00000079974.19"
"14075","ENSG00000144357.18_167679",167671,167679,9,"ENSG00000144357.18",1,2,"UMVVVVVVV",1,7,0.786749482401656,115,121,133,136,142,148,157,160,"ATGATAA","ATAA","ATGATAA","CTGC",2.27854530489203,12,6,9,36,3.08515402764691,4.56886401506511,7.71586194467173,101,"ENSG00000079974.19"
"36601","ENSG00000242029.1_148131",148123,148131,9,"ENSG00000242029.1",1,8,"VVVVVUVMV",1,7,0.806211180124224,85,91,133,136,153,159,174,177,"ATGAAGA","TTCA","GTGAAAA","CTGA",2.50768597209335,42,17,15,83,1.24594420407597,4.49096267117458,7.71580739167147,101,"ENSG00000079974.19"
"33828","ENSG00000231252.4_152068",152060,152068,9,"ENSG00000231252.4",1,1,"MVUVVVVVV",1,7,0.789648033126294,114,120,133,136,151,157,210,213,"ATGAAGA","CAGT","GTGGGGA","CTGA",2.50172782762222,13,15,53,90,1.5506665508367,4.55721301707955,7.71580514958472,101,"ENSG00000079974.19"
"45340","ENSG00000285471.1_177819",177811,177819,9,"ENSG00000285471.1",1,8,"VVVVUVVMV",1,7,0.773913043478261,107,113,133,136,142,148,159,162,"GTGAGGA","CACA","ATAAGGA","CTGA",2.40247632124627,20,6,11,46,2.4640621002461,4.62014272713864,7.71579490105169,101,"ENSG00000079974.19"
"601","ENSG00000021574.14_65084",65076,65084,9,"ENSG00000021574.14",0,NA,"UVVVVUVVV",2,7,0.824844720496894,101,107,133,136,143,149,169,172,"ATGATGA","ATGT","GTGTTGT","CTGG",2.40234414639922,26,7,20,62,1.64997038135609,4.41639950600438,7.71577838799196,101,"ENSG00000079974.19"
"20872","ENSG00000165929.13_23616",23608,23616,9,"ENSG00000165929.13",0,NA,"VVUVVVUVV",2,7,0.769772256728778,114,120,133,136,140,146,159,162,"AGGAAGA","GGGA","GTGGAGA","CTGA",2.36239164483867,13,4,13,39,2.79731102162552,4.63664716347083,7.71573619038594,101,"ENSG00000079974.19"
"42696","ENSG00000265933.5_691",683,691,9,"ENSG00000265933.5",1,2,"VMVVVUVVV",1,7,0.806211180124223,110,116,133,136,154,160,172,175,"ATAATTG","GTGA","GGGATGA","CTGA",2.38165737627507,17,18,12,56,2.08582511341122,4.49088523881126,7.71572995930816,101,"ENSG00000079974.19"
"11776","ENSG00000136021.19_29297",29289,29297,9,"ENSG00000136021.19",1,1,"MVUVVVVVV",1,7,0.789648033126294,116,122,133,136,140,146,154,157,"AGTATGA","CAGA","CTGAGGA","TTGA",2.27686861454029,11,4,8,32,3.04928404403719,4.55710203524312,7.71569416774829,101,"ENSG00000079974.19"
"13259","ENSG00000140836.17_277860",277852,277860,9,"ENSG00000140836.17",1,8,"VVVVVUVMV",1,7,0.806211180124224,111,117,133,136,179,185,197,200,"AAGATGG","CGGA","ATGGAAA","CTGA",2.424510315694,16,43,12,80,1.79995006417375,4.4908380422001,7.715682762697,101,"ENSG00000079974.19"
"14512","ENSG00000145244.12_158116",158108,158116,9,"ENSG00000145244.12",1,2,"VMVUVVVVV",1,7,0.764803312629399,102,108,133,136,142,148,168,171,"CTTATGC","CTGA","GGGATGA","CTGA",2.5430725361918,25,6,20,60,1.67194470669801,4.65644040366084,7.71565365417844,101,"ENSG00000079974.19"
"17707","ENSG00000154928.19_250963",250955,250963,9,"ENSG00000154928.19",1,8,"VVVUVVVMV",1,7,0.764803312629399,83,89,105,108,114,120,133,136,"GTAATGA","CTGA","TTCAAGA","ATGA",2.38143059286981,16,6,13,44,2.74952189876665,4.65643146280802,7.71564471332561,101,"ENSG00000079974.19"
"4534","ENSG00000100979.15_2392",2384,2392,9,"ENSG00000100979.15",1,1,"MVVVVUUVV",2,6,0.714285714285714,116,122,133,136,156,162,172,175,"AGGATGT","GTGA","GTGATGC","CTGA",2.57706718048648,11,20,10,50,2.25355634868482,4.85850105464868,7.71564391179154,101,"ENSG00000079974.19"
"25280","ENSG00000180357.10_130330",130322,130330,9,"ENSG00000180357.10",1,2,"VMVVVUVVV",1,7,0.806211180124223,95,101,133,136,143,149,165,168,"TTGAAGA","TTGT","CTGATAA","CTGA",2.42718098635616,32,7,16,64,1.7818935750846,4.49077503769808,7.71561975819498,101,"ENSG00000079974.19"
"8862","ENSG00000121075.11_27353",27345,27353,9,"ENSG00000121075.11",0,NA,"VVVVUVUVV",2,7,0.775983436853002,114,120,133,136,139,145,153,156,"AGGAGGG","GTGA","CTGGAGA","CTGA",2.33423818794419,13,3,8,33,2.88489831338736,4.61162155825382,7.71555530566583,101,"ENSG00000079974.19"
"29761","ENSG00000198677.13_79332",79324,79332,9,"ENSG00000198677.13",1,6,"VVVUVMVVV",1,7,0.78343685300207,112,118,133,136,149,155,166,169,"ATAAAGA","CTGG","ATCCAGA","CTGA",2.36039276146588,15,13,11,48,2.59124703897076,4.58179969551917,7.71554710752745,101,"ENSG00000079974.19"
"13818","ENSG00000143603.19_151860",151852,151860,9,"ENSG00000143603.19",1,5,"VVVVMUVVV",1,7,0.808695652173913,40,46,70,73,77,83,133,136,"CTGATGA","CTGA","TTAATGA","CTCA",2.52971635705294,24,4,50,87,1.05824266615638,4.48075459496066,7.71553720365631,101,"ENSG00000079974.19"
"4621","ENSG00000101336.18_36562",36554,36562,9,"ENSG00000101336.18",1,3,"UVMVVVVVV",1,7,0.785507246376811,98,104,110,113,116,122,133,136,"ATGATGA","GTAA","ATAATGG","TTGA",2.35185092761947,6,3,11,29,2.61485576578733,4.57346548747928,7.71549447298652,101,"ENSG00000079974.19"
"39148","ENSG00000253117.5_28895",28887,28895,9,"ENSG00000253117.5",1,8,"UVVVVVVMV",1,7,0.786749482401656,108,114,133,136,142,148,162,165,"CTGTTGA","GGGA","TTGAAGG","CTGA",2.37601840674525,19,6,14,48,2.43383939366063,4.5684905263239,7.71548845593053,101,"ENSG00000079974.19"
"41036","ENSG00000258417.3_55168",55160,55168,9,"ENSG00000258417.3",1,8,"UVVVVVVMV",1,7,0.786749482401656,108,114,133,136,142,148,162,165,"CTGTTGA","GGGA","TTGAAGG","CTGA",2.37601840674525,19,6,14,48,2.43383939366063,4.5684905263239,7.71548845593053,101,"ENSG00000079974.19"
"34229","ENSG00000232234.4_57681",57673,57681,9,"ENSG00000232234.4",1,2,"VMVVVUVVV",1,7,0.806211180124223,116,122,133,136,142,148,195,198,"TTGTTTA","CTTA","ATGAAGA","CTGA",2.39987819826114,11,6,47,73,1.96336679841651,4.49063869670603,7.71548341720292,101,"ENSG00000079974.19"
"45177","ENSG00000285216.1_2230",2222,2230,9,"ENSG00000285216.1",1,2,"VMVVVUVVV",1,7,0.806211180124223,116,122,133,136,142,148,195,198,"TTGTTTA","CTTA","ATGAAGA","CTGA",2.39987819826114,11,6,47,73,1.96336679841651,4.49063869670603,7.71548341720292,101,"ENSG00000079974.19"
"9641","ENSG00000125954.13_44655",44647,44655,9,"ENSG00000125954.13",1,8,"VVVVUVVMV",1,7,0.773913043478261,89,95,133,136,143,149,158,161,"GTAATGA","GAGA","AGGATGA","CTGA",2.47158876295211,38,7,9,63,2.00156659607148,4.61970625393805,7.71535842785109,101,"ENSG00000079974.19"
"8599","ENSG00000119698.12_82289",82281,82289,9,"ENSG00000119698.12",1,2,"VMVVVUVVV",1,7,0.806211180124223,106,112,133,136,150,156,176,179,"ATTCTGT","CTGT","GTGATGA","CTGA",2.46191958367154,21,14,20,64,1.54899297128358,4.49044754894013,7.71529226943703,101,"ENSG00000079974.19"
"16633","ENSG00000151929.10_2857",2849,2857,9,"ENSG00000151929.10",1,8,"VVUVVVVMV",1,7,0.767701863354037,116,122,133,136,147,153,165,168,"ATAATGA","CTTG","AGGGCGA","CTGA",2.36960185245815,11,11,12,43,2.78034280521069,4.64442212206625,7.7152295754824,101,"ENSG00000079974.19"
"6856","ENSG00000112137.19_75270",75262,75270,9,"ENSG00000112137.19",1,3,"VVMVVVUVV",1,7,0.768944099378882,113,119,133,136,147,153,161,164,"ATGATGC","CTGG","TTGAAGC","TTGA",2.36418707224127,14,11,8,42,2.79655794474881,4.63945127325599,7.71522767077152,101,"ENSG00000079974.19"
"21097","ENSG00000166436.18_19780",19772,19780,9,"ENSG00000166436.18",1,5,"VVVVMUVVV",1,7,0.808695652173913,71,77,93,96,105,111,133,136,"ATTCTGT","CTGA","ATTATAC","CTGA",2.35883200375746,16,9,22,56,2.19607645856274,4.48040578756979,7.71518839626544,101,"ENSG00000079974.19"
"19682","ENSG00000163606.11_3584",3576,3584,9,"ENSG00000163606.11",1,8,"UVVVVVVMV",1,7,0.786749482401656,85,91,133,136,144,150,161,164,"AACATGA","CTGT","CTGAGGT","CTGA",2.44491116514363,42,8,11,70,1.97308171648263,4.56812237102671,7.71512030063333,101,"ENSG00000079974.19"
"6685","ENSG00000111404.7_190640",190632,190640,9,"ENSG00000111404.7",1,3,"UVMVVVVVV",1,7,0.785507246376811,91,97,133,136,145,151,191,194,"ATGATGA","CTAT","CTGATAG","CTGA",2.59726843943443,36,9,40,94,0.977218391425048,4.57308533024698,7.71511431575422,101,"ENSG00000079974.19"
"25570","ENSG00000182168.15_99068",99060,99068,9,"ENSG00000182168.15",1,1,"MVVVVUUVV",2,6,0.714285714285714,112,118,133,136,163,169,222,225,"GTGATGA","CAGA","ATGATGT","CTGA",2.76502115092964,15,27,53,104,0.998355178016132,4.85795737938677,7.71510023652962,101,"ENSG00000079974.19"
"26508","ENSG00000184345.5_291",283,291,9,"ENSG00000184345.5",1,8,"VVVVVUVMV",1,7,0.806211180124224,74,80,95,98,112,118,133,136,"CTGATGA","TTTA","TTGAGGA","TTGA",2.34171138220504,15,14,15,53,2.34953424156411,4.49023586406609,7.71508058456298,101,"ENSG00000079974.19"
"36237","ENSG00000239268.5_171324",171316,171324,9,"ENSG00000239268.5",1,5,"VVVVMUVVV",1,7,0.808695652173913,112,118,133,136,141,147,156,159,"AGGCTGT","CTGG","GTACCGA","CTGA",2.2532570994277,15,5,9,38,2.89939127144395,4.48027631690715,7.7150589256028,101,"ENSG00000079974.19"
"11641","ENSG00000135605.13_106291",106283,106291,9,"ENSG00000135605.13",1,2,"VMUVVVVVV",1,7,0.767701863354037,115,121,133,136,147,153,161,164,"CTGATGT","GAGA","ATAATAT","CTGA",2.35926334429068,12,11,8,40,2.84852128879153,4.64423589601568,7.71504334943183,101,"ENSG00000079974.19"
"21814","ENSG00000169064.13_43541",43533,43541,9,"ENSG00000169064.13",1,8,"UVVVVVVMV",1,7,0.786749482401656,99,105,133,136,143,149,159,162,"ATAATGT","TTGA","ATTTAGA","CTGA",2.4291008927569,28,7,10,54,2.07802709333375,4.56800826126161,7.71500619086823,101,"ENSG00000079974.19"
"24747","ENSG00000177694.16_863475",863467,863475,9,"ENSG00000177694.16",1,8,"VVVVVUVMV",1,7,0.806211180124224,115,121,133,136,184,190,205,208,"ATGGTGA","GTAA","GTGGGTA","CTGA",2.42129822692628,12,48,15,84,1.81860902958668,4.49014930227381,7.71499402277071,101,"ENSG00000079974.19"
"42354","ENSG00000261742.6_30781",30773,30781,9,"ENSG00000261742.6",1,1,"MVVVVUVVV",1,7,0.82815734989648,113,119,133,136,157,163,174,177,"CTCAGGA","CTGT","ATCATAA","CTGA",2.31317735608757,14,21,11,55,2.1880838288605,4.40231655069442,7.71494595028034,101,"ENSG00000079974.19"
"21974","ENSG00000169436.17_199783",199775,199783,9,"ENSG00000169436.17",1,1,"MVVVVVUVV",1,7,0.792132505175983,8,14,29,32,71,77,133,136,"GGGATGA","CTGA","ATAAAGG","CTGA",2.58997257004711,15,39,56,119,0.919162271012701,4.54641151783169,7.71494153853563,101,"ENSG00000079974.19"
"11356","ENSG00000134744.14_144424",144416,144424,9,"ENSG00000134744.14",1,1,"MVVVVUVVV",1,7,0.82815734989648,85,91,133,136,150,156,168,171,"ATGCTGC","CTGT","ATGGAAA","CTGA",2.40413816737522,42,14,12,77,1.58155855755559,4.40228658501426,7.71491598460018,101,"ENSG00000079974.19"
"29655","ENSG00000198561.16_33641",33633,33641,9,"ENSG00000198561.16",1,8,"VVVVVUVMV",1,7,0.806211180124224,112,118,133,136,141,147,176,179,"GTGATAG","CTCA","TTGTAGA","CTGA",2.3955586888846,15,5,29,58,1.98987271555205,4.49006599369568,7.71491071419257,101,"ENSG00000079974.19"
"40024","ENSG00000254732.2_45105",45097,45105,9,"ENSG00000254732.2",1,8,"VVVVVUVMV",1,7,0.806211180124224,112,118,133,136,141,147,176,179,"GTGATAG","CTCA","TTGTAGA","CTGA",2.3955586888846,15,5,29,58,1.98987271555205,4.49006599369568,7.71491071419257,101,"ENSG00000079974.19"
"47470","ENSG00000288534.1_74302",74294,74302,9,"ENSG00000288534.1",1,8,"VVVVVUVMV",1,7,0.806211180124224,112,118,133,136,141,147,176,179,"GTGATAG","CTCA","TTGTAGA","CTGA",2.3955586888846,15,5,29,58,1.98987271555205,4.49006599369568,7.71491071419257,101,"ENSG00000079974.19"
"6872","ENSG00000112182.16_127651",127643,127651,9,"ENSG00000112182.16",1,8,"UVVVVVVMV",1,7,0.786749482401656,113,119,133,136,154,160,169,172,"ATGTTTA","CAGA","TTAATCA","CTGA",2.39033079587805,14,18,9,50,2.33605336437419,4.56789800089029,7.71489593049692,101,"ENSG00000079974.19"
"23764","ENSG00000173926.6_88563",88555,88563,9,"ENSG00000173926.6",1,3,"VVMVUVVVV",1,7,0.772670807453416,39,45,60,63,107,113,133,136,"GTGATTA","CTCA","GTGAAGT","CTGA",2.56014943303383,15,44,20,88,1.42915423777267,4.62420428116622,7.71488751097988,101,"ENSG00000079974.19"
"18147","ENSG00000156269.5_11680",11672,11680,9,"ENSG00000156269.5",1,6,"VVUVVMVVV",1,7,0.786335403726708,83,89,106,109,116,122,133,136,"GTGATTG","CTGA","CTGATCA","TTGA",2.32930476300602,17,7,11,44,2.74945851448307,4.56953923363081,7.71488084853764,101,"ENSG00000079974.19"
"16583","ENSG00000151812.15_403628",403620,403628,9,"ENSG00000151812.15",0,NA,"VVVVUVUVV",2,7,0.775983436853002,78,84,96,99,105,111,133,136,"ATGGTAA","ATGA","ATAATCA","CTGA",2.40765465008391,12,6,22,49,2.39275669173859,4.61094692307449,7.7148806704865,101,"ENSG00000079974.19"
"10200","ENSG00000129682.16_558912",558904,558912,9,"ENSG00000129682.16",1,6,"VVVVVMUVV",1,7,0.788819875776397,111,117,133,136,151,157,207,210,"ATGTTGA","TTGA","ATGGTCC","CTGA",2.52662862073188,16,15,50,90,1.39420041850854,4.55959780584693,7.71487730895252,101,"ENSG00000079974.19"
"21607","ENSG00000168490.14_3036",3028,3036,9,"ENSG00000168490.14",1,7,"UVVVVVMVV",1,7,0.787991718426501,86,92,108,111,115,121,133,136,"ATTATGA","CTAA","ATGTTAA","ATGA",2.33901881043628,16,4,12,41,2.65788790436904,4.56283666015272,7.71480353385873,101,"ENSG00000079974.19"
"4263","ENSG00000099991.18_97523",97515,97523,9,"ENSG00000099991.18",1,1,"MVVUVVVVV",1,7,0.786749482401656,109,115,133,136,165,171,182,185,"ATGATGA","CAGA","CTGATCC","CTGT",2.48366450159707,18,29,11,67,1.71339533469278,4.56778966966832,7.71478759927494,101,"ENSG00000079974.19"
"7153","ENSG00000112977.16_49945",49937,49945,9,"ENSG00000112977.16",1,2,"VMUVVVVVV",1,7,0.767701863354037,114,120,133,136,143,149,197,200,"CTGATGA","CAGG","CGGGTGA","CTGA",2.48646886290002,13,7,48,77,1.99943951928136,4.64397465132037,7.71478210473652,101,"ENSG00000079974.19"
"35454","ENSG00000236107.10_154310",154302,154310,9,"ENSG00000236107.10",1,8,"VVVUVVVMV",1,7,0.764803312629399,115,121,133,136,151,157,173,176,"ACAATGT","CTGA","GAGATTA","CTGA",2.44642039710847,12,15,16,52,2.31279323573076,4.65556563744681,7.71477888796441,101,"ENSG00000079974.19"
"30215","ENSG00000204138.13_36836",36828,36836,9,"ENSG00000204138.13",1,2,"UMVVVVVVV",1,7,0.786749482401656,111,117,133,136,182,188,202,205,"TTGATGA","CTCT","TTGTTAA","CTGA",2.48391622912598,16,46,14,85,1.71137509664347,4.5677041560375,7.71470208564413,101,"ENSG00000079974.19"
"31881","ENSG00000225148.1_1731",1723,1731,9,"ENSG00000225148.1",1,2,"VMVVVUVVV",1,7,0.806211180124223,111,117,133,136,141,147,159,162,"ATAATAA","ATGC","GTGACTG","CTGA",2.28218415340219,16,5,12,42,2.74482874259766,4.48984744131973,7.71469216181662,101,"ENSG00000079974.19"
"21098","ENSG00000166436.18_37691",37683,37691,9,"ENSG00000166436.18",0,NA,"VVVVUVUVV",2,7,0.775983436853002,106,112,133,136,143,149,158,161,"ATGATGA","GTGG","GTGAGAA","CAGA",2.40456960709816,21,7,9,46,2.41253869010613,4.6107506843568,7.7146844317688,101,"ENSG00000079974.19"
"18883","ENSG00000159200.18_77012",77004,77012,9,"ENSG00000159200.18",1,2,"VMVVVUVVV",1,7,0.806211180124223,107,113,133,136,147,153,172,175,"ATCATGA","GTAA","GTTCAGA","CTGA",2.40879083597853,20,11,19,59,1.90071284789866,4.48982960527221,7.7146743257691,101,"ENSG00000079974.19"
"47597","ENSG00000288711.1_76812",76804,76812,9,"ENSG00000288711.1",1,2,"VMVVVUVVV",1,7,0.806211180124223,107,113,133,136,147,153,172,175,"ATCATGA","GTAA","GTTCAGA","CTGA",2.40879083597853,20,11,19,59,1.90071284789866,4.48982960527221,7.7146743257691,101,"ENSG00000079974.19"
"22476","ENSG00000170624.14_307798",307790,307798,9,"ENSG00000170624.14",1,2,"VMVVVVUVV",1,7,0.770186335403727,85,91,133,136,145,151,166,169,"ATGTTGA","GTGA","GTATTCA","CTGA",2.51509974595598,42,9,15,75,1.76836735193065,4.63392474790929,7.7146700895242,101,"ENSG00000079974.19"
"43762","ENSG00000273540.5_150975",150967,150975,9,"ENSG00000273540.5",0,NA,"VVVUVUVVV",2,7,0.802898550724638,82,88,103,106,116,122,133,136,"GTGATGG","TTGA","TTTTTGA","CAGA",2.28191670335654,15,10,11,45,2.79949049047824,4.5030671282138,7.71466133111235,101,"ENSG00000079974.19"
"13396","ENSG00000141337.13_48609",48601,48609,9,"ENSG00000141337.13",1,6,"VVVVVMUVV",1,7,0.788819875776397,112,118,133,136,145,151,159,162,"GGGAAGG","CTTA","TTGATGG","CTGA",2.30596965051085,15,9,8,41,2.8643814981537,4.55937812538984,7.71465762849543,101,"ENSG00000079974.19"
"18894","ENSG00000159216.19_233177",233169,233177,9,"ENSG00000159216.19",1,8,"VVVVUVVMV",1,7,0.773913043478261,111,117,133,136,141,147,163,166,"CTGAAGA","CTGT","GGAATAA","CTGA",2.39155984717075,16,5,16,46,2.53199886574366,4.61893279505384,7.71458496896688,101,"ENSG00000079974.19"
"18302","ENSG00000156959.9_29348",29340,29348,9,"ENSG00000156959.9",1,2,"VMVVVUVVV",1,7,0.806211180124223,88,94,103,106,114,120,133,136,"CTGAGGA","CTGA","GATATGT","CTAA",2.27579706858663,9,8,13,39,2.78682419156769,4.48970116220298,7.71454588269987,101,"ENSG00000079974.19"
"33136","ENSG00000228801.8_19230",19222,19230,9,"ENSG00000228801.8",1,2,"VMVVUVVVV",1,7,0.773913043478261,74,80,101,104,110,116,133,136,"CTGATTA","CTGA","GTGAGGA","TTGA",2.45761489432648,21,6,17,53,2.0913869014375,4.61887154923684,7.71452372314988,101,"ENSG00000079974.19"
"30593","ENSG00000205930.11_201178",201170,201178,9,"ENSG00000205930.11",1,8,"VVVVVUVMV",1,7,0.806211180124224,82,88,105,108,114,120,133,136,"AAGTTGT","CAGA","TGGATAA","CTGA",2.2941975132482,17,6,13,45,2.6639508472496,4.48965023389274,7.71449495438964,101,"ENSG00000079974.19"
"22083","ENSG00000169777.7_995",987,995,9,"ENSG00000169777.7",1,3,"UVMVVVVVV",1,7,0.785507246376811,103,109,133,136,147,153,185,188,"GTGATGA","CTCG","GTGTTGT","CTGA",2.57194724943115,24,11,32,76,1.14350772998953,4.57245568154929,7.71448466705654,101,"ENSG00000079974.19"
"38200","ENSG00000249781.7_192469",192461,192469,9,"ENSG00000249781.7",1,3,"UVMVVVVVV",1,7,0.785507246376811,103,109,133,136,147,153,185,188,"GTGATGA","CTCG","GTGTTGT","CTGA",2.57194724943115,24,11,32,76,1.14350772998953,4.57245568154929,7.71448466705654,101,"ENSG00000079974.19"
"8140","ENSG00000117000.9_22232",22224,22232,9,"ENSG00000117000.9",1,1,"MVVVVVUVV",1,7,0.792132505175983,113,119,133,136,144,150,162,165,"TAGTTGA","ATAA","GTGGTGA","CTGA",2.28939416035098,14,8,12,43,2.92097912702687,4.54590171567501,7.71443173637894,101,"ENSG00000079974.19"
"37083","ENSG00000245248.9_104889",104881,104889,9,"ENSG00000245248.9",1,8,"VVVVVUVMV",1,7,0.806211180124224,56,62,101,104,111,117,133,136,"AGGATGG","CCGA","GAGAAGG","CTGA",2.42965381473881,39,7,16,71,1.76058678553619,4.48956972094874,7.71441444144563,101,"ENSG00000079974.19"
"28030","ENSG00000188001.10_214617",214609,214617,9,"ENSG00000188001.10",1,1,"MVUVVVVVV",1,7,0.789648033126294,114,120,133,136,146,152,163,166,"GTGAAAA","ATGG","GTGAAGG","CTGA",2.29967649564447,13,10,11,43,2.89199271304926,4.55579233766977,7.71438447017494,101,"ENSG00000079974.19"
"38733","ENSG00000250954.6_156858",156850,156858,9,"ENSG00000250954.6",1,2,"VMVUVVVVV",1,7,0.764803312629399,90,96,133,136,146,152,166,169,"GTGATAA","CTGA","AGTCTGA","CTGA",2.52702196065155,37,10,14,70,1.77383869770555,4.65516294217897,7.71437619269656,101,"ENSG00000079974.19"
"47704","ENSG00000289084.1_410139",410131,410139,9,"ENSG00000289084.1",1,2,"VMVVVUVVV",1,7,0.806211180124223,52,58,69,72,76,82,133,136,"TTGAAGA","GTGA","ATCAGAA","CTGA",2.42151723436888,11,4,51,75,1.81447118395118,4.48947985326926,7.71432457376615,101,"ENSG00000079974.19"
"46831","ENSG00000287256.3_65960",65952,65960,9,"ENSG00000287256.3",1,8,"VVUVVVVMV",1,7,0.767701863354037,43,49,66,69,102,108,133,136,"GAGATGA","CAGA","GTGATGG","CTGA",2.62751703822484,17,33,25,84,1.05726841825819,4.64351216827261,7.71431962168876,101,"ENSG00000079974.19"
"8277","ENSG00000117751.18_1424",1416,1424,9,"ENSG00000117751.18",1,1,"MVVVVUVVV",1,7,0.82815734989648,115,121,133,136,179,185,217,220,"ATGCTGT","CTGT","ATGATTT","CTGA",2.47681860186758,12,43,32,96,1.09458228696637,4.40167657485423,7.71430597444015,101,"ENSG00000079974.19"
"38548","ENSG00000250387.3_30921",30913,30921,9,"ENSG00000250387.3",1,1,"MVUVVVVVV",1,7,0.789648033126294,80,86,100,103,113,119,133,136,"CTGAAGA","CTGA","CTTATGG","CTGT",2.32297998926439,14,10,14,47,2.73623958476761,4.55569321163256,7.71428534413773,101,"ENSG00000079974.19"
"45006","ENSG00000284696.2_14378",14370,14378,9,"ENSG00000284696.2",1,5,"VVVVMVUVV",1,7,0.772670807453416,77,83,107,110,115,121,133,136,"ATGATTA","CTGA","CTGAGAA","CAGA",2.45791180947431,24,5,12,50,2.10829792229732,4.62359416303151,7.71427739284518,101,"ENSG00000079974.19"
"35449","ENSG00000236088.12_165802",165794,165802,9,"ENSG00000236088.12",1,2,"VMVVVUVVV",1,7,0.806211180124223,113,119,133,136,178,184,198,201,"ATGTAGA","AGGA","GTGAGGA","CTGA",2.41763263395773,14,42,14,79,1.84017033604087,4.4894303072731,7.71427502776999,101,"ENSG00000079974.19"
"14045","ENSG00000144290.17_246864",246856,246864,9,"ENSG00000144290.17",1,1,"MVUVVVVVV",1,7,0.789648033126294,82,88,99,102,111,117,133,136,"GTCATGA","CTGA","ATTCAGA","TTGA",2.32991093993101,11,9,16,45,2.68993440327286,4.55566850070323,7.71426063320841,101,"ENSG00000079974.19"
"14519","ENSG00000145293.17_25705",25697,25705,9,"ENSG00000145293.17",0,NA,"UVVVVVUVV",2,7,0.788819875776397,97,103,133,136,147,153,165,168,"GTGCTTA","CTGA","AAGATCA","CTGA",2.45987996862423,30,11,12,62,1.83669348622587,4.55897331926352,7.71425282236912,101,"ENSG00000079974.19"
"4097","ENSG00000095002.15_174451",174443,174451,9,"ENSG00000095002.15",1,6,"VVVVUMVVV",1,7,0.792546583850932,112,118,133,136,142,148,167,170,"AAGATGC","GTAA","ATGATAT","CTGA",2.35595867248122,15,6,19,49,2.46976436755127,4.54403887935652,7.71422521476025,101,"ENSG00000079974.19"
"12932","ENSG00000139618.18_66780",66772,66780,9,"ENSG00000139618.18",0,NA,"VVVVUVUVV",2,7,0.775983436853002,93,99,133,136,142,148,181,184,"ATGATGA","GTCA","TTGTTGT","CTGA",2.60537295352298,34,6,33,82,1.07190308133892,4.61026402620637,7.71419777361838,101,"ENSG00000079974.19"
"45145","ENSG00000285095.2_21472",21464,21472,9,"ENSG00000285095.2",1,7,"UVVVVVMVV",1,7,0.787991718426501,115,121,133,136,150,156,173,176,"ATGATAA","CCTA","GTCATTG","CTGA",2.38919633284202,12,14,17,52,2.32085406700248,4.56220740482066,7.71417427852666,101,"ENSG00000079974.19"
"15671","ENSG00000149177.15_172702",172694,172702,9,"ENSG00000149177.15",1,8,"VVVVVUVMV",1,7,0.806211180124224,102,108,133,136,141,147,165,168,"GAGATGA","TTAA","GTGCTGC","CTGA",2.43269686605016,25,5,18,57,1.73926735920601,4.48931161655177,7.71415633704867,101,"ENSG00000079974.19"
"4044","ENSG00000092439.16_65273",65265,65273,9,"ENSG00000092439.16",1,8,"UVVVVVVMV",1,7,0.786749482401656,115,121,133,136,150,156,169,172,"ATGATTA","TTGA","CTGAAGG","CTCA",2.35869255736864,12,14,13,48,2.54391809797968,4.56713378677598,7.71413171638261,101,"ENSG00000079974.19"
"2758","ENSG00000078114.19_399075",399067,399075,9,"ENSG00000078114.19",1,8,"VVVVVUVMV",1,7,0.806211180124224,88,94,133,136,144,150,186,189,"ATGATGC","GTTA","TTGATAA","CTGA",2.53863326856051,39,8,36,92,1.03288968289618,4.4892778683249,7.7141225888218,101,"ENSG00000079974.19"
"4728","ENSG00000101842.14_11753",11745,11753,9,"ENSG00000101842.14",1,2,"VMVVVUVVV",1,7,0.806211180124223,86,92,106,109,114,120,133,136,"ATGATTA","CTGC","ATGGCTA","GTGA",2.2677594079444,14,5,13,41,2.83865348206628,4.48926238375724,7.71410710425414,101,"ENSG00000079974.19"
"30109","ENSG00000203711.16_36112",36104,36112,9,"ENSG00000203711.16",1,8,"VVVVVUVMV",1,7,0.806211180124224,86,92,106,109,116,122,133,136,"CTGATGA","TAGA","GTTTAGA","CAGA",2.24747483048256,14,7,11,41,2.97383677531519,4.4892505779664,7.7140952984633,101,"ENSG00000079974.19"
"44726","ENSG00000283453.3_192478",192470,192478,9,"ENSG00000283453.3",1,3,"UVMVVVVVV",1,7,0.785507246376811,113,119,133,136,140,146,164,167,"CTGTTGA","CCCA","ATGAAAA","CTGA",2.37665528815106,14,4,18,45,2.44374705213794,4.57202890995291,7.71405789546016,101,"ENSG00000079974.19"
"48199","ENSG00000290597.1_119959",119951,119959,9,"ENSG00000290597.1",1,3,"UVMVVVVVV",1,7,0.785507246376811,113,119,133,136,140,146,164,167,"CTGTTGA","CCCA","ATGAAAA","CTGA",2.37665528815106,14,4,18,45,2.44374705213794,4.57202890995291,7.71405789546016,101,"ENSG00000079974.19"
"7070","ENSG00000112699.11_209137",209129,209137,9,"ENSG00000112699.11",1,8,"VVVVUVVMV",1,7,0.773913043478261,86,92,133,136,144,150,165,168,"TTGATGT","TTGA","GTGCCAA","CTGA",2.50031029022777,41,8,15,73,1.80472155963959,4.61836420695618,7.71401638086922,101,"ENSG00000079974.19"
"888","ENSG00000039068.20_91067",91059,91067,9,"ENSG00000039068.20",1,8,"VVVVUVVMV",1,7,0.773913043478261,46,52,62,65,105,111,133,136,"ATGATGA","CGGA","GTGGTGA","ATGA",2.57085601995255,10,40,22,81,1.33431378026914,4.61833847832153,7.71399065223457,101,"ENSG00000079974.19"
"16238","ENSG00000151229.13_235291",235283,235291,9,"ENSG00000151229.13",1,3,"VVMVVUVVV",1,7,0.804968944099379,116,122,133,136,184,190,230,233,"ATGAAGA","TTCA","GTGCTGA","CTGA",2.546959620742,11,48,40,108,0.996708827118023,4.49410990801617,7.71398568441369,101,"ENSG00000079974.19"
"23452","ENSG00000172987.13_150353",150345,150353,9,"ENSG00000172987.13",1,1,"MVVVVVUVV",1,7,0.792132505175983,66,72,85,88,95,101,133,136,"ATGCTGA","ATGA","ATGATGG","GTGA",2.4143540801635,13,7,32,61,2.08595446593717,4.54541208342345,7.71394210412738,101,"ENSG00000079974.19"
"26826","ENSG00000185046.20_854347",854339,854347,9,"ENSG00000185046.20",1,1,"MVVUVUVVV",2,6,0.708902691511387,116,122,133,136,144,150,163,166,"AGGATGA","AAGA","AGGAAGA","CTGA",2.49127154478131,11,8,13,41,2.90473314802163,4.87830252830759,7.71391329435313,101,"ENSG00000079974.19"
"7988","ENSG00000116199.12_3900",3892,3900,9,"ENSG00000116199.12",1,1,"MVVUVVVVV",1,7,0.786749482401656,112,118,133,136,142,148,157,160,"ATTATGA","CAGA","GTACAGA","GTGA",2.29963541583347,15,6,9,39,2.93671406819146,4.56690421010365,7.71390213971027,101,"ENSG00000079974.19"
"515","ENSG00000015479.20_3292",3284,3292,9,"ENSG00000015479.20",0,NA,"UVVUVVVVV",2,7,0.78343685300207,58,64,78,81,91,97,133,136,"ATGATTG","GTGA","ATTAGGA","CTGA",2.46214569142509,14,10,36,69,1.90621428401564,4.58012972337906,7.71387713538734,101,"ENSG00000079974.19"
"44333","ENSG00000280987.4_23214",23206,23214,9,"ENSG00000280987.4",0,NA,"UVVUVVVVV",2,7,0.78343685300207,58,64,78,81,91,97,133,136,"ATGATTG","GTGA","ATTAGGA","CTGA",2.46214569142509,14,10,36,69,1.90621428401564,4.58012972337906,7.71387713538734,101,"ENSG00000079974.19"
"22908","ENSG00000171723.16_265803",265795,265803,9,"ENSG00000171723.16",1,5,"UVVVMVVVV",1,7,0.789233954451346,113,119,133,136,140,146,154,157,"AAGATGG","CTTT","GTGCTTT","CTGA",2.29713086333801,14,4,8,35,2.91345959558434,4.55691633779277,7.71385215559816,101,"ENSG00000079974.19"
"6363","ENSG00000109586.12_14564",14556,14564,9,"ENSG00000109586.12",1,2,"VMVUVVVVV",1,7,0.764803312629399,113,119,133,136,155,161,175,178,"ATGATGA","GTGA","AAGATTA","CTGG",2.46906606230761,14,19,14,56,2.15800361379361,4.65461100729443,7.71382425781202,101,"ENSG00000079974.19"
"24895","ENSG00000178568.15_285424",285416,285424,9,"ENSG00000178568.15",1,8,"UVVVVVVMV",1,7,0.786749482401656,113,119,133,136,142,148,191,194,"TTAATGT","ATGA","CTGATAA","CTGA",2.44625387474964,14,6,43,72,1.95885831290406,4.56680436947542,7.71380229908205,101,"ENSG00000079974.19"
"47159","ENSG00000287722.1_351821",351813,351821,9,"ENSG00000287722.1",1,3,"VVMVUVVVV",1,7,0.772670807453416,115,121,133,136,143,149,170,173,"TTGAGGA","AAGA","ATGAGTA","CTGA",2.40455635614525,12,7,21,49,2.46164960855905,4.62300632904851,7.71368955886217,101,"ENSG00000079974.19"
"16562","ENSG00000151789.13_713410",713402,713410,9,"ENSG00000151789.13",1,7,"UVVVVVMVV",1,7,0.787991718426501,115,121,133,136,143,149,165,168,"GTAATCA","CAGA","ATCAAAA","CTGA",2.32192727635641,12,7,16,44,2.76737040921505,4.56172139623111,7.71368826993711,101,"ENSG00000079974.19"
"22379","ENSG00000170419.11_21258",21250,21258,9,"ENSG00000170419.11",1,1,"MVVVVUVVV",1,7,0.82815734989648,32,38,50,53,71,77,133,136,"ATGAAAA","CAGA","AGGAGGA","CTGA",2.43454445864102,12,18,56,95,1.37349499196582,4.40094784572649,7.71357724531241,101,"ENSG00000079974.19"
"31631","ENSG00000224223.1_6613",6605,6613,9,"ENSG00000224223.1",1,1,"MVVVVUVVV",1,7,0.82815734989648,32,38,50,53,71,77,133,136,"ATGAAAA","CAGA","AGGAGGA","CTGA",2.43454445864102,12,18,56,95,1.37349499196582,4.40094784572649,7.71357724531241,101,"ENSG00000079974.19"
"28447","ENSG00000189127.8_5966",5958,5966,9,"ENSG00000189127.8",0,NA,"UVVVVUVVV",2,7,0.824844720496894,106,112,133,136,143,149,181,184,"AGGATGA","TTGG","ATGGCGG","CTGA",2.42346560915231,21,7,32,69,1.50016671780937,4.41415102803953,7.71352991002711,101,"ENSG00000079974.19"
"21531","ENSG00000168216.13_10808",10800,10808,9,"ENSG00000168216.13",1,2,"VMUVVVVVV",1,7,0.767701863354037,71,77,93,96,113,119,133,136,"CTTAGGA","CTGA","CTGTGGA","CTGA",2.46501846544851,16,17,14,56,2.13738062442858,4.642709265188,7.71351671860415,101,"ENSG00000079974.19"
"35508","ENSG00000236212.2_39185",39177,39185,9,"ENSG00000236212.2",0,NA,"VVVUVVUVV",2,7,0.766873706004141,109,115,133,136,142,148,175,178,"GTGAAGA","TTAA","GTGAGGA","CTGA",2.50954931173862,18,6,27,60,1.85370258198037,4.64600783172612,7.71350265574268,101,"ENSG00000079974.19"
"25596","ENSG00000182185.19_99258",99250,99258,9,"ENSG00000182185.19",1,5,"VVVVMUVVV",1,7,0.808695652173913,109,115,133,136,145,151,206,209,"AGGATGA","TAGA","GTACAGA","CTGA",2.44456937483915,18,9,55,91,1.61766663436845,4.4786989499907,7.71348155868635,101,"ENSG00000079974.19"
"34786","ENSG00000234147.4_199767",199759,199767,9,"ENSG00000234147.4",1,6,"UVVVVMVVV",1,7,0.805383022774327,81,87,104,107,111,117,133,136,"ATGATGA","CTGA","ATAATAA","ATAA",2.34184966216216,17,4,16,46,2.35540152092027,4.49193315050034,7.71346524159765,101,"ENSG00000079974.19"
"13360","ENSG00000141076.18_14637",14629,14637,9,"ENSG00000141076.18",1,8,"UVVVVVVMV",1,7,0.786749482401656,109,115,133,136,139,145,154,157,"ATGATGA","ATAA","ATGATTC","ATGA",2.37825885457691,18,3,9,39,2.41065720183996,4.56642905808817,7.7134269876948,101,"ENSG00000079974.19"
"47008","ENSG00000287478.1_6023",6015,6023,9,"ENSG00000287478.1",1,2,"VMVVVUVVV",1,7,0.806211180124223,107,113,133,136,138,144,159,162,"ATGTTTA","CTTA","ATGCTAA","CTGA",2.41760306188623,20,2,15,46,1.83680813833844,4.48854047106166,7.71338519155856,101,"ENSG00000079974.19"
"4284","ENSG00000100077.16_17011",17003,17011,9,"ENSG00000100077.16",1,8,"VVVVVUVMV",1,7,0.806211180124224,86,92,133,136,157,163,176,179,"AGGATGA","CAGT","ACGATGA","CTGA",2.51934242307512,41,21,13,84,1.15853770833966,4.48853846554345,7.71338318604034,101,"ENSG00000079974.19"
"30467","ENSG00000205054.9_22961",22953,22961,9,"ENSG00000205054.9",1,2,"VMVVUVVVV",1,7,0.773913043478261,96,102,133,136,143,149,157,160,"AAGAGGA","CTGA","ATAGTGC","CTGA",2.46879619342349,31,7,8,55,2.01224736441911,4.61772216347725,7.7133743373903,101,"ENSG00000079974.19"
"30035","ENSG00000198961.10_5110",5102,5110,9,"ENSG00000198961.10",1,8,"VVVVVUVMV",1,7,0.806211180124224,68,74,87,90,113,119,133,136,"ATGATGT","GTGA","CTGATCT","TTGA",2.38708663621982,13,23,14,59,2.04004895092253,4.48848996476366,7.71333468526056,101,"ENSG00000079974.19"
"32180","ENSG00000226266.8_12754",12746,12754,9,"ENSG00000226266.8",1,1,"MVVVVUVVV",1,7,0.82815734989648,116,122,133,136,156,162,172,175,"CAGATGG","GTAA","CTGATTA","CTGA",2.30236685068413,11,20,10,50,2.25355634868482,4.40066717164475,7.71329657123067,101,"ENSG00000079974.19"
"3368","ENSG00000083067.25_452178",452170,452178,9,"ENSG00000083067.25",1,8,"VVVUVVVMV",1,7,0.764803312629399,95,101,133,136,148,154,165,168,"CTGATGC","GTGA","CTGGAGA","CTGA",2.52619302210086,32,12,11,64,1.77500101403963,4.65407195701134,7.71328520752894,101,"ENSG00000079974.19"
"13776","ENSG00000143469.21_218981",218973,218981,9,"ENSG00000143469.21",1,2,"VMVVVVUVV",1,7,0.770186335403727,109,115,133,136,144,150,160,163,"ATGAGGT","TTGA","AATATTA","CTGA",2.38066991944061,18,8,10,45,2.65898769979868,4.63253012401735,7.71327546563226,101,"ENSG00000079974.19"
"38815","ENSG00000251095.8_107705",107697,107705,9,"ENSG00000251095.8",1,6,"UVVVUMVVV",2,6,0.695238095238095,96,102,133,136,183,189,206,209,"ATGATGA","CTGA","CTGACAA","CTGA",2.84966216216216,31,47,17,104,0.731469187118479,4.93230423371656,7.71325661466894,101,"ENSG00000079974.19"
"25218","ENSG00000179915.25_993762",993754,993762,9,"ENSG00000179915.25",1,8,"VVVVVVUMV",1,7,0.770186335403727,108,114,133,136,149,155,181,184,"ATGTTGT","CTCA","GTGATGT","CTGA",2.55339565649794,19,13,26,67,1.50733204748311,4.63249243936735,7.71323778098226,101,"ENSG00000079974.19"
"4424","ENSG00000100523.16_92999",92991,92999,9,"ENSG00000100523.16",1,7,"VVVVVUMVV",1,7,0.807453416149068,113,119,133,136,146,152,200,203,"AGAATGA","GTGA","ATGTGGC","CTGA",2.41015216208064,14,10,48,81,1.8659520458772,4.4834082816037,7.71322194619998,101,"ENSG00000079974.19"
"274","ENSG00000007237.19_107926",107918,107926,9,"ENSG00000007237.19",1,3,"VVMVVVUVV",1,7,0.768944099378882,111,117,133,136,153,159,176,179,"TTGATGT","CTGG","GTGTTTT","CTGA",2.48788661029001,16,17,17,59,1.96361014579796,4.63738022026617,7.7131566177817,101,"ENSG00000079974.19"
"23703","ENSG00000173588.16_145107",145099,145107,9,"ENSG00000173588.16",1,8,"UVVVVVVMV",1,7,0.786749482401656,116,122,133,136,142,148,156,159,"ATGTTGA","CAGA","AAGAGCA","ATGA",2.2738463512686,11,6,8,34,3.10547079730643,4.56611161810761,7.71310954771424,101,"ENSG00000079974.19"
"27049","ENSG00000185483.13_29969",29961,29969,9,"ENSG00000185483.13",1,2,"UMVVVVVVV",1,7,0.786749482401656,108,114,133,136,155,161,169,172,"ATAATGT","ATGA","CTTTTGA","CTGA",2.45764427891528,19,19,8,55,1.87976546134538,4.56601516352847,7.7130130931351,101,"ENSG00000079974.19"
"37560","ENSG00000248468.2_17345",17337,17345,9,"ENSG00000248468.2",1,1,"MVVVVVUVV",1,7,0.792132505175983,36,42,59,62,111,117,133,136,"ATGTGGA","CTGA","ACTATGA","CTGA",2.49946236815503,17,49,16,91,1.51462878348042,4.54442780946182,7.71295783016575,101,"ENSG00000079974.19"
"8211","ENSG00000117419.16_108999",108991,108999,9,"ENSG00000117419.16",1,1,"MVVVVUVVV",1,7,0.82815734989648,112,118,133,136,141,147,158,161,"AGGAGGA","CTGT","ATGAGAA","TTGA",2.21120482027043,15,5,11,40,2.85983504323997,4.40030012792737,7.71292952751329,101,"ENSG00000079974.19"
"20069","ENSG00000164199.18_543026",543018,543026,9,"ENSG00000164199.18",1,6,"UVVVVMVVV",1,7,0.805383022774327,90,96,133,136,152,158,169,172,"CTGATGT","GTGA","ATTTAGA","CTGA",2.47302886199862,37,16,11,73,1.4786981891552,4.49138931728651,7.71292140838382,101,"ENSG00000079974.19"
"14909","ENSG00000146143.19_260526",260518,260526,9,"ENSG00000146143.19",1,3,"UVMVVVVVV",1,7,0.785507246376811,113,119,133,136,140,146,164,167,"CTGCTGA","CCCA","ATGAAAA","CTGA",2.37594957184901,14,4,18,45,2.44374705213794,4.57085271611617,7.71288170162342,101,"ENSG00000079974.19"
"11741","ENSG00000135951.16_20729",20721,20729,9,"ENSG00000135951.16",1,1,"MVVVVVUVV",1,7,0.792132505175983,110,116,133,136,144,150,158,161,"AATATGG","CAGA","TTGATTG","CTGA",2.31572335057106,17,8,8,42,2.7391952019519,4.54433771810641,7.71286773881034,101,"ENSG00000079974.19"
"7537","ENSG00000114686.9_6502",6494,6502,9,"ENSG00000114686.9",1,2,"VMVVVUUVV",2,6,0.692339544513457,89,95,102,105,109,115,133,136,"ATGGTGA","CTGA","GTCAATA","CTGA",2.64428441320643,7,4,18,38,2.14539845618909,4.94349030272466,7.71284848077849,101,"ENSG00000079974.19"
"11821","ENSG00000136153.20_118340",118332,118340,9,"ENSG00000136153.20",1,1,"MVVVUVVVV",1,7,0.795859213250517,114,120,133,136,146,152,160,163,"ATCCTGA","CTAT","ATAATGT","CTGA",2.28155248309347,13,10,8,40,2.90710278039866,4.52936316692212,7.71280001992419,101,"ENSG00000079974.19"
"42294","ENSG00000261553.5_189001",188993,189001,9,"ENSG00000261553.5",1,1,"MVVVUVVVV",1,7,0.795859213250517,114,120,133,136,146,152,160,163,"ATCCTGA","CTAT","ATAATGT","CTGA",2.28155248309347,13,10,8,40,2.90710278039866,4.52936316692212,7.71280001992419,101,"ENSG00000079974.19"
"15055","ENSG00000146918.20_17472",17464,17472,9,"ENSG00000146918.20",1,7,"UVVVVVMVV",1,7,0.787991718426501,105,111,133,136,144,150,182,185,"GGGATTA","CTGA","GTGCTGT","CTGA",2.52438655133609,22,8,32,71,1.41403997291326,4.5608209121218,7.71278778582781,101,"ENSG00000079974.19"
"15433","ENSG00000148219.18_668677",668669,668677,9,"ENSG00000148219.18",1,1,"MVVVVVUVV",1,7,0.792132505175983,100,106,133,136,148,154,186,189,"AGGATGA","CTCA","ATGGTGG","CTGA",2.58271238721949,27,12,32,80,0.958922287118353,4.54425121714541,7.71278123784934,101,"ENSG00000079974.19"
"22246","ENSG00000170017.12_95845",95837,95845,9,"ENSG00000170017.12",1,7,"VVVVVUMVV",1,7,0.807453416149068,112,118,133,136,141,147,164,167,"ATCATCA","ATGC","GAGATTA","CTGA",2.30835526099532,15,5,17,46,2.542672494596,4.48292689197453,7.7127405565708,101,"ENSG00000079974.19"
"35561","ENSG00000236306.3_921",913,921,9,"ENSG00000236306.3",1,2,"VMVVVUUVV",2,6,0.692339544513457,113,119,133,136,162,168,185,188,"ATGAAGG","CTGA","CTGATGA","CTGA",2.70113898081215,14,26,17,66,1.76583645755259,4.94335741574172,7.71271559379555,101,"ENSG00000079974.19"
"39399","ENSG00000253553.9_5713",5705,5713,9,"ENSG00000253553.9",1,1,"MVVUVVVVV",1,7,0.786749482401656,111,117,133,136,152,158,167,170,"GTCATGC","CTAA","GTTATGC","CTGA",2.390534738099,16,16,9,50,2.32592373781962,4.56570549795323,7.71270342755986,101,"ENSG00000079974.19"
"40123","ENSG00000255041.1_32408",32400,32408,9,"ENSG00000255041.1",0,NA,"VVUUVVVVV",2,7,0.764389233954451,101,107,133,136,156,162,175,178,"ATGAGGA","CTGG","ATGAGCA","CTGA",2.59347494165242,26,20,13,68,1.33073396355095,4.65514172697511,7.71269866279291,101,"ENSG00000079974.19"
"22591","ENSG00000170921.16_75577",75569,75577,9,"ENSG00000170921.16",1,8,"VVVUVVVMV",1,7,0.764803312629399,44,50,63,66,112,118,133,136,"TTAATGA","CAGA","TGGATGA","CTGA",2.51986251973316,13,46,15,83,1.81483080889289,4.65347856844516,7.71269181896276,101,"ENSG00000079974.19"
"1376","ENSG00000054611.14_337447",337439,337447,9,"ENSG00000054611.14",1,7,"VVUVVVMVV",1,7,0.768944099378882,95,101,133,136,142,148,159,162,"ATGCTGA","GTGT","ATGAAAA","CTGA",2.48319106902747,32,6,11,58,1.99295025907046,4.63688934648007,7.7126657439956,101,"ENSG00000079974.19"
"3518","ENSG00000085377.15_130368",130360,130368,9,"ENSG00000085377.15",1,1,"MVUVVVVVV",1,7,0.789648033126294,114,120,133,136,142,148,203,206,"GAGGTGA","TTGA","CTGATTA","CTGA",2.43541866297949,13,6,55,83,1.98012769470625,4.55406302864238,7.71265516114756,101,"ENSG00000079974.19"
"26385","ENSG00000184115.18_2572",2564,2572,9,"ENSG00000184115.18",0,NA,"VVUVVVUVV",2,7,0.769772256728778,86,92,133,136,141,147,156,159,"CTGATGG","CTCA","TTGGTGC","CTGA",2.49046471656012,41,5,9,64,1.93103956879305,4.63353441979847,7.71262344671358,101,"ENSG00000079974.19"
"27427","ENSG00000186148.14_2561",2553,2561,9,"ENSG00000186148.14",0,NA,"VVUVVVUVV",2,7,0.769772256728778,86,92,133,136,141,147,156,159,"CTGATGG","CTCA","TTGGTGC","CTGA",2.49046471656012,41,5,9,64,1.93103956879305,4.63353441979847,7.71262344671358,101,"ENSG00000079974.19"
"40622","ENSG00000257207.5_51813",51805,51813,9,"ENSG00000257207.5",0,NA,"VVUVVVUVV",2,7,0.769772256728778,86,92,133,136,141,147,156,159,"CTGATGG","CTCA","TTGGTGC","CTGA",2.49046471656012,41,5,9,64,1.93103956879305,4.63353441979847,7.71262344671358,101,"ENSG00000079974.19"
"42360","ENSG00000261760.9_2436",2428,2436,9,"ENSG00000261760.9",0,NA,"VVUVVVUVV",2,7,0.769772256728778,86,92,133,136,141,147,156,159,"CTGATGG","CTCA","TTGGTGC","CTGA",2.49046471656012,41,5,9,64,1.93103956879305,4.63353441979847,7.71262344671358,101,"ENSG00000079974.19"
"43758","ENSG00000273471.1_12411",12403,12411,9,"ENSG00000273471.1",0,NA,"VVUVVVUVV",2,7,0.769772256728778,86,92,133,136,141,147,156,159,"CTGATGG","CTCA","TTGGTGC","CTGA",2.49046471656012,41,5,9,64,1.93103956879305,4.63353441979847,7.71262344671358,101,"ENSG00000079974.19"
"44474","ENSG00000282304.1_2601",2593,2601,9,"ENSG00000282304.1",0,NA,"VVUVVVUVV",2,7,0.769772256728778,86,92,133,136,141,147,156,159,"CTGATGG","CTCA","TTGGTGC","CTGA",2.49046471656012,41,5,9,64,1.93103956879305,4.63353441979847,7.71262344671358,101,"ENSG00000079974.19"
"44823","ENSG00000283684.1_12795",12787,12795,9,"ENSG00000283684.1",0,NA,"VVUVVVUVV",2,7,0.769772256728778,86,92,133,136,141,147,156,159,"CTGATGG","CTCA","TTGGTGC","CTGA",2.49046471656012,41,5,9,64,1.93103956879305,4.63353441979847,7.71262344671358,101,"ENSG00000079974.19"
"44894","ENSG00000284337.1_51801",51793,51801,9,"ENSG00000284337.1",0,NA,"VVUVVVUVV",2,7,0.769772256728778,86,92,133,136,141,147,156,159,"CTGATGG","CTCA","TTGGTGC","CTGA",2.49046471656012,41,5,9,64,1.93103956879305,4.63353441979847,7.71262344671358,101,"ENSG00000079974.19"
"48242","ENSG00000290731.1_17072",17064,17072,9,"ENSG00000290731.1",0,NA,"VVUVVVUVV",2,7,0.769772256728778,86,92,133,136,141,147,156,159,"CTGATGG","CTCA","TTGGTGC","CTGA",2.49046471656012,41,5,9,64,1.93103956879305,4.63353441979847,7.71262344671358,101,"ENSG00000079974.19"
"48243","ENSG00000290732.1_17086",17078,17086,9,"ENSG00000290732.1",0,NA,"VVUVVVUVV",2,7,0.769772256728778,86,92,133,136,141,147,156,159,"CTGATGG","CTCA","TTGGTGC","CTGA",2.49046471656012,41,5,9,64,1.93103956879305,4.63353441979847,7.71262344671358,101,"ENSG00000079974.19"
"48244","ENSG00000290733.1_13904",13896,13904,9,"ENSG00000290733.1",0,NA,"VVUVVVUVV",2,7,0.769772256728778,86,92,133,136,141,147,156,159,"CTGATGG","CTCA","TTGGTGC","CTGA",2.49046471656012,41,5,9,64,1.93103956879305,4.63353441979847,7.71262344671358,101,"ENSG00000079974.19"
"20830","ENSG00000165805.10_27609",27601,27609,9,"ENSG00000165805.10",1,2,"VMVVVUVVV",1,7,0.806211180124223,67,73,100,103,110,116,133,136,"ATTAAGT","CTGA","GTGCAGG","CTGA",2.42261588290831,27,7,17,60,1.80023811307096,4.48775266644826,7.71259738694516,101,"ENSG00000079974.19"
"7113","ENSG00000112851.16_20552",20544,20552,9,"ENSG00000112851.16",0,NA,"UVUVVVVVV",2,7,0.786335403726708,35,41,73,76,114,120,133,136,"CTGGTGA","CTGA","GAGATAA","CTGA",2.59729348261458,32,38,13,92,0.95362583336239,4.5672289293649,7.71257054427173,101,"ENSG00000079974.19"
"27045","ENSG00000185477.5_66005",65997,66005,9,"ENSG00000185477.5",1,1,"MVVVVUVVV",1,7,0.82815734989648,116,122,133,136,140,146,156,159,"AAAATGA","CTTA","ATGTTAA","TTGA",2.19307102893964,11,4,10,34,2.97925104248428,4.39993114218713,7.71256054177305,101,"ENSG00000079974.19"
"19107","ENSG00000161405.17_69729",69721,69729,9,"ENSG00000161405.17",0,NA,"VVVVUUVVV",2,7,0.812008281573499,110,116,133,136,141,147,161,164,"ACCATGA","GTGG","GTGTGGC","CTGA",2.29412472909307,17,5,14,45,2.56383636382487,4.46450030611134,7.71253343240534,101,"ENSG00000079974.19"
"1283","ENSG00000051596.10_69438",69430,69438,9,"ENSG00000051596.10",1,8,"VVVVVUVMV",1,7,0.806211180124224,107,113,133,136,176,182,197,200,"TTAATGA","CTGG","ATGAGCA","CTGA",2.49538037566795,20,40,15,84,1.31488110076104,4.48768756797018,7.71253228846707,101,"ENSG00000079974.19"
"22265","ENSG00000170089.18_2962",2954,2962,9,"ENSG00000170089.18",1,8,"VVVVVUVMV",1,7,0.806211180124224,107,113,133,136,176,182,197,200,"TTAATGA","CTGG","ATGAGCA","CTGA",2.49538037566795,20,40,15,84,1.31488110076104,4.48768756797018,7.71253228846707,101,"ENSG00000079974.19"
"48445","ENSG00000291113.1_69150",69142,69150,9,"ENSG00000291113.1",1,8,"VVVVVUVMV",1,7,0.806211180124224,107,113,133,136,176,182,197,200,"TTAATGA","CTGG","ATGAGCA","CTGA",2.49538037566795,20,40,15,84,1.31488110076104,4.48768756797018,7.71253228846707,101,"ENSG00000079974.19"
"13237","ENSG00000140718.21_56496",56488,56496,9,"ENSG00000140718.21",0,NA,"UVVVUVVVV",2,7,0.792546583850932,115,121,133,136,181,187,195,198,"GTGGTGA","CATA","GTGTTGC","CTGA",2.42796433946334,12,45,8,74,1.98289495447284,4.54233097105711,7.71251730646084,101,"ENSG00000079974.19"
"33195","ENSG00000228999.4_2020",2012,2020,9,"ENSG00000228999.4",0,NA,"VVVVUUVVV",2,7,0.812008281573499,115,121,133,136,144,150,162,165,"ATGATGC","CTAT","CTGCAGA","CAGA",2.23333010395079,12,8,12,41,2.9690210902687,4.46447211248517,7.71250523877916,101,"ENSG00000079974.19"
"33682","ENSG00000230731.3_12917",12909,12917,9,"ENSG00000230731.3",1,8,"VVVVUVVMV",1,7,0.773913043478261,70,76,91,94,114,120,133,136,"GAGATGA","CTGA","GTTATGA","CTGG",2.45412039377062,15,20,13,57,2.10660637549547,4.61685225015824,7.71250442407128,101,"ENSG00000079974.19"
"25785","ENSG00000182752.10_113542",113534,113542,9,"ENSG00000182752.10",1,1,"MVVVVVUVV",1,7,0.792132505175983,106,112,133,136,144,150,189,192,"ATGATGC","CTGG","ATACTCA","CTGA",2.51316752590923,21,8,39,77,1.42136951874895,4.54395492286928,7.71248494357322,101,"ENSG00000079974.19"
"41063","ENSG00000258526.8_141683",141675,141683,9,"ENSG00000258526.8",1,3,"UVMVVVVVV",1,7,0.785507246376811,86,92,133,136,145,151,205,208,"CTGATGA","CAGA","GTTAGGC","CTGA",2.59937868683534,41,9,54,113,0.952593329522589,4.57044614377288,7.71247512928013,101,"ENSG00000079974.19"
"34915","ENSG00000234377.8_589698",589690,589698,9,"ENSG00000234377.8",1,8,"VVVUVVVMV",1,7,0.764803312629399,107,113,133,136,146,152,168,171,"ATGATGA","TTGA","CAGATGG","CAGA",2.46988668418776,20,10,16,55,2.1471342692962,4.65326137430366,7.71247462482125,101,"ENSG00000079974.19"
"15811","ENSG00000149639.15_51623",51615,51623,9,"ENSG00000149639.15",1,8,"VVUVVVVMV",1,7,0.767701863354037,106,112,133,136,145,151,164,167,"ATAATGA","CCTA","GTGGAGT","CTGA",2.44298961756994,21,9,13,52,2.27979314932535,4.64159764994791,7.71240510336405,101,"ENSG00000079974.19"
"15141","ENSG00000147162.15_6032",6024,6032,9,"ENSG00000147162.15",1,1,"MVVVVVUVV",1,7,0.792132505175983,115,121,133,136,144,150,163,166,"ATGTTGA","ATAA","ATGATGT","CTCA",2.28780001892025,12,8,13,42,2.92332954603795,4.54383241804324,7.71236243874717,101,"ENSG00000079974.19"
"22320","ENSG00000170310.15_222639",222631,222639,9,"ENSG00000170310.15",1,2,"VMVVVUVVV",1,7,0.806211180124223,94,100,111,114,115,121,133,136,"TTGATGA","CAGA","AGGAGCA","CTGG",2.32247921326156,11,1,12,33,2.46681669377113,4.48750286221204,7.71234758270893,101,"ENSG00000079974.19"
"3718","ENSG00000088387.22_77880",77872,77880,9,"ENSG00000088387.22",1,8,"VVVVUVVMV",1,7,0.773913043478261,112,118,133,136,153,159,170,173,"GTGAGGA","AAGA","CTGACCA","CTGA",2.42142261813766,15,17,11,52,2.32366327493513,4.61662018229654,7.71227235620959,101,"ENSG00000079974.19"
"32808","ENSG00000227954.7_291867",291859,291867,9,"ENSG00000227954.7",1,5,"UVVVMVVVV",1,7,0.789233954451346,112,118,133,136,158,164,177,180,"ATTATGA","CCAA","GTGCATA","CTGA",2.42835775547375,15,22,13,59,2.03210536470229,4.55528926696516,7.71222508477054,101,"ENSG00000079974.19"
"12812","ENSG00000139155.9_13401",13393,13401,9,"ENSG00000139155.9",1,8,"VVVVVUVMV",1,7,0.806211180124224,115,121,133,136,143,149,163,166,"ATGACCA","CAGA","ATGCTGA","ATGA",2.25908621136511,12,7,14,42,2.88891902407969,4.48737344162845,7.71221816212534,101,"ENSG00000079974.19"
"3972","ENSG00000091483.8_10354",10346,10354,9,"ENSG00000091483.8",1,8,"VVVUVVVMV",1,7,0.764803312629399,49,55,66,69,116,122,133,136,"GTGCTGA","ATGA","CAGTTGA","CTGA",2.49744214841498,11,47,11,78,1.96225398683109,4.65296707739941,7.71218032791701,101,"ENSG00000079974.19"
"19912","ENSG00000163964.18_5800",5792,5800,9,"ENSG00000163964.18",0,NA,"VVVUVVUVV",2,7,0.766873706004141,107,113,133,136,149,155,174,177,"AGCATGA","CGGA","GTGATTA","CTGA",2.52283197450878,20,13,19,61,1.75977185061689,4.64466292016885,7.71215774418541,101,"ENSG00000079974.19"
"23775","ENSG00000174004.6_5881",5873,5881,9,"ENSG00000174004.6",0,NA,"VVVUVVUVV",2,7,0.766873706004141,107,113,133,136,149,155,174,177,"AGCATGA","CGGA","GTGATTA","CTGA",2.52283197450878,20,13,19,61,1.75977185061689,4.64466292016885,7.71215774418541,101,"ENSG00000079974.19"
"23057","ENSG00000172159.16_206572",206564,206572,9,"ENSG00000172159.16",1,8,"VVVUVVVMV",1,7,0.764803312629399,108,114,133,136,175,181,189,192,"ATGTTGA","CTGG","CTGCTTA","CTGA",2.55685696782115,19,39,8,75,1.56602735714848,4.65293511898903,7.71214836950663,101,"ENSG00000079974.19"
"4034","ENSG00000092345.14_58020",58012,58020,9,"ENSG00000092345.14",1,8,"UVVVVVVMV",1,7,0.786749482401656,20,26,36,39,76,82,133,136,"GTGATGC","CAGA","GTGAGTA","CTGA",2.59886877104446,10,37,51,107,0.934776155362792,4.56514199058147,7.71213992018809,101,"ENSG00000079974.19"
"44054","ENSG00000277215.2_254099",254091,254099,9,"ENSG00000277215.2",1,2,"UMVVVVVVV",1,7,0.786749482401656,55,61,73,76,82,88,133,136,"ATGATGA","CTGG","ATGTACA","GTGA",2.44039012780213,12,6,45,72,1.99129244324766,4.56513999048213,7.71213792008875,101,"ENSG00000079974.19"
"6539","ENSG00000110675.13_13039",13031,13039,9,"ENSG00000110675.13",0,NA,"UVVVUVVVV",2,7,0.792546583850932,115,121,133,136,145,151,159,162,"GTGTCGA","CTAA","GACATGT","CTGA",2.27656274740682,12,9,8,38,2.99071377040895,4.54194968828027,7.712136023684,101,"ENSG00000079974.19"
"25619","ENSG00000182247.10_132231",132223,132231,9,"ENSG00000182247.10",1,2,"UMVVVVVVV",1,7,0.786749482401656,114,120,133,136,147,153,181,184,"CTGATGG","AAGA","GTAAAGA","CTGA",2.43829752277059,13,11,28,61,2.00521140497991,4.56513205586262,7.71212998546925,101,"ENSG00000079974.19"
"30204","ENSG00000204120.16_76867",76859,76867,9,"ENSG00000204120.16",1,5,"UVVVMUVVV",2,6,0.711387163561077,115,121,133,136,139,145,155,158,"ATAATGA","GTGG","ATGAATA","CTGA",2.48977265295201,12,3,10,34,2.86771789302922,4.86655056151065,7.71209921575495,101,"ENSG00000079974.19"
"1063","ENSG00000047346.13_630",622,630,9,"ENSG00000047346.13",1,1,"MVVVVVUVV",1,7,0.792132505175983,99,105,133,136,149,155,166,169,"ATGATCA","ATGT","ATAAAGA","CTGA",2.46245818157059,28,13,11,61,1.75788113505237,4.54356725304741,7.71209727375134,101,"ENSG00000079974.19"
"31190","ENSG00000218336.9_518776",518768,518776,9,"ENSG00000218336.9",1,8,"UVVVVVVMV",1,7,0.786749482401656,108,114,133,136,150,156,175,178,"CTGATGA","GTGC","TTTATCA","CTGA",2.47281317420131,19,14,19,61,1.77489154789257,4.56507817730865,7.71207610691528,101,"ENSG00000079974.19"
"31182","ENSG00000218336.9_331720",331712,331720,9,"ENSG00000218336.9",1,5,"VVVVMUVVV",1,7,0.808695652173913,113,119,133,136,140,146,155,158,"ATGACAA","CACA","GGGATTT","CTGA",2.25088887679759,14,4,9,36,2.90285289478319,4.47719468502511,7.71197729372076,101,"ENSG00000079974.19"
"21338","ENSG00000167193.8_35365",35357,35365,9,"ENSG00000167193.8",1,8,"UVVVVVVMV",1,7,0.786749482401656,93,99,133,136,143,149,181,184,"ATGGTGA","CTGG","ATGGTGG","CTGA",2.57360431900084,34,7,32,82,1.10253451464511,4.56497416032934,7.71197208993596,101,"ENSG00000079974.19"
"39232","ENSG00000253322.1_210215",210207,210215,9,"ENSG00000253322.1",1,1,"MVVUVVVVV",1,7,0.786749482401656,62,68,80,83,115,121,133,136,"TTGGTGA","CTGT","GCCATGA","CTGA",2.43995118354947,12,32,12,65,1.99342029689749,4.56494038014016,7.71193830974679,101,"ENSG00000079974.19"
"3366","ENSG00000083067.25_371643",371635,371643,9,"ENSG00000083067.25",1,6,"VVVVVMUVV",1,7,0.788819875776397,87,93,133,136,141,147,162,165,"CTGATGG","ATAA","ATGATAA","CTGA",2.47149727837726,40,5,15,69,1.74997469656612,4.5566558047703,7.71193530787589,101,"ENSG00000079974.19"
"41289","ENSG00000258779.8_113386",113378,113386,9,"ENSG00000258779.8",1,8,"VVVVVUVMV",1,7,0.806211180124224,110,116,133,136,145,151,175,178,"AGGAGGA","TTGT","GAGATGA","CTGA",2.38934440021109,17,9,24,59,2.0193696229663,4.48708307276006,7.71192779325695,101,"ENSG00000079974.19"
"32913","ENSG00000228262.11_391612",391604,391612,9,"ENSG00000228262.11",1,1,"MVUVVVVVV",1,7,0.789648033126294,91,97,133,136,145,151,164,167,"ATGAAGA","CTGA","AGGAAGA","CAGA",2.45059953954736,36,9,13,67,1.87578303616755,4.55327832495415,7.71187045745933,101,"ENSG00000079974.19"
"5750","ENSG00000106554.13_125355",125347,125355,9,"ENSG00000106554.13",1,8,"VVUVVVVMV",1,7,0.767701863354037,116,122,133,136,143,149,159,162,"ATGATGA","TAGA","GTTATCT","CTGT",2.32659051976167,11,7,10,37,3.05362272147605,4.64105654663847,7.71186400005461,101,"ENSG00000079974.19"
"30716","ENSG00000211448.14_86531",86523,86531,9,"ENSG00000211448.14",1,2,"VMVVVUUVV",2,6,0.692339544513457,114,120,133,136,174,180,191,194,"GTGATGA","CTGG","GTTATAA","CTGA",2.6666369798374,13,38,11,71,1.99242100978447,4.94250021884178,7.71185839689561,101,"ENSG00000079974.19"
"24370","ENSG00000176124.15_107215",107207,107215,9,"ENSG00000176124.15",0,NA,"UVVVVUVVV",2,7,0.824844720496894,61,67,81,84,96,102,133,136,"CTGATGT","CTGT","GTGATGT","CTTA",2.37195144138115,14,12,31,66,1.83690638582843,4.41247899875903,7.71185788074661,101,"ENSG00000079974.19"
"14137","ENSG00000144455.14_125105",125097,125105,9,"ENSG00000144455.14",1,5,"UVVVMUVVV",2,6,0.711387163561077,91,97,133,136,141,147,157,160,"ATGATGT","CTTA","ATGTTGG","CTGA",2.62915642452904,36,5,10,60,1.9374907574987,4.86630006358975,7.71184871783406,101,"ENSG00000079974.19"
"33028","ENSG00000228566.2_141568",141560,141568,9,"ENSG00000228566.2",1,1,"MVVVVVUVV",1,7,0.792132505175983,85,91,133,136,150,156,172,175,"TCGATGA","CTGC","GTGTAGA","CTGA",2.51868099867391,42,14,16,81,1.38204195590389,4.54331215343249,7.71184217413642,101,"ENSG00000079974.19"
"9552","ENSG00000125388.20_19542",19534,19542,9,"ENSG00000125388.20",1,8,"VVVVUVVMV",1,7,0.773913043478261,116,122,133,136,142,148,196,199,"AGGCTGA","CTTA","TTGATGG","CTGA",2.47534156300203,11,6,48,74,1.96242306172992,4.61617503710252,7.71182721101557,101,"ENSG00000079974.19"
"7806","ENSG00000115762.17_23093",23085,23093,9,"ENSG00000115762.17",0,NA,"VVUVVVUVV",2,7,0.769772256728778,60,66,81,84,106,112,133,136,"GTGATGT","CAGA","CTCATCA","CTGA",2.54359312445574,15,22,21,67,1.57330554815608,4.63264826113192,7.71173728804704,101,"ENSG00000079974.19"
"47729","ENSG00000289130.2_46965",46957,46965,9,"ENSG00000289130.2",0,NA,"VVVUVUVVV",2,7,0.802898550724638,106,112,133,136,146,152,162,165,"ATGATGA","GAGA","CAGATGG","CGGA",2.3537621758738,21,10,10,50,2.30875419617235,4.50012550883275,7.7117197117313,101,"ENSG00000079974.19"
"11209","ENSG00000134250.21_86675",86667,86675,9,"ENSG00000134250.21",1,2,"VMUVVVVVV",1,7,0.767701863354037,77,83,93,96,108,114,133,136,"GTGAAGT","CAGA","GAGAAGA","CTGA",2.44535699797994,10,12,19,50,2.26120232212228,4.6408955771638,7.71170303057995,101,"ENSG00000079974.19"
"19058","ENSG00000160654.11_1358",1350,1358,9,"ENSG00000160654.11",1,7,"VVVUVVMVV",1,7,0.766045548654244,66,72,86,89,95,101,133,136,"ATGATGA","CTGG","ATGGTGG","CAGA",2.48280084208784,14,6,32,61,2.03804608103413,4.64751292373827,7.71169511835525,101,"ENSG00000079974.19"
"6370","ENSG00000109654.16_143794",143786,143794,9,"ENSG00000109654.16",1,8,"VVVVVUVMV",1,7,0.806211180124224,56,62,74,77,82,88,133,136,"CTGATGT","CAGA","GTGAAGA","GTGA",2.40126750399079,12,5,45,71,1.938941677629,4.48684792605856,7.71169264655546,101,"ENSG00000079974.19"
"47522","ENSG00000288637.1_143522",143514,143522,9,"ENSG00000288637.1",1,8,"VVVVVUVMV",1,7,0.806211180124224,56,62,74,77,82,88,133,136,"CTGATGT","CAGA","GTGAAGA","GTGA",2.40126750399079,12,5,45,71,1.938941677629,4.48684792605856,7.71169264655546,101,"ENSG00000079974.19"
"37156","ENSG00000245750.11_138597",138589,138597,9,"ENSG00000245750.11",1,8,"VVVUVVVMV",1,7,0.764803312629399,110,116,133,136,142,148,160,163,"ATGGTGG","CTGG","GAGCCGA","CTGA",2.38564834520771,17,6,12,44,2.70555693640262,4.65246980944683,7.71168305996443,101,"ENSG00000079974.19"
"9076","ENSG00000122547.11_48180",48172,48180,9,"ENSG00000122547.11",1,8,"VVVVVVUMV",1,7,0.770186335403727,86,92,133,136,181,187,195,198,"GTGAAGA","CTCA","CTGATGA","CTGA",2.63096216310688,41,45,8,103,0.983829034102689,4.63089419703714,7.71163953865205,101,"ENSG00000079974.19"
"5164","ENSG00000103528.17_42699",42691,42699,9,"ENSG00000103528.17",1,6,"VVVVVMUVV",1,7,0.788819875776397,85,91,103,106,113,119,133,136,"AAGAAGA","GTGA","TTGATGA","CTGG",2.30047109339728,12,7,14,42,2.88891902407969,4.55634824501539,7.71162774812098,101,"ENSG00000079974.19"
"35398","ENSG00000235904.3_63159",63151,63159,9,"ENSG00000235904.3",1,1,"MVUVVVVVV",1,7,0.789648033126294,115,121,133,136,175,181,191,194,"ATGAGGA","AGGA","TTTCTGA","CTGA",2.43044281534589,12,39,10,70,2.00914957389594,4.55302541905047,7.71161755155565,101,"ENSG00000079974.19"
"35156","ENSG00000235139.2_21923",21915,21923,9,"ENSG00000235139.2",1,1,"MVVVVUVVV",1,7,0.82815734989648,103,109,133,136,146,152,162,165,"AGGATTG","ATGA","ATTAGGA","CTGA",2.32193425917429,24,10,10,53,2.11636081702423,4.39898063621322,7.71161003579914,101,"ENSG00000079974.19"
"12981","ENSG00000139734.19_489358",489350,489358,9,"ENSG00000139734.19",1,1,"MVVVVUVVV",1,7,0.82815734989648,109,115,133,136,159,165,175,178,"GTGATGG","CAGA","GTGAGAA","TTGA",2.36347323698207,18,23,10,60,1.83939854724972,4.39897169844921,7.71160109803513,101,"ENSG00000079974.19"
"21051","ENSG00000166326.7_66214",66206,66214,9,"ENSG00000166326.7",1,2,"VMVVVUVVV",1,7,0.806211180124223,114,120,133,136,143,149,195,198,"CTTATTA","CTGG","ATGCTGA","CTGA",2.39179326261983,13,7,46,75,2.00153928172852,4.48670692479851,7.7115516452954,101,"ENSG00000079974.19"
"45922","ENSG00000286046.1_377833",377825,377833,9,"ENSG00000286046.1",0,NA,"UVUVVVVVV",2,7,0.786335403726708,110,116,133,136,158,164,207,210,"GGGATGA","TTGA","TTGATAA","CTGA",2.59421615577928,17,22,43,91,0.969752732257391,4.56613177602981,7.71147339093664,101,"ENSG00000079974.19"
"44374","ENSG00000281371.1_270",262,270,9,"ENSG00000281371.1",1,3,"VVMVVUVVV",1,7,0.804968944099379,110,116,133,136,149,155,167,170,"CTTAAGA","CTGG","CTGATAT","CTGA",2.3338053170172,17,13,12,51,2.40768236343698,4.49159611922125,7.71147189561876,101,"ENSG00000079974.19"
"8998","ENSG00000121988.18_332777",332769,332777,9,"ENSG00000121988.18",0,NA,"VVVUUVVVV",2,7,0.770600414078675,115,121,133,136,141,147,156,159,"AAAATGC","TTGA","TTGCTGT","CTGA",2.31815621042461,12,5,9,35,3.06188807165969,4.62906570195593,7.71146735827063,101,"ENSG00000079974.19"
"22958","ENSG00000171817.17_35095",35087,35095,9,"ENSG00000171817.17",1,8,"VVVVVVUMV",1,7,0.770186335403727,89,95,104,107,115,121,133,136,"CTGCTGA","CTGA","TTGGAGA","TTGA",2.3523126641676,9,8,12,38,2.84078310998864,4.63071688444315,7.71146222605806,101,"ENSG00000079974.19"
"42969","ENSG00000267470.6_37587",37579,37587,9,"ENSG00000267470.6",1,8,"VVVVVVUMV",1,7,0.770186335403727,89,95,104,107,115,121,133,136,"CTGCTGA","CTGA","TTGGAGA","TTGA",2.3523126641676,9,8,12,38,2.84078310998864,4.63071688444315,7.71146222605806,101,"ENSG00000079974.19"
"31248","ENSG00000220913.1_3883",3875,3883,9,"ENSG00000220913.1",1,1,"MVVVVVUVV",1,7,0.792132505175983,116,122,133,136,140,146,188,191,"TTCATGA","TTCA","ATGAAGA","CTGA",2.45181547341895,11,4,42,66,1.82623553402026,4.54291800586999,7.71144802657392,101,"ENSG00000079974.19"
"10274","ENSG00000130338.13_42790",42782,42790,9,"ENSG00000130338.13",1,1,"MVVVVUVVV",1,7,0.82815734989648,114,120,133,136,182,188,198,201,"TTGATCA","ATAA","ATTTTGA","CTGA",2.33962727322744,13,46,10,78,1.99769014294355,4.39880132444828,7.7114307240342,101,"ENSG00000079974.19"
"32638","ENSG00000227408.1_4122",4114,4122,9,"ENSG00000227408.1",0,NA,"VVUUVVVVV",2,7,0.764389233954451,109,115,133,136,143,149,172,175,"ATGATAA","ATAA","ATGAAGG","CTGA",2.48854771801944,18,7,23,57,2.02502601078186,4.65383603272787,7.71139296854567,101,"ENSG00000079974.19"
"27497","ENSG00000186314.12_339778",339770,339778,9,"ENSG00000186314.12",1,2,"VMVVVVUVV",1,7,0.770186335403727,114,120,133,136,144,150,162,165,"AAGATGT","AGGA","ATGAAAC","CTGA",2.33472050517404,13,8,12,42,2.95772979160902,4.63063328985899,7.7113786314739,101,"ENSG00000079974.19"
"1512","ENSG00000058272.19_60298",60290,60298,9,"ENSG00000058272.19",1,6,"UVVVVMVVV",1,7,0.805383022774327,93,99,133,136,144,150,163,166,"TTTATGA","CTTA","ATACAGA","CTGA",2.40622070431695,34,8,13,64,1.91786292295078,4.48983357126594,7.71136566236325,101,"ENSG00000079974.19"
"16867","ENSG00000152495.11_95914",95906,95914,9,"ENSG00000152495.11",1,3,"VVMVUVVVV",1,7,0.772670807453416,116,122,133,136,141,147,178,181,"TAGATCA","CTGT","GTGATGA","CTGA",2.4703881792961,11,5,31,56,2.01343110448701,4.62067140828192,7.71135463809559,101,"ENSG00000079974.19"
"35929","ENSG00000237489.5_58210",58202,58210,9,"ENSG00000237489.5",1,2,"VMUVVVVVV",1,7,0.767701863354037,106,112,133,136,144,150,193,196,"GTGATTA","ATGA","GTGAGGG","CTGA",2.57318356776305,21,8,43,81,1.40762974451251,4.64054671573322,7.71135416914936,101,"ENSG00000079974.19"
"30302","ENSG00000204442.4_452390",452382,452390,9,"ENSG00000204442.4",1,3,"UVMVVVVVV",1,7,0.785507246376811,75,81,91,94,103,109,133,136,"AATATGA","CTAA","ATTATGT","CTGA",2.41399056645735,10,9,24,52,2.18399018301546,4.56931515651611,7.71134414202336,101,"ENSG00000079974.19"
"23496","ENSG00000173068.19_438815",438807,438815,9,"ENSG00000173068.19",1,2,"VMVUVVVVV",1,7,0.764803312629399,84,90,100,103,107,113,133,136,"ATTCTGA","GTGA","GTAAAGA","CTGA",2.44839703848492,10,4,20,43,2.28586036411534,4.65212682183704,7.71134007235463,101,"ENSG00000079974.19"
"26672","ENSG00000184838.15_40317",40309,40317,9,"ENSG00000184838.15",1,1,"MVVVUVVVV",1,7,0.795859213250517,111,117,133,136,149,155,198,201,"GTGATCA","CAGT","ATGATGT","CTGA",2.48523290115023,16,13,43,81,1.54323859622139,4.52786448430573,7.7113013373078,101,"ENSG00000079974.19"
"38784","ENSG00000251026.2_217930",217922,217930,9,"ENSG00000251026.2",1,1,"MVVVVUVVV",1,7,0.82815734989648,111,117,133,136,145,151,162,165,"ATGAAGA","CATA","AGGAAGA","ATGA",2.22213734349873,16,9,11,45,2.78027541315198,4.39863109245254,7.71126049203846,101,"ENSG00000079974.19"
"11714","ENSG00000135903.20_75540",75532,75540,9,"ENSG00000135903.20",1,5,"VVUVMVVVV",1,7,0.770186335403727,102,108,133,136,147,153,172,175,"CTGATGC","CTCA","GTGAGAA","CTGA",2.54098452668429,25,11,19,64,1.58211788336878,4.63050368198268,7.71124902359759,101,"ENSG00000079974.19"
"22622","ENSG00000170962.13_4077",4069,4077,9,"ENSG00000170962.13",0,NA,"UVVVVUVVV",2,7,0.824844720496894,114,120,133,136,139,145,155,158,"TTGTTGC","CAGG","TTGGTGG","CTGA",2.22289663903536,13,3,10,35,2.82812012749484,4.41185776359931,7.71123664558689,101,"ENSG00000079974.19"
"21319","ENSG00000167081.18_73719",73711,73719,9,"ENSG00000167081.18",1,7,"UVVVVVMVV",1,7,0.787991718426501,107,113,133,136,179,185,196,199,"ATATTGA","ATGA","CTGAAGA","CTGA",2.51353504309159,20,43,11,83,1.48014592636147,4.55926155340969,7.71122842711569,101,"ENSG00000079974.19"
"24698","ENSG00000177570.15_376355",376347,376355,9,"ENSG00000177570.15",1,8,"VVVVUVVMV",1,7,0.773913043478261,114,120,133,136,143,149,202,205,"GTGATAA","GTCA","ATGATGG","CTGA",2.46981045471507,13,7,53,82,1.99679912616064,4.61555053939861,7.71120271331166,101,"ENSG00000079974.19"
"4885","ENSG00000102245.9_10372",10364,10372,9,"ENSG00000102245.9",1,1,"MVVVUUVVV",2,6,0.718012422360248,115,121,133,136,149,155,172,175,"ATGATCA","ATGG","GTGCTGA","CTGA",2.54460266961308,12,13,17,51,2.39239884315455,4.83910416014376,7.71115384958476,101,"ENSG00000079974.19"
"4620","ENSG00000101336.18_30514",30506,30514,9,"ENSG00000101336.18",1,2,"VMVUVVVVV",1,7,0.764803312629399,114,120,133,136,147,153,202,205,"ATTATCA","CTGA","CTAATAA","CTGA",2.51607650346182,13,11,49,82,1.83378945746555,4.65190820346943,7.71112145398703,101,"ENSG00000079974.19"
"48450","ENSG00000291117.1_6808",6800,6808,9,"ENSG00000291117.1",1,1,"MVVUVVVVV",1,7,0.786749482401656,96,102,133,136,178,184,193,196,"AGGAGGA","CTGA","GTGATTG","CTGA",2.58311120753781,31,42,9,91,1.03565971254061,4.56410027403151,7.71109820363813,101,"ENSG00000079974.19"
"9443","ENSG00000124731.13_14490",14482,14490,9,"ENSG00000124731.13",1,8,"VVVVUVVMV",1,7,0.773913043478261,113,119,133,136,142,148,175,178,"ATGATGG","GTCA","GTGGCCA","CTGA",2.44655549324337,14,6,27,56,2.15127819842658,4.61541203834559,7.71106421225864,101,"ENSG00000079974.19"
"20082","ENSG00000164253.14_32022",32014,32022,9,"ENSG00000164253.14",1,2,"VMVVVUVVV",1,7,0.806211180124223,87,93,102,105,115,121,133,136,"ATAATGA","CATA","GAGATGA","CAGA",2.28286898687085,9,10,12,40,2.72565214616319,4.48619468132555,7.71103940182245,101,"ENSG00000079974.19"
"16701","ENSG00000152104.12_183800",183792,183800,9,"ENSG00000152104.12",1,8,"UVVVVVVMV",1,7,0.786749482401656,92,98,133,136,143,149,185,188,"TTGATGG","CTGG","ATGATGG","CTGA",2.5804802845924,35,7,36,87,1.05278852216627,4.56399760486223,7.71099553446886,101,"ENSG00000079974.19"
"34777","ENSG00000234129.10_252140",252132,252140,9,"ENSG00000234129.10",1,7,"VVVVVUMVV",1,7,0.807453416149068,82,88,104,107,114,120,133,136,"ATGAAGA","CTGA","CTGAAGA","CTTT",2.27423008974041,16,7,13,45,2.76303691370971,4.48114271132811,7.71095637592438,101,"ENSG00000079974.19"
"19661","ENSG00000163581.14_26157",26149,26157,9,"ENSG00000163581.14",1,8,"VVVVUVVMV",1,7,0.773913043478261,110,116,133,136,186,192,223,226,"AGGATGA","GTGA","AAGATGA","CTGA",2.6397114231766,17,50,31,107,0.86310319428995,4.61529483720015,7.7109470111132,101,"ENSG00000079974.19"
"18986","ENSG00000160058.19_16771",16763,16771,9,"ENSG00000160058.19",0,NA,"VVUVUVVVV",2,7,0.773498964803312,114,120,133,136,140,146,193,196,"AGGAGGA","TTGA","GTGAGGG","CTGA",2.49444938786457,13,4,47,73,1.83814088860682,4.61695086859266,7.71094672780591,101,"ENSG00000079974.19"
"31775","ENSG00000224789.1_3859",3851,3859,9,"ENSG00000224789.1",1,2,"VMVVVVUVV",1,7,0.770186335403727,114,120,133,136,146,152,198,201,"ATGAAGT","GTGA","ATGTTGG","CTGA",2.49315190935791,13,10,46,78,1.8997700329589,4.63019569050291,7.71094103211782,101,"ENSG00000079974.19"
"2553","ENSG00000075711.21_243101",243093,243101,9,"ENSG00000075711.21",0,NA,"VVVVUUVVV",2,7,0.812008281573499,112,118,133,136,154,160,183,186,"AAGATGG","CTGG","CAGACGA","CTGA",2.43156252199918,15,18,23,65,1.64092717648633,4.46283599745354,7.71086912374754,101,"ENSG00000079974.19"
"11568","ENSG00000135341.19_14118",14110,14118,9,"ENSG00000135341.19",1,8,"VVUVVVVMV",1,7,0.767701863354037,115,121,133,136,143,149,163,166,"TTGCTAA","TTGA","GTGCTTA","CTGA",2.35069008957546,12,7,14,42,2.88891902407969,4.64004657197902,7.71085402539517,101,"ENSG00000079974.19"
"35828","ENSG00000237324.3_18809",18801,18809,9,"ENSG00000237324.3",1,8,"UVVVVVVMV",1,7,0.786749482401656,116,122,133,136,140,146,154,157,"TTGAGGA","ATCA","ATCATTC","CTGA",2.28089565696046,11,4,8,32,3.04928404403719,4.56381377261006,7.71081170221668,101,"ENSG00000079974.19"
"3014","ENSG00000080224.18_935578",935570,935578,9,"ENSG00000080224.18",1,3,"UVMVVVVVV",1,7,0.785507246376811,95,101,133,136,153,159,169,172,"ATGACGA","TTGA","AGGTTGT","CTGA",2.52354498619756,32,17,10,68,1.45148955966482,4.56878070024547,7.71080968575271,101,"ENSG00000079974.19"
"15560","ENSG00000148680.16_114547",114539,114547,9,"ENSG00000148680.16",1,8,"VVVVVUVMV",1,7,0.806211180124224,113,119,133,136,144,150,166,169,"GTGCTGA","CTGT","GTGCTGG","CTGG",2.28480356724934,14,8,16,47,2.71183369767137,4.4859643698334,7.7108090903303,101,"ENSG00000079974.19"
"7907","ENSG00000116035.4_44927",44919,44927,9,"ENSG00000116035.4",1,1,"MVVVVUVVV",1,7,0.82815734989648,108,114,133,136,143,149,198,201,"AAGAGGA","ATGA","ATGGGGG","CTGA",2.40192100315186,19,7,49,84,1.57991185198396,4.39817963491576,7.71080903450169,101,"ENSG00000079974.19"
"7908","ENSG00000116039.13_9603",9595,9603,9,"ENSG00000116039.13",1,1,"MVVVVUVVV",1,7,0.82815734989648,108,114,133,136,143,149,198,201,"AAGAGGA","ATGA","ATGGGGG","CTGA",2.40192100315186,19,7,49,84,1.57991185198396,4.39817963491576,7.71080903450169,101,"ENSG00000079974.19"
"5923","ENSG00000107249.24_388744",388736,388744,9,"ENSG00000107249.24",0,NA,"VVUVVVUVV",2,7,0.769772256728778,66,72,80,83,96,102,133,136,"GGGAAGA","CTGA","GTGAAGT","CTGA",2.54916887600374,8,13,31,61,1.53241637629799,4.63171888741406,7.71080791432918,101,"ENSG00000079974.19"
"168","ENSG00000005889.16_58312",58304,58312,9,"ENSG00000005889.16",1,1,"MVVVUVVVV",1,7,0.795859213250517,111,117,133,136,143,149,172,175,"AAGATGA","GTGT","ATTATAC","CTGA",2.3869299349223,16,7,23,55,2.19661432262783,4.52737013886079,7.71080699186286,101,"ENSG00000079974.19"
"15025","ENSG00000146648.21_68749",68741,68749,9,"ENSG00000146648.21",1,1,"MVVVVUUVV",2,6,0.714285714285714,115,121,133,136,144,150,161,164,"TCGAAGA","CTGA","CTGAGGC","CTGA",2.46134534322608,12,8,11,40,3.00568632882915,4.85366382091742,7.71080667806027,101,"ENSG00000079974.19"
"22440","ENSG00000170579.17_449195",449187,449195,9,"ENSG00000170579.17",1,1,"MVUVVVVVV",1,7,0.789648033126294,115,121,133,136,178,184,199,202,"AAGATGG","CTAA","GTCATGG","CTGA",2.45799442167106,12,42,15,78,1.82216166319677,4.55219778525097,7.71078991775614,101,"ENSG00000079974.19"
"6820","ENSG00000111961.19_22516",22508,22516,9,"ENSG00000111961.19",1,8,"UVVVVVVMV",1,7,0.786749482401656,79,85,99,102,107,113,133,136,"ATTTTGA","CTTA","ATGGAAA","CTGA",2.3762292515904,14,5,20,48,2.41360275810169,4.56378277550943,7.71078070511605,101,"ENSG00000079974.19"
"44233","ENSG00000279956.1_115467",115459,115467,9,"ENSG00000279956.1",0,NA,"UVVVVVUVV",2,7,0.788819875776397,85,91,133,136,168,174,183,186,"CTGATGA","CTGT","ATGCTTT","CTGA",2.57805610878169,42,32,9,92,1.03460315916965,4.55541097109523,7.71069047420082,101,"ENSG00000079974.19"
"19893","ENSG00000163909.8_4761",4753,4761,9,"ENSG00000163909.8",1,8,"VVVVVUVMV",1,7,0.806211180124224,99,105,133,136,145,151,166,169,"GTGATGC","CTAC","CTGCTGT","CTGA",2.41464778535289,28,9,15,61,1.8456283865481,4.48582007222517,7.71066479272207,101,"ENSG00000079974.19"
"27197","ENSG00000185737.13_436862",436854,436862,9,"ENSG00000185737.13",1,6,"UVVVVMVVV",1,7,0.805383022774327,111,117,133,136,147,153,206,209,"GTGATGT","TTCA","CTGGTGC","CTGA",2.4423347947869,16,11,53,89,1.67420437866745,4.48910908597836,7.71064117707567,101,"ENSG00000079974.19"
"39269","ENSG00000253394.7_191729",191721,191729,9,"ENSG00000253394.7",1,8,"UVVVVVVMV",1,7,0.786749482401656,114,120,133,136,173,179,187,190,"TTTATGG","CTCA","GTGTTGA","CTGA",2.43979798154706,13,37,8,67,1.98919975177882,4.5636299071898,7.71062783679643,101,"ENSG00000079974.19"
"11315","ENSG00000134532.20_246050",246042,246050,9,"ENSG00000134532.20",1,7,"UVVVVUMVV",2,6,0.710144927536232,112,118,133,136,179,185,231,234,"CTGATGA","CTGA","GTGCTGT","CTGA",2.78409015048923,15,43,46,113,0.919507586248877,4.87002714737761,7.71060685752254,101,"ENSG00000079974.19"
"47146","ENSG00000287709.3_31772",31764,31772,9,"ENSG00000287709.3",1,6,"UVVVVMVVV",1,7,0.805383022774327,106,112,133,136,140,146,164,167,"ATTATGA","CCCA","TAGCTGA","CTGA",2.4108554087904,21,4,18,52,1.88391206705779,4.48907036474845,7.71060245584576,101,"ENSG00000079974.19"
"46650","ENSG00000286980.1_22473",22465,22473,9,"ENSG00000286980.1",0,NA,"UVVVVUVVV",2,7,0.824844720496894,115,121,133,136,137,143,151,154,"AAAATGA","GTTA","ATTATAT","CTGA",2.24481686923953,12,1,8,30,2.67934450310494,4.41119757450878,7.71057645649636,101,"ENSG00000079974.19"
"21108","ENSG00000166444.19_9824",9816,9824,9,"ENSG00000166444.19",1,2,"VMVVVUVVV",1,7,0.806211180124223,112,118,133,136,143,149,167,170,"ATGATGA","ATAA","AAGTAGA","ATGA",2.30942439511745,15,7,18,49,2.54673175462944,4.48572359718644,7.71056831768334,101,"ENSG00000079974.19"
"15478","ENSG00000148484.18_17307",17299,17307,9,"ENSG00000148484.18",1,1,"MVUVVVVVV",1,7,0.789648033126294,111,117,133,136,138,144,162,165,"ATGATGC","CTGA","GTAAATA","CTCA",2.43040288073258,16,2,18,45,2.00521388732689,4.55197493971936,7.71056707222454,101,"ENSG00000079974.19"
"2788","ENSG00000078295.17_289397",289389,289397,9,"ENSG00000078295.17",1,2,"VMUVVVVVV",1,7,0.767701863354037,104,110,133,136,185,191,207,210,"ATGATGA","GAGA","TTGATAT","CTGA",2.62894919324832,23,49,16,97,1.03266841982713,4.63974909370398,7.71055654712012,101,"ENSG00000079974.19"
"3205","ENSG00000082293.13_142698",142690,142698,9,"ENSG00000082293.13",1,2,"UMVVVVVVV",1,7,0.786749482401656,79,85,101,104,111,117,133,136,"AAGAAGA","CTTA","ATAATCT","CTGA",2.34837461722774,16,7,16,48,2.59825334375833,4.56352103131915,7.71051896092578,101,"ENSG00000079974.19"
"7666","ENSG00000115306.16_121579",121571,121579,9,"ENSG00000115306.16",1,2,"UMVVVUVVV",2,6,0.708902691511387,113,119,133,136,148,154,163,166,"TTGTTGA","CTGA","ATCTTAA","CTGA",2.51437300921246,14,12,9,44,2.73707024608165,4.87488924354118,7.71050000958673,101,"ENSG00000079974.19"
"42039","ENSG00000260390.1_4014",4006,4014,9,"ENSG00000260390.1",1,5,"VVVUMVVVV",1,7,0.767287784679089,111,117,133,136,150,156,167,170,"AGGAAGC","CTGA","CTTAAGA","CTGA",2.41765888153503,16,14,11,50,2.44723331944775,4.64123979908698,7.71039093780334,101,"ENSG00000079974.19"
"9746","ENSG00000126883.19_24688",24680,24688,9,"ENSG00000126883.19",1,5,"VVUVMVVVV",1,7,0.770186335403727,63,69,83,86,91,97,133,136,"ATAAGGA","GTGA","ATAATGA","CTGA",2.48685440463724,14,5,36,64,1.93944332110881,4.62961817133927,7.71036351295418,101,"ENSG00000079974.19"
"22208","ENSG00000169946.14_539373",539365,539373,9,"ENSG00000169946.14",1,8,"VVVVVUVMV",1,7,0.806211180124224,113,119,133,136,143,149,158,161,"ATGCTGA","ATGT","CAGATGA","CTGT",2.2402034844019,14,7,9,39,3.0073188496743,4.48550218642175,7.71034690691864,101,"ENSG00000079974.19"
"34169","ENSG00000232023.3_366186",366178,366186,9,"ENSG00000232023.3",1,8,"UVVVVVVMV",1,7,0.786749482401656,71,77,92,95,102,108,133,136,"ATGATGA","ATGA","ATTTTAA","CTGT",2.41062239660096,15,7,25,56,2.18252750527698,4.56333587065419,7.71033380026081,101,"ENSG00000079974.19"
"30235","ENSG00000204262.14_159446",159438,159446,9,"ENSG00000204262.14",1,2,"VMVVVUVVV",1,7,0.806211180124223,109,115,133,136,140,146,154,157,"ATGATGA","TGGA","AAGAACA","CAGA",2.3119178971905,18,4,8,39,2.52906923516199,4.485463804108,7.7103085246049,101,"ENSG00000079974.19"
"38603","ENSG00000250560.2_181",173,181,9,"ENSG00000250560.2",1,8,"VVVUVVVMV",1,7,0.764803312629399,41,47,58,61,111,117,133,136,"GTGATGT","CAGA","GTCTGGA","CTGA",2.53050190823953,11,50,16,86,1.73418677586118,4.6510498743645,7.7102631248821,101,"ENSG00000079974.19"
"44476","ENSG00000282381.2_16662",16654,16662,9,"ENSG00000282381.2",1,6,"UVVVVMVVV",1,7,0.805383022774327,111,117,133,136,160,166,180,183,"GTCATGA","TTAA","TTGAAAA","CTGA",2.41481583885147,16,24,14,63,1.85592288937178,4.4886737870954,7.71020587819271,101,"ENSG00000079974.19"
"47978","ENSG00000289879.1_15675",15667,15675,9,"ENSG00000289879.1",1,8,"VVVUVVVMV",1,7,0.764803312629399,115,121,133,136,143,149,165,168,"GTGATAC","CAGA","GTGCGCA","CTGA",2.3754824414368,12,7,16,44,2.76737040921505,4.65098000469843,7.71019325521603,101,"ENSG00000079974.19"
"45171","ENSG00000285190.1_76924",76916,76924,9,"ENSG00000285190.1",1,1,"MVVVVVUVV",1,7,0.792132505175983,70,76,90,93,97,103,133,136,"ATGAAGA","ATGA","ATGAAGA","ATGA",2.4357574091213,14,4,30,57,1.92824628418445,4.54165725291494,7.71018727361887,101,"ENSG00000079974.19"
"37022","ENSG00000244337.2_3661",3653,3661,9,"ENSG00000244337.2",1,1,"MVVVVUVVV",1,7,0.82815734989648,51,57,101,104,112,118,133,136,"GGGATGA","CGGA","GTGGTGA","GTGA",2.36790508613865,44,8,15,76,1.80406961130524,4.39752587972407,7.71015527930999,101,"ENSG00000079974.19"
"20223","ENSG00000164483.17_31367",31359,31367,9,"ENSG00000164483.17",1,8,"VVVVVUVMV",1,7,0.806211180124224,115,121,133,136,153,159,210,213,"ATGAGGA","GTGC","GGGAGGA","CTGA",2.4766111676782,12,17,51,89,1.43024353951731,4.48524616434299,7.71009088483989,101,"ENSG00000079974.19"
"39941","ENSG00000254530.2_206743",206735,206743,9,"ENSG00000254530.2",1,8,"VVVVVVUMV",1,7,0.770186335403727,111,117,133,136,143,149,161,164,"CGGAGGA","CTGG","ATGCAGA","CTGA",2.35690977733496,16,7,12,44,2.80464300286273,4.62934371294062,7.71008905455553,101,"ENSG00000079974.19"
"8449","ENSG00000118960.13_9622",9614,9622,9,"ENSG00000118960.13",1,8,"VVVVVUVMV",1,7,0.806211180124224,84,90,133,136,137,143,152,155,"AAGATGA","GGGA","ATGAACA","CTGA",2.49242762206501,43,1,9,62,1.32475781833811,4.48523549135955,7.71008021185644,101,"ENSG00000079974.19"
"27453","ENSG00000186188.11_33446",33438,33446,9,"ENSG00000186188.11",1,8,"VVVVVUVMV",1,7,0.806211180124224,94,100,133,136,154,160,170,173,"GTGATGT","CACA","GTGGGGA","CTGA",2.48268717783327,33,18,10,70,1.38965676885645,4.48522615526957,7.71007087576647,101,"ENSG00000079974.19"
"37693","ENSG00000248673.2_423453",423445,423453,9,"ENSG00000248673.2",1,2,"VMVUVVVVV",1,7,0.764803312629399,102,108,133,136,169,175,187,190,"ATGATGA","CCCA","TTGAAGT","CTGA",2.61663280536481,25,33,12,79,1.15901997350036,4.65080966898311,7.71002291950071,101,"ENSG00000079974.19"
"18712","ENSG00000158258.16_635866",635858,635866,9,"ENSG00000158258.16",1,7,"VVVVVUMVV",1,7,0.807453416149068,87,93,133,136,143,149,158,161,"TTGCTGA","TTGG","GTGATTG","CTGA",2.38810916281536,40,7,9,65,2.00002100850792,4.48018719015258,7.71000085474885,101,"ENSG00000079974.19"
"7725","ENSG00000115464.15_2313",2305,2313,9,"ENSG00000115464.15",1,7,"VVVVUVMVV",1,7,0.775155279503105,74,80,86,89,93,99,133,136,"ATAATGA","CTTA","AAGATTA","CTGA",2.55725829801509,6,4,34,53,1.38892289405502,4.60932788687224,7.70994900488467,101,"ENSG00000079974.19"
"6210","ENSG00000108684.15_1150664",1150656,1150664,9,"ENSG00000108684.15",1,8,"VVVVVUVMV",1,7,0.806211180124224,94,100,106,109,114,120,133,136,"TGGATGA","CTGA","GGGAGCA","ATGA",2.30911016905856,6,5,13,33,2.5462754142017,4.48508580198136,7.70993052247826,101,"ENSG00000079974.19"
"15381","ENSG00000148120.18_15344",15336,15344,9,"ENSG00000148120.18",1,1,"MVVVVUVVV",1,7,0.82815734989648,108,114,133,136,139,145,155,158,"GTGGGGA","CTGG","GTATTCA","CTGA",2.29306629376671,19,3,10,41,2.30185910235753,4.39724193186723,7.70987133145315,101,"ENSG00000079974.19"
"35832","ENSG00000237352.6_125763",125755,125763,9,"ENSG00000237352.6",1,8,"VVUVVVVMV",1,7,0.767701863354037,94,100,133,136,167,173,185,188,"ATGAGGA","TTGA","GTGATAT","CTGA",2.63081416213072,33,31,12,85,1.01748607422438,4.63906178877397,7.70986924219011,101,"ENSG00000079974.19"
"24157","ENSG00000175352.12_5968",5960,5968,9,"ENSG00000175352.12",1,5,"VVVVMVUVV",1,7,0.772670807453416,102,108,133,136,168,174,183,186,"TTGATGG","GTGA","ATGTTGA","CTGA",2.5906656302948,25,32,9,75,1.20562900383999,4.61918330145133,7.70986653126499,101,"ENSG00000079974.19"
"10054","ENSG00000128923.11_3421",3413,3421,9,"ENSG00000128923.11",0,NA,"VVVVUVUVV",2,7,0.775983436853002,48,54,73,76,86,92,133,136,"ATGATGC","CTGA","GGGATGA","CTAA",2.53977788073258,19,10,41,79,1.49184258695416,4.60592378129284,7.70985752870485,101,"ENSG00000079974.19"
"30949","ENSG00000214870.11_60421",60413,60421,9,"ENSG00000214870.11",1,2,"VMVVVVUVV",1,7,0.770186335403727,99,105,133,136,149,155,176,179,"ATGATGA","ATGG","TTCAGGA","CTGA",2.59259674254981,28,13,21,71,1.2324464850441,4.62910619217737,7.70985153379228,101,"ENSG00000079974.19"
"12990","ENSG00000139793.21_164311",164303,164311,9,"ENSG00000139793.21",1,2,"VMVVVUVVV",1,7,0.806211180124223,108,114,133,136,141,147,158,161,"GAGATCA","CAGA","ATTAATA","CTGA",2.3155871544773,19,5,11,44,2.50276775571577,4.48500386305777,7.70984858355466,101,"ENSG00000079974.19"
"6568","ENSG00000110721.12_11208",11200,11208,9,"ENSG00000110721.12",1,8,"UVVVVVVMV",1,7,0.786749482401656,114,120,133,136,145,151,160,163,"ATGATGT","GTGA","ATTGTTA","CTGT",2.29101400108468,13,9,9,40,2.9779462793036,4.56284323830037,7.709841167907,101,"ENSG00000079974.19"
"25332","ENSG00000180891.13_18646",18638,18646,9,"ENSG00000180891.13",1,8,"VVVVUVVMV",1,7,0.773913043478261,104,110,133,136,184,190,202,205,"GGGATGG","CTGA","CTGCTGA","CTGA",2.58360443409182,23,48,12,92,1.23246100514813,4.61412264144006,7.70977481535311,101,"ENSG00000079974.19"
"26285","ENSG00000183780.13_134840",134832,134840,9,"ENSG00000183780.13",1,2,"UMVVVUVVV",2,6,0.708902691511387,74,80,92,95,116,122,133,136,"AAGGTGA","CTGA","TTGATTA","CTGA",2.59081746266379,12,21,11,53,2.22446802164912,4.87414610985194,7.70975687589748,101,"ENSG00000079974.19"
"47060","ENSG00000287564.2_67858",67850,67858,9,"ENSG00000287564.2",1,8,"UVVVVVVMV",1,7,0.786749482401656,82,88,98,101,109,115,133,136,"ATGATGG","GTGA","ATTATGG","CTGG",2.35543441283881,10,8,18,45,2.54802798582962,4.56273101785542,7.70972894746204,101,"ENSG00000079974.19"
"21494","ENSG00000168028.15_14420",14412,14420,9,"ENSG00000168028.15",1,1,"MVVVVUVVV",1,7,0.82815734989648,70,76,94,97,107,113,133,136,"ATGATCA","ATGA","ATAATAA","TTGA",2.32609960744801,18,10,20,57,2.08095677459209,4.39707187272804,7.70970127231397,101,"ENSG00000079974.19"
"48012","ENSG00000290020.1_5926",5918,5926,9,"ENSG00000290020.1",1,2,"VMVVVUVVV",1,7,0.806211180124223,115,121,133,136,164,170,185,188,"AAGCTGA","CTCA","CTGTTTA","CTGA",2.40730642153256,12,28,15,64,1.89058946026008,4.48482473428596,7.70966945478285,101,"ENSG00000079974.19"
"27375","ENSG00000186094.18_1135765",1135757,1135765,9,"ENSG00000186094.18",1,2,"VMVUVVVVV",1,7,0.764803312629399,97,103,133,136,163,169,183,186,"ATGATGC","CTGG","GTGAACA","CTGA",2.63985671509842,30,27,14,80,1.00256683442844,4.6504029004378,7.7096161509554,101,"ENSG00000079974.19"
"42181","ENSG00000261008.9_243241",243233,243241,9,"ENSG00000261008.9",1,2,"VMVUVVVVV",1,7,0.764803312629399,111,117,133,136,139,145,196,199,"ATAATGA","CTGG","AAGATTA","CTGA",2.55913564469845,16,3,51,79,1.54069402593363,4.65039958098082,7.70961283149842,101,"ENSG00000079974.19"
"3012","ENSG00000080224.18_926052",926044,926052,9,"ENSG00000080224.18",1,8,"VVVVVVUMV",1,7,0.770186335403727,111,117,133,136,174,180,192,195,"ATCATGA","CATA","GTGAATA","CTGA",2.50626487447259,16,38,12,75,1.80699627220493,4.62885719217222,7.70960253378712,101,"ENSG00000079974.19"
"26463","ENSG00000184304.17_502209",502201,502209,9,"ENSG00000184304.17",0,NA,"UVVUVVVVV",2,7,0.78343685300207,86,92,102,105,112,118,133,136,"TTGATGA","TTGA","GTCTTGC","CTGC",2.33141495762831,10,7,15,41,2.7605648588743,4.57583281076576,7.70958022277404,101,"ENSG00000079974.19"
"38054","ENSG00000249429.1_8884",8876,8884,9,"ENSG00000249429.1",1,7,"VVVUVVMVV",1,7,0.766045548654244,107,113,133,136,139,145,155,158,"GTGATGG","CAGC","TTGAAGT","CTGA",2.45592821962205,20,3,10,42,2.20862868122173,4.64537086967552,7.70955306429249,101,"ENSG00000079974.19"
"36415","ENSG00000240553.1_48388",48380,48388,9,"ENSG00000240553.1",1,8,"VVVVVVUMV",1,7,0.770186335403727,115,121,133,136,145,151,187,190,"AAGATAA","CAGA","GTGCAGA","CTGA",2.4780467426823,12,9,36,66,1.99482879132742,4.62878510230235,7.70953044391726,101,"ENSG00000079974.19"
"21987","ENSG00000169504.15_17085",17077,17085,9,"ENSG00000169504.15",0,NA,"UVVUVVVVV",2,7,0.78343685300207,116,122,133,136,139,145,156,159,"TGGATGA","AGGA","ATGCCTA","CTGA",2.32123530375879,11,3,11,34,2.8281652332091,4.57576681456693,7.70951422657521,101,"ENSG00000079974.19"
"11960","ENSG00000136715.19_76043",76035,76043,9,"ENSG00000136715.19",1,8,"UVVVVUVMV",2,6,0.708902691511387,112,118,133,136,153,159,188,191,"TTGATGA","GTGA","TTGAGGA","CTGA",2.70134119868252,15,17,29,70,1.48656707435994,4.87387709972752,7.70948786577307,101,"ENSG00000079974.19"
"16790","ENSG00000152253.9_49878",49870,49878,9,"ENSG00000152253.9",1,1,"MVVVVUVVV",1,7,0.82815734989648,114,120,133,136,144,150,197,200,"GTCATAA","CTGC","AGGATCA","CTGA",2.34002689026063,13,8,47,77,1.98703006387436,4.39680233306963,7.70943173265555,101,"ENSG00000079974.19"
"43837","ENSG00000274282.1_3794",3786,3794,9,"ENSG00000274282.1",0,NA,"VVVUVVUVV",2,7,0.766873706004141,110,116,133,136,145,151,167,170,"CTGTTGA","CTGT","ATTAGGT","CTGA",2.41547492756519,17,9,16,51,2.46457668551793,4.64193571732147,7.70943054133803,101,"ENSG00000079974.19"
"20600","ENSG00000165140.12_1821",1813,1821,9,"ENSG00000165140.12",0,NA,"VVVVVUUVV",2,7,0.808281573498965,93,99,133,136,138,144,156,159,"ATGATGG","CAAA","GTGGTTT","CTGA",2.46146274639765,34,2,12,57,1.49539834896839,4.47628749790485,7.7094137919007,101,"ENSG00000079974.19"
"4382","ENSG00000100354.21_8573",8565,8573,9,"ENSG00000100354.21",1,7,"UVVVVVMVV",1,7,0.787991718426501,116,122,133,136,148,154,196,199,"ATTAGGA","CTGG","TTGCTGA","CTGA",2.47131240994287,11,12,42,74,1.75435708627168,4.55744328813937,7.70941016184538,101,"ENSG00000079974.19"
"29149","ENSG00000197321.16_203994",203986,203994,9,"ENSG00000197321.16",0,NA,"VVVVUVUVV",2,7,0.775983436853002,112,118,133,136,151,157,169,172,"GTGATGG","CAGA","ATGAGGA","CTGC",2.40000195319829,15,15,12,51,2.42184094375225,4.60546349126854,7.70939723868055,101,"ENSG00000079974.19"
"21890","ENSG00000169282.18_324926",324918,324926,9,"ENSG00000169282.18",1,3,"VVMVUVVVV",1,7,0.772670807453416,101,107,133,136,140,146,155,158,"AGGATGA","TAGA","GTGTGGG","CTGA",2.47539707754185,26,4,9,48,1.97182079438645,4.6186169944997,7.70930022431337,101,"ENSG00000079974.19"
"47266","ENSG00000287916.1_219057",219049,219057,9,"ENSG00000287916.1",1,3,"VVMVUVVVV",1,7,0.772670807453416,101,107,133,136,140,146,155,158,"AGGATGA","TAGA","GTGTGGG","CTGA",2.47539707754185,26,4,9,48,1.97182079438645,4.6186169944997,7.70930022431337,101,"ENSG00000079974.19"
"12181","ENSG00000137571.11_107325",107317,107325,9,"ENSG00000137571.11",1,2,"VMVVVVUVV",1,7,0.770186335403727,114,120,133,136,142,148,156,159,"GCTATGA","GTGA","ATTAGGC","CTGA",2.31777693796803,13,6,8,36,3.06214521483788,4.62849786698952,7.70924320860443,101,"ENSG00000079974.19"
"28324","ENSG00000188674.11_19890",19882,19890,9,"ENSG00000188674.11",1,2,"VMVVVUVVV",1,7,0.806211180124223,105,111,133,136,145,151,160,163,"ATGCTGG","GGGA","TTGAGAA","CTGA",2.34752332291759,22,9,9,49,2.28742971601786,4.48439630053379,7.70924102103068,101,"ENSG00000079974.19"
"10760","ENSG00000132704.16_5742",5734,5742,9,"ENSG00000132704.16",1,1,"MVVVUVVVV",1,7,0.795859213250517,115,121,133,136,148,154,169,172,"CTGGTGA","GGGA","TTTATAA","CTGA",2.32773197414115,12,12,15,48,2.58494111848045,4.52578856985537,7.70922542285744,101,"ENSG00000079974.19"
"39746","ENSG00000254180.2_12323",12315,12323,9,"ENSG00000254180.2",1,8,"VVVVUVVMV",1,7,0.773913043478261,101,107,133,136,180,186,200,203,"AGGATGA","GTGA","GTGCTGC","CTGA",2.61690736912254,26,44,14,93,1.00824093684432,4.61357251608199,7.70922468999503,101,"ENSG00000079974.19"
"38695","ENSG00000250900.6_6505",6497,6505,9,"ENSG00000250900.6",1,1,"MVVVUUVVV",2,6,0.718012422360248,115,121,133,136,149,155,199,202,"GTGATGA","CTGG","GTGCAGG","CTGA",2.64678900686442,12,13,44,78,1.70338958299107,4.83716240718847,7.70921209662947,101,"ENSG00000079974.19"
"18356","ENSG00000157152.17_19292",19284,19292,9,"ENSG00000157152.17",0,NA,"UVVVVUVVV",2,7,0.824844720496894,111,117,133,136,142,148,189,192,"ATCTTGT","GTGA","TTGATCA","CTGA",2.37012779579481,16,6,41,72,1.83846741588106,4.40982984696161,7.70920872894919,101,"ENSG00000079974.19"
"37047","ENSG00000244650.2_25206",25198,25206,9,"ENSG00000244650.2",1,8,"UVVVVVVMV",1,7,0.786749482401656,115,121,133,136,154,160,168,171,"ATGAGGC","GTGC","TTGGTGA","CTGA",2.38393851752275,12,18,8,47,2.35584576824569,4.56219230459934,7.70919023420596,101,"ENSG00000079974.19"
"23055","ENSG00000172159.16_147201",147193,147201,9,"ENSG00000172159.16",1,1,"MVUVVVVVV",1,7,0.789648033126294,44,50,69,72,80,86,133,136,"ATGATGA","GTGA","ATGCTGC","CTAA",2.49509767427673,19,8,47,83,1.5682710197547,4.55056387873322,7.7091560112384,101,"ENSG00000079974.19"
"5000","ENSG00000102678.7_14594",14586,14594,9,"ENSG00000102678.7",1,6,"VVVVVMUVV",1,7,0.788819875776397,116,122,133,136,154,160,173,176,"GTGATGA","ATGA","GTAAATA","GTGA",2.39223845713044,11,18,13,51,2.26716785093942,4.55385605795226,7.70913556105785,101,"ENSG00000079974.19"
"4706","ENSG00000101745.17_8768",8760,8768,9,"ENSG00000101745.17",0,NA,"UVVVVVUVV",2,7,0.788819875776397,90,96,133,136,147,153,205,208,"ATTATGA","ATGA","CTGAAAA","CTGA",2.60614808882964,37,11,52,109,0.840988973984863,4.55382739154561,7.7091068946512,101,"ENSG00000079974.19"
"42622","ENSG00000265257.5_42260",42252,42260,9,"ENSG00000265257.5",0,NA,"UVVVVVUVV",2,7,0.788819875776397,90,96,133,136,147,153,205,208,"ATTATGA","ATGA","CTGAAAA","CTGA",2.60614808882964,37,11,52,109,0.840988973984863,4.55382739154561,7.7091068946512,101,"ENSG00000079974.19"
"26004","ENSG00000183117.20_793913",793905,793913,9,"ENSG00000183117.20",0,NA,"UVVVVUVVV",2,7,0.824844720496894,114,120,133,136,168,174,183,186,"GTTATCT","GTGA","ATGATGC","CTGA",2.34140323496015,13,32,9,63,2.02944324841957,4.40969953703848,7.70907841902606,101,"ENSG00000079974.19"
"39972","ENSG00000254560.6_118834",118826,118834,9,"ENSG00000254560.6",1,8,"VVVVVUVMV",1,7,0.806211180124224,106,112,133,136,183,189,208,211,"GTGATAA","ATGA","ATGCTGT","CTGA",2.5424947433529,21,47,19,96,0.986834362278282,4.48419982949107,7.70904454998796,101,"ENSG00000079974.19"
"44001","ENSG00000276644.5_106407",106399,106407,9,"ENSG00000276644.5",1,2,"VMVVVVUVV",1,7,0.770186335403727,97,103,133,136,140,146,180,183,"ATGATGA","AAGA","ATAAAGA","CTGA",2.63523767039881,30,4,34,77,0.944920148256572,4.62829282106216,7.70903816267707,101,"ENSG00000079974.19"
"34965","ENSG00000234477.1_37225",37217,37225,9,"ENSG00000234477.1",1,1,"MVVVUVVVV",1,7,0.795859213250517,97,103,133,136,144,150,160,163,"ATGATGA","ATGA","ATCCTTA","GTGA",2.41083354524961,30,8,10,57,2.03015898116039,4.52559565403945,7.70903250704152,101,"ENSG00000079974.19"
"17260","ENSG00000153707.19_960434",960426,960434,9,"ENSG00000153707.19",1,2,"VMUVVVVVV",1,7,0.767701863354037,108,114,133,136,144,150,161,164,"GAGATAA","TTGA","CTGAAGG","CTGA",2.40009589313837,19,8,11,47,2.55202089867251,4.63816504656542,7.70897249998156,101,"ENSG00000079974.19"
"5240","ENSG00000104059.5_39673",39665,39673,9,"ENSG00000104059.5",1,8,"VVVUVVVMV",1,7,0.764803312629399,89,95,133,136,141,147,157,160,"ATGATGA","CTGG","ATGAATA","CAGA",2.49969273397973,38,5,10,62,1.93438100132553,4.64974980696427,7.70896305748187,101,"ENSG00000079974.19"
"17397","ENSG00000154079.6_18555",18547,18555,9,"ENSG00000154079.6",1,8,"VVVVVUVMV",1,7,0.806211180124224,86,92,133,136,146,152,160,163,"GTGAGGA","CTCA","ACCATGC","CTGA",2.40855602814341,41,10,8,68,1.87933245043506,4.48409315951444,7.70893788001134,101,"ENSG00000079974.19"
"28505","ENSG00000189337.17_904240",904232,904240,9,"ENSG00000189337.17",1,1,"MVVVVUVVV",1,7,0.82815734989648,34,40,48,51,78,84,133,136,"ATGGTGA","CTGA","ATGTTGA","CAGA",2.51448832247284,8,27,49,93,0.821841973173879,4.39627436408154,7.70890376366746,101,"ENSG00000079974.19"
"17022","ENSG00000152969.21_108449",108441,108449,9,"ENSG00000152969.21",0,NA,"VVUVVVUVV",2,7,0.769772256728778,87,93,133,136,142,148,196,199,"GTGAGGA","CTGA","TTGCTGG","CTGA",2.62951265044155,40,6,48,103,0.989154980524804,4.62980982920045,7.70889885611556,101,"ENSG00000079974.19"
"25377","ENSG00000181215.16_108413",108405,108413,9,"ENSG00000181215.16",0,NA,"VVUVVVUVV",2,7,0.769772256728778,87,93,133,136,142,148,196,199,"GTGAGGA","CTGA","TTGCTGG","CTGA",2.62951265044155,40,6,48,103,0.989154980524804,4.62980982920045,7.70889885611556,101,"ENSG00000079974.19"
"34485","ENSG00000233146.1_11414",11406,11414,9,"ENSG00000233146.1",1,8,"VVUVVVVMV",1,7,0.767701863354037,106,112,133,136,140,146,156,159,"ATGATGG","CTCA","GTGATGG","CTCA",2.44439942128324,21,4,10,44,2.25623726654087,4.63805835210729,7.70886580552344,101,"ENSG00000079974.19"
"8635","ENSG00000119950.21_45195",45187,45195,9,"ENSG00000119950.21",0,NA,"UVVVVVUVV",2,7,0.788819875776397,111,117,133,136,146,152,161,164,"ATAATGA","ATGA","CTCTTGA","TTGA",2.32063239226176,16,10,9,44,2.74342649492762,4.55357727750151,7.7088567806071,101,"ENSG00000079974.19"
"13955","ENSG00000144036.16_534658",534650,534658,9,"ENSG00000144036.16",1,2,"VMVUVVVVV",1,7,0.764803312629399,86,92,105,108,114,120,133,136,"CTGATGA","TTGA","GAGGAGA","CTTA",2.35137668988935,13,6,13,41,2.9227224780417,4.64964176932601,7.70885501984361,101,"ENSG00000079974.19"
"11166","ENSG00000134138.22_134151",134143,134151,9,"ENSG00000134138.22",1,2,"VMVVVUVVV",1,7,0.806211180124223,106,112,133,136,152,158,171,174,"AGGATGA","CCCA","ATGGAAA","CTGA",2.41776803109866,21,16,13,59,1.81754338453652,4.48399923129857,7.70884395179546,101,"ENSG00000079974.19"
"2672","ENSG00000077254.14_20818",20810,20818,9,"ENSG00000077254.14",1,8,"VVUVVVVMV",1,7,0.767701863354037,115,121,133,136,144,150,198,201,"TTGAAGA","CTAA","TTGAAGT","CTGA",2.48421649104107,12,8,48,77,1.99061702741228,4.63801507525485,7.708822528671,101,"ENSG00000079974.19"
"31284","ENSG00000221955.11_57578",57570,57578,9,"ENSG00000221955.11",1,8,"UVVVVVVMV",1,7,0.786749482401656,116,122,133,136,148,154,162,165,"AAGATGA","CTGG","TTGCTGT","TTGA",2.32400087996219,11,12,8,40,2.75392514849667,4.56181608706115,7.70881401666778,101,"ENSG00000079974.19"
"40314","ENSG00000255523.1_4845",4837,4845,9,"ENSG00000255523.1",1,2,"VMVVVUVVV",1,7,0.806211180124223,90,96,107,110,114,120,133,136,"ATTATCT","GTGA","GTAATCT","CTGA",2.26878210686311,11,4,13,37,2.81054232819474,4.4839390934872,7.70878381398409,101,"ENSG00000079974.19"
"32268","ENSG00000226571.2_216438",216430,216438,9,"ENSG00000226571.2",1,1,"MVVVVVUVV",1,7,0.792132505175983,80,86,99,102,110,116,133,136,"GTGGTGA","TTGA","GTGAGTA","TTGA",2.32174637607039,13,8,17,47,2.68264508947955,4.54023856582054,7.70876858652447,101,"ENSG00000079974.19"
"15404","ENSG00000148158.17_57579",57571,57579,9,"ENSG00000148158.17",1,6,"VVVUVMVVV",1,7,0.78343685300207,101,107,133,136,143,149,162,165,"CTGATGA","CTTT","GAGCTAA","CTGA",2.43708650573058,26,7,13,55,2.05274520835517,4.5749971449731,7.70874455698138,101,"ENSG00000079974.19"
"9047","ENSG00000122482.22_66695",66687,66695,9,"ENSG00000122482.22",1,8,"VVVVUVVMV",1,7,0.773913043478261,111,117,133,136,156,162,171,174,"ATGAGGT","ATGT","GTGATGC","CTGA",2.45064548010766,16,20,9,54,2.11461663836021,4.61306329310282,7.70871546701586,101,"ENSG00000079974.19"
"27011","ENSG00000185420.19_486452",486444,486452,9,"ENSG00000185420.19",1,7,"UVVVVVMVV",1,7,0.787991718426501,99,105,133,136,174,180,195,198,"ATGATGA","GAGA","ATGAGTT","CTGA",2.59812149054561,28,38,15,90,0.906175579278138,4.55674637906222,7.70871325276823,101,"ENSG00000079974.19"
"12213","ENSG00000137672.13_213858",213850,213858,9,"ENSG00000137672.13",1,1,"MVVVVVUVV",1,7,0.792132505175983,116,122,133,136,139,145,155,158,"ATCCTGA","CAAA","CAGAGGA","CTGA",2.29147303412009,11,3,10,33,2.88390446837489,4.54009784062721,7.70862786133114,101,"ENSG00000079974.19"
"19983","ENSG00000164117.14_19788",19780,19788,9,"ENSG00000164117.14",1,3,"VVMVVUVVV",1,7,0.804968944099379,92,98,133,136,145,151,204,207,"ATGAGGA","CTGG","CAGATGG","CTGA",2.54913372543621,35,9,53,106,0.960482066549249,4.48867672569766,7.70855250209517,101,"ENSG00000079974.19"
"41981","ENSG00000260202.2_29742",29734,29742,9,"ENSG00000260202.2",1,7,"UVVVVVMVV",1,7,0.787991718426501,114,120,133,136,139,145,167,170,"CTGCTGC","CTGA","GAGATTT","CTGA",2.41791100822064,13,3,22,47,2.10686722896857,4.55656848760988,7.70853536131588,101,"ENSG00000079974.19"
"31506","ENSG00000223930.9_107023",107015,107023,9,"ENSG00000223930.9",1,1,"MVVVVUVVV",1,7,0.82815734989648,114,120,133,136,159,165,179,182,"GTGATGT","CTAA","ATGATAT","TTGA",2.33152864261068,13,23,14,59,2.04004895092253,4.39589330874843,7.70852270833435,101,"ENSG00000079974.19"
"18903","ENSG00000159216.19_469516",469508,469516,9,"ENSG00000159216.19",1,2,"VMVVUVVVV",1,7,0.773913043478261,70,76,86,89,101,107,133,136,"TTGGTGA","GTGA","GTTATGC","CTGA",2.4794938551322,10,12,26,57,1.92149119595423,4.61286255754222,7.70851473145526,101,"ENSG00000079974.19"
"37495","ENSG00000248309.9_459096",459088,459096,9,"ENSG00000248309.9",1,2,"UMVVVVVVV",1,7,0.786749482401656,105,111,133,136,170,176,184,187,"GTCATGC","CTGA","GGGAAGA","CTGA",2.53571198668676,22,34,8,73,1.3412886511802,4.56150880727298,7.70850673687961,101,"ENSG00000079974.19"
"2572","ENSG00000075884.14_431549",431541,431549,9,"ENSG00000075884.14",1,2,"UMVVVUVVV",2,6,0.708902691511387,106,112,133,136,146,152,186,189,"ATGATGA","CTTA","GCGATCA","CTGA",2.71798309965159,21,10,34,74,1.37159914180085,4.87287161820286,7.70848238424841,101,"ENSG00000079974.19"
"17440","ENSG00000154162.15_728738",728730,728738,9,"ENSG00000154162.15",1,8,"VVUVVVVMV",1,7,0.767701863354037,115,121,133,136,151,157,177,180,"ATAAAGA","CTGA","AAGACCA","CTGA",2.47203569350932,12,15,20,56,2.07039238368599,4.63765758510369,7.70846503851984,101,"ENSG00000079974.19"
"11971","ENSG00000136754.18_15762",15754,15762,9,"ENSG00000136754.18",1,2,"VMVVVUVVV",1,7,0.806211180124223,84,90,103,106,111,117,133,136,"ATCATGC","CTAT","TTTATAA","CTGA",2.2854437574836,13,5,16,43,2.69799301074586,4.4835711818258,7.70841590232269,101,"ENSG00000079974.19"
"35065","ENSG00000234828.9_198144",198136,198144,9,"ENSG00000234828.9",1,6,"UVVVVMVVV",1,7,0.805383022774327,115,121,133,136,153,159,186,189,"ATAATGA","TTCA","CAGATGT","CTGA",2.44730878341915,12,17,27,65,1.63183731832397,4.48680730194623,7.70833939304354,101,"ENSG00000079974.19"
"36852","ENSG00000243276.6_425817",425809,425817,9,"ENSG00000243276.6",1,2,"VMVVVUUVV",2,6,0.692339544513457,87,93,106,109,112,118,133,136,"ATGATGG","ATGA","GAGAAGC","CTGA",2.5813174845839,13,3,15,40,2.54671263256553,4.93887396578121,7.70823214383504,101,"ENSG00000079974.19"
"11998","ENSG00000136842.14_96857",96849,96857,9,"ENSG00000136842.14",1,7,"UVVVVVMVV",1,7,0.787991718426501,116,122,133,136,147,153,187,190,"AAGATGA","TTGG","GTGCGGT","CTGA",2.45273167611907,11,11,34,65,1.87344483374063,4.55624733530027,7.70821420900627,101,"ENSG00000079974.19"
"19047","ENSG00000160460.17_73616",73608,73616,9,"ENSG00000160460.17",1,1,"MVVVVVUVV",1,7,0.792132505175983,86,92,133,136,145,151,160,163,"ATAATGA","ATAA","GTGGTTT","CTGA",2.43127681355817,41,9,9,68,1.95017594934001,4.53967200993195,7.70820203063588,101,"ENSG00000079974.19"
"376","ENSG00000010310.9_4743",4735,4743,9,"ENSG00000010310.9",1,1,"MVVVUVVVV",1,7,0.795859213250517,109,115,133,136,146,152,193,196,"ATGAGGC","GTGA","GTTAGGA","CTGA",2.47762615071289,18,10,41,78,1.58135427403656,4.52471548636395,7.70815233936602,101,"ENSG00000079974.19"
"48110","ENSG00000290441.1_32825",32817,32825,9,"ENSG00000290441.1",1,1,"MVVVVVUVV",1,7,0.792132505175983,109,115,133,136,161,167,180,183,"GTCATGA","ATGA","AGGCAGA","CTGA",2.46733714927328,18,25,13,65,1.70936634844759,4.53957016923404,7.70810018993797,101,"ENSG00000079974.19"
"8324","ENSG00000118246.14_28487",28479,28487,9,"ENSG00000118246.14",1,8,"UVVVVVVMV",1,7,0.786749482401656,112,118,133,136,143,149,158,161,"CTGATGA","CAGT","GTAAAGA","TTGA",2.29546216443282,15,7,9,40,2.94121729565198,4.56107459796769,7.70807252757432,101,"ENSG00000079974.19"
"5366","ENSG00000104375.17_51660",51652,51660,9,"ENSG00000104375.17",1,8,"VVUVVVVMV",1,7,0.767701863354037,113,119,133,136,145,151,171,174,"GTGCTGA","CAGC","GTGGTCA","CTGA",2.41767499859933,14,9,20,52,2.43116828496716,4.63725040224068,7.70805785565683,101,"ENSG00000079974.19"
"30739","ENSG00000212993.6_75013",75005,75013,9,"ENSG00000212993.6",1,8,"VVVVVUVMV",1,7,0.806211180124224,57,63,102,105,110,116,133,136,"GTGATGA","GTGA","GGGAGGA","CAGA",2.44525258615756,39,5,17,70,1.63113903132377,4.4832057347602,7.7080504552571,101,"ENSG00000079974.19"
"39313","ENSG00000253438.5_840873",840865,840873,9,"ENSG00000253438.5",1,8,"VVVVVUVMV",1,7,0.806211180124224,57,63,102,105,110,116,133,136,"GTGATGA","GTGA","GGGAGGA","CAGA",2.44525258615756,39,5,17,70,1.63113903132377,4.4832057347602,7.7080504552571,101,"ENSG00000079974.19"
"25245","ENSG00000180205.4_16832",16824,16832,9,"ENSG00000180205.4",1,1,"MVUVVVVVV",1,7,0.789648033126294,109,115,133,136,139,145,157,160,"CTGAGGT","CAGA","CTAAAGA","CTGA",2.37825434486811,18,3,12,42,2.34270310926573,4.54943301876328,7.70802515126846,101,"ENSG00000079974.19"
"35242","ENSG00000235450.1_52762",52754,52762,9,"ENSG00000235450.1",0,NA,"VVUVVUVVV",2,7,0.805797101449275,115,121,133,136,141,147,194,197,"AAGGTGA","TTGC","ATGAAGA","CTGA",2.40044436115177,12,5,47,73,1.93637302549512,4.48483385829339,7.70802226409049,101,"ENSG00000079974.19"
"7085","ENSG00000112701.18_108148",108140,108148,9,"ENSG00000112701.18",1,8,"UVVVVVVMV",1,7,0.786749482401656,113,119,133,136,145,151,165,168,"TTAATGC","CTAA","CTAATTA","CTGA",2.3180754359952,14,9,14,46,2.78995296156916,4.56094730038429,7.70794522999091,101,"ENSG00000079974.19"
"41638","ENSG00000259404.8_23721",23713,23721,9,"ENSG00000259404.8",0,NA,"VVVVVUUVV",2,7,0.808281573498965,70,76,101,104,114,120,133,136,"TTGATGA","TTGA","CTCAAGA","TTGA",2.38652475492561,25,10,13,57,1.98908161848934,4.47481166283168,7.70793795682754,101,"ENSG00000079974.19"
"48392","ENSG00000291062.1_23721",23713,23721,9,"ENSG00000291062.1",0,NA,"VVVVVUUVV",2,7,0.808281573498965,70,76,101,104,114,120,133,136,"TTGATGA","TTGA","CTCAAGA","TTGA",2.38652475492561,25,10,13,57,1.98908161848934,4.47481166283168,7.70793795682754,101,"ENSG00000079974.19"
"3382","ENSG00000083067.25_847273",847265,847273,9,"ENSG00000083067.25",1,8,"UVVVVUVMV",2,6,0.708902691511387,91,97,133,136,142,148,161,164,"AAGATGA","CTGA","AGGAATA","CTGA",2.63698913053844,36,6,13,64,1.90899736710387,4.87223122600671,7.70784199205225,101,"ENSG00000079974.19"
"41897","ENSG00000259929.5_26841",26833,26841,9,"ENSG00000259929.5",1,2,"VMVVVUVVV",1,7,0.806211180124223,116,122,133,136,140,146,154,157,"AGGATGA","GTCA","ATGGAGA","CTGT",2.23240103639969,11,4,8,32,3.04928404403719,4.48298940500878,7.70783412550568,101,"ENSG00000079974.19"
"41991","ENSG00000260242.1_48309",48301,48309,9,"ENSG00000260242.1",1,2,"VMVVVUVVV",1,7,0.806211180124223,116,122,133,136,140,146,154,157,"AGGATGA","GTCA","ATGGAGA","CTGT",2.23240103639969,11,4,8,32,3.04928404403719,4.48298940500878,7.70783412550568,101,"ENSG00000079974.19"
"4634","ENSG00000101391.21_1152",1144,1152,9,"ENSG00000101391.21",1,1,"MVVVVUVVV",1,7,0.82815734989648,115,121,133,136,142,148,169,172,"ATTATGG","GCGA","AAGTTCA","CTGA",2.27018563311654,12,6,21,48,2.44610458047867,4.39516886698057,7.70779826656649,101,"ENSG00000079974.19"
"35324","ENSG00000235711.5_13111",13103,13111,9,"ENSG00000235711.5",0,NA,"VVVVUVUVV",2,7,0.775983436853002,43,49,63,66,74,80,133,136,"TTGATGA","CAGA","CTGAGGA","GTGA",2.46952916499901,14,8,53,84,1.9517277103827,4.60381386926069,7.7077476166727,101,"ENSG00000079974.19"
"28679","ENSG00000196352.18_41505",41497,41505,9,"ENSG00000196352.18",1,2,"VMVVUVVVV",1,7,0.773913043478261,68,74,94,97,106,112,133,136,"ATGATGG","GTGA","GTGAAGA","ATGA",2.48206327384267,20,9,21,59,1.90122195874861,4.61207761275827,7.70772978667131,101,"ENSG00000079974.19"
"1737","ENSG00000065809.14_118203",118195,118203,9,"ENSG00000065809.14",1,2,"UMVVVVVVV",1,7,0.786749482401656,110,116,133,136,137,143,151,154,"ATGTTGG","CTTA","GAGAAGG","CTGA",2.4075641878852,17,1,8,35,2.19249776323395,4.56073142061716,7.70772935022378,101,"ENSG00000079974.19"
"9980","ENSG00000128655.19_137386",137378,137386,9,"ENSG00000128655.19",1,5,"UVVVMVVVV",1,7,0.789233954451346,109,115,133,136,172,178,191,194,"GTAATGA","ATCA","GTGCTGA","CTGA",2.49019627064754,18,36,13,76,1.60186167827541,4.55079253731475,7.70772835512013,101,"ENSG00000079974.19"
"35666","ENSG00000236664.1_41036",41028,41036,9,"ENSG00000236664.1",1,5,"UVVVMVVVV",1,7,0.789233954451346,109,115,133,136,172,178,191,194,"GTAATGA","ATCA","GTGCTGA","CTGA",2.49019627064754,18,36,13,76,1.60186167827541,4.55079253731475,7.70772835512013,101,"ENSG00000079974.19"
"6521","ENSG00000110436.13_122944",122936,122944,9,"ENSG00000110436.13",1,8,"VVVUVVVMV",1,7,0.764803312629399,109,115,133,136,143,149,166,169,"ATAAGGA","CAGA","CAGAAGA","CTGA",2.43442823002709,18,7,17,51,2.36443557425484,4.64848927694219,7.70770252745979,101,"ENSG00000079974.19"
"20915","ENSG00000165973.19_811784",811776,811784,9,"ENSG00000165973.19",1,8,"VVVUVVVMV",1,7,0.764803312629399,102,108,133,136,138,144,166,169,"TTAATGA","GTGA","ATGATGA","CTGA",2.62338666731629,25,2,22,58,1.1045664747155,4.6484527308727,7.7076659813903,101,"ENSG00000079974.19"
"43108","ENSG00000268746.1_104262",104254,104262,9,"ENSG00000268746.1",1,8,"VVVUVVVMV",1,7,0.764803312629399,91,97,133,136,174,180,197,200,"ATGATGA","CAGA","GGGATTG","CTGA",2.68184259040016,36,38,17,100,0.714841637562345,4.64844806005752,7.70766131057512,101,"ENSG00000079974.19"
"28587","ENSG00000196189.14_9811",9803,9811,9,"ENSG00000196189.14",1,2,"VMVVVUVVV",1,7,0.806211180124223,68,74,83,86,106,112,133,136,"CATATGA","CTGA","TTGATAT","CTGA",2.45347756012894,9,20,21,59,1.57455412568713,4.48276779830334,7.70761251880024,101,"ENSG00000079974.19"
"1333","ENSG00000053747.17_204453",204445,204453,9,"ENSG00000053747.17",1,8,"VVVVVUVMV",1,7,0.806211180124224,81,87,98,101,108,114,133,136,"ATGATGC","ATGA","AAGAGGC","CTAA",2.30651755532582,11,7,19,46,2.55419265928851,4.48274409036517,7.70758881086206,101,"ENSG00000079974.19"
"31997","ENSG00000225546.6_228939",228931,228939,9,"ENSG00000225546.6",0,NA,"UVVVUVVVV",2,7,0.792546583850932,99,105,133,136,170,176,186,189,"TTGATGA","AAGA","TTTATGA","CTGA",2.5571242932602,28,34,10,81,1.10209663834466,4.5373979816865,7.70758431709023,101,"ENSG00000079974.19"
"14523","ENSG00000145335.17_84624",84616,84624,9,"ENSG00000145335.17",1,8,"VVVVVVUMV",1,7,0.770186335403727,115,121,133,136,145,151,162,165,"AGGAGGA","CTAC","GTGACAA","CTGA",2.33199970413829,12,9,11,41,2.96068183600898,4.62683663256607,7.70758197418097,101,"ENSG00000079974.19"
"350","ENSG00000009413.16_44214",44206,44214,9,"ENSG00000009413.16",1,3,"VVMVVUVVV",1,7,0.804968944099379,110,116,133,136,183,189,217,220,"ATGTTGA","CTAT","TTGATGA","CTGA",2.55293050146117,17,47,28,101,0.931286244303397,4.4877057301778,7.70758150657531,101,"ENSG00000079974.19"
"1446","ENSG00000056291.19_35424",35416,35424,9,"ENSG00000056291.19",0,NA,"VVVVVUUVV",2,7,0.808281573498965,90,96,107,110,116,122,133,136,"AATATGG","CTTA","ACGTTGG","CTGA",2.23108683279546,11,6,11,37,3.02323689980693,4.47428727961084,7.7074135736067,101,"ENSG00000079974.19"
"11526","ENSG00000135297.17_24277",24269,24277,9,"ENSG00000135297.17",1,5,"VVVVMUVVV",1,7,0.808695652173913,100,106,133,136,138,144,153,156,"TTGCTGC","CTGA","CAGTTGA","CTGA",2.43915342653875,27,2,9,47,1.62928643730879,4.47257732022511,7.70735992892076,101,"ENSG00000079974.19"
"25552","ENSG00000182150.19_22947",22939,22947,9,"ENSG00000182150.19",1,2,"VMVVVVUVV",1,7,0.770186335403727,83,89,133,136,149,155,165,168,"GTGTTGA","ATGA","TTGATTT","CTGA",2.52179651336568,44,13,10,76,1.69446734913847,4.62661102622741,7.70735636784232,101,"ENSG00000079974.19"
"33426","ENSG00000229727.7_25784",25776,25784,9,"ENSG00000229727.7",1,5,"VVVVMUVVV",1,7,0.808695652173913,58,64,76,79,88,94,133,136,"AGGATGA","CTCA","CTGATGG","CTGG",2.38718873857084,12,9,39,69,1.97563334026743,4.47255623268493,7.70733884138058,101,"ENSG00000079974.19"
"40868","ENSG00000258010.4_8040",8032,8040,9,"ENSG00000258010.4",1,6,"VVUVVMVVV",1,7,0.786335403726708,63,69,102,105,107,113,133,136,"GTGAGGA","CTGA","GTTATTC","CTGA",2.57841467746858,33,2,20,64,1.05852990764069,4.56199027269113,7.70733188759797,101,"ENSG00000079974.19"
"39188","ENSG00000253286.6_13121",13113,13121,9,"ENSG00000253286.6",0,NA,"UVVVVUVVV",2,7,0.824844720496894,107,113,133,136,142,148,160,163,"ATGGAGA","TTCA","GTGTTAT","CTGA",2.27950416908357,20,6,12,47,2.43500268998503,4.40792428763554,7.70730316962311,101,"ENSG00000079974.19"
"30998","ENSG00000215174.2_1779",1771,1779,9,"ENSG00000215174.2",1,1,"MVVVVVUVV",1,7,0.792132505175983,106,112,133,136,146,152,172,175,"GTGATGA","TGGA","ATGATGA","CTGT",2.449602973164,21,10,20,60,1.82439477059638,4.53877031458909,7.70730033529302,101,"ENSG00000079974.19"
"150","ENSG00000005700.15_72309",72301,72309,9,"ENSG00000005700.15",1,8,"UVVVVVVMV",1,7,0.786749482401656,114,120,133,136,146,152,192,195,"ATCATGA","ATGG","CTTAGGA","CTGA",2.44903592697064,13,10,40,72,1.91429752046264,4.56030092506674,7.70729885467336,101,"ENSG00000079974.19"
"15449","ENSG00000148344.11_2774",2766,2774,9,"ENSG00000148344.11",1,7,"VVVVUVMVV",1,7,0.775155279503105,116,122,133,136,149,155,173,176,"GTCATGA","CAGG","CTGAACA","CTGA",2.41817888979353,11,13,18,51,2.30549175894195,4.60667108939137,7.70729220740379,101,"ENSG00000079974.19"
"41574","ENSG00000259275.5_16893",16885,16893,9,"ENSG00000259275.5",1,7,"VVVUVVMVV",1,7,0.766045548654244,81,87,99,102,108,114,133,136,"ATAGTCA","CTGA","CTGAGGC","CTGA",2.40135945755212,12,6,19,46,2.5633594974395,4.64310563694674,7.70728783156372,101,"ENSG00000079974.19"
"34204","ENSG00000232139.6_15093",15085,15093,9,"ENSG00000232139.6",1,6,"VVVVUMVVV",1,7,0.792546583850932,94,100,107,110,115,121,133,136,"ATAATTA","CTCA","AAAATAA","CTGA",2.31582377357056,7,5,12,33,2.70951731002549,4.53708561679063,7.70727195219436,101,"ENSG00000079974.19"
"2070","ENSG00000069849.11_24213",24205,24213,9,"ENSG00000069849.11",1,2,"UMVVVVVVV",1,7,0.786749482401656,109,115,133,136,176,182,196,199,"ATAATGA","TGGA","GTGCTGG","CTGA",2.50438445655787,18,40,14,81,1.54512020584195,4.5602541457236,7.70725207533022,101,"ENSG00000079974.19"
"47450","ENSG00000288245.1_6332",6324,6332,9,"ENSG00000288245.1",1,1,"MVVVVUVVV",1,7,0.82815734989648,112,118,133,136,139,145,155,158,"ATCATAA","CCTA","ATAGAGA","CTGA",2.23338889564124,15,3,10,37,2.68918365767444,4.39461074048734,7.70724014007326,101,"ENSG00000079974.19"
"33492","ENSG00000230006.10_7199",7191,7199,9,"ENSG00000230006.10",0,NA,"UVVVVVUVV",2,7,0.788819875776397,111,117,133,136,150,156,173,176,"ATTATGG","CTGC","GGGCAGA","CTGA",2.40742696941529,16,14,17,56,2.15831394611392,4.5519567688873,7.70723627199289,101,"ENSG00000079974.19"
"48457","ENSG00000291127.1_24104",24096,24104,9,"ENSG00000291127.1",0,NA,"UVVVVVUVV",2,7,0.788819875776397,111,117,133,136,150,156,173,176,"ATTATGG","CTGC","GGGCAGA","CTGA",2.40742696941529,16,14,17,56,2.15831394611392,4.5519567688873,7.70723627199289,101,"ENSG00000079974.19"
"29495","ENSG00000198104.4_7314",7306,7314,9,"ENSG00000198104.4",1,8,"VVVVVUVMV",1,7,0.806211180124224,115,121,133,136,149,155,211,214,"ATCATCA","CTGC","GTGCTCA","CTGA",2.43519666748316,12,13,56,90,1.69486147672518,4.48237648165322,7.70722120215011,101,"ENSG00000079974.19"
"29496","ENSG00000198104.4_7382",7374,7382,9,"ENSG00000198104.4",1,8,"VVVVVUVMV",1,7,0.806211180124224,115,121,133,136,149,155,211,214,"ATCATCA","CTGC","GTGCTCA","CTGA",2.43519666748316,12,13,56,90,1.69486147672518,4.48237648165322,7.70722120215011,101,"ENSG00000079974.19"
"29507","ENSG00000198104.4_8606",8598,8606,9,"ENSG00000198104.4",1,8,"VVVVVUVMV",1,7,0.806211180124224,115,121,133,136,149,155,211,214,"ATCATCA","CTGC","GTGCTCA","CTGA",2.43519666748316,12,13,56,90,1.69486147672518,4.48237648165322,7.70722120215011,101,"ENSG00000079974.19"
"21765","ENSG00000168916.16_102347",102339,102347,9,"ENSG00000168916.16",1,1,"MVUVVVVVV",1,7,0.789648033126294,113,119,133,136,148,154,189,192,"ATGGTGT","CTGT","TTGCAGA","CTGA",2.46175477745743,14,12,35,70,1.78278845387624,4.54862174256477,7.70721387506994,101,"ENSG00000079974.19"
"20121","ENSG00000164318.18_125619",125611,125619,9,"ENSG00000164318.18",1,7,"VVUVVVMVV",1,7,0.768944099378882,95,101,133,136,147,153,169,172,"CTGATGA","AAGA","TTGAGCA","CTGA",2.53630417223939,32,11,16,68,1.61701144980611,4.63142648285052,7.70720288036605,101,"ENSG00000079974.19"
"46703","ENSG00000287069.1_232450",232442,232450,9,"ENSG00000287069.1",1,2,"VMVVUVVVV",1,7,0.773913043478261,94,100,133,136,141,147,160,163,"ATGAAGA","GAGA","ATGTTTA","CTGA",2.48679414785359,33,5,13,60,1.86746595943053,4.61152340294695,7.70717557686,101,"ENSG00000079974.19"
"30090","ENSG00000203650.9_23681",23673,23681,9,"ENSG00000203650.9",1,8,"VVVVUVVMV",1,7,0.773913043478261,114,120,133,136,141,147,160,163,"GGGAGGG","CAGA","CTGATGG","CTGA",2.3350074657554,13,5,13,40,2.87932552744932,4.61151049145467,7.70716266536771,101,"ENSG00000079974.19"
"27200","ENSG00000185737.13_582608",582600,582608,9,"ENSG00000185737.13",1,8,"VVUVVVVMV",1,7,0.767701863354037,72,78,91,94,101,107,133,136,"AGCATCA","CTGA","GTGAAGG","CTGA",2.44699587775849,13,7,26,55,2.23199251032174,4.63632459051125,7.7071320439274,101,"ENSG00000079974.19"
"47234","ENSG00000287883.1_6254",6246,6254,9,"ENSG00000287883.1",1,7,"VVVUVVMVV",1,7,0.766045548654244,115,121,133,136,147,153,162,165,"GTCATGA","ATGA","CTGATGT","ATGA",2.35705722649336,12,11,9,41,2.85804558259554,4.64294010647115,7.70712230108813,101,"ENSG00000079974.19"
"687","ENSG00000024862.18_13555",13547,13555,9,"ENSG00000024862.18",1,8,"VVVVVUVMV",1,7,0.806211180124224,111,117,133,136,143,149,186,189,"GTGAGGA","CTCC","ATGAACA","CTGA",2.40819609765597,16,7,37,69,1.87445031755792,4.48227274214944,7.70711746264633,101,"ENSG00000079974.19"
"42609","ENSG00000265148.7_29144",29136,29144,9,"ENSG00000265148.7",1,1,"MVVVVUVVV",1,7,0.82815734989648,70,76,92,95,115,121,133,136,"TTCATGA","CTGA","CTCTTGA","ATGA",2.3255627763942,16,20,12,57,2.07395685764435,4.39442717506809,7.70705657465401,101,"ENSG00000079974.19"
"3448","ENSG00000084093.19_55146",55138,55146,9,"ENSG00000084093.19",1,7,"VVVUVVMVV",1,7,0.766045548654244,83,89,133,136,142,148,192,195,"ATTATGA","TTGA","GTGAGGC","CTGA",2.63672632429289,44,6,44,103,0.993296345356561,4.64286796016062,7.70705015477759,101,"ENSG00000079974.19"
"38636","ENSG00000250697.2_157812",157804,157812,9,"ENSG00000250697.2",1,2,"UMVVVVVVV",1,7,0.786749482401656,113,119,133,136,139,145,156,159,"GTGCTGG","CTTA","GTACTGG","CTGA",2.32660797805858,14,3,11,37,2.72940261748816,4.56003061780301,7.70702854740963,101,"ENSG00000079974.19"
"12281","ENSG00000137801.11_3997",3989,3997,9,"ENSG00000137801.11",1,8,"UVVVVVVMV",1,7,0.786749482401656,116,122,133,136,175,181,190,193,"TAGATGA","CTTA","ATGTAAA","CTGA",2.43859871791629,11,39,9,68,1.98243828660519,4.55994076817845,7.70693869778507,101,"ENSG00000079974.19"
"9898","ENSG00000128245.15_3440",3432,3440,9,"ENSG00000128245.15",1,2,"UMVVVVVVV",1,7,0.786749482401656,113,119,133,136,143,149,157,160,"GTTATCA","CTGG","ATTGTGT","CTGA",2.28533172654246,14,7,8,38,3.00386870971515,4.5598533883329,7.70685131793952,101,"ENSG00000079974.19"
"45312","ENSG00000285404.1_193063",193055,193063,9,"ENSG00000285404.1",1,2,"UMVVVVVVV",1,7,0.786749482401656,113,119,133,136,143,149,157,160,"GTTATCA","CTGG","ATTGTGT","CTGA",2.28533172654246,14,7,8,38,3.00386870971515,4.5598533883329,7.70685131793952,101,"ENSG00000079974.19"
"34598","ENSG00000233571.1_159477",159469,159477,9,"ENSG00000233571.1",0,NA,"VVUVVUVVV",2,7,0.805797101449275,115,121,133,136,143,149,171,174,"ATCATAA","CAGC","GTGCTCA","CTGA",2.32889362283401,12,7,22,50,2.40850884980784,4.48361658384198,7.70680498963908,101,"ENSG00000079974.19"
"22497","ENSG00000170624.14_833423",833415,833423,9,"ENSG00000170624.14",0,NA,"UVVVVVUVV",2,7,0.788819875776397,76,82,96,99,115,121,133,136,"TTGATGA","ATGA","ATAATTA","CTGT",2.36924888432722,14,16,12,51,2.41107232663391,4.55151622220385,7.70679572530944,101,"ENSG00000079974.19"
"20459","ENSG00000164893.9_71214",71206,71214,9,"ENSG00000164893.9",1,5,"UVVVMVVVV",1,7,0.789233954451346,73,79,87,90,108,114,133,136,"CAGATGT","CTGA","TTCAAGA","CTGA",2.4779451734727,8,18,19,54,1.67925191918888,4.54972160225171,7.7066574200571,101,"ENSG00000079974.19"
"44754","ENSG00000283538.3_53350",53342,53350,9,"ENSG00000283538.3",1,5,"UVVVMVVVV",1,7,0.789233954451346,83,89,133,136,148,154,201,204,"ATGATGA","TTAA","AAGAGGA","CTGA",2.61413390471197,44,12,47,112,0.771075507722577,4.54965871811726,7.70659453592264,101,"ENSG00000079974.19"
"14612","ENSG00000145451.13_94920",94912,94920,9,"ENSG00000145451.13",1,7,"VVVVUVMVV",1,7,0.775155279503105,115,121,133,136,149,155,169,172,"GAGATGA","ATTA","GTGTCGG","CTGA",2.37845465450194,12,13,14,48,2.56750450935278,4.60596721817477,7.70658833618719,101,"ENSG00000079974.19"
"8515","ENSG00000119397.19_33156",33148,33156,9,"ENSG00000119397.19",1,1,"MVVVVUVVV",1,7,0.82815734989648,82,88,133,136,150,156,166,169,"ATAATGA","TGGA","AAAAAGA","CTGA",2.39289797007138,45,14,10,78,1.62302217725364,4.39391882776571,7.70654822735163,101,"ENSG00000079974.19"
"45638","ENSG00000285755.2_74893",74885,74893,9,"ENSG00000285755.2",1,2,"UMVVVVVVV",1,7,0.786749482401656,116,122,133,136,142,148,162,165,"AGCAAGA","ATGA","ATGATTG","CTGA",2.30622998529915,11,6,14,40,2.86308628654337,4.55948821380109,7.70648614340771,101,"ENSG00000079974.19"
"2919","ENSG00000079308.21_189301",189293,189301,9,"ENSG00000079308.21",1,8,"VVVVVUVMV",1,7,0.806211180124224,116,122,133,136,146,152,203,206,"GAGATAA","CTGC","GTGAAGC","CTGA",2.40773899854039,11,10,51,81,1.8749443038123,4.48163440685373,7.70647912735063,101,"ENSG00000079974.19"
"18415","ENSG00000157306.14_34600",34592,34600,9,"ENSG00000157306.14",1,2,"UMVVVVVVV",1,7,0.786749482401656,57,63,76,79,90,96,133,136,"TTGATGT","CTGC","AAGAGGG","CTGA",2.45558853076493,13,11,37,70,1.86728217023314,4.55946809383316,7.70646602343979,101,"ENSG00000079974.19"
"32609","ENSG00000227303.1_153988",153980,153988,9,"ENSG00000227303.1",1,8,"VVVVVUVMV",1,7,0.806211180124224,31,37,53,56,81,87,133,136,"ATAATGA","CTGA","ATGAGGA","GTGA",2.54375758253339,16,25,46,96,0.967807974383888,4.48154796448495,7.70639268498184,101,"ENSG00000079974.19"
"9795","ENSG00000127324.9_296109",296101,296109,9,"ENSG00000127324.9",1,1,"MVVVVVUVV",1,7,0.792132505175983,108,114,133,136,143,149,203,206,"ATTATGA","AAGA","AAGAAGA","CTGA",2.48604811166223,19,7,54,89,1.57777336885754,4.53785686165144,7.70638688235537,101,"ENSG00000079974.19"
"13390","ENSG00000141298.19_54679",54671,54679,9,"ENSG00000141298.19",0,NA,"UVVVUVVVV",2,7,0.792546583850932,90,96,133,136,152,158,167,170,"AGGATGA","TTGA","ACTATGG","CTGA",2.49794637903358,37,16,9,71,1.49153951896025,4.53612884479603,7.70631518019976,101,"ENSG00000079974.19"
"10661","ENSG00000132256.20_119326",119318,119326,9,"ENSG00000132256.20",1,1,"MVVVVUVVV",1,7,0.82815734989648,112,118,133,136,144,150,172,175,"TTGATGG","TTGA","TTGAAGG","TTGA",2.29062959194329,15,8,22,54,2.30379375321483,4.39366442487585,7.70629382446177,101,"ENSG00000079974.19"
"35551","ENSG00000236283.5_57810",57802,57810,9,"ENSG00000236283.5",0,NA,"UVVVVUVVV",2,7,0.824844720496894,114,120,133,136,140,146,157,160,"ATATTTA","GTGT","CTGCTGA","CTGA",2.20944407309011,13,4,11,37,2.89801098999725,4.40690953598283,7.7062884179704,101,"ENSG00000079974.19"
"31875","ENSG00000225096.3_74976",74968,74976,9,"ENSG00000225096.3",1,6,"VVVVVMUVV",1,7,0.788819875776397,78,84,101,104,111,117,133,136,"GTGGTGG","CTGA","ATGAGGA","CTTA",2.35339454820533,17,7,16,49,2.5147123053786,4.55100232335353,7.70628182645912,101,"ENSG00000079974.19"
"48159","ENSG00000290551.1_239776",239768,239776,9,"ENSG00000290551.1",1,8,"VVVVVUVMV",1,7,0.806211180124224,108,114,133,136,153,159,187,190,"ATAATGA","TTCA","GTGAAAA","CTGA",2.51192026990563,19,17,28,73,1.17950276234545,4.48140947376242,7.70625419425931,101,"ENSG00000079974.19"
"20992","ENSG00000166171.13_34011",34003,34011,9,"ENSG00000166171.13",1,8,"UVVVVVVMV",1,7,0.786749482401656,106,112,133,136,149,155,167,170,"GGGATGA","CTTT","GTGTTGG","CTGA",2.42624595231549,21,13,12,55,2.06205044035658,4.55925586394829,7.70625379355492,101,"ENSG00000079974.19"
"33575","ENSG00000230423.3_93711",93703,93711,9,"ENSG00000230423.3",1,6,"VVVVVMUVV",1,7,0.788819875776397,85,91,107,110,115,121,133,136,"TAGATGA","CTGA","CTAATTA","CTCA",2.31886006807165,16,5,12,42,2.74482874259766,4.55097396576883,7.70625346887442,101,"ENSG00000079974.19"
"1820","ENSG00000066135.13_5576",5568,5576,9,"ENSG00000066135.13",1,8,"VVVVVUVMV",1,7,0.806211180124224,35,41,62,65,79,85,133,136,"ATGATGA","CTGC","CTGGTGA","ATGA",2.53336352511102,21,14,48,92,1.03649085148853,4.48139525472383,7.70623997522073,101,"ENSG00000079974.19"
"45087","ENSG00000284989.1_5576",5568,5576,9,"ENSG00000284989.1",1,8,"VVVVVUVMV",1,7,0.806211180124224,35,41,62,65,79,85,133,136,"ATGATGA","CTGC","CTGGTGA","ATGA",2.53336352511102,21,14,48,92,1.03649085148853,4.48139525472383,7.70623997522073,101,"ENSG00000079974.19"
"33706","ENSG00000230843.1_817",809,817,9,"ENSG00000230843.1",1,6,"VVVVVMUVV",1,7,0.788819875776397,116,122,133,136,187,193,208,211,"ATAATGT","CTTA","ATAATGT","CTGA",2.46167486613579,11,51,15,86,1.79256799455615,4.55093344219869,7.70621294530428,101,"ENSG00000079974.19"
"18675","ENSG00000158089.15_187344",187336,187344,9,"ENSG00000158089.15",0,NA,"VVUVVUVVV",2,7,0.805797101449275,89,95,108,111,114,120,133,136,"GTCATGG","CTGA","TTGAAGG","GTGA",2.28849212830004,13,3,13,38,2.67544884834434,4.48301575925282,7.70620416504992,101,"ENSG00000079974.19"
"40971","ENSG00000258216.7_273844",273836,273844,9,"ENSG00000258216.7",1,3,"UVMVVVVVV",1,7,0.785507246376811,107,113,133,136,139,145,159,162,"ATTTTGA","CGGA","TTGAATA","CTGA",2.42848682440101,20,3,14,46,2.0667136686755,4.56415645783723,7.70618544334447,101,"ENSG00000079974.19"
"17964","ENSG00000155959.12_38784",38776,38784,9,"ENSG00000155959.12",1,1,"MVVVVUVVV",1,7,0.82815734989648,111,117,133,136,151,157,167,170,"ACGATGG","AGGA","ATACTGG","CTGA",2.27725976064334,16,15,10,50,2.39246131675029,4.39354826359314,7.70617766317906,101,"ENSG00000079974.19"
"37068","ENSG00000244968.7_68450",68442,68450,9,"ENSG00000244968.7",0,NA,"UVVVVVUVV",2,7,0.788819875776397,108,114,133,136,144,150,168,171,"GTGATTA","GTTA","GAGATAA","CTGA",2.40058764972361,19,8,18,54,2.19961600491436,4.55088341743461,7.7061629205402,101,"ENSG00000079974.19"
"15392","ENSG00000148123.15_168597",168589,168597,9,"ENSG00000148123.15",1,8,"VVVVUVVMV",1,7,0.773913043478261,82,88,133,136,145,151,163,166,"ATATTGA","CTGC","TTGATGT","CTGA",2.47996584341632,45,9,12,75,1.90887614523068,4.61049544200154,7.70614761591458,101,"ENSG00000079974.19"
"24268","ENSG00000175600.16_634549",634541,634549,9,"ENSG00000175600.16",1,5,"VVVVMVUVV",1,7,0.772670807453416,94,100,133,136,139,145,186,189,"ATGATGT","TTGA","ATGGAGA","CTGA",2.65908245115016,33,3,41,86,0.734607081196745,4.61545585554945,7.70613908536312,101,"ENSG00000079974.19"
"7580","ENSG00000114867.22_5391",5383,5391,9,"ENSG00000114867.22",1,8,"VVVUVVVMV",1,7,0.764803312629399,115,121,133,136,138,144,153,156,"ATTGTGC","GTGA","TTGAGGA","CTGA",2.37106596932472,12,2,9,32,2.78058107509119,4.646921884314,7.7061351348316,101,"ENSG00000079974.19"
"6939","ENSG00000112319.21_188796",188788,188796,9,"ENSG00000112319.21",1,1,"MVUVVVVVV",1,7,0.789648033126294,79,85,97,100,107,113,133,136,"CTGGTGA","CTGA","ATTAAGA","GTGA",2.35076235327095,12,7,20,48,2.51839261260212,4.54753540860212,7.7061275411073,101,"ENSG00000079974.19"
"18263","ENSG00000156687.11_549480",549472,549480,9,"ENSG00000156687.11",1,5,"VVVVMUVVV",1,7,0.808695652173913,114,120,133,136,173,179,189,192,"AAGATGA","TTCA","ATTTTCA","CTGA",2.38142474262111,13,37,10,69,2.00903211378403,4.47129926614786,7.70608187484352,101,"ENSG00000079974.19"
"7703","ENSG00000115414.21_55414",55406,55414,9,"ENSG00000115414.21",1,2,"VMVVUVVVV",1,7,0.773913043478261,113,119,133,136,144,150,165,168,"AAGAGGA","ATAA","GTGATAT","CTGA",2.3504937545641,14,8,15,46,2.77174603734722,4.61042610027697,7.70607827419002,101,"ENSG00000079974.19"
"4142","ENSG00000095777.17_137256",137248,137256,9,"ENSG00000095777.17",0,NA,"UVVUVVVVV",2,7,0.78343685300207,111,117,133,136,183,189,207,210,"ATGTTGA","CTTA","GTCAAAA","CTGA",2.5220404319486,16,47,18,90,1.47568203742103,4.5723212292696,7.70606864127788,101,"ENSG00000079974.19"
"32805","ENSG00000227954.7_254019",254011,254019,9,"ENSG00000227954.7",1,6,"VVUVVMVVV",1,7,0.786335403726708,112,118,133,136,143,149,171,174,"ATAATGA","TAGA","GTGATGA","CTGT",2.38883869109815,15,7,22,53,2.3172294361571,4.56070517753618,7.70604679244301,101,"ENSG00000079974.19"
"14382","ENSG00000144820.8_60869",60861,60869,9,"ENSG00000144820.8",1,2,"VMVVVVUVV",1,7,0.770186335403727,108,114,133,136,138,144,160,163,"ATTATGA","CGGG","GTGCAGA","CTGA",2.49547237087138,19,2,16,46,1.86471361184435,4.62529902108005,7.70604436269496,101,"ENSG00000079974.19"
"39987","ENSG00000254602.2_8064",8056,8064,9,"ENSG00000254602.2",1,8,"VVVVVUVMV",1,7,0.806211180124224,65,71,100,103,115,121,133,136,"ATGATGT","CTCA","CTGGTGA","GTGA",2.42130381647892,29,12,12,62,1.78247524032267,4.48112517087888,7.70596989137577,101,"ENSG00000079974.19"
"16509","ENSG00000151704.16_28879",28871,28879,9,"ENSG00000151704.16",1,7,"UVVVVVMVV",1,7,0.787991718426501,89,95,103,106,115,121,133,136,"TTGATGA","CTGC","ATGCTTT","GTGA",2.32744488735466,8,9,12,38,2.69959062410802,4.55397246828476,7.70593934199077,101,"ENSG00000079974.19"
"14477","ENSG00000145087.13_324754",324746,324754,9,"ENSG00000145087.13",1,5,"UVVVMVVVV",1,7,0.789233954451346,98,104,133,136,159,165,179,182,"TTGAGGA","ATGA","ATGATGC","CTGA",2.5639299819613,29,23,14,75,1.10306854090666,4.54898377182883,7.70591958963422,101,"ENSG00000079974.19"
"36519","ENSG00000241593.5_36960",36952,36960,9,"ENSG00000241593.5",1,2,"VMVUVVVVV",1,7,0.764803312629399,112,118,133,136,156,162,178,181,"ATGGTGA","CTGC","ATCTTGT","CTGA",2.49612042866494,15,20,16,60,1.94599511436324,4.64669949303238,7.70591274354998,101,"ENSG00000079974.19"
"35332","ENSG00000235731.3_79576",79568,79576,9,"ENSG00000235731.3",0,NA,"UVVUVVVVV",2,7,0.78343685300207,83,89,95,98,109,115,133,136,"ATGATAT","ATGA","GTGGGCA","CTGA",2.44819221040358,6,11,18,44,1.9672924381234,4.57214346020347,7.70589087221176,101,"ENSG00000079974.19"
"1537","ENSG00000059758.8_73614",73606,73614,9,"ENSG00000059758.8",1,6,"UVVVVMVVV",1,7,0.805383022774327,115,121,133,136,137,143,152,155,"ATGGTGA","TTGA","ATGACTT","CTTA",2.29518581747142,12,1,9,31,2.63618269851883,4.4843553704154,7.70588746151271,101,"ENSG00000079974.19"
"22460","ENSG00000170581.15_5005",4997,5005,9,"ENSG00000170581.15",1,8,"VVVVVUVMV",1,7,0.806211180124224,116,122,133,136,143,149,167,170,"GTGAACA","CCGA","GTAGTCA","CTGA",2.29607495094206,11,7,18,45,2.61688134685066,4.4810119216161,7.70585664211299,101,"ENSG00000079974.19"
"47780","ENSG00000289309.1_195355",195347,195355,9,"ENSG00000289309.1",1,2,"VMUVVVVVV",1,7,0.767701863354037,114,120,133,136,181,187,202,205,"ATCATGA","CCTA","TTGATGG","CTGA",2.50871779281647,13,45,15,82,1.81533737433634,4.63503066494486,7.70583811836101,101,"ENSG00000079974.19"
"24422","ENSG00000176204.14_811447",811439,811447,9,"ENSG00000176204.14",1,2,"VMVVVVUVV",1,7,0.770186335403727,84,90,133,136,138,144,154,157,"ATGATCA","TTGA","GAGAAAA","CTGA",2.54619883711976,43,2,10,64,1.52564334549446,4.62507556490654,7.70582090652145,101,"ENSG00000079974.19"
"2751","ENSG00000078070.14_74021",74013,74021,9,"ENSG00000078070.14",0,NA,"UVVVUVVVV",2,7,0.792546583850932,114,120,133,136,139,145,159,162,"GTGTTGC","TTGG","TTGATTA","CTGA",2.32947808554896,13,3,14,39,2.61265716166711,4.53562776633172,7.70581410173544,101,"ENSG00000079974.19"
"11106","ENSG00000133958.14_75084",75076,75084,9,"ENSG00000133958.14",1,2,"VMVVVUVVV",1,7,0.806211180124223,114,120,133,136,142,148,181,184,"ATGCTAG","CTAA","ATGAAGA","CTGA",2.38027800995236,13,6,33,61,2.05532303263098,4.48096077474501,7.70580549524191,101,"ENSG00000079974.19"
"589","ENSG00000020577.14_56451",56443,56451,9,"ENSG00000020577.14",1,1,"MVVVVUVVV",1,7,0.82815734989648,84,90,133,136,155,161,175,178,"CTGAAGA","CTTT","GTGAAGA","CTGA",2.45667132520072,43,19,14,85,1.19462219487899,4.39310775738762,7.70573715697354,101,"ENSG00000079974.19"
"14464","ENSG00000145075.13_137591",137583,137591,9,"ENSG00000145075.13",1,6,"VVVUVMVVV",1,7,0.78343685300207,71,77,98,101,110,116,133,136,"TTGGTGA","CTTA","CTCATAA","CTGA",2.43449197355725,21,9,17,56,2.05800454579033,4.57198775904301,7.70573517105129,101,"ENSG00000079974.19"
"45293","ENSG00000285336.1_137663",137655,137663,9,"ENSG00000285336.1",1,6,"VVVUVMVVV",1,7,0.78343685300207,71,77,98,101,110,116,133,136,"TTGGTGA","CTTA","CTCATAA","CTGA",2.43449197355725,21,9,17,56,2.05800454579033,4.57198775904301,7.70573517105129,101,"ENSG00000079974.19"
"15844","ENSG00000149972.12_1178038",1178030,1178038,9,"ENSG00000149972.12",1,2,"VMUVVVVVV",1,7,0.767701863354037,116,122,133,136,151,157,177,180,"CTAAGGA","CTGA","GTGCTCA","CTGA",2.47417579011616,11,15,20,55,2.04506876908734,4.6348935091321,7.70570096254825,101,"ENSG00000079974.19"
"14424","ENSG00000144893.13_243359",243351,243359,9,"ENSG00000144893.13",1,7,"VVUVVVMVV",1,7,0.768944099378882,103,109,133,136,148,154,208,211,"CTGATGA","ATGA","ACGATGC","CTGA",2.63022171697437,24,12,54,99,0.984850563955983,4.62991550261294,7.70569190012847,101,"ENSG00000079974.19"
"33551","ENSG00000230283.1_56",48,56,9,"ENSG00000230283.1",1,8,"UVVVVVVMV",1,7,0.786749482401656,2,8,17,20,25,31,58,61,"ATGAAGG","CTAA","ATAATGG","CTGA",2.43940767817033,9,5,27,50,1.97205416481058,4.55869300481986,7.70569093442649,101,"ENSG00000079974.19"
"40462","ENSG00000256389.2_17066",17058,17066,9,"ENSG00000256389.2",1,8,"UVVVVVVMV",1,7,0.786749482401656,107,113,133,136,184,190,204,207,"AAGAAGA","CTGA","ATAATTA","CTGA",2.53072935541399,20,48,14,91,1.36310706246626,4.55865902463988,7.70565695424651,101,"ENSG00000079974.19"
"46710","ENSG00000287092.1_151261",151253,151261,9,"ENSG00000287092.1",1,3,"VVMVVUVVV",1,7,0.804968944099379,98,104,133,136,149,155,171,174,"TTGAAGA","CTTA","CTGGTGG","CTGA",2.46477548792907,29,13,16,67,1.51126223167267,4.48577470446662,7.70565048086414,101,"ENSG00000079974.19"
"11050","ENSG00000133773.12_7318",7310,7318,9,"ENSG00000133773.12",1,6,"UVVVVMVVV",1,7,0.805383022774327,42,48,72,75,80,86,133,136,"GAGATGA","CTGG","GTTTTGA","CTGA",2.51730854280827,24,5,47,85,1.15428105570896,4.48408450194103,7.70561659303834,101,"ENSG00000079974.19"
"26478","ENSG00000184305.16_1174457",1174449,1174457,9,"ENSG00000184305.16",1,2,"VMVVVVUVV",1,7,0.770186335403727,94,100,107,110,116,122,133,136,"ATGATGA","CAGG","GTGAATG","ATGA",2.35645689773897,7,6,11,33,2.78957949917831,4.62482303769286,7.70556837930777,101,"ENSG00000079974.19"
"2410","ENSG00000074416.16_134968",134960,134968,9,"ENSG00000074416.16",1,7,"VVVVUVMVV",1,7,0.775155279503105,112,118,133,136,137,143,153,156,"GAGATGG","CTGG","ATGCTGG","CTGA",2.40789986631244,15,1,10,35,2.36680658625476,4.60486809041776,7.70548920843018,101,"ENSG00000079974.19"
"22808","ENSG00000171467.16_37636",37628,37636,9,"ENSG00000171467.16",1,8,"VVVVVUVMV",1,7,0.806211180124224,116,122,133,136,150,156,177,180,"AGGATGT","GAGA","ATTAAGA","CTGA",2.37968679791367,11,14,21,55,2.05793856133047,4.48062930352207,7.70547402401897,101,"ENSG00000079974.19"
"8852","ENSG00000121005.9_42229",42221,42229,9,"ENSG00000121005.9",1,1,"MVVUVVVVV",1,7,0.786749482401656,115,121,133,136,165,171,226,229,"TTGATCA","CTGA","GTGAGCT","CTGA",2.57575065803277,12,29,55,105,1.06221747468065,4.55847213205811,7.70547006166473,101,"ENSG00000079974.19"
"15248","ENSG00000147481.17_751480",751472,751480,9,"ENSG00000147481.17",1,1,"MVVVUUVVV",2,6,0.718012422360248,55,61,103,106,113,119,133,136,"ATGATGT","ATGA","ATAATAA","CTGA",2.61921367514637,42,7,14,72,1.8720288169393,4.83336332947878,7.70541301891977,101,"ENSG00000079974.19"
"21802","ENSG00000168994.14_12983",12975,12983,9,"ENSG00000168994.14",0,NA,"VVVVUVUVV",2,7,0.775983436853002,114,120,133,136,179,185,198,201,"GTGGTGA","CAGA","GTTTTGT","CTGA",2.47307245602796,13,43,13,78,1.91873242896472,4.60147053395445,7.70540428136646,101,"ENSG00000079974.19"
"38410","ENSG00000250131.2_85586",85578,85586,9,"ENSG00000250131.2",1,7,"VVVVUVMVV",1,7,0.775155279503105,68,74,83,86,92,98,133,136,"ATAATTA","CTGA","ATTAACA","CTGA",2.48188174722005,9,6,35,59,1.87307275008868,4.60473776622225,7.70535888423468,101,"ENSG00000079974.19"
"38146","ENSG00000249693.3_11510",11502,11510,9,"ENSG00000249693.3",1,2,"VMUVVVVVV",1,7,0.767701863354037,109,115,133,136,142,148,158,161,"CTGATGA","ATGA","CAGAGGA","CTCA",2.38133778840294,18,6,10,43,2.66252010637791,4.63452634059937,7.70533379401552,101,"ENSG00000079974.19"
"20372","ENSG00000164749.13_11453",11445,11453,9,"ENSG00000164749.13",0,NA,"VVVVUUVVV",2,7,0.812008281573499,110,116,133,136,180,186,225,228,"ATGGTGA","TTGA","CTCTTGA","CTGA",2.55688948542508,17,44,39,109,0.783243454352689,4.45729333929664,7.70532646559064,101,"ENSG00000079974.19"
"13971","ENSG00000144152.13_33144",33136,33144,9,"ENSG00000144152.13",1,1,"MVVVVUVVV",1,7,0.82815734989648,80,86,97,100,114,120,133,136,"ATCATGA","CCGA","AAGATTT","CTGC",2.25767484760503,11,14,13,47,2.51949956070578,4.39266630285149,7.70529570243741,101,"ENSG00000079974.19"
"43009","ENSG00000267586.7_335373",335365,335373,9,"ENSG00000267586.7",0,NA,"VVVUVVUVV",2,7,0.766873706004141,113,119,133,136,150,156,165,168,"TTGATGG","TAGA","TTTAGGA","CTGA",2.39425669006546,14,14,9,46,2.5894393111255,4.63778764455714,7.7052824685737,101,"ENSG00000079974.19"
"37099","ENSG00000245317.2_1618",1610,1618,9,"ENSG00000245317.2",1,5,"VVVVMUVVV",1,7,0.808695652173913,106,112,133,136,155,161,192,195,"TTGCTGA","CTGA","GTGGTTT","CTGA",2.55631931993744,21,19,31,80,0.839762092922282,4.4704727231263,7.70525533182195,101,"ENSG00000079974.19"
"32396","ENSG00000226965.2_215087",215079,215087,9,"ENSG00000226965.2",1,2,"UMVVVVVVV",1,7,0.786749482401656,110,116,133,136,140,146,154,157,"AAGAAGT","CTCA","ATGTAGA","CTGA",2.34003389583114,17,4,8,38,2.63273535038935,4.55824033064923,7.70523826025586,101,"ENSG00000079974.19"
"39241","ENSG00000253347.1_8701",8693,8701,9,"ENSG00000253347.1",1,2,"UMVVVVVVV",1,7,0.786749482401656,114,120,133,136,138,144,153,156,"AAGGTCA","CTGA","ATTAAAA","CTGA",2.32576257891625,13,2,9,33,2.72772849389642,4.55820308833452,7.70520101794115,101,"ENSG00000079974.19"
"9500","ENSG00000124818.15_27697",27689,27697,9,"ENSG00000124818.15",1,1,"MVVVVVUVV",1,7,0.792132505175983,116,122,133,136,187,193,233,236,"TTGATGT","CTAA","CTGTTGA","CTGA",2.57259553698892,11,51,40,111,0.9960247900014,4.53666542581522,7.70519544651915,101,"ENSG00000079974.19"
"1561","ENSG00000060718.22_65391",65383,65391,9,"ENSG00000060718.22",1,2,"VMVVVVUVV",1,7,0.770186335403727,40,46,63,66,75,81,133,136,"ATGGTGA","GAGA","TTGATCA","CTGA",2.51858833618448,17,9,52,87,1.70711697251268,4.6244264701023,7.70517181171721,101,"ENSG00000079974.19"
"38669","ENSG00000250802.7_12631",12623,12631,9,"ENSG00000250802.7",1,8,"UVVVVVVMV",1,7,0.786749482401656,112,118,133,136,143,149,185,188,"GGGATGT","CAGA","CTGAGTA","CTGA",2.44185672856797,15,7,36,67,1.95356900249628,4.55815346490402,7.70515139451065,101,"ENSG00000079974.19"
"45017","ENSG00000284762.1_12587",12579,12587,9,"ENSG00000284762.1",1,8,"UVVVVVVMV",1,7,0.786749482401656,112,118,133,136,143,149,185,188,"GGGATGT","CAGA","CTGAGTA","CTGA",2.44185672856797,15,7,36,67,1.95356900249628,4.55815346490402,7.70515139451065,101,"ENSG00000079974.19"
"45095","ENSG00000285000.1_68417",68409,68417,9,"ENSG00000285000.1",1,8,"UVVVVVVMV",1,7,0.786749482401656,112,118,133,136,143,149,185,188,"GGGATGT","CAGA","CTGAGTA","CTGA",2.44185672856797,15,7,36,67,1.95356900249628,4.55815346490402,7.70515139451065,101,"ENSG00000079974.19"
"29088","ENSG00000197140.15_38599",38591,38599,9,"ENSG00000197140.15",1,1,"MVVVVUVVV",1,7,0.82815734989648,85,91,133,136,142,148,169,172,"GGGATGA","AGGA","AGGAGGA","CTGA",2.41876034953498,42,6,21,78,1.4448140956175,4.39247077312935,7.70510017271527,101,"ENSG00000079974.19"
"19949","ENSG00000164048.14_40023",40015,40023,9,"ENSG00000164048.14",1,2,"VMVVVVUVV",1,7,0.770186335403727,85,91,98,101,110,116,133,136,"CTGTTGA","CAGA","GAGATCT","CTGA",2.43299682994316,7,9,17,42,2.27735772147308,4.62433414694021,7.70507948855512,101,"ENSG00000079974.19"
"37955","ENSG00000249259.3_136043",136035,136043,9,"ENSG00000249259.3",1,6,"VVVVVMUVV",1,7,0.788819875776397,114,120,133,136,148,154,166,169,"ATGATAA","TAGA","GTGGTGA","GTGA",2.32132074420807,13,12,12,46,2.7236491260237,4.54978018851937,7.70505969162496,101,"ENSG00000079974.19"
"25774","ENSG00000182732.18_261371",261363,261371,9,"ENSG00000182732.18",1,2,"VMVVVUVVV",1,7,0.806211180124223,3,9,20,23,71,77,133,136,"GTGATGG","CAGA","GACATGA","CTGA",2.54159220416354,11,48,56,124,0.976787629098205,4.48018391421378,7.70502863471067,101,"ENSG00000079974.19"
"19714","ENSG00000163625.17_64642",64634,64642,9,"ENSG00000163625.17",1,1,"MVVVVVUVV",1,7,0.792132505175983,105,111,133,136,142,148,200,203,"GTGAGAA","CTGA","GTGATAT","CTGA",2.52352496948254,22,6,52,89,1.32238260821823,4.53647060119212,7.70500062189606,101,"ENSG00000079974.19"
"9781","ENSG00000127249.15_70322",70314,70322,9,"ENSG00000127249.15",1,2,"VMVVVUVVV",1,7,0.806211180124223,114,120,133,136,148,154,173,176,"ATGATGC","CTGT","GTGGAGT","CTCA",2.33754451470072,13,12,19,53,2.33691292363537,4.48013575541004,7.70498047590693,101,"ENSG00000079974.19"
"42283","ENSG00000261502.4_29262",29254,29262,9,"ENSG00000261502.4",0,NA,"UVVVVVUVV",2,7,0.788819875776397,81,87,101,104,115,121,133,136,"CTTAAGA","CAGA","GTGACAC","CTGA",2.31563543405539,14,11,12,46,2.76117004326452,4.54968490090845,7.70496440401404,101,"ENSG00000079974.19"
"23495","ENSG00000173068.19_409672",409664,409672,9,"ENSG00000173068.19",1,3,"UVMVVVVVV",1,7,0.785507246376811,73,79,97,100,106,112,133,136,"ATGATCA","CTGA","GTGAGCG","CCGA",2.42117822436056,18,6,21,54,2.11054503111961,4.56293329838084,7.70496228388809,101,"ENSG00000079974.19"
"11782","ENSG00000136044.12_23846",23838,23846,9,"ENSG00000136044.12",1,8,"UVVVVVVMV",1,7,0.786749482401656,52,58,73,76,85,91,133,136,"GTGATGA","CTCA","GTGAGAA","CTCA",2.45370963128153,15,9,42,75,1.8737672554076,4.55795786598778,7.70495579559441,101,"ENSG00000079974.19"
"29347","ENSG00000197826.12_120397",120389,120397,9,"ENSG00000197826.12",1,5,"VVVVMUVVV",1,7,0.808695652173913,60,66,78,81,87,93,133,136,"AGGATGA","CTTA","AAGATGA","ATGA",2.38138907828119,12,6,40,67,2.00440743253021,4.47008365526788,7.70486626396353,101,"ENSG00000079974.19"
"21448","ENSG00000167674.15_7929",7921,7929,9,"ENSG00000167674.15",1,1,"MVVUVUVVV",2,6,0.708902691511387,115,121,133,136,151,157,167,170,"ATGAAGA","CTGT","CTTGTGA","CTGA",2.53779064262747,12,15,10,46,2.55807491051647,4.86916979867489,7.70478056472044,101,"ENSG00000079974.19"
"38461","ENSG00000250241.7_53482",53474,53482,9,"ENSG00000250241.7",1,8,"UVVVVVVMV",1,7,0.786749482401656,112,118,133,136,148,154,170,173,"CAGATGA","GTAA","ATGTTCA","CTGA",2.36954579745023,15,12,16,52,2.43414168460168,4.5577784169008,7.70477634650743,101,"ENSG00000079974.19"
"5679","ENSG00000106133.19_2335",2327,2335,9,"ENSG00000106133.19",0,NA,"VVVVUUVVV",2,7,0.812008281573499,114,120,133,136,145,151,161,164,"AGGTTGA","CTAA","CTGATGC","CTGC",2.22847573415352,13,9,10,41,2.97034679915309,4.45671292337748,7.70474604967148,101,"ENSG00000079974.19"
"31398","ENSG00000223705.12_2334",2326,2334,9,"ENSG00000223705.12",0,NA,"VVVVUUVVV",2,7,0.812008281573499,114,120,133,136,145,151,161,164,"AGGTTGA","CTAA","CTGATGC","CTGC",2.22847573415352,13,9,10,41,2.97034679915309,4.45671292337748,7.70474604967148,101,"ENSG00000079974.19"
"48273","ENSG00000290831.1_2408",2400,2408,9,"ENSG00000290831.1",0,NA,"VVVVUUVVV",2,7,0.812008281573499,114,120,133,136,145,151,161,164,"AGGTTGA","CTAA","CTGATGC","CTGC",2.22847573415352,13,9,10,41,2.97034679915309,4.45671292337748,7.70474604967148,101,"ENSG00000079974.19"
"48478","ENSG00000291151.1_2380",2372,2380,9,"ENSG00000291151.1",0,NA,"VVVVUUVVV",2,7,0.812008281573499,114,120,133,136,145,151,161,164,"AGGTTGA","CTAA","CTGATGC","CTGC",2.22847573415352,13,9,10,41,2.97034679915309,4.45671292337748,7.70474604967148,101,"ENSG00000079974.19"
"30803","ENSG00000213759.10_6290",6282,6290,9,"ENSG00000213759.10",1,6,"VVVUVMVVV",1,7,0.78343685300207,82,88,133,136,145,151,162,165,"GTGATGA","CTGG","GTGTTGT","CTGG",2.45210995281037,45,9,11,74,1.93658756431223,4.57099681242867,7.70474422443695,101,"ENSG00000079974.19"
"30990","ENSG00000215110.7_6226",6218,6226,9,"ENSG00000215110.7",1,6,"VVVUVMVVV",1,7,0.78343685300207,82,88,133,136,145,151,162,165,"GTGATGA","CTGG","GTGTTGT","CTGG",2.45210995281037,45,9,11,74,1.93658756431223,4.57099681242867,7.70474422443695,101,"ENSG00000079974.19"
"33199","ENSG00000228999.4_365851",365843,365851,9,"ENSG00000228999.4",1,2,"VMVUVVVVV",1,7,0.764803312629399,112,118,133,136,152,158,184,187,"ATGATTA","ACGA","CTGAGGA","CTGA",2.54212146192356,15,16,26,66,1.63445732354662,4.64548343409259,7.70469668461018,101,"ENSG00000079974.19"
"44588","ENSG00000283117.1_134597",134589,134597,9,"ENSG00000283117.1",1,1,"MVVVUVVVV",1,7,0.795859213250517,112,118,133,136,145,151,206,209,"CTGATGC","AGGA","ATGAAGG","CTGA",2.43363433387571,15,9,55,88,1.86078114439269,4.52125250922436,7.70468936222643,101,"ENSG00000079974.19"
"23830","ENSG00000174373.17_239884",239876,239884,9,"ENSG00000174373.17",1,6,"VVVVVMUVV",1,7,0.788819875776397,108,114,133,136,167,173,188,191,"ATAATGA","CTTA","GTTTTAA","CTGA",2.51418397369077,19,31,15,74,1.43640605975175,4.54940813775589,7.70468764086148,101,"ENSG00000079974.19"
"33958","ENSG00000231649.3_198",190,198,9,"ENSG00000231649.3",0,NA,"VVVUUVVVV",2,7,0.770600414078675,85,91,98,101,111,117,133,136,"GTGATGA","CTCA","GGGAAGA","CTCA",2.43048327993018,7,10,16,42,2.28589916994701,4.62228025903705,7.70468191535175,101,"ENSG00000079974.19"
"44932","ENSG00000284491.3_3165",3157,3165,9,"ENSG00000284491.3",1,1,"MVUVVVVVV",1,7,0.789648033126294,116,122,133,136,141,147,157,160,"AAGAGGA","ATAA","ACAATGA","CTGA",2.2719464572668,11,5,10,35,3.03788541383819,4.54604878223756,7.70464091474273,101,"ENSG00000079974.19"
"14079","ENSG00000144366.17_141773",141765,141773,9,"ENSG00000144366.17",1,8,"VVUVVVVMV",1,7,0.767701863354037,114,120,133,136,152,158,179,182,"ATTATGA","ATGG","ATGAACA","CTGA",2.48859299462404,13,16,21,59,1.94453887295792,4.63378970927955,7.7045971626957,101,"ENSG00000079974.19"
"7307","ENSG00000113492.14_48763",48755,48763,9,"ENSG00000113492.14",1,1,"MVVVVUVVV",1,7,0.82815734989648,111,117,133,136,147,153,161,164,"GTTCTGA","AGGA","GTGGAGC","CTGA",2.23589191078925,16,11,8,44,2.66183619051146,4.39194556560995,7.70457496519587,101,"ENSG00000079974.19"
"34861","ENSG00000234323.10_109863",109855,109863,9,"ENSG00000234323.10",0,NA,"VVVUUVVVV",2,7,0.770600414078675,109,115,133,136,149,155,177,180,"CTGATCA","TTGA","GAGAGGA","CTGA",2.50807614977115,18,13,22,62,1.76808043959068,4.62214702618292,7.70454868249762,101,"ENSG00000079974.19"
"11387","ENSG00000134775.16_306686",306678,306686,9,"ENSG00000134775.16",1,3,"UVMVVVVVV",1,7,0.785507246376811,96,102,133,136,184,190,204,207,"ATGAAGA","CAGA","ATGATTG","CTGA",2.60176524770814,31,48,14,102,0.904859681972678,4.56249033334007,7.70451931884732,101,"ENSG00000079974.19"
"11975","ENSG00000136758.20_38266",38258,38266,9,"ENSG00000136758.20",1,6,"UVVVVMVVV",1,7,0.805383022774327,98,104,133,136,149,155,196,199,"CTGATGA","CTTT","ATGATAA","CTGA",2.5743331273522,29,13,41,92,0.769587360212442,4.48295205230678,7.70448414340409,101,"ENSG00000079974.19"
"20079","ENSG00000164253.14_110024",110016,110024,9,"ENSG00000164253.14",1,1,"MVVVVUVVV",1,7,0.82815734989648,114,120,133,136,141,147,178,181,"ATTAAGA","ATGG","CTGAAAA","CTGA",2.32996835463472,13,5,31,58,2.03422360623748,4.39183649261724,7.70446589220317,101,"ENSG00000079974.19"
"4530","ENSG00000100902.11_19015",19007,19015,9,"ENSG00000100902.11",1,8,"UVVVVVVMV",1,7,0.786749482401656,114,120,133,136,146,152,194,197,"ATTATGG","TTGA","CTAATAA","CTGA",2.44834805320246,13,10,42,74,1.90753471817366,4.55746376821418,7.7044616978208,101,"ENSG00000079974.19"
"41307","ENSG00000258790.1_175099",175091,175099,9,"ENSG00000258790.1",1,8,"UVVVVVVMV",1,7,0.786749482401656,114,120,133,136,146,152,194,197,"ATTATGG","TTGA","CTAATAA","CTGA",2.44834805320246,13,10,42,74,1.90753471817366,4.55746376821418,7.7044616978208,101,"ENSG00000079974.19"
"29241","ENSG00000197555.10_7859",7851,7859,9,"ENSG00000197555.10",1,7,"UVVVVVMVV",1,7,0.787991718426501,85,91,99,102,114,120,133,136,"TGGGTGA","CTGA","AAGGTGG","CTGA",2.36646166720708,8,12,13,42,2.43351363563599,4.55248118758746,7.70444806129347,101,"ENSG00000079974.19"
"37876","ENSG00000249008.1_2711",2703,2711,9,"ENSG00000249008.1",1,5,"VVVVMUVVV",1,7,0.808695652173913,108,114,133,136,145,151,159,162,"TTGATGA","GTGC","AAGATGA","CTGT",2.30474574695957,19,9,8,45,2.51359288605256,4.46964113311242,7.70442374180807,101,"ENSG00000079974.19"
"47045","ENSG00000287544.1_55191",55183,55191,9,"ENSG00000287544.1",1,5,"VVVVMUVVV",1,7,0.808695652173913,108,114,133,136,145,151,159,162,"TTGATGA","GTGC","AAGATGA","CTGT",2.30474574695957,19,9,8,45,2.51359288605256,4.46964113311242,7.70442374180807,101,"ENSG00000079974.19"
"24138","ENSG00000175224.17_26522",26514,26522,9,"ENSG00000175224.17",1,3,"UVMVVVVVV",1,7,0.785507246376811,72,78,86,89,94,100,133,136,"ATGATGA","TTGA","ATAATTA","CTCA",2.47664344094452,8,5,33,55,1.73853717339764,4.56237336159028,7.70440234709752,101,"ENSG00000079974.19"
"22532","ENSG00000170745.12_131667",131659,131667,9,"ENSG00000170745.12",0,NA,"UVVVVVUVV",2,7,0.788819875776397,110,116,133,136,159,165,175,178,"ATGAAGC","AGGA","GTGATGG","CTGA",2.44024386772148,17,23,10,59,1.92804147232735,4.54908348095098,7.70436298405657,101,"ENSG00000079974.19"
"13670","ENSG00000143153.14_165122",165114,165122,9,"ENSG00000143153.14",1,1,"MVVVVUVVV",1,7,0.82815734989648,110,116,133,136,138,144,199,202,"ATAAGGA","ATGA","GTAATTA","CTGA",2.44288950340935,17,2,55,83,1.2809281890964,4.39171455295636,7.70434395254228,101,"ENSG00000079974.19"
"37984","ENSG00000249307.8_110139",110131,110139,9,"ENSG00000249307.8",1,8,"VVVUVVVMV",1,7,0.764803312629399,91,97,109,112,113,119,133,136,"ATGCTGG","CTGG","TTGATAG","CTGA",2.442097304753,12,1,14,36,2.29978357988248,4.64510806955895,7.70432132007655,101,"ENSG00000079974.19"
"17057","ENSG00000153060.8_8907",8899,8907,9,"ENSG00000153060.8",1,2,"VMVVVVUVV",1,7,0.770186335403727,113,119,133,136,142,148,157,160,"GCGATGG","GTGG","GTGGGGA","CTGA",2.32319529357075,14,6,9,38,3.00615666399917,4.62353132195104,7.70427666356595,101,"ENSG00000079974.19"
"43178","ENSG00000269745.1_1331",1323,1331,9,"ENSG00000269745.1",1,2,"VMVVVUVVV",1,7,0.806211180124223,116,122,133,136,149,155,208,211,"GTGCTGA","CAAA","GTGACGT","CTGA",2.43713132914765,11,13,53,86,1.67015804025557,4.47942505864331,7.70426977914021,101,"ENSG00000079974.19"
"46141","ENSG00000286215.1_825934",825926,825934,9,"ENSG00000286215.1",1,2,"VMVVVUVVV",1,7,0.806211180124223,116,122,133,136,148,154,169,172,"ATAATCG","CTTA","AGGAAGA","CTGA",2.30357176479874,11,12,15,47,2.56052258120655,4.47941691996621,7.7042616404631,101,"ENSG00000079974.19"
"15128","ENSG00000147117.8_3510",3502,3510,9,"ENSG00000147117.8",1,6,"VVVVUMVVV",1,7,0.792546583850932,116,122,133,136,145,151,164,167,"CTGGTCA","CTGG","GTGGGGG","CTGA",2.29111931547226,11,9,13,42,2.8619218755468,4.53401266134046,7.70419899674418,101,"ENSG00000079974.19"
"38406","ENSG00000250131.2_195531",195523,195531,9,"ENSG00000250131.2",1,7,"UVVVVVMVV",1,7,0.787991718426501,99,105,133,136,148,154,177,180,"GTCATGA","ATGA","GGGAAGA","CTGA",2.55095201413815,28,12,23,72,1.20253854623819,4.5522213267898,7.7041882004958,101,"ENSG00000079974.19"
"1286","ENSG00000052126.16_39129",39121,39129,9,"ENSG00000052126.16",1,1,"MVVVVVUVV",1,7,0.792132505175983,88,94,104,107,115,121,133,136,"ATAATGA","CTGG","TGGGTGA","CTGG",2.2850646987525,10,8,12,39,2.90880467451024,4.53564233321506,7.70417235391899,101,"ENSG00000079974.19"
"31385","ENSG00000223679.1_4118",4110,4118,9,"ENSG00000223679.1",1,8,"VVVVVVUMV",1,7,0.770186335403727,107,113,133,136,147,153,161,164,"CTGATAA","CAGA","ATATGGA","CTGA",2.42793492479525,20,11,8,48,2.30744757675667,4.62342010218125,7.70416544379616,101,"ENSG00000079974.19"
"27554","ENSG00000186487.21_197434",197426,197434,9,"ENSG00000186487.21",1,2,"VMVVUVVVV",1,7,0.773913043478261,88,94,133,136,139,145,192,195,"ATGAGGA","ATGA","CTGATGT","CTGA",2.6589352509918,39,3,47,98,0.707791893179122,4.60850672494778,7.70415889886082,101,"ENSG00000079974.19"
"12715","ENSG00000138798.13_63538",63530,63538,9,"ENSG00000138798.13",1,2,"UMVVVVVVV",1,7,0.786749482401656,83,89,133,136,140,146,156,159,"ATCATGA","GTGT","GTAATCA","CTGA",2.45857593475064,44,4,10,67,1.83803989755632,4.55713653230681,7.70413446191344,101,"ENSG00000079974.19"
"28811","ENSG00000196535.20_76678",76670,76678,9,"ENSG00000196535.20",1,8,"VVVVVUVMV",1,7,0.806211180124224,93,99,133,136,140,146,165,168,"AGGAGGA","CTGC","GTGAGGG","CTGA",2.47379857434768,34,4,19,66,1.42515341971733,4.47928597884213,7.70413069933902,101,"ENSG00000079974.19"
"35848","ENSG00000237356.7_162988",162980,162988,9,"ENSG00000237356.7",1,8,"VVVVVUVMV",1,7,0.806211180124224,96,102,133,136,147,153,208,211,"ATGAGGA","CTGT","GTGTGGG","CTGA",2.55736085901534,31,11,55,106,0.867960170375681,4.47925814095282,7.70410286144972,101,"ENSG00000079974.19"
"9441","ENSG00000124721.18_33059",33051,33059,9,"ENSG00000124721.18",1,2,"VMVUVVVVV",1,7,0.764803312629399,112,118,133,136,146,152,169,172,"TGGATGA","AAGA","GTGGTAA","CTGA",2.41104668115621,15,10,17,51,2.50578083620944,4.64485634431272,7.70406959483032,101,"ENSG00000079974.19"
"6771","ENSG00000111859.17_130507",130499,130507,9,"ENSG00000111859.17",1,7,"VVUVVVMVV",1,7,0.768944099378882,62,68,104,107,116,122,133,136,"ATGAAGC","CTGA","GAAATTA","CTGA",2.48561149363902,36,9,11,65,1.94242569417458,4.62829224627534,7.70406864379087,101,"ENSG00000079974.19"
"19137","ENSG00000161981.11_2779",2771,2779,9,"ENSG00000161981.11",1,8,"VVVVUVVMV",1,7,0.773913043478261,114,120,133,136,143,149,157,160,"CGGAAGA","CCGA","GTGCCGG","CTGA",2.30684219092375,13,7,8,37,3.05461656648853,4.60839112649504,7.70404330040809,101,"ENSG00000079974.19"
"18957","ENSG00000159592.11_54261",54253,54261,9,"ENSG00000159592.11",1,1,"MVVVVUVVV",1,7,0.82815734989648,114,120,133,136,142,148,185,188,"CTGATGT","CAAA","GCCATGT","CTGA",2.33243557393584,13,6,37,65,2.01597385432981,4.39138608680886,7.70401548639478,101,"ENSG00000079974.19"
"17159","ENSG00000153283.13_292977",292969,292977,9,"ENSG00000153283.13",1,8,"VVVVVUVMV",1,7,0.806211180124224,107,113,133,136,142,148,170,173,"GTGAGGA","GTGT","CTGGTGT","CTGA",2.40521358996054,20,6,22,57,1.88175372520979,4.47912774790335,7.70397246840025,101,"ENSG00000079974.19"
"48394","ENSG00000291063.1_35631",35623,35631,9,"ENSG00000291063.1",1,1,"MVVVVVUVV",1,7,0.792132505175983,106,112,133,136,145,151,161,164,"TTGGTGA","GTGG","ATGCTGT","CTGA",2.36700632849417,21,9,10,49,2.36155758272403,4.53539994317129,7.70392996387522,101,"ENSG00000079974.19"
"16915","ENSG00000152689.18_112073",112065,112073,9,"ENSG00000152689.18",1,1,"MVVVVUVVV",1,7,0.82815734989648,114,120,133,136,143,149,161,164,"AAAAAGA","AAGA","TTGGAGA","CTGA",2.18809695390603,13,7,12,41,2.97784358213778,4.39128915204449,7.70391855163041,101,"ENSG00000079974.19"
"33133","ENSG00000228791.8_157480",157472,157480,9,"ENSG00000228791.8",1,1,"MVVVVUVVV",1,7,0.82815734989648,113,119,133,136,140,146,163,166,"TTGAAGG","CAGA","ATGATGA","CTTA",2.25853614774166,14,4,17,44,2.50797228325648,4.39121998371688,7.7038493833028,101,"ENSG00000079974.19"
"21851","ENSG00000169126.16_181818",181810,181818,9,"ENSG00000169126.16",1,7,"UVVVVVMVV",1,7,0.787991718426501,89,95,105,108,116,122,133,136,"GAGATCA","CTGA","ATCATGA","GTGA",2.28839586716594,10,8,11,38,2.95154406691556,4.55187912867212,7.70384600237812,101,"ENSG00000079974.19"
"40195","ENSG00000255240.6_89363",89355,89363,9,"ENSG00000255240.6",1,1,"MVVUVVVVV",1,7,0.786749482401656,114,120,133,136,147,153,163,166,"AGGATGT","CAGC","GAGATAC","CTGA",2.30764256187538,13,11,10,43,2.84307618458625,4.55683998260553,7.70383791221216,101,"ENSG00000079974.19"
"4834","ENSG00000102001.13_7959",7951,7959,9,"ENSG00000102001.13",0,NA,"UVVVVVUVV",2,7,0.788819875776397,113,119,133,136,169,175,218,221,"ATGATGT","CTTA","TTTATAA","CTGA",2.57848074885337,14,33,43,99,1.00431912838379,4.54854769685156,7.70382719995715,101,"ENSG00000079974.19"
"41817","ENSG00000259786.7_252584",252576,252584,9,"ENSG00000259786.7",1,7,"VVVVVUMVV",1,7,0.807453416149068,83,89,101,104,108,114,133,136,"TTTATGG","GTGA","ATGTTAG","CTGA",2.32112134182849,12,4,19,44,2.42189389354475,4.47400904310034,7.70382270769661,101,"ENSG00000079974.19"
"39762","ENSG00000254186.3_403807",403799,403807,9,"ENSG00000254186.3",0,NA,"UVVVVUVVV",2,7,0.824844720496894,84,90,133,136,142,148,176,179,"ATGCTGA","TTCA","CTGAGGC","CTGA",2.46881763348304,43,6,28,86,1.15885238933766,4.40440915313948,7.70378803512706,101,"ENSG00000079974.19"
"26680","ENSG00000184863.11_96882",96874,96882,9,"ENSG00000184863.11",1,3,"UVMVVVVVV",1,7,0.785507246376811,92,98,133,136,156,162,179,182,"AGGATGA","CTGG","GTCATGT","CTGA",2.58940783423096,35,20,17,81,0.984301036555583,4.56175498285716,7.7037839683644,101,"ENSG00000079974.19"
"37216","ENSG00000246084.7_101924",101916,101924,9,"ENSG00000246084.7",1,7,"VVUVVVMVV",1,7,0.768944099378882,57,63,77,80,87,93,133,136,"ATGATGA","CAGA","CAGATGT","ATGA",2.47907955951213,14,7,40,70,1.98434855832332,4.62788640543438,7.70366280294991,101,"ENSG00000079974.19"
"9587","ENSG00000125686.12_42067",42059,42067,9,"ENSG00000125686.12",1,8,"VVVVVVUMV",1,7,0.770186335403727,115,121,133,136,150,156,166,169,"CTAATGA","AAGA","CGGAAGA","CTGA",2.37938004627857,12,14,10,45,2.62895403536702,4.62287191930604,7.70361726092095,101,"ENSG00000079974.19"
"34311","ENSG00000232624.8_177091",177083,177091,9,"ENSG00000232624.8",1,6,"UVVVVMVVV",1,7,0.805383022774327,111,117,133,136,173,179,195,198,"ATGAGCA","CTTA","GTGTTGG","CTGA",2.44774203554585,16,37,16,78,1.60989508448981,4.48204383036553,7.70357592146284,101,"ENSG00000079974.19"
"13792","ENSG00000143473.14_92634",92626,92634,9,"ENSG00000143473.14",1,1,"MVVUVUVVV",2,6,0.708902691511387,82,88,102,105,114,120,133,136,"TTGATGT","TTGA","AGAATGA","CTGA",2.4948204253629,14,9,13,45,2.83962813440549,4.86794107587288,7.70355184191843,101,"ENSG00000079974.19"
"38178","ENSG00000249740.4_65673",65665,65673,9,"ENSG00000249740.4",1,8,"VVUVVVVMV",1,7,0.767701863354037,75,81,94,97,115,121,133,136,"GTGATGC","CTGA","TTGAAAA","TTGA",2.43063018643581,13,18,12,52,2.32673044223487,4.63273292128506,7.70354037470121,101,"ENSG00000079974.19"
"9647","ENSG00000125966.10_26792",26784,26792,9,"ENSG00000125966.10",1,8,"VVVVUVVMV",1,7,0.773913043478261,116,122,133,136,137,143,151,154,"ATCAAGA","CTGG","GTTCTAA","CTGA",2.35644188265835,11,1,8,29,2.72142089428563,4.60775836133533,7.70341053524837,101,"ENSG00000079974.19"
"32737","ENSG00000227681.5_235963",235955,235963,9,"ENSG00000227681.5",1,2,"UMVVVVVVV",1,7,0.786749482401656,114,120,133,136,146,152,179,182,"ATGATGG","TTCA","ATTATAC","CTGA",2.41923301666792,13,10,27,59,2.097375634496,4.55639893640387,7.70339686601049,101,"ENSG00000079974.19"
"42642","ENSG00000265425.1_4120",4112,4120,9,"ENSG00000265425.1",1,8,"VVVVVUVMV",1,7,0.806211180124224,116,122,133,136,146,152,162,165,"AAGAAGA","GTAA","GGGGTGT","CTGA",2.251155331296,11,10,10,40,2.90610893538618,4.47845278600655,7.70329750650345,101,"ENSG00000079974.19"
"32891","ENSG00000228221.6_93362",93354,93362,9,"ENSG00000228221.6",1,6,"UVVVVMVVV",1,7,0.805383022774327,94,100,133,136,146,152,185,188,"ATGGTGA","TGGA","CTGAGGA","CTGA",2.54039029302242,33,10,33,85,0.991108632800558,4.48176097990417,7.70329307100148,101,"ENSG00000079974.19"
"5322","ENSG00000104324.16_239422",239414,239422,9,"ENSG00000104324.16",0,NA,"VVUVVVUVV",2,7,0.769772256728778,92,98,133,136,140,146,158,161,"ATGAAGA","ATGT","GTGGAGA","CTGA",2.50385464154503,35,4,12,60,1.80441355084877,4.62419445695391,7.70328348386902,101,"ENSG00000079974.19"
"10421","ENSG00000131016.17_92648",92640,92648,9,"ENSG00000131016.17",1,7,"VVVVVUMVV",1,7,0.807453416149068,97,103,111,114,115,121,133,136,"ATGATGT","CTAA","TGGTTGA","CTGT",2.32584163613525,8,1,12,30,2.38822135680402,4.47345806609309,7.70327173068936,101,"ENSG00000079974.19"
"30146","ENSG00000203805.11_26248",26240,26248,9,"ENSG00000203805.11",1,6,"VVVVVMUVV",1,7,0.788819875776397,91,97,110,113,116,122,133,136,"GTGAGGA","ATGA","TTAATGA","CTTA",2.31106892735139,13,3,11,36,2.78483965074055,4.54799145827079,7.70327096137638,101,"ENSG00000079974.19"
"2263","ENSG00000072315.4_134844",134836,134844,9,"ENSG00000072315.4",1,8,"VVVVVUVMV",1,7,0.806211180124224,111,117,133,136,143,149,173,176,"GTAATAA","AAGA","GTGATAA","CTGA",2.36428820779224,16,7,24,56,2.1517110936391,4.47840811973017,7.70325284022706,101,"ENSG00000079974.19"
"31655","ENSG00000224318.6_10577",10569,10577,9,"ENSG00000224318.6",1,2,"VMVUVVVVV",1,7,0.764803312629399,74,80,94,97,115,121,133,136,"AGGCTGA","CAGA","ATAAAGA","CTGA",2.44215713483168,14,18,12,53,2.29488475621427,4.6439830804397,7.7031963309573,101,"ENSG00000079974.19"
"42727","ENSG00000266076.1_19734",19726,19734,9,"ENSG00000266076.1",1,2,"VMVVVUVVV",1,7,0.806211180124223,67,73,81,84,93,99,133,136,"ATAATGA","CTTA","GTGATGT","CTTA",2.42519990033169,8,9,34,60,1.74523735547294,4.47830917275439,7.70315389325129,101,"ENSG00000079974.19"
"5759","ENSG00000106571.15_141644",141636,141644,9,"ENSG00000106571.15",1,6,"VVVVUMVVV",1,7,0.792546583850932,104,110,133,136,147,153,166,169,"GTCATGA","CTTC","GTGATTG","CTGA",2.41568686006042,23,11,13,56,2.02723363849298,4.53295317639061,7.70313951179433,101,"ENSG00000079974.19"
"10454","ENSG00000131089.17_71166",71158,71166,9,"ENSG00000131089.17",1,7,"VVVUVVMVV",1,7,0.766045548654244,92,98,108,111,115,121,133,136,"GGGATGT","CTGT","AAGTAGA","CTGA",2.35634496132513,10,4,12,35,2.84677672509838,4.63893578348315,7.70311797810013,101,"ENSG00000079974.19"
"12070","ENSG00000137074.20_76370",76362,76370,9,"ENSG00000137074.20",1,6,"VVVVUMVVV",1,7,0.792546583850932,110,116,133,136,158,164,177,180,"GTGATGT","TTCA","CAGAAGA","CTGA",2.43811182181393,17,22,13,61,1.87762134684687,4.53292503973493,7.70311137513866,101,"ENSG00000079974.19"
"7285","ENSG00000113448.20_432910",432902,432910,9,"ENSG00000113448.20",1,3,"UVMVVVVVV",1,7,0.785507246376811,89,95,133,136,156,162,179,182,"CTGTTGA","CTGA","TTGATCT","CTGA",2.58983667197543,38,20,17,84,0.978664531563428,4.56106058618325,7.70308957169049,101,"ENSG00000079974.19"
"35037","ENSG00000234795.11_5951",5943,5951,9,"ENSG00000234795.11",0,NA,"VVVUUVVVV",2,7,0.770600414078675,114,120,133,136,140,146,169,172,"AAGATGA","CCTA","CTCAAGA","CTGA",2.44340625244759,13,4,23,49,2.1932744015564,4.62066235446841,7.70306401078311,101,"ENSG00000079974.19"
"48061","ENSG00000290323.1_39549",39541,39549,9,"ENSG00000290323.1",0,NA,"VVVUUVVVV",2,7,0.770600414078675,114,120,133,136,140,146,169,172,"AAGATGA","CCTA","CTCAAGA","CTGA",2.44340625244759,13,4,23,49,2.1932744015564,4.62066235446841,7.70306401078311,101,"ENSG00000079974.19"
"30361","ENSG00000204740.11_502263",502255,502263,9,"ENSG00000204740.11",1,2,"VMVUVVVVV",1,7,0.764803312629399,60,66,75,78,86,92,133,136,"TTAATAA","CTGA","GAGATGA","CTGA",2.51032616729291,9,8,41,67,1.83964181090802,4.64378739821519,7.70300064873279,101,"ENSG00000079974.19"
"12701","ENSG00000138785.16_88825",88817,88825,9,"ENSG00000138785.16",1,2,"UMVVVVVVV",1,7,0.786749482401656,46,52,65,68,74,80,133,136,"ATGATGT","CTCA","TTGAAGA","GTGA",2.43650651918163,13,6,53,81,1.98060896640507,4.55599644023731,7.70299436984394,101,"ENSG00000079974.19"
"38858","ENSG00000251175.5_20011",20003,20011,9,"ENSG00000251175.5",1,2,"UMVVVVVVV",1,7,0.786749482401656,46,52,65,68,74,80,133,136,"ATGATGT","CTCA","TTGAAGA","GTGA",2.43650651918163,13,6,53,81,1.98060896640507,4.55599644023731,7.70299436984394,101,"ENSG00000079974.19"
"25212","ENSG00000179915.25_800664",800656,800664,9,"ENSG00000179915.25",1,1,"MVVVVUVVV",1,7,0.82815734989648,102,108,133,136,160,166,179,182,"ATGAAGA","ATGC","ATTATGC","CTGA",2.44854902303541,25,24,13,71,1.23758567664365,4.39031145755326,7.70294085713918,101,"ENSG00000079974.19"
"18401","ENSG00000157211.12_13140",13132,13140,9,"ENSG00000157211.12",1,2,"VMVVUVVVV",1,7,0.773913043478261,100,106,133,136,144,150,169,172,"ATTATGA","TGGA","GTGGAGA","CTGA",2.5146528075659,27,8,19,63,1.66455205017098,4.60722602515257,7.70287819906561,101,"ENSG00000079974.19"
"40472","ENSG00000256407.2_59443",59435,59443,9,"ENSG00000256407.2",1,2,"VMVVUVVVV",1,7,0.773913043478261,100,106,133,136,144,150,169,172,"ATTATGA","TGGA","GTGGAGA","CTGA",2.5146528075659,27,8,19,63,1.66455205017098,4.60722602515257,7.70287819906561,101,"ENSG00000079974.19"
"6482","ENSG00000110107.9_6102",6094,6102,9,"ENSG00000110107.9",1,8,"VVVUVVVMV",1,7,0.764803312629399,76,82,98,101,109,115,133,136,"CTGTTGT","CTGC","GTGAAGT","CTGA",2.41703520150059,16,8,18,51,2.46106634516174,4.64365858879141,7.70287183930901,101,"ENSG00000079974.19"
"10705","ENSG00000132434.10_64307",64299,64307,9,"ENSG00000132434.10",1,8,"UVVVVVVMV",1,7,0.786749482401656,88,94,109,112,116,122,133,136,"AAGATGA","CAGA","CTCATAA","CTTA",2.31684089082277,15,4,11,39,2.77782053741616,4.55585661905867,7.70285454866529,101,"ENSG00000079974.19"
"4708","ENSG00000101746.16_123872",123864,123872,9,"ENSG00000101746.16",1,1,"MVVVVVUVV",1,7,0.792132505175983,83,89,133,136,141,147,162,165,"AAGATAA","GTGA","ATGAATA","CTGA",2.45826007945461,44,5,15,73,1.74888187396044,4.53432060091446,7.7028506216184,101,"ENSG00000079974.19"
"23268","ENSG00000172456.18_34078",34070,34078,9,"ENSG00000172456.18",1,7,"VVVVUVMVV",1,7,0.775155279503105,55,61,79,82,91,97,133,136,"AGGATGT","TTGA","GAGAAGA","CTGA",2.51216024445158,18,9,36,72,1.66105050426487,4.60219636681885,7.70281748483127,101,"ENSG00000079974.19"
"26654","ENSG00000184719.12_68903",68895,68903,9,"ENSG00000184719.12",1,8,"VVVVVUVMV",1,7,0.806211180124224,113,119,133,136,142,148,169,172,"ATGATCT","GGGA","CTAATTA","CTGA",2.32545895968351,14,6,21,50,2.40877252320025,4.47795806360591,7.7028027841028,101,"ENSG00000079974.19"
"27772","ENSG00000187323.12_687099",687091,687099,9,"ENSG00000187323.12",1,1,"MVVVVUUVV",2,6,0.714285714285714,114,120,133,136,146,152,161,164,"ATGATGA","TTGA","GCAATGA","CAGA",2.46988668418776,13,10,9,41,2.91662707420267,4.84563457553027,7.70277743267313,101,"ENSG00000079974.19"
"33201","ENSG00000228999.4_460033",460025,460033,9,"ENSG00000228999.4",1,3,"UVMVVVVVV",1,7,0.785507246376811,89,95,133,136,149,155,182,185,"GTGATTA","CTAA","GTGATGG","CTGA",2.60130042836583,38,13,27,87,0.900768715548613,4.56069289283021,7.70272187833745,101,"ENSG00000079974.19"
"41281","ENSG00000258766.1_242275",242267,242275,9,"ENSG00000258766.1",1,6,"VVVVUMVVV",1,7,0.792546583850932,82,88,133,136,141,147,162,165,"GTGATAA","TAGA","CCGATGA","CTGA",2.45719597462171,45,5,15,74,1.74878682488312,4.5325233305903,7.70270966599403,101,"ENSG00000079974.19"
"27469","ENSG00000186260.17_104945",104937,104945,9,"ENSG00000186260.17",1,2,"UMVVVVVVV",1,7,0.786749482401656,54,60,73,76,115,121,133,136,"AAGATGC","CTGG","TTGACCA","CTGA",2.43900800779902,13,39,12,73,1.96271177720113,4.55569129063198,7.70268922023861,101,"ENSG00000079974.19"
"44109","ENSG00000278259.5_17857",17849,17857,9,"ENSG00000278259.5",1,6,"UVVVVMVVV",1,7,0.805383022774327,114,120,133,136,146,152,173,176,"AAGATGG","TTAA","CTGGTCA","CTGA",2.33554881821404,13,10,21,53,2.35429579200826,4.48115531169213,7.70268740278944,101,"ENSG00000079974.19"
"19496","ENSG00000163116.10_583954",583946,583954,9,"ENSG00000163116.10",1,1,"MVVVVUVVV",1,7,0.82815734989648,104,110,133,136,186,192,202,205,"ATAAAGA","TTGA","ATTAGGA","CTGA",2.442917792755,23,50,10,92,1.27386717729573,4.38999644891559,7.70262584850151,101,"ENSG00000079974.19"
"39661","ENSG00000254044.5_74301",74293,74301,9,"ENSG00000254044.5",1,1,"MVVVVUVVV",1,7,0.82815734989648,104,110,133,136,186,192,202,205,"ATAAAGA","TTGA","ATTAGGA","CTGA",2.442917792755,23,50,10,92,1.27386717729573,4.38999644891559,7.70262584850151,101,"ENSG00000079974.19"
"36862","ENSG00000243276.6_99099",99091,99099,9,"ENSG00000243276.6",1,6,"VVUVVMVVV",1,7,0.786335403726708,113,119,133,136,144,150,159,162,"CTGATGA","AAGA","ATAAAGA","CTGT",2.28702811046333,14,8,9,40,2.98227872674073,4.55728319912407,7.7026248140309,101,"ENSG00000079974.19"
"23244","ENSG00000172379.22_105771",105763,105771,9,"ENSG00000172379.22",0,NA,"UVVVVUVVV",2,7,0.824844720496894,114,120,133,136,182,188,242,245,"GTGATTG","CTCA","GTGAGGA","CTGA",2.49212589167313,13,46,54,122,0.998753254378431,4.40323146638316,7.70261034837074,101,"ENSG00000079974.19"
"10262","ENSG00000130234.13_34252",34244,34252,9,"ENSG00000130234.13",1,2,"VMVVVVUVV",1,7,0.770186335403727,114,120,133,136,146,152,160,163,"GTGCTGA","TTGG","ATTAACA","CTGA",2.3369855599429,13,10,8,40,2.90710278039866,4.62175162833784,7.70249696995275,101,"ENSG00000079974.19"
"45454","ENSG00000285602.1_102624",102616,102624,9,"ENSG00000285602.1",1,2,"VMVVVVUVV",1,7,0.770186335403727,114,120,133,136,146,152,160,163,"GTGCTGA","TTGG","ATTAACA","CTGA",2.3369855599429,13,10,8,40,2.90710278039866,4.62175162833784,7.70249696995275,101,"ENSG00000079974.19"
"12202","ENSG00000137642.13_152821",152813,152821,9,"ENSG00000137642.13",1,6,"UVVVVMVVV",1,7,0.805383022774327,107,113,133,136,137,143,152,155,"TAGATGA","CAGA","ATCTTCA","CTGA",2.40963726271892,20,1,9,39,1.8594949991922,4.48093585432958,7.70246794542689,101,"ENSG00000079974.19"
"39616","ENSG00000253925.1_37968",37960,37968,9,"ENSG00000253925.1",1,1,"MVVVVVUVV",1,7,0.792132505175983,116,122,133,136,147,153,164,167,"ATTCTGA","GTCA","TTGAGCA","CTGA",2.29838636213272,11,11,11,42,2.81308666297025,4.53391560263044,7.70244562333437,101,"ENSG00000079974.19"
"23732","ENSG00000173706.15_4772",4764,4772,9,"ENSG00000173706.15",1,2,"UMVVVVVVV",1,7,0.786749482401656,106,112,133,136,140,146,157,160,"ATGAGGA","TTTA","ATTTTGT","CTGA",2.3973614509715,21,4,11,45,2.23936645981481,4.55544403323954,7.70244196284617,101,"ENSG00000079974.19"
"31713","ENSG00000224514.3_63124",63116,63124,9,"ENSG00000224514.3",1,1,"MVVVVUVVV",1,7,0.82815734989648,90,96,133,136,149,155,194,197,"GTGAGGA","GAGA","GTGAGGA","CTGA",2.52535373558176,37,13,39,98,0.723432040255684,4.38978090270019,7.70241030228611,101,"ENSG00000079974.19"
"25074","ENSG00000179399.15_1054558",1054550,1054558,9,"ENSG00000179399.15",1,3,"UVMVVVVVV",1,7,0.785507246376811,56,62,77,80,113,119,133,136,"GTGATTA","CTCA","TTTCTGA","CTGA",2.46471024384464,15,33,14,71,1.81000538975885,4.56035175384745,7.70238073935469,101,"ENSG00000079974.19"
"23160","ENSG00000172264.19_522586",522578,522586,9,"ENSG00000172264.19",1,8,"UVVVVVVMV",1,7,0.786749482401656,91,97,106,109,114,120,133,136,"ATGATGT","CTGT","ATGTTTG","CTGT",2.31481592409655,9,5,13,36,2.78941286543395,4.55537975651941,7.70237768612604,101,"ENSG00000079974.19"
"28353","ENSG00000188803.15_61146",61138,61146,9,"ENSG00000188803.15",1,6,"UVVVVMVVV",1,7,0.805383022774327,93,99,133,136,145,151,184,187,"ATGCTGG","CTTA","ATGAGGA","CTGA",2.53270306617775,34,9,33,85,1.03868937788502,4.48084412143417,7.70237621253148,101,"ENSG00000079974.19"
"14036","ENSG00000144285.23_101306",101298,101306,9,"ENSG00000144285.23",1,7,"UVVVVVMVV",1,7,0.787991718426501,88,94,133,136,168,174,189,192,"ATGATGA","GGGA","ATTTTGA","CTGA",2.60206011314819,39,32,15,95,0.854478073225127,4.55038637355327,7.70235324725927,101,"ENSG00000079974.19"
"5961","ENSG00000107341.5_97322",97314,97322,9,"ENSG00000107341.5",0,NA,"UVVVUVVVV",2,7,0.792546583850932,100,106,133,136,169,175,186,189,"ATGATAA","ATGG","GTGATGC","CTGA",2.55164284537458,27,33,11,80,1.11763673277029,4.53214725881688,7.7023335942206,101,"ENSG00000079974.19"
"31956","ENSG00000225458.1_12581",12573,12581,9,"ENSG00000225458.1",1,5,"VVVVMUVVV",1,7,0.808695652173913,59,65,80,83,107,113,133,136,"TTGATGA","CTTA","ATGTTGA","CTCA",2.44461755069831,15,24,20,68,1.57257540320072,4.46750643529737,7.70228904399302,101,"ENSG00000079974.19"
"36667","ENSG00000242536.2_212767",212759,212767,9,"ENSG00000242536.2",1,1,"MVUVVVVVV",1,7,0.789648033126294,26,32,52,55,76,82,133,136,"CTGAAGA","CTGA","CTGTAGA","CTGA",2.61659726725667,20,21,51,101,0.730752637566085,4.54368360481931,7.70227573732448,101,"ENSG00000079974.19"
"9763","ENSG00000127124.16_363399",363391,363399,9,"ENSG00000127124.16",0,NA,"UVVVVUVVV",2,7,0.824844720496894,116,122,133,136,142,148,167,170,"GTGATGT","CTTA","GAGAACA","CAGA",2.26074835378439,11,6,19,45,2.53991395977249,4.40289241291711,7.70227129490469,101,"ENSG00000079974.19"
"24311","ENSG00000175779.5_432564",432556,432564,9,"ENSG00000175779.5",0,NA,"VVVVUUVVV",2,7,0.812008281573499,112,118,133,136,148,154,192,195,"AGGAGGG","CTGA","TTGGTCA","CTGA",2.41669239590685,15,12,38,74,1.70556849311932,4.45421278312457,7.70224590941857,101,"ENSG00000079974.19"
"17350","ENSG00000153944.12_386896",386888,386896,9,"ENSG00000153944.12",1,5,"VVVVMUVVV",1,7,0.808695652173913,91,97,133,136,146,152,160,163,"ATGATTC","CTCA","GGGAGGG","CTGA",2.39781173586242,36,10,8,63,1.88442442723627,4.4674589999131,7.70224160860875,101,"ENSG00000079974.19"
"48133","ENSG00000290523.1_11351",11343,11351,9,"ENSG00000290523.1",0,NA,"VVVVUVUVV",2,7,0.775983436853002,99,105,133,136,147,153,167,170,"TTGATGT","GTGA","GGGAGGT","CTGA",2.49131519923565,28,11,14,62,1.78440671026093,4.59829367629132,7.70222742370332,101,"ENSG00000079974.19"
"918","ENSG00000040633.13_3924",3916,3924,9,"ENSG00000040633.13",1,7,"VVVVVUMVV",1,7,0.807453416149068,90,96,107,110,115,121,133,136,"GTGATGA","CTGA","ATGTTAC","CTTT",2.24196234431326,11,5,12,37,2.94317471065411,4.4723975848523,7.70221124944857,101,"ENSG00000079974.19"
"29239","ENSG00000197555.10_320874",320866,320874,9,"ENSG00000197555.10",1,2,"UMVVVVVVV",1,7,0.786749482401656,27,33,65,68,80,86,133,136,"CTGATGA","CTGT","AAGATAA","CTGA",2.61395137905196,32,12,47,100,0.794109870726081,4.55511309943479,7.70211102904142,101,"ENSG00000079974.19"
"34351","ENSG00000232825.3_207820",207812,207820,9,"ENSG00000232825.3",0,NA,"UVUVVVVVV",2,7,0.786335403726708,110,116,133,136,156,162,180,183,"TTGATGA","GTGG","CTAATGC","CTGA",2.48370164501747,17,20,18,64,1.66905568917792,4.55676666399026,7.70210827889709,101,"ENSG00000079974.19"
"34892","ENSG00000234352.9_240896",240888,240896,9,"ENSG00000234352.9",1,8,"VVVVUVVMV",1,7,0.773913043478261,66,72,100,103,109,115,133,136,"ATCATGA","CTGG","GTCCTGC","CTGA",2.50915436048551,28,6,18,61,1.69782082263067,4.60637913980019,7.70203131371323,101,"ENSG00000079974.19"
"29905","ENSG00000198853.12_11527",11519,11527,9,"ENSG00000198853.12",1,1,"MVVVVUVVV",1,7,0.82815734989648,109,115,133,136,143,149,175,178,"GTTATGA","ATAA","ATGGTTG","CTGA",2.34820345482541,18,7,26,60,1.90266528542015,4.38933874606405,7.70196814564997,101,"ENSG00000079974.19"
"13939","ENSG00000143995.20_2046",2038,2046,9,"ENSG00000143995.20",1,8,"VVVVVUVMV",1,7,0.806211180124224,69,75,89,92,104,110,133,136,"ATGATCA","TTGA","GTGATTG","ATGA",2.37299661704254,14,12,23,58,2.08842164499883,4.47709977298727,7.70194449348416,101,"ENSG00000079974.19"
"15645","ENSG00000148948.8_864319",864311,864319,9,"ENSG00000148948.8",1,2,"VMVVVVUVV",1,7,0.770186335403727,73,79,98,101,111,117,133,136,"AAGAAGA","CTGG","ATGTTGG","CTGA",2.43766750445164,19,10,16,54,2.23365686710972,4.62119339086349,7.7019387324784,101,"ENSG00000079974.19"
"24886","ENSG00000178568.15_1091550",1091542,1091550,9,"ENSG00000178568.15",1,2,"UMVVVVVVV",1,7,0.786749482401656,98,104,133,136,141,147,155,158,"ATAATGG","TTAA","GTGATTA","CTGA",2.43732812928234,29,5,8,51,1.97067132949739,4.55488138117825,7.70187931078488,101,"ENSG00000079974.19"
"20388","ENSG00000164764.11_54917",54909,54917,9,"ENSG00000164764.11",1,3,"UVMVVVVVV",1,7,0.785507246376811,47,53,62,65,115,121,133,136,"ATGATCA","CTGA","ATGGAGA","CAGA",2.46663551200535,9,50,12,80,1.79515366834702,4.55984760376234,7.70187658926959,101,"ENSG00000079974.19"
"40342","ENSG00000255622.4_2279",2271,2279,9,"ENSG00000255622.4",1,8,"VVVVVUVMV",1,7,0.806211180124224,81,87,96,99,109,115,133,136,"ACCAGGA","CAGA","ATGAAGT","CTGA",2.32999652238437,9,10,18,46,2.37465092953807,4.4769902696918,7.7018349901887,101,"ENSG00000079974.19"
"48293","ENSG00000290893.1_2279",2271,2279,9,"ENSG00000290893.1",1,8,"VVVVVUVMV",1,7,0.806211180124224,81,87,96,99,109,115,133,136,"ACCAGGA","CAGA","ATGAAGT","CTGA",2.32999652238437,9,10,18,46,2.37465092953807,4.4769902696918,7.7018349901887,101,"ENSG00000079974.19"
"33908","ENSG00000231426.7_79856",79848,79856,9,"ENSG00000231426.7",1,8,"VVVVVVUMV",1,7,0.770186335403727,113,119,133,136,141,147,159,162,"GTGAAGA","TGGA","ATCTTAA","CTGA",2.33966317873452,14,5,12,40,2.88653824664236,4.6210731928848,7.7018185344997,101,"ENSG00000079974.19"
"25840","ENSG00000182973.20_32968",32960,32968,9,"ENSG00000182973.20",1,6,"UVVVVMVVV",1,7,0.805383022774327,91,97,133,136,143,149,179,182,"TTGATGC","ATGA","ATGGTTA","CTGA",2.51825094459648,36,7,30,82,1.13272987099458,4.48026737540945,7.70179946650676,101,"ENSG00000079974.19"
"38942","ENSG00000251314.2_7559",7551,7559,9,"ENSG00000251314.2",1,8,"UVVVVVVMV",1,7,0.786749482401656,94,100,111,114,115,121,133,136,"ATTATGA","CAGA","GTTAGGA","ATGA",2.36282918996474,11,1,12,33,2.46681669377113,4.55475282338402,7.70175075299065,101,"ENSG00000079974.19"
"6251","ENSG00000108953.17_45936",45928,45936,9,"ENSG00000108953.17",1,8,"VVVVVUVMV",1,7,0.806211180124224,88,94,133,136,150,156,174,177,"TTGATGA","ATAA","ATCATGC","CTGA",2.49699634616417,39,14,18,80,1.26096494419888,4.47690181299001,7.7017465334869,101,"ENSG00000079974.19"
"7106","ENSG00000112787.14_25031",25023,25031,9,"ENSG00000112787.14",1,6,"VVVVVMUVV",1,7,0.788819875776397,98,104,133,136,147,153,166,169,"ATGCTGA","GTGG","AGGAAGA","CTGA",2.45596055706996,29,11,13,62,1.81278343837046,4.54646345470921,7.7017429578148,101,"ENSG00000079974.19"
"32085","ENSG00000225882.1_129043",129035,129043,9,"ENSG00000225882.1",1,2,"VMVVVVUVV",1,7,0.770186335403727,66,72,84,87,95,101,133,136,"AGGAAGA","CTAA","GTGGGGA","CTGA",2.4610157695892,12,8,32,61,2.07713197406809,4.62097594283236,7.70172128444726,101,"ENSG00000079974.19"
"36575","ENSG00000241956.11_17797",17789,17797,9,"ENSG00000241956.11",1,1,"MVVVVVUVV",1,7,0.792132505175983,68,74,85,88,104,110,133,136,"TTGATGA","CTCA","ATGATGT","CTGT",2.44658637121962,11,16,23,59,1.82211043428997,4.53317156060519,7.70170158130913,101,"ENSG00000079974.19"
"6100","ENSG00000108018.16_130359",130351,130359,9,"ENSG00000108018.16",0,NA,"VVVVVUUVV",2,7,0.808281573498965,108,114,133,136,159,165,182,185,"ATGAAGG","CACA","CTGATGA","CTGA",2.46396751648173,19,23,17,68,1.44754952169435,4.46849990789314,7.701626201889,101,"ENSG00000079974.19"
"45526","ENSG00000285683.2_25942",25934,25942,9,"ENSG00000285683.2",1,2,"VMVVVUVVV",1,7,0.806211180124223,92,98,105,108,116,122,133,136,"ATGATCA","GTGA","GTATTAA","ATGA",2.27869747199636,7,8,11,35,2.71580582827819,4.47678057706349,7.70162529756038,101,"ENSG00000079974.19"
"3704","ENSG00000088367.23_125656",125648,125656,9,"ENSG00000088367.23",1,8,"VVVVUVVMV",1,7,0.773913043478261,112,118,133,136,146,152,160,163,"GTGTTGG","GTGA","GAGATCG","CTGA",2.34275476512476,15,10,8,42,2.8052555133981,4.60590515355746,7.7015573274705,101,"ENSG00000079974.19"
"34944","ENSG00000234426.3_252765",252757,252765,9,"ENSG00000234426.3",1,2,"VMVVVVUVV",1,7,0.770186335403727,82,88,133,136,144,150,164,167,"TTGATAA","CTGT","ATGAGAA","CTGA",2.49373314343809,45,8,14,76,1.85823216048952,4.62077994585252,7.70152528746743,101,"ENSG00000079974.19"
"36778","ENSG00000242908.6_155169",155161,155169,9,"ENSG00000242908.6",1,1,"MVVVVVUVV",1,7,0.792132505175983,113,119,133,136,141,147,156,159,"TGGATGA","GTGG","GCTCTGA","CTGA",2.27385714102159,14,5,9,37,2.97283552479713,4.53297078290193,7.70150080360586,101,"ENSG00000079974.19"
"12126","ENSG00000137409.21_8211",8203,8211,9,"ENSG00000137409.21",1,8,"UVVVVUVMV",2,6,0.708902691511387,109,115,133,136,146,152,186,189,"ATGAAGA","GTGA","GTGTTGA","CTGA",2.67530628718316,18,10,34,71,1.62813555123893,4.86587769978167,7.70148846582721,101,"ENSG00000079974.19"
"41324","ENSG00000258844.2_11481",11473,11481,9,"ENSG00000258844.2",1,7,"VVVUVVMVV",1,7,0.766045548654244,91,97,104,107,111,117,133,136,"CTGGTGC","CTGA","GTGTTTC","CTGA",2.43578637299968,7,4,16,36,2.31060381556523,4.63729490889077,7.70147710350775,101,"ENSG00000079974.19"
"16412","ENSG00000151474.23_356019",356011,356019,9,"ENSG00000151474.23",1,2,"UMVVVVVVV",1,7,0.786749482401656,108,114,133,136,147,153,169,172,"ATGATGC","GTGA","TTGGTGA","CTGT",2.40710045848421,19,11,16,55,2.17049190016519,4.55445707251498,7.70145500212161,101,"ENSG00000079974.19"
"45346","ENSG00000285471.1_243595",243587,243595,9,"ENSG00000285471.1",1,8,"UVVVVVVMV",1,7,0.786749482401656,94,100,109,112,116,122,133,136,"CTGATGG","CAGA","GTGCTCA","ATGA",2.30240968215418,9,4,11,33,2.86804924483839,4.55436178146657,7.70135971107319,101,"ENSG00000079974.19"
"31089","ENSG00000215483.12_428672",428664,428672,9,"ENSG00000215483.12",1,1,"MVVVVVUVV",1,7,0.792132505175983,44,50,64,67,73,79,133,136,"ACAATGC","CTGA","ATTAGGA","CTGA",2.42737171937287,14,6,54,83,1.9486240278742,4.53277553925666,7.70130555996059,101,"ENSG00000079974.19"
"34478","ENSG00000233143.4_492141",492133,492141,9,"ENSG00000233143.4",1,1,"MVVUVVVVV",1,7,0.786749482401656,110,116,133,136,154,160,178,181,"ATGAAGT","CTAA","GAGATGG","CTGA",2.46801332819226,17,18,18,62,1.76380054472623,4.55430568316867,7.70130361277529,101,"ENSG00000079974.19"
"16507","ENSG00000151702.18_9083",9075,9083,9,"ENSG00000151702.18",1,2,"VMUVVVVVV",1,7,0.767701863354037,111,117,133,136,155,161,170,173,"ATGCTGA","CCAA","CTGGAGA","CTGA",2.45437865993503,16,19,9,53,2.15942457914499,4.63048724467796,7.70129469809411,101,"ENSG00000079974.19"
"19744","ENSG00000163635.20_111671",111663,111671,9,"ENSG00000163635.20",1,8,"VVVUVVVMV",1,7,0.764803312629399,116,122,133,136,180,186,198,201,"GTTATAA","CTGA","ATGGTGG","CTGA",2.49480875326632,11,44,12,76,1.93608212631817,4.64203512035674,7.70124837087434,101,"ENSG00000079974.19"
"27119","ENSG00000185565.12_79773",79765,79773,9,"ENSG00000185565.12",1,6,"VVVVUMVVV",1,7,0.792546583850932,47,53,66,69,85,91,133,136,"ATAAAGA","CTCA","ATGATAA","CTGA",2.49390001715712,13,16,42,80,1.49798815054514,4.53099706623149,7.70118340163521,101,"ENSG00000079974.19"
"7386","ENSG00000113805.9_331066",331058,331066,9,"ENSG00000113805.9",1,2,"VMUVVVVVV",1,7,0.767701863354037,114,120,133,136,155,161,194,197,"ATTATGA","GTGT","GTGAAGA","CTGA",2.56907894834998,13,19,33,74,1.3943100592328,4.63037576205817,7.70118321547432,101,"ENSG00000079974.19"
"34425","ENSG00000233005.2_638193",638185,638193,9,"ENSG00000233005.2",0,NA,"VVUVUVVVV",2,7,0.773498964803312,113,119,133,136,150,156,167,170,"AGGAGGA","GGGA","TTGATGC","CTGA",2.37816118555087,14,14,11,48,2.57431153672816,4.60717986010016,7.70117571931341,101,"ENSG00000079974.19"
"8229","ENSG00000117528.14_61494",61486,61494,9,"ENSG00000117528.14",1,6,"UVVVVMVVV",1,7,0.805383022774327,110,116,133,136,161,167,203,206,"GTGATGA","ATTA","AAGATGT","CTGA",2.54932025369323,17,25,36,87,0.923074505321107,4.47963571581899,7.7011678069163,101,"ENSG00000079974.19"
"11693","ENSG00000135837.17_35678",35670,35678,9,"ENSG00000135837.17",1,2,"UMVVVVVVV",1,7,0.786749482401656,108,114,133,136,146,152,163,166,"GTTATTA","ATGA","ATTATAA","CTGA",2.36318319821566,19,10,11,49,2.4620212489147,4.55414397592145,7.70114190552807,101,"ENSG00000079974.19"
"16420","ENSG00000151474.23_512973",512965,512973,9,"ENSG00000151474.23",0,NA,"VVUVVVUVV",2,7,0.769772256728778,114,120,133,136,140,146,155,158,"ATCTTGA","TTTA","GTGGTTA","CTGA",2.32866914804755,13,4,9,35,2.9636559347714,4.62202923043877,7.70111825735388,101,"ENSG00000079974.19"
"6825","ENSG00000111962.8_208673",208665,208673,9,"ENSG00000111962.8",1,8,"VVVVVVUMV",1,7,0.770186335403727,108,114,133,136,148,154,171,174,"TTTATGA","CTGC","TTGCTGT","CTGA",2.46617159309684,19,12,17,57,2.04029166044308,4.62035890360551,7.70110424522042,101,"ENSG00000079974.19"
"24209","ENSG00000175497.17_14677",14669,14677,9,"ENSG00000175497.17",1,2,"VMVVVUVVV",1,7,0.806211180124223,113,119,133,136,143,149,159,162,"ATGGACA","GTTA","GTGATGC","CTGA",2.23620134872607,14,7,10,40,2.99698625746431,4.47624881224286,7.70109353273976,101,"ENSG00000079974.19"
"44835","ENSG00000283692.2_398678",398670,398678,9,"ENSG00000283692.2",1,1,"MVVVVVUVV",1,7,0.792132505175983,98,104,133,136,165,171,186,189,"GAGATGA","ATGA","GTGAAAA","CTGA",2.57896817647197,29,29,15,82,0.937010156816582,4.5325328333241,7.70106285402803,101,"ENSG00000079974.19"
"13325","ENSG00000140945.17_87461",87453,87461,9,"ENSG00000140945.17",1,1,"MVVVUVVVV",1,7,0.795859213250517,112,118,133,136,146,152,202,205,"CTGATGT","AAGA","ATGGTGG","CTGA",2.4390315511709,15,10,50,84,1.81014420794368,4.51758863727076,7.70102549027282,101,"ENSG00000079974.19"
"26207","ENSG00000183668.18_53850",53842,53850,9,"ENSG00000183668.18",0,NA,"UVVVVUVVV",2,7,0.824844720496894,104,110,133,136,175,181,194,197,"AAGATGC","CTAA","ATGATAC","CTGA",2.46079463720064,23,39,13,84,1.20121125044218,4.40162720794494,7.70100608993252,101,"ENSG00000079974.19"
"36448","ENSG00000241104.5_32966",32958,32966,9,"ENSG00000241104.5",0,NA,"UVVVVUVVV",2,7,0.824844720496894,104,110,133,136,175,181,194,197,"AAGATGC","CTAA","ATGATAC","CTGA",2.46079463720064,23,39,13,84,1.20121125044218,4.40162720794494,7.70100608993252,101,"ENSG00000079974.19"
"26606","ENSG00000184588.18_90429",90421,90429,9,"ENSG00000184588.18",1,8,"VVVVUVVMV",1,7,0.773913043478261,60,66,92,95,102,108,133,136,"ATGTTGA","ATGA","CTCATTA","CTGA",2.55221592580917,26,7,25,67,1.40663427199053,4.60535177767958,7.70100395159263,101,"ENSG00000079974.19"
"26947","ENSG00000185345.24_283590",283582,283590,9,"ENSG00000185345.24",0,NA,"VVUUVVVVV",2,7,0.764389233954451,80,86,104,107,116,122,133,136,"GTGATGA","GTGA","ATGGAAA","GTGA",2.39524052052049,18,9,11,47,2.60548191312479,4.64343801248201,7.70099494829982,101,"ENSG00000079974.19"
"38800","ENSG00000251031.2_207465",207457,207465,9,"ENSG00000251031.2",1,2,"UMVVVVVVV",1,7,0.786749482401656,116,122,133,136,154,160,176,179,"AAGATGA","CATA","GTAAGTA","CTGA",2.41646009086047,11,18,16,54,2.10617758843739,4.55397788187679,7.70097581148342,101,"ENSG00000079974.19"
"16059","ENSG00000150672.19_1715039",1715031,1715039,9,"ENSG00000150672.19",1,3,"VVMVVVUVV",1,7,0.768944099378882,112,118,133,136,145,151,181,184,"TTGGTGA","CTGT","CTGAGAA","CTGA",2.47711334571164,15,9,30,63,1.98663900531437,4.62518199418132,7.70095839169685,101,"ENSG00000079974.19"
"37212","ENSG00000245937.10_10531",10523,10531,9,"ENSG00000245937.10",1,2,"VMVVVUVVV",1,7,0.806211180124223,100,106,133,136,148,154,209,212,"ATGATGA","GTGT","ATAAAGG","CTGA",2.5552617503298,27,12,55,103,0.869289705540673,4.47609201026818,7.70093673076507,101,"ENSG00000079974.19"
"28734","ENSG00000196396.10_1087",1079,1087,9,"ENSG00000196396.10",1,8,"VVVVVUVMV",1,7,0.806211180124224,85,91,109,112,116,122,133,136,"AGGAGGA","CTGA","AAGAGGA","GTGA",2.30955305116716,18,4,11,42,2.50730467495223,4.47608125401665,7.70092597451355,101,"ENSG00000079974.19"
"46836","ENSG00000287270.1_1089",1081,1089,9,"ENSG00000287270.1",1,6,"VVVUVMVVV",1,7,0.78343685300207,93,99,133,136,150,156,165,168,"GTGATAT","CTGT","GTGATAA","CTGA",2.49525246003768,34,14,9,66,1.63353436626705,4.56713769162956,7.70088510363784,101,"ENSG00000079974.19"
"38471","ENSG00000250305.9_23163",23155,23163,9,"ENSG00000250305.9",0,NA,"VVVUVUVVV",2,7,0.802898550724638,116,122,133,136,142,148,162,165,"ATGGTGG","ATGC","ATTATCT","CTGA",2.26409331865425,11,6,14,40,2.86308628654337,4.48926043605958,7.70085463895813,101,"ENSG00000079974.19"
"9096","ENSG00000122591.13_8513",8505,8513,9,"ENSG00000122591.13",1,1,"MVUVVVVVV",1,7,0.789648033126294,100,106,133,136,145,151,159,162,"ATGATGA","TTAA","TTGATGG","CTGG",2.42029944525251,27,9,8,53,2.03354744763987,4.54221927066415,7.70081140316933,101,"ENSG00000079974.19"
"7286","ENSG00000113448.20_46012",46004,46012,9,"ENSG00000113448.20",1,8,"UVVVVVVMV",1,7,0.786749482401656,116,122,133,136,142,148,187,190,"GGAATGA","TTGA","GTGCAGA","CTGA",2.43475824603467,11,6,39,65,1.9834904332895,4.55380301838016,7.70080094798678,101,"ENSG00000079974.19"
"39410","ENSG00000253554.7_482640",482632,482640,9,"ENSG00000253554.7",1,2,"UMVVVVVVV",1,7,0.786749482401656,115,121,133,136,146,152,163,166,"AAGAAGA","CTGA","ATTAGGA","CTAA",2.29704812954526,12,10,11,42,2.90155585125339,4.55380251205545,7.70080044166208,101,"ENSG00000079974.19"
"44891","ENSG00000284240.1_14147",14139,14147,9,"ENSG00000284240.1",1,2,"VMUVVVVVV",1,7,0.767701863354037,79,85,98,101,109,115,133,136,"GGGATGG","CTGG","TTAAAGA","CTGA",2.38496825880514,13,8,18,48,2.62015654254086,4.62998623364379,7.70079368705994,101,"ENSG00000079974.19"
"40299","ENSG00000255496.1_34869",34861,34869,9,"ENSG00000255496.1",1,2,"UMVVVUVVV",2,6,0.708902691511387,83,89,133,136,144,150,159,162,"ATGATGA","TTGT","TTGCAGA","CTGA",2.62126697645706,44,8,9,70,1.98557462548957,4.86517195046749,7.70078271651304,101,"ENSG00000079974.19"
"877","ENSG00000038532.17_75687",75679,75687,9,"ENSG00000038532.17",1,5,"VVVVMUVVV",1,7,0.808695652173913,107,113,133,136,180,186,210,213,"ATGGTGA","CTCA","ACGAGGA","CTGA",2.55846292604342,20,44,24,97,0.807488361924239,4.4659769672201,7.70075957591575,101,"ENSG00000079974.19"
"42899","ENSG00000267295.1_3811",3803,3811,9,"ENSG00000267295.1",0,NA,"UVVVVVUVV",2,7,0.788819875776397,99,105,133,136,152,158,172,175,"ATGATGA","CTCA","GTGAATA","CAGA",2.51157836804935,28,16,14,67,1.43797013327962,4.54545648006882,7.70073598317441,101,"ENSG00000079974.19"
"43846","ENSG00000274378.1_3811",3803,3811,9,"ENSG00000274378.1",0,NA,"UVVVVVUVV",2,7,0.788819875776397,99,105,133,136,152,158,172,175,"ATGATGA","CTCA","GTGAATA","CAGA",2.51157836804935,28,16,14,67,1.43797013327962,4.54545648006882,7.70073598317441,101,"ENSG00000079974.19"
"34719","ENSG00000233891.8_281873",281865,281873,9,"ENSG00000233891.8",1,8,"VVVVUVVMV",1,7,0.773913043478261,115,121,133,136,140,146,155,158,"AAGAAGT","ATGA","ATTCTGA","CTGA",2.31252749001982,12,4,9,34,3.00325370030578,4.60502590844281,7.70067808235585,101,"ENSG00000079974.19"
"43495","ENSG00000271955.2_648677",648669,648677,9,"ENSG00000271955.2",1,8,"VVVVUVVMV",1,7,0.773913043478261,115,121,133,136,140,146,155,158,"AAGAAGT","ATGA","ATTCTGA","CTGA",2.31252749001982,12,4,9,34,3.00325370030578,4.60502590844281,7.70067808235585,101,"ENSG00000079974.19"
"43153","ENSG00000269437.8_47155",47147,47155,9,"ENSG00000269437.8",0,NA,"VVVVUUVVV",2,7,0.812008281573499,54,60,72,75,79,85,133,136,"AGGATTA","AAGA","CTGTTGA","CTGA",2.39528012066488,12,4,48,73,1.84172785214474,4.45256549747766,7.70059862377165,101,"ENSG00000079974.19"
"45033","ENSG00000284800.2_78959",78951,78959,9,"ENSG00000284800.2",0,NA,"VVVVUUVVV",2,7,0.812008281573499,54,60,72,75,79,85,133,136,"AGGATTA","AAGA","CTGTTGA","CTGA",2.39528012066488,12,4,48,73,1.84172785214474,4.45256549747766,7.70059862377165,101,"ENSG00000079974.19"
"2842","ENSG00000078328.23_612278",612270,612278,9,"ENSG00000078328.23",1,7,"UVVVVVMVV",1,7,0.787991718426501,97,103,111,114,116,122,133,136,"GTGATAA","TTGG","ATTATAT","CTGA",2.33685234407001,8,2,11,30,2.6154655359637,4.54862029077428,7.70058716448028,101,"ENSG00000079974.19"
"17852","ENSG00000155530.4_128062",128054,128062,9,"ENSG00000155530.4",1,1,"MVUVVVVVV",1,7,0.789648033126294,112,118,133,136,141,147,155,158,"TTAATTA","TTGA","ATCAAGT","CTGA",2.29019100986766,15,5,8,37,2.89994278903026,4.54197071370367,7.70056284620885,101,"ENSG00000079974.19"
"45379","ENSG00000285534.1_22744",22736,22744,9,"ENSG00000285534.1",1,8,"UVVVVVVMV",1,7,0.786749482401656,44,50,62,65,112,118,133,136,"ATGATTA","ATAA","TTGAGTA","CTGA",2.45927032621338,12,47,15,83,1.81894731260055,4.55352070517244,7.70051863477906,101,"ENSG00000079974.19"
"10551","ENSG00000131558.15_248627",248619,248627,9,"ENSG00000131558.15",1,1,"MVVVVVUVV",1,7,0.792132505175983,92,98,133,136,140,146,156,159,"ATGATGG","TTGA","CTGATGC","TTGA",2.44222269881162,35,4,10,58,1.84633331837641,4.53195449428014,7.70048451498407,101,"ENSG00000079974.19"
"37154","ENSG00000245729.2_63399",63391,63399,9,"ENSG00000245729.2",1,5,"UVVVMVVVV",1,7,0.789233954451346,110,116,133,136,150,156,194,197,"ATGCTGA","TGGA","TTGCTGA","CTGA",2.51491357689203,17,14,38,78,1.40804779288124,4.5435345763737,7.70047039417908,101,"ENSG00000079974.19"
"37911","ENSG00000249159.6_63405",63397,63405,9,"ENSG00000249159.6",1,5,"UVVVMVVVV",1,7,0.789233954451346,110,116,133,136,150,156,194,197,"ATGCTGA","TGGA","TTGCTGA","CTGA",2.51491357689203,17,14,38,78,1.40804779288124,4.5435345763737,7.70047039417908,101,"ENSG00000079974.19"
"33923","ENSG00000231504.1_666",658,666,9,"ENSG00000231504.1",0,NA,"VVVVVUUVV",2,7,0.808281573498965,28,34,64,67,73,79,133,136,"ATGATGA","TTGA","ATGAGGC","ATGA",2.5261427170063,30,6,54,99,1.02835262460618,4.46732601782871,7.70045231182457,101,"ENSG00000079974.19"
"38276","ENSG00000249867.6_291865",291857,291865,9,"ENSG00000249867.6",1,5,"UVVVMVVVV",1,7,0.789233954451346,114,120,133,136,145,151,160,163,"ATTATGT","TTAA","ATATTTA","CTGA",2.27941158977177,13,9,9,40,2.9779462793036,4.54350588611218,7.70044170391756,101,"ENSG00000079974.19"
"4667","ENSG00000101542.10_2626",2618,2626,9,"ENSG00000101542.10",1,5,"UVVVMUVVV",2,6,0.711387163561077,86,92,105,108,114,120,133,136,"TTTATGA","CGGA","GTTGTGA","CTGA",2.47452557442485,13,6,13,41,2.9227224780417,4.85488991021851,7.70043856446282,101,"ENSG00000079974.19"
"26416","ENSG00000184220.12_83041",83033,83041,9,"ENSG00000184220.12",1,7,"VVVVUVMVV",1,7,0.775155279503105,59,65,100,103,111,117,133,136,"TTGATGT","GTGA","ATGTAGC","CTGA",2.49680506410052,35,8,16,68,1.75377930397184,4.59978659949382,7.70040771750624,101,"ENSG00000079974.19"
"48514","ENSG00000291216.1_1367",1359,1367,9,"ENSG00000291216.1",0,NA,"VVUVVUVVV",2,7,0.805797101449275,116,122,133,136,145,151,167,170,"ATGCTGA","TTGG","ATGATGC","CTGT",2.28282485655628,11,9,16,45,2.68993440327286,4.47719169507869,7.70038010087579,101,"ENSG00000079974.19"
"31071","ENSG00000215421.10_445932",445924,445932,9,"ENSG00000215421.10",0,NA,"UVVUVVVVV",2,7,0.78343685300207,98,104,133,136,146,152,166,169,"CTGATAA","CTGC","TTGACAA","CTGA",2.46574929579955,29,10,14,62,1.82813191615024,4.56661513870347,7.70036255071175,101,"ENSG00000079974.19"
"17780","ENSG00000155052.15_802164",802156,802164,9,"ENSG00000155052.15",1,8,"UVVVVVVMV",1,7,0.786749482401656,113,119,133,136,149,155,183,186,"CAGATGT","ATGA","CTGATGT","CTGA",2.45710038860648,14,13,28,64,1.83255655989463,4.55330645431779,7.70030438392441,101,"ENSG00000079974.19"
"35731","ENSG00000236915.3_55374",55366,55374,9,"ENSG00000236915.3",1,2,"UMVVVVVVV",1,7,0.786749482401656,113,119,133,136,146,152,178,181,"ATAATGA","GTCA","GTAAAAA","CTGA",2.41719882756216,14,10,26,59,2.09842995303274,4.55327220086179,7.70027013046841,101,"ENSG00000079974.19"
"6881","ENSG00000112182.16_75343",75335,75343,9,"ENSG00000112182.16",1,5,"VVVVMUVVV",1,7,0.808695652173913,95,101,133,136,141,147,157,160,"CTGATGA","CTTA","ATGTTTA","CTTA",2.38606214975472,32,5,10,56,1.95482894754271,4.46547748647688,7.70026009517254,101,"ENSG00000079974.19"
"19016","ENSG00000160191.18_87220",87212,87220,9,"ENSG00000160191.18",1,8,"VVVVVUVMV",1,7,0.806211180124224,94,100,133,136,146,152,166,169,"AGGATGA","TGGA","ATTAATA","CTGA",2.41725799744173,33,10,14,66,1.78646727162624,4.47538014697611,7.700224867473,101,"ENSG00000079974.19"
"37102","ENSG00000245322.8_121716",121708,121716,9,"ENSG00000245322.8",1,3,"VVMVVUVVV",1,7,0.804968944099379,103,109,133,136,139,145,156,159,"CTCATGA","GTGG","GTGATAT","CTGA",2.40209097868776,24,3,11,47,1.90743934913589,4.48034480176358,7.70022057816109,101,"ENSG00000079974.19"
"8024","ENSG00000116539.14_94799",94791,94799,9,"ENSG00000116539.14",1,8,"VVVVVVUMV",1,7,0.770186335403727,116,122,133,136,144,150,158,161,"ATGAAGA","GTAA","GTGAAGA","CAGA",2.31502889380775,11,8,8,36,3.0441558848178,4.61942046088404,7.70016580249895,101,"ENSG00000079974.19"
"11530","ENSG00000135298.15_204514",204506,204514,9,"ENSG00000135298.15",1,8,"VVUVVVVMV",1,7,0.767701863354037,81,87,101,104,109,115,133,136,"CAGATGA","CTGG","AAGTTCA","CTGA",2.39727418682208,14,5,18,46,2.53553703001725,4.62934123554111,7.70014868895726,101,"ENSG00000079974.19"
"5193","ENSG00000103742.12_28592",28584,28592,9,"ENSG00000103742.12",0,NA,"VVVUVVUVV",2,7,0.766873706004141,114,120,133,136,137,143,151,154,"ATGATCA","GTCA","GGGCTGC","CTGA",2.38761536707274,13,1,8,31,2.6131738857098,4.63265241654868,7.70014724056524,101,"ENSG00000079974.19"
"32118","ENSG00000226026.7_26997",26989,26997,9,"ENSG00000226026.7",1,1,"MVVVVVUVV",1,7,0.792132505175983,108,114,133,136,144,150,168,171,"ATGATAC","CAGA","ATTCTGT","CTGA",2.38900996198841,19,8,18,54,2.19961600491436,4.53158727120927,7.7001172919132,101,"ENSG00000079974.19"
"14689","ENSG00000145730.21_109637",109629,109637,9,"ENSG00000145730.21",1,6,"UVVVVMVVV",1,7,0.805383022774327,110,116,133,136,165,171,191,194,"ATTATAA","TTGA","GTGAAGG","CTGA",2.48724202171225,17,29,20,75,1.33270058709509,4.47857851629419,7.7001106073915,101,"ENSG00000079974.19"
"43148","ENSG00000269300.1_172",164,172,9,"ENSG00000269300.1",1,8,"VVVVVUVMV",1,7,0.806211180124224,104,110,133,136,142,148,157,160,"ATCATGG","GAGA","TTGGTAA","CTGA",2.34641889036251,23,6,9,47,2.25821471587668,4.47525182957335,7.70009655007025,101,"ENSG00000079974.19"
"46568","ENSG00000286836.1_63267",63259,63267,9,"ENSG00000286836.1",0,NA,"VVVUUVVVV",2,7,0.770600414078675,115,121,133,136,148,154,175,178,"ATGAAAA","CAGA","GTTTTGA","CTGA",2.43665594512751,12,12,21,54,2.22639266570909,4.61769140830645,7.70009306462115,101,"ENSG00000079974.19"
"13363","ENSG00000141161.12_34990",34982,34990,9,"ENSG00000141161.12",1,3,"VVMVVUVVV",1,7,0.804968944099379,42,48,65,68,75,81,133,136,"GAGATGC","CTGG","GTGATCT","CTGA",2.42463589265282,17,7,52,85,1.7565208357237,4.48019003001896,7.70006580641648,101,"ENSG00000079974.19"
"24075","ENSG00000175093.5_48955",48947,48955,9,"ENSG00000175093.5",1,5,"UVVVMVVVV",1,7,0.789233954451346,106,112,133,136,141,147,156,159,"ATGAGGT","AAGA","GTCATCA","CTGA",2.37357278789104,21,5,9,44,2.34858436457467,4.54310073762873,7.70003655543411,101,"ENSG00000079974.19"
"16898","ENSG00000152583.13_21819",21811,21819,9,"ENSG00000152583.13",1,6,"VVVVVMUVV",1,7,0.788819875776397,64,70,86,89,95,101,133,136,"ATGATTA","CTGA","CTGTTCA","CTTA",2.4400245025245,16,6,32,63,1.91204830351095,4.54471958008524,7.69999908319083,101,"ENSG00000079974.19"
"1544","ENSG00000060656.20_19658",19650,19658,9,"ENSG00000060656.20",1,6,"VVVUVMVVV",1,7,0.78343685300207,109,115,133,136,173,179,192,195,"ATGATGC","CAGG","TTGAGGG","CTGA",2.49990876495804,18,37,13,77,1.59894669387792,4.56625128173288,7.69999869374116,101,"ENSG00000079974.19"
"11768","ENSG00000136002.20_16349",16341,16349,9,"ENSG00000136002.20",1,2,"UMVVVUVVV",2,6,0.708902691511387,107,113,133,136,141,147,159,162,"GTGATGG","CAGA","CTGGTGG","CTGA",2.56101787983921,20,5,12,46,2.38399991109327,4.86436311083867,7.69997387688422,101,"ENSG00000079974.19"
"12156","ENSG00000137491.15_42514",42506,42514,9,"ENSG00000137491.15",1,1,"MVVVVVUVV",1,7,0.792132505175983,102,108,133,136,164,170,178,181,"ATGATGT","GAGA","CTGAATA","CTGA",2.5350549505582,25,28,8,70,1.22527199467838,4.53140958293327,7.6999396036372,101,"ENSG00000079974.19"
"33138","ENSG00000228804.5_6054",6046,6054,9,"ENSG00000228804.5",1,2,"UMVVVUVVV",2,6,0.708902691511387,112,118,133,136,167,173,197,200,"GTGATGA","CTGG","GTCATGA","CTGA",2.7287146825401,15,31,24,79,1.26579331103713,4.86430613199278,7.69991689803833,101,"ENSG00000079974.19"
"5033","ENSG00000102780.17_216475",216467,216475,9,"ENSG00000102780.17",1,2,"UMVVVVVVV",1,7,0.786749482401656,112,118,133,136,138,144,152,155,"TTGATGA","AGGA","ATGCTGA","GTGA",2.34451489462726,15,2,8,34,2.58157395972986,4.55291831431123,7.69991624391786,101,"ENSG00000079974.19"
"34823","ENSG00000234213.1_638",630,638,9,"ENSG00000234213.1",1,2,"UMVVVVVVV",1,7,0.786749482401656,112,118,133,136,138,144,152,155,"TTGATGA","AGGA","ATGCTGA","GTGA",2.34451489462726,15,2,8,34,2.58157395972986,4.55291831431123,7.69991624391786,101,"ENSG00000079974.19"
"2059","ENSG00000069667.16_46854",46846,46854,9,"ENSG00000069667.16",1,6,"VVVVVMUVV",1,7,0.788819875776397,110,116,133,136,145,151,197,200,"GTGATGG","TTGC","ATGTAGA","CTGA",2.47005218792703,17,9,46,81,1.71152620198172,4.54463519704047,7.69991470014606,101,"ENSG00000079974.19"
"27711","ENSG00000187210.14_87318",87310,87318,9,"ENSG00000187210.14",1,2,"VMVVVVUVV",1,7,0.770186335403727,81,87,105,108,114,120,133,136,"GTGTTGA","CTGA","GTTGTGA","ATGA",2.38548637545197,18,6,13,46,2.57340124586314,4.61916093721907,7.69990627883398,101,"ENSG00000079974.19"
"42350","ENSG00000261742.6_154128",154120,154128,9,"ENSG00000261742.6",1,8,"UVVVVVVMV",1,7,0.786749482401656,61,67,81,84,115,121,133,136,"GTAATGA","CTGA","GTGAGAA","CAGA",2.43708334383506,14,31,12,66,1.96439936790042,4.55290541503354,7.69990334464017,101,"ENSG00000079974.19"
"4391","ENSG00000100393.15_10140",10132,10140,9,"ENSG00000100393.15",1,1,"MVVVVUUVV",2,6,0.714285714285714,110,116,133,136,147,153,168,171,"AAGATGG","TTGA","ATGATCA","CTGA",2.54449295869369,17,11,15,52,2.40746880583347,4.84268879928119,7.69983165642405,101,"ENSG00000079974.19"
"12273","ENSG00000137766.18_88589",88581,88589,9,"ENSG00000137766.18",1,8,"UVVVVVVMV",1,7,0.786749482401656,74,80,106,109,113,119,133,136,"GAGATGA","CTGA","TTGAGGA","CTGT",2.45526662929186,26,4,14,53,1.84287439592772,4.55282964780169,7.69982757740832,101,"ENSG00000079974.19"
"32064","ENSG00000225755.2_1393",1385,1393,9,"ENSG00000225755.2",1,2,"UMVVVVVVV",1,7,0.786749482401656,98,104,133,136,168,174,186,189,"CTGGTGA","CAGA","ATGAGGA","CTGA",2.57389958652826,29,32,12,82,1.05192044006109,4.55281275422904,7.69981068383566,101,"ENSG00000079974.19"
"22364","ENSG00000170396.9_216546",216538,216546,9,"ENSG00000170396.9",1,3,"UVMVVVVVV",1,7,0.785507246376811,105,111,133,136,143,149,161,164,"TTGATCA","CAAA","CTCATGA","CTGA",2.39028762146679,22,7,12,50,2.29584283740129,4.55777341179497,7.69980239730222,101,"ENSG00000079974.19"
"20673","ENSG00000165309.14_102657",102649,102657,9,"ENSG00000165309.14",1,8,"VVVVUUVMV",2,6,0.696066252587992,115,121,133,136,143,149,157,160,"TTGTTGG","CTGA","ATGGTGT","CTGA",2.4868900083923,12,7,8,36,3.08286607336289,4.91553319899456,7.69979820934652,101,"ENSG00000079974.19"
"47879","ENSG00000289565.1_7396",7388,7396,9,"ENSG00000289565.1",1,6,"VVVVUMVVV",1,7,0.792546583850932,109,115,133,136,147,153,180,183,"AGGATGA","GTTA","CTGATTC","CTGA",2.46200195526062,18,11,27,65,1.70500483449992,4.52958780072602,7.69977413612975,101,"ENSG00000079974.19"
"38567","ENSG00000250437.1_76953",76945,76953,9,"ENSG00000250437.1",1,5,"UVVVMVVVV",1,7,0.789233954451346,108,114,133,136,184,190,199,202,"AAGCTGA","ATGA","TTGATGG","CTGA",2.48917501572124,19,48,9,85,1.57682428076534,4.54283109639341,7.69976691419879,101,"ENSG00000079974.19"
"26203","ENSG00000183662.12_431567",431559,431567,9,"ENSG00000183662.12",1,1,"MVVVUVVVV",1,7,0.795859213250517,76,82,97,100,112,118,133,136,"AGGATCA","GTGT","ATGCAGA","CTGA",2.33585222745124,15,12,15,51,2.49290068452352,4.51631221688295,7.69974906988502,101,"ENSG00000079974.19"
"35529","ENSG00000236242.1_13153",13145,13153,9,"ENSG00000236242.1",1,8,"UVVVVVVMV",1,7,0.786749482401656,76,82,101,104,112,118,133,136,"AAGATGA","GTGA","GTGGGGA","CTAA",2.37448545346382,19,8,15,51,2.38104187765839,4.55273622518763,7.69973415479425,101,"ENSG00000079974.19"
"30400","ENSG00000204929.13_152563",152555,152563,9,"ENSG00000204929.13",1,7,"VVVUVVMVV",1,7,0.766045548654244,43,49,90,93,102,108,133,136,"ATAATGA","CTCA","TGGATGA","CTGA",2.59762600849779,41,9,25,84,1.22466788923359,4.63554365313805,7.69972584775503,101,"ENSG00000079974.19"
"7168","ENSG00000113100.10_58954",58946,58954,9,"ENSG00000113100.10",1,1,"MVVVVUVVV",1,7,0.82815734989648,110,116,133,136,144,150,206,209,"ATGTTGA","CTAT","ATATTGT","CTGA",2.37092036632603,17,8,56,90,1.74218315833386,4.38707973346019,7.69970913304611,101,"ENSG00000079974.19"
"38342","ENSG00000250033.5_109433",109425,109433,9,"ENSG00000250033.5",1,1,"MVVVVUVVV",1,7,0.82815734989648,112,118,133,136,180,186,207,210,"GTTATGA","CAGT","ATGATTT","CTGA",2.42626714508012,15,44,21,89,1.37305636541106,4.38704266648629,7.69967206607222,101,"ENSG00000079974.19"
"34545","ENSG00000233369.7_34106",34098,34106,9,"ENSG00000233369.7",0,NA,"VVVVUVUVV",2,7,0.775983436853002,60,66,83,86,96,102,133,136,"CTCATGC","CTGA","CTGAGGG","CTGA",2.49338033340327,17,10,31,67,1.76036662155979,4.5957255443954,7.6996592918074,101,"ENSG00000079974.19"
"42440","ENSG00000263001.8_92195",92187,92195,9,"ENSG00000263001.8",0,NA,"VVVVUVUVV",2,7,0.775983436853002,60,66,83,86,96,102,133,136,"CTCATGC","CTGA","CTGAGGG","CTGA",2.49338033340327,17,10,31,67,1.76036662155979,4.5957255443954,7.6996592918074,101,"ENSG00000079974.19"
"44036","ENSG00000277053.5_13628",13620,13628,9,"ENSG00000277053.5",0,NA,"VVVVUVUVV",2,7,0.775983436853002,60,66,83,86,96,102,133,136,"CTCATGC","CTGA","CTGAGGG","CTGA",2.49338033340327,17,10,31,67,1.76036662155979,4.5957255443954,7.6996592918074,101,"ENSG00000079974.19"
"48287","ENSG00000290871.1_34060",34052,34060,9,"ENSG00000290871.1",0,NA,"VVVVUVUVV",2,7,0.775983436853002,60,66,83,86,96,102,133,136,"CTCATGC","CTGA","CTGAGGG","CTGA",2.49338033340327,17,10,31,67,1.76036662155979,4.5957255443954,7.6996592918074,101,"ENSG00000079974.19"
"25036","ENSG00000179242.16_204418",204410,204418,9,"ENSG00000179242.16",1,1,"MVVVVUVVV",1,7,0.82815734989648,114,120,133,136,145,151,203,206,"CTGAGGA","CTTG","CAGAAGA","CTGA",2.34005832692838,13,9,52,83,1.94772618826108,4.38702875861257,7.6996581581985,101,"ENSG00000079974.19"
"43706","ENSG00000273272.2_1781",1773,1781,9,"ENSG00000273272.2",1,1,"MVVVVVUVV",1,7,0.792132505175983,79,85,99,102,108,114,133,136,"CAGATGA","CTGA","ACGCTGA","ATGA",2.33993787176127,14,6,19,48,2.52482412095374,4.53110248317388,7.69963250387781,101,"ENSG00000079974.19"
"19617","ENSG00000163492.16_170789",170781,170789,9,"ENSG00000163492.16",1,2,"VMVVVVUVV",1,7,0.770186335403727,111,117,133,136,143,149,158,161,"ATTAAGA","TTAA","GTGACTA","CTGA",2.34221497625635,16,7,9,41,2.86068301322478,4.6188623804001,7.69960772201501,101,"ENSG00000079974.19"
"27328","ENSG00000185973.12_175010",175002,175010,9,"ENSG00000185973.12",1,3,"VVMVVUVVV",1,7,0.804968944099379,89,95,106,109,114,120,133,136,"ACTATGC","CTGA","CTGAAGA","CTCA",2.25505681748514,11,5,13,38,2.88521413468769,4.47973156281383,7.69960733921134,101,"ENSG00000079974.19"
"9084","ENSG00000122574.12_94698",94690,94698,9,"ENSG00000122574.12",1,2,"VMVVVVUVV",1,7,0.770186335403727,99,105,133,136,141,147,160,163,"CTGATGA","CTGA","GTGAATC","CTGT",2.48202692655101,28,5,13,55,1.92859536160333,4.61886038465251,7.69960572626742,101,"ENSG00000079974.19"
"33985","ENSG00000231689.3_270069",270061,270069,9,"ENSG00000231689.3",1,5,"VVVVMUVVV",1,7,0.808695652173913,111,117,133,136,138,144,154,157,"GTGATAA","CAGG","GAAGTGA","CTGA",2.3125932406299,16,2,10,37,2.44195526195229,4.46481088320457,7.69959349190022,101,"ENSG00000079974.19"
"37176","ENSG00000245768.7_295794",295786,295794,9,"ENSG00000245768.7",0,NA,"UVVVVUVVV",2,7,0.824844720496894,114,120,133,136,153,159,175,178,"AGCATGA","GTCA","GTTTTGA","CTGA",2.31277844475875,13,17,16,55,2.18230537225667,4.40020708432875,7.69958596631633,101,"ENSG00000079974.19"
"25018","ENSG00000179136.8_81812",81804,81812,9,"ENSG00000179136.8",1,5,"VVVUMVVVV",1,7,0.767287784679089,115,121,133,136,144,150,172,175,"ATGATGA","CAGA","GGTAGGA","CTCA",2.41902285101792,12,8,22,51,2.39486190421808,4.63042022775106,7.69957136646741,101,"ENSG00000079974.19"
"10610","ENSG00000131845.15_8229",8221,8229,9,"ENSG00000131845.15",1,3,"UVMVVVVVV",1,7,0.785507246376811,87,93,106,109,116,122,133,136,"ATGATTA","CTGC","GTAAAGT","CTGT",2.28232866470116,13,7,11,40,3.01450882069823,4.55750831300983,7.69953729851707,101,"ENSG00000079974.19"
"22021","ENSG00000169621.11_123766",123758,123766,9,"ENSG00000169621.11",1,5,"VVUVMVVVV",1,7,0.770186335403727,100,106,133,136,141,147,163,166,"ATGCTGT","ATGA","ATGAGGC","CTGA",2.50237948033052,27,5,16,57,1.79262961981597,4.61878987217153,7.69953521378644,101,"ENSG00000079974.19"
"10265","ENSG00000130305.17_2373",2365,2373,9,"ENSG00000130305.17",0,NA,"VVVVUUVVV",2,7,0.812008281573499,114,120,133,136,145,151,162,165,"AGGTTGA","CTAA","CTGATGC","CTGC",2.22847573415352,13,9,11,42,2.94939053734931,4.45147385792653,7.69950698422053,101,"ENSG00000079974.19"
"23933","ENSG00000174482.11_286673",286665,286673,9,"ENSG00000174482.11",0,NA,"UVVUVVVVV",2,7,0.78343685300207,106,112,133,136,143,149,162,165,"ATTTTGA","CTCA","GTGACAT","CTGA",2.38999223234337,21,7,13,50,2.32968541968188,4.56574174215942,7.69948915416771,101,"ENSG00000079974.19"
"19102","ENSG00000161267.12_48906",48898,48906,9,"ENSG00000161267.12",1,7,"VVVVVUMVV",1,7,0.807453416149068,83,89,133,136,156,162,173,176,"ATGATGT","TTCA","CGGAGGA","CTGA",2.49217988290607,44,20,11,84,1.26416192029303,4.46967361825004,7.69948728284631,101,"ENSG00000079974.19"
"11735","ENSG00000135945.10_24173",24165,24173,9,"ENSG00000135945.10",1,2,"UMVVVVVVV",1,7,0.786749482401656,113,119,133,136,137,143,152,155,"GTGTTGT","CTCA","TAGATCA","CTGA",2.35701340621661,14,1,9,33,2.49647750791415,4.55247505400622,7.69947298361285,101,"ENSG00000079974.19"
"435","ENSG00000011376.12_97027",97019,97027,9,"ENSG00000011376.12",1,8,"VVVVVUVMV",1,7,0.806211180124224,116,122,133,136,144,150,170,173,"ACAATTA","CAGA","GTGCTTA","CTGA",2.31282121148773,11,8,20,48,2.47968242405704,4.47462262516047,7.69946734565737,101,"ENSG00000079974.19"
"43151","ENSG00000269405.7_47095",47087,47095,9,"ENSG00000269405.7",0,NA,"VVVVUUVVV",2,7,0.812008281573499,53,59,72,75,79,85,133,136,"AGGATTA","AAGA","CTGTTGA","CTGA",2.39528012066488,13,4,48,74,1.83719715192023,4.45143282242153,7.69946594871553,101,"ENSG00000079974.19"
"4517","ENSG00000100815.12_7489",7481,7489,9,"ENSG00000100815.12",0,NA,"UVVVVVUVV",2,7,0.788819875776397,104,110,133,136,142,148,161,164,"ATGAAGA","GTTA","ATAAAGC","CTGA",2.40004614359151,23,6,13,51,2.17641568243738,4.54418082659519,7.69946032970078,101,"ENSG00000079974.19"
"26080","ENSG00000183230.18_942937",942929,942937,9,"ENSG00000183230.18",1,2,"VMVVVUVVV",1,7,0.806211180124223,58,64,71,74,83,89,133,136,"ATTATGA","CTGA","GTAATTA","CTCA",2.44905489107037,7,9,44,69,1.57137188356343,4.47460112267481,7.69944584317171,101,"ENSG00000079974.19"
"34100","ENSG00000231912.2_5800",5792,5800,9,"ENSG00000231912.2",1,6,"VVVVVMUVV",1,7,0.788819875776397,114,120,133,136,148,154,162,165,"TTGATGT","CTGA","ATATTTA","CTCA",2.31263885700526,13,12,8,42,2.75903702750799,4.54415735188576,7.69943685499135,101,"ENSG00000079974.19"
"6478","ENSG00000110080.20_45280",45272,45280,9,"ENSG00000110080.20",0,NA,"VVVUUVVVV",2,7,0.770600414078675,106,112,133,136,153,159,173,176,"ATGATGC","TTGC","ATGAGCA","CTGA",2.51382924833253,21,17,14,61,1.70926082686628,4.61703062060411,7.69943227691881,101,"ENSG00000079974.19"
"45825","ENSG00000285939.2_731518",731510,731518,9,"ENSG00000285939.2",1,8,"VVVVVUVMV",1,7,0.806211180124224,82,88,103,106,115,121,133,136,"GTGACAA","TAGA","GTGAATT","CTGA",2.26112575346548,15,9,12,45,2.82414445701873,4.47457903669715,7.69942375719405,101,"ENSG00000079974.19"
"33815","ENSG00000231226.1_1503",1495,1503,9,"ENSG00000231226.1",1,1,"MVVVVUUVV",2,6,0.714285714285714,115,121,133,136,143,149,181,184,"CTGATGA","CTGG","TTATTGA","CTGA",2.59178843466202,12,7,32,60,2.09048802973514,4.84226939853715,7.69941225568,101,"ENSG00000079974.19"
"18642","ENSG00000157985.20_455337",455329,455337,9,"ENSG00000157985.20",0,NA,"UVVVUVVVV",2,7,0.792546583850932,82,88,97,100,109,115,133,136,"ATGATAA","CTGG","ATGAAGT","CTGC",2.35319467657285,9,9,18,45,2.42892777464298,4.52922307128215,7.69940940668588,101,"ENSG00000079974.19"
"20856","ENSG00000165891.16_42497",42489,42497,9,"ENSG00000165891.16",0,NA,"UVVVVUVVV",2,7,0.824844720496894,114,120,133,136,154,160,178,181,"ATCAGGA","ATTA","TGGATGA","CTGA",2.33935415668585,13,18,18,58,2.00442701066667,4.40003034714308,7.69940922913066,101,"ENSG00000079974.19"
"13746","ENSG00000143341.12_395443",395435,395443,9,"ENSG00000143341.12",1,8,"VVUVVVVMV",1,7,0.767701863354037,111,117,133,136,145,151,166,169,"ATGAAGA","CTCT","GTCATCT","CTGA",2.38609077708608,16,9,15,49,2.60676869659968,4.62851013596005,7.6993175893762,101,"ENSG00000079974.19"
"31061","ENSG00000215418.2_706",698,706,9,"ENSG00000215418.2",1,8,"VVVVVUVMV",1,7,0.806211180124224,106,112,133,136,140,146,154,157,"AAGATGA","GTGA","ATGTTGC","CTGT",2.34791088782675,21,4,8,42,2.24513148273467,4.47446768372825,7.69931240422515,101,"ENSG00000079974.19"
"21596","ENSG00000168434.13_25386",25378,25386,9,"ENSG00000168434.13",1,2,"VMVVUVVVV",1,7,0.773913043478261,99,105,133,136,146,152,199,202,"CTGATGA","TTGG","GTGATGG","CTGA",2.61503539877256,28,10,47,94,0.981032258784818,4.60365039598381,7.69930256989685,101,"ENSG00000079974.19"
"47617","ENSG00000288720.2_43807",43799,43807,9,"ENSG00000288720.2",1,1,"MVVVUVVVV",1,7,0.795859213250517,115,121,133,136,168,174,184,187,"ATGAAGA","ATGC","ATGCTCC","CTGA",2.40420780681919,12,32,10,63,2.03532828727407,4.51584508318384,7.69928193618591,101,"ENSG00000079974.19"
"13666","ENSG00000143147.15_33441",33433,33441,9,"ENSG00000143147.15",1,2,"VMVVVUVVV",1,7,0.806211180124223,110,116,133,136,151,157,209,212,"AAAATAA","CTGA","ATGAAGA","CTGA",2.48809759388888,17,15,52,93,1.31038826040499,4.47442638824938,7.69927110874627,101,"ENSG00000079974.19"
"32026","ENSG00000225689.2_129523",129515,129523,9,"ENSG00000225689.2",1,2,"VMVVVUVVV",1,7,0.806211180124223,77,83,91,94,106,112,133,136,"TTTATGA","CTGA","GTGAGGC","CTGG",2.39094030736806,8,12,21,50,1.95804250583224,4.47441113873816,7.69925585923505,101,"ENSG00000079974.19"
"5273","ENSG00000104237.11_132346",132338,132346,9,"ENSG00000104237.11",1,5,"VVUVMVVVV",1,7,0.770186335403727,85,91,133,136,142,148,160,163,"ATAATGA","CCGT","GTGCTTA","CTGA",2.47969882756216,42,6,12,69,1.94253334696682,4.61846471601197,7.69921005762688,101,"ENSG00000079974.19"
"12656","ENSG00000138759.20_433820",433812,433820,9,"ENSG00000138759.20",1,5,"UVVVMVVVV",1,7,0.789233954451346,80,86,103,106,111,117,133,136,"CTCAAGA","TTGA","CTGAATA","CTGA",2.35819219957183,17,5,16,47,2.44775496710294,4.54225907439546,7.69919489220084,101,"ENSG00000079974.19"
"22583","ENSG00000170921.16_160739",160731,160739,9,"ENSG00000170921.16",0,NA,"UVUVVVVVV",2,7,0.786335403726708,115,121,133,136,151,157,165,168,"GTTATAA","CTGC","CTGCTTA","CTGA",2.35086774169781,12,15,8,44,2.54282906144387,4.55382016819065,7.69916178309748,101,"ENSG00000079974.19"
"2789","ENSG00000078295.17_304445",304437,304445,9,"ENSG00000078295.17",1,1,"MVVVVUVVV",1,7,0.82815734989648,114,120,133,136,168,174,182,185,"AGGATTA","CTTT","GTGTTGG","CTGA",2.33026853523715,13,32,8,62,2.01096613013248,4.38652242459504,7.69915182418096,101,"ENSG00000079974.19"
"1151","ENSG00000048342.18_118033",118025,118033,9,"ENSG00000048342.18",1,1,"MVVVUVVVV",1,7,0.795859213250517,102,108,133,136,140,146,159,162,"GTAATTA","CTGG","TTGATGG","CTGA",2.42005588921961,25,4,13,51,1.92912014379699,4.51570651798193,7.699143370984,101,"ENSG00000079974.19"
"19247","ENSG00000162618.15_67119",67111,67119,9,"ENSG00000162618.15",1,2,"VMUVVVVVV",1,7,0.767701863354037,115,121,133,136,144,150,169,172,"GAGATGA","ATGC","GTGTAGC","CTGA",2.39237513787643,12,8,19,48,2.56391001398769,4.62826939995764,7.69907685337379,101,"ENSG00000079974.19"
"9708","ENSG00000126733.22_355200",355192,355200,9,"ENSG00000126733.22",1,7,"UVVVVVMVV",1,7,0.787991718426501,116,122,133,136,144,150,161,164,"ATGGTGA","CTCA","ATGTAAA","CTTA",2.27944506890057,11,8,11,39,2.99201626321764,4.54707918063869,7.69904605434469,101,"ENSG00000079974.19"
"5551","ENSG00000105810.10_42326",42318,42326,9,"ENSG00000105810.10",1,1,"MVVUVVVVV",1,7,0.786749482401656,101,107,133,136,151,157,167,170,"ATGATGG","TTAA","ATTATTA","CTGA",2.47812049848641,26,15,10,60,1.6873707895819,4.55204352820616,7.69904145781278,101,"ENSG00000079974.19"
"24546","ENSG00000176783.15_45610",45602,45610,9,"ENSG00000176783.15",1,1,"MVVVVUVVV",1,7,0.82815734989648,73,79,98,101,105,111,133,136,"GTGATGG","CTGT","GTGAAGT","ATGA",2.3584694330597,19,4,22,54,1.82227837807104,4.38635198295059,7.69898138253651,101,"ENSG00000079974.19"
"22366","ENSG00000170396.9_232043",232035,232043,9,"ENSG00000170396.9",1,6,"VVVVVMUVV",1,7,0.788819875776397,112,118,133,136,146,152,190,193,"ATAAGGA","ATGA","ATGCTAA","CTGA",2.45049085476071,15,10,38,72,1.83791983010651,4.5436313821278,7.69891088523339,101,"ENSG00000079974.19"
"15213","ENSG00000147324.11_91636",91628,91636,9,"ENSG00000147324.11",1,3,"VVMUVVVVV",1,7,0.763561076604555,112,118,133,136,149,155,194,197,"ATGATGG","CGCA","CTGATAA","CTGA",2.54249361691147,15,13,39,76,1.62855883284557,4.64462906973051,7.69887337614872,101,"ENSG00000079974.19"
"33439","ENSG00000229846.2_157381",157373,157381,9,"ENSG00000229846.2",1,5,"UVVVMVVVV",1,7,0.789233954451346,89,95,107,110,116,122,133,136,"ATGATGC","ATAA","ATGAAGG","CTAA",2.27071530673806,12,6,11,38,3.02956426608759,4.541916577752,7.69885239555738,101,"ENSG00000079974.19"
"10250","ENSG00000130158.14_26944",26936,26944,9,"ENSG00000130158.14",1,2,"VMVVVUVVV",1,7,0.806211180124223,112,118,133,136,137,143,151,154,"ATGGTGA","CTGT","GAGACGA","CTGG",2.32085172285024,15,1,8,33,2.42358477214728,4.47398239778723,7.69882711828412,101,"ENSG00000079974.19"
"26395","ENSG00000184156.17_317386",317378,317386,9,"ENSG00000184156.17",1,8,"VVVUVVVMV",1,7,0.764803312629399,94,100,109,112,113,119,133,136,"TGGATGA","ATGA","ATGACTG","CTGA",2.44753179345875,9,1,14,33,2.24157232784927,4.63961273772691,7.69882598824451,101,"ENSG00000079974.19"
"5335","ENSG00000104331.9_2979",2971,2979,9,"ENSG00000104331.9",1,1,"MVVVVUVVV",1,7,0.82815734989648,115,121,133,136,156,162,172,175,"ATGTAAA","CTGT","ATGTAGA","CTGA",2.28991434801952,12,20,10,51,2.27861959164014,4.3861788112759,7.69880821086182,101,"ENSG00000079974.19"
"291","ENSG00000007350.17_7975",7967,7975,9,"ENSG00000007350.17",1,8,"VVUVVVVMV",1,7,0.767701863354037,61,67,82,85,99,105,133,136,"ATAATGA","CTCA","GAGAGCA","CTGA",2.52076790038968,15,14,28,66,1.70679129313877,4.6279776572675,7.69878511068365,101,"ENSG00000079974.19"
"10393","ENSG00000130783.14_24731",24723,24731,9,"ENSG00000130783.14",0,NA,"VVUVVUVVV",2,7,0.805797101449275,57,63,103,106,116,122,133,136,"GTCATGA","CTGA","CTGTTGT","TTGA",2.40254607506614,40,10,11,70,1.88541003320376,4.47559596674451,7.69878437254161,101,"ENSG00000079974.19"
"7516","ENSG00000114541.15_249200",249192,249200,9,"ENSG00000114541.15",0,NA,"VVUVUVVVV",2,7,0.773498964803312,70,76,93,96,109,115,133,136,"ATGTTAA","CTCA","GTGAGGC","CTGA",2.45008600201283,17,13,18,57,2.08519719638662,4.60477596911804,7.69877182833129,101,"ENSG00000079974.19"
"48308","ENSG00000290926.1_20250",20242,20250,9,"ENSG00000290926.1",0,NA,"UVVVVUVVV",2,7,0.824844720496894,76,82,96,99,105,111,133,136,"ATCATGC","CTAA","ATGAAGA","CTGG",2.28624131270465,14,6,22,51,2.35577601118412,4.39934619063712,7.6987250726247,101,"ENSG00000079974.19"
"8214","ENSG00000117419.16_38706",38698,38706,9,"ENSG00000117419.16",1,8,"VVVVVUVMV",1,7,0.806211180124224,107,113,133,136,137,143,157,160,"GAGATAA","CTGG","ATGCTGA","CTGA",2.42990194293034,20,1,14,44,1.69611957936223,4.47386646639113,7.69871118688802,101,"ENSG00000079974.19"
"8935","ENSG00000121766.16_19994",19986,19994,9,"ENSG00000121766.16",1,6,"VVUVVMVVV",1,7,0.786335403726708,105,111,133,136,145,151,168,171,"ATGATGA","CTGG","GTCAAGG","CTAA",2.43423665289865,22,9,17,57,1.98521013848261,4.55336362278507,7.69870523769191,101,"ENSG00000079974.19"
"13461","ENSG00000141458.13_4639",4631,4639,9,"ENSG00000141458.13",0,NA,"UVVVUVVVV",2,7,0.792546583850932,112,118,133,136,160,166,180,183,"ATGGTAA","CTCA","ATGGAGA","CTGA",2.42798200184117,15,24,14,62,1.9275043473159,4.52851275656426,7.69869909196798,101,"ENSG00000079974.19"
"14307","ENSG00000144668.12_128724",128716,128724,9,"ENSG00000144668.12",1,1,"MVVVVUVVV",1,7,0.82815734989648,116,122,133,136,144,150,170,173,"AGGTTGA","CTTG","GTGTCCA","CTGA",2.25967461753091,11,8,20,48,2.47968242405704,4.38604496856578,7.6986743681517,101,"ENSG00000079974.19"
"5197","ENSG00000103852.13_31483",31475,31483,9,"ENSG00000103852.13",1,6,"VVVVVMUVV",1,7,0.788819875776397,52,58,72,75,82,88,133,136,"AAGATGG","GTGA","GTGGTTG","CTGA",2.43034584067455,14,7,45,75,1.97123367410731,4.54338481965108,7.69866432275667,101,"ENSG00000079974.19"
"266","ENSG00000007174.18_104332",104324,104332,9,"ENSG00000007174.18",0,NA,"UVVVVUVVV",2,7,0.824844720496894,106,112,133,136,149,155,187,190,"CTGAGGA","TTCA","GTGATGG","CTGA",2.46041728491641,21,13,32,75,1.19435189319704,4.39928344815994,7.69866233014752,101,"ENSG00000079974.19"
"28842","ENSG00000196569.14_57940",57932,57940,9,"ENSG00000196569.14",1,7,"VVVUVVMVV",1,7,0.766045548654244,115,121,133,136,149,155,170,173,"AGGAAGA","ATGA","ATGGGGC","CTGA",2.40376039547291,12,13,15,49,2.51260178087105,4.63441777100594,7.69859996562292,101,"ENSG00000079974.19"
"25291","ENSG00000180438.15_77664",77656,77664,9,"ENSG00000180438.15",1,3,"UVMVVUVVV",2,6,0.707660455486542,89,95,133,136,143,149,161,164,"CTGATGA","CTGT","CTGTTAA","CTGA",2.62662029797088,38,7,12,66,1.96101275684839,4.86795368583023,7.6985955077764,101,"ENSG00000079974.19"
"45424","ENSG00000285572.2_124481",124473,124481,9,"ENSG00000285572.2",1,2,"VMVVVUVVV",1,7,0.806211180124223,113,119,133,136,144,150,174,177,"GTTATGC","GTGA","ATTTAGA","CTGA",2.34458849502615,14,8,24,55,2.26438637022738,4.47374408426709,7.69858880476399,101,"ENSG00000079974.19"
"29374","ENSG00000197872.11_22295",22287,22295,9,"ENSG00000197872.11",0,NA,"VVVUVUVVV",2,7,0.802898550724638,56,62,88,91,96,102,133,136,"ATGCTCA","CTGA","AAGCTGA","CTGA",2.51633727278796,26,5,31,71,1.172231203707,4.48695325557335,7.6985474584719,101,"ENSG00000079974.19"
"25022","ENSG00000179213.14_22776",22768,22776,9,"ENSG00000179213.14",0,NA,"UVVVVVUVV",2,7,0.788819875776397,112,118,133,136,149,155,174,177,"GTGGAGA","CTGT","GTGAGAA","CTGA",2.39912185960662,15,13,19,56,2.1789172186468,4.5432657373394,7.69854524044499,101,"ENSG00000079974.19"
"31314","ENSG00000223342.2_12357",12349,12357,9,"ENSG00000223342.2",0,NA,"VVVVUVUVV",2,7,0.775983436853002,96,102,133,136,158,164,180,183,"GTGGTGA","CTAA","GTGAGGA","CTGA",2.60762356298599,31,22,16,78,0.994164630002269,4.59458042914388,7.69851417655588,101,"ENSG00000079974.19"
"7729","ENSG00000115464.15_96802",96794,96802,9,"ENSG00000115464.15",0,NA,"UVVVUVVVV",2,7,0.792546583850932,86,92,101,104,113,119,133,136,"ATGGAGA","CTGA","GTGGTGG","CTGG",2.31462936781171,9,9,14,41,2.68236905385569,4.52830787648343,7.69849421188716,101,"ENSG00000079974.19"
"3857","ENSG00000089472.18_77424",77416,77424,9,"ENSG00000089472.18",1,7,"VVUVVVMVV",1,7,0.768944099378882,64,70,89,92,112,118,133,136,"ATAATGA","CTGA","ATGATTA","CTAA",2.52282370222451,19,20,15,63,1.67192770639014,4.62268809697171,7.69846449448724,101,"ENSG00000079974.19"
"6886","ENSG00000112195.9_1194",1186,1194,9,"ENSG00000112195.9",1,6,"VVVVVMUVV",1,7,0.788819875776397,100,106,133,136,173,179,193,196,"AGCATGA","CTGA","GTGGTGC","CTGA",2.5777602209655,27,37,14,87,0.987522769865575,4.54314772740889,7.69842723051448,101,"ENSG00000079974.19"
"6683","ENSG00000111404.7_151125",151117,151125,9,"ENSG00000111404.7",1,2,"VMVVUVVVV",1,7,0.773913043478261,71,77,98,101,109,115,133,136,"ATTATCA","CAGA","CTGAGGT","CTGA",2.45678733710523,21,8,18,56,2.0325051320689,4.60277184485927,7.69842401877232,101,"ENSG00000079974.19"
"11138","ENSG00000134030.14_149108",149100,149108,9,"ENSG00000134030.14",1,2,"VMVVVUVVV",1,7,0.806211180124223,112,118,133,136,148,154,164,167,"GTGATAA","CAGA","TTGAGGC","CTGT",2.28222362441078,15,12,10,46,2.67942335938739,4.47356188053149,7.69840660102838,101,"ENSG00000079974.19"
"33348","ENSG00000229425.5_169896",169888,169896,9,"ENSG00000229425.5",0,NA,"VVUUVVVVV",2,7,0.764389233954451,83,89,100,103,112,118,133,136,"ATGATTT","CTGA","CTAATGA","CTGG",2.37176973859887,11,9,15,44,2.75117389582503,4.6407430382877,7.69829997410551,101,"ENSG00000079974.19"
"10017","ENSG00000128829.12_47408",47400,47408,9,"ENSG00000128829.12",1,2,"VMVVVUVVV",1,7,0.806211180124223,116,122,133,136,178,184,196,199,"TTGATGG","CCAA","ATGATTC","CTGA",2.39340363895427,11,42,12,74,1.93775692047186,4.47344529504175,7.69829001553864,101,"ENSG00000079974.19"
"24074","ENSG00000175093.5_15923",15915,15923,9,"ENSG00000175093.5",1,5,"UVVVMVVVV",1,7,0.789233954451346,69,75,87,90,116,122,133,136,"GTGACAA","CTGC","TTGATAA","CTGA",2.41125059279167,12,26,11,58,2.09023957960891,4.54131088288834,7.69824670069372,101,"ENSG00000079974.19"
"11724","ENSG00000135913.11_23533",23525,23533,9,"ENSG00000135913.11",1,2,"UMVVVVVVV",1,7,0.786749482401656,114,120,133,136,185,191,212,215,"ATAATCA","CTGT","GTGATAA","CTGA",2.5121896512868,13,49,21,92,1.45703538789772,4.55124159911909,7.69823952872571,101,"ENSG00000079974.19"
"40871","ENSG00000258017.3_38054",38046,38054,9,"ENSG00000258017.3",1,2,"VMVUVVVVV",1,7,0.764803312629399,43,49,64,67,108,114,133,136,"TTGAAGA","CTTA","GTGATAA","CTGA",2.55979237982096,15,41,19,84,1.49081883049584,4.6390253406589,7.6982385911765,101,"ENSG00000079974.19"
"1351","ENSG00000054282.16_28174",28166,28174,9,"ENSG00000054282.16",1,1,"MVUVVVVVV",1,7,0.789648033126294,35,41,60,63,95,101,133,136,"CTGATGC","CTGT","TTGATGA","CTGA",2.61840710727489,19,32,32,92,0.702518343072864,4.53964143122637,7.69823356373155,101,"ENSG00000079974.19"
"1451","ENSG00000056586.16_24527",24519,24527,9,"ENSG00000056586.16",1,8,"VVVVVUVMV",1,7,0.806211180124224,114,120,133,136,183,189,206,209,"CAGTTGA","CAGA","ATGAAGA","CTGA",2.4297832577789,13,47,17,86,1.69494543276853,4.47337512115697,7.69821984165387,101,"ENSG00000079974.19"
"24681","ENSG00000177483.12_27701",27693,27701,9,"ENSG00000177483.12",1,6,"UVVVVMVVV",1,7,0.805383022774327,116,122,133,136,139,145,155,158,"ATGATGT","CTTG","ATGTTGC","CAGA",2.25342686121148,11,3,10,33,2.88390446837489,4.47668755244619,7.6982196435435,101,"ENSG00000079974.19"
"1577","ENSG00000061938.21_38853",38845,38853,9,"ENSG00000061938.21",0,NA,"VVVVVUUVV",2,7,0.808281573498965,82,88,133,136,143,149,164,167,"CTGAGGA","CCGG","GTGAAGC","CTGA",2.40645519548029,45,7,15,76,1.81732775432151,4.46509059771419,7.69821689171005,101,"ENSG00000079974.19"
"34689","ENSG00000233797.4_36061",36053,36061,9,"ENSG00000233797.4",1,2,"VMVVVUVVV",1,7,0.806211180124223,76,82,103,106,111,117,133,136,"AAGAGGA","CTGA","ATGATCA","CTAA",2.368983210798,21,5,16,51,2.10026507700415,4.47337162058105,7.69821634107794,101,"ENSG00000079974.19"
"24267","ENSG00000175600.16_584700",584692,584700,9,"ENSG00000175600.16",0,NA,"VVVVUVUVV",2,7,0.775983436853002,92,98,106,109,115,121,133,136,"GTGAAGA","CTGT","GAGATGA","ATGA",2.33585819929594,8,6,12,35,2.80463758214713,4.59425639436335,7.69819014177536,101,"ENSG00000079974.19"
"12571","ENSG00000138653.10_148441",148433,148441,9,"ENSG00000138653.10",1,2,"UMVVVVVVV",1,7,0.786749482401656,29,35,52,55,75,81,133,136,"ATAAAGA","CTGA","TTTATGA","CTGA",2.57549853134716,17,20,52,98,1.03459628244175,4.5511466228557,7.69814455246232,101,"ENSG00000079974.19"
"17554","ENSG00000154429.11_15980",15972,15980,9,"ENSG00000154429.11",1,8,"VVVVVUVMV",1,7,0.806211180124224,48,54,64,67,75,81,133,136,"AGGATGA","CAGA","GTGAAGG","CTTA",2.39779441845061,10,8,52,79,1.9074503913489,4.47318662858825,7.69803134908514,101,"ENSG00000079974.19"
"23949","ENSG00000174482.11_941150",941142,941150,9,"ENSG00000174482.11",1,8,"VVVVVUVMV",1,7,0.806211180124224,113,119,133,136,147,153,170,173,"CTGTTGA","ATGT","GAGATTT","CTGA",2.30932608864492,14,11,17,51,2.49708326756014,4.47314763129823,7.69799235179513,101,"ENSG00000079974.19"
"17895","ENSG00000155761.14_172175",172167,172175,9,"ENSG00000155761.14",1,8,"VVVVVUVMV",1,7,0.806211180124224,115,121,133,136,138,144,153,156,"AGGAGGA","GTAA","GGGCAGA","CTGA",2.26679731855496,12,2,9,32,2.78058107509119,4.47314079969774,7.69798552019463,101,"ENSG00000079974.19"
"35182","ENSG00000235268.2_575",567,575,9,"ENSG00000235268.2",1,8,"VVVVVUVMV",1,7,0.806211180124224,35,41,54,57,100,106,133,136,"ATGATGA","CTTA","GTGTTTA","ATGA",2.50339574443924,13,43,27,92,1.2032343558598,4.47313482969701,7.6979795501939,101,"ENSG00000079974.19"
"40378","ENSG00000255855.2_275",267,275,9,"ENSG00000255855.2",1,8,"VVVVVUVMV",1,7,0.806211180124224,35,41,54,57,100,106,133,136,"ATGATGA","CTTA","GTGTTTA","ATGA",2.50339574443924,13,43,27,92,1.2032343558598,4.47313482969701,7.6979795501939,101,"ENSG00000079974.19"
"29203","ENSG00000197416.5_9344",9336,9344,9,"ENSG00000197416.5",1,1,"MVVVVUVVV",1,7,0.82815734989648,104,110,133,136,182,188,197,200,"TGGATGA","CTGT","GTGCCTA","CTGA",2.44012969877959,23,46,9,87,1.27376622335063,4.38532438713698,7.6979537867229,101,"ENSG00000079974.19"
"6660","ENSG00000111249.14_54487",54479,54487,9,"ENSG00000111249.14",1,8,"VVUVVVVMV",1,7,0.767701863354037,99,105,133,136,137,143,154,157,"ATGATGT","CAGA","GAGCTTA","CTGA",2.56767807743978,28,1,11,49,1.39065458298749,4.6271271081465,7.69793456156265,101,"ENSG00000079974.19"
"34680","ENSG00000233766.8_4972",4964,4972,9,"ENSG00000233766.8",0,NA,"UVVVUVVVV",2,7,0.792546583850932,114,120,133,136,142,148,161,164,"ATGATGT","GAGA","ATAAGGA","ATGA",2.27823786561612,13,6,13,41,2.9227224780417,4.52774372887062,7.69793006427435,101,"ENSG00000079974.19"
"17465","ENSG00000154217.16_196246",196238,196246,9,"ENSG00000154217.16",1,8,"UVVVVVVMV",1,7,0.786749482401656,103,109,133,136,138,144,152,155,"TTGATGA","GAGA","AGGAAGC","CTGA",2.47017703232593,24,2,8,43,1.73578345126629,4.55090758335978,7.69790551296641,101,"ENSG00000079974.19"
"27321","ENSG00000185942.13_667542",667534,667542,9,"ENSG00000185942.13",1,2,"UMVVVVVVV",1,7,0.786749482401656,116,122,133,136,142,148,158,161,"ATAATGT","GTCA","ATATTCA","CTGA",2.27136201730448,11,6,10,36,3.06115136982541,4.55089120463049,7.69788913423711,101,"ENSG00000079974.19"
"29064","ENSG00000197099.8_182939",182931,182939,9,"ENSG00000197099.8",1,2,"VMVVVUVVV",1,7,0.806211180124223,52,58,75,78,83,89,133,136,"AAGATGA","CTGA","ATTATCA","CAGA",2.42949033710215,17,5,44,75,1.69552352533591,4.47303144317089,7.69787616366779,101,"ENSG00000079974.19"
"46793","ENSG00000287177.1_3497",3489,3497,9,"ENSG00000287177.1",0,NA,"UVVVVUVVV",2,7,0.824844720496894,79,85,94,97,113,119,133,136,"ATGATGT","ATGA","ATTTTGC","CTTA",2.30936811530081,9,16,14,48,2.19809677503515,4.39847105259347,7.69784993458105,101,"ENSG00000079974.19"
"9838","ENSG00000127804.13_105601",105593,105601,9,"ENSG00000127804.13",0,NA,"UVVUVVVVV",2,7,0.78343685300207,110,116,133,136,151,157,168,171,"GTGGGGA","CTGT","GTGGGGA","CTGA",2.39419883275125,17,15,11,52,2.29488134099878,4.56405172316845,7.69779913517673,101,"ENSG00000079974.19"
"47294","ENSG00000287949.1_105580",105572,105580,9,"ENSG00000287949.1",1,2,"VMVVVUVVV",1,7,0.806211180124223,112,118,133,136,154,160,173,176,"ATGTTCA","ATAA","GTGAAGT","CTGA",2.35355473941981,15,18,13,55,2.20140392127478,4.47294221268505,7.69778693318194,101,"ENSG00000079974.19"
"35780","ENSG00000237073.1_7724",7716,7724,9,"ENSG00000237073.1",1,2,"VMVVVUVVV",1,7,0.806211180124223,107,113,133,136,144,150,160,163,"GTTAAGA","TTAA","TTGATGG","CTGA",2.31179556381285,20,8,10,47,2.47974673934051,4.47292929118988,7.69777401168677,101,"ENSG00000079974.19"
"31140","ENSG00000216863.11_153746",153738,153746,9,"ENSG00000216863.11",1,8,"VVVVVUVMV",1,7,0.806211180124224,48,54,67,70,78,84,133,136,"ATGAAGG","CAGA","AGGCTCA","CTGA",2.38593765229339,13,8,49,79,1.98531770531818,4.47289218015186,7.69773690064875,101,"ENSG00000079974.19"
"25679","ENSG00000182504.12_35646",35638,35646,9,"ENSG00000182504.12",1,8,"UVVVVVVMV",1,7,0.786749482401656,107,113,133,136,166,172,182,185,"TTGATGG","CTGT","AAGATGT","CTGA",2.49918039114451,20,30,10,69,1.54139903418145,4.55065041045288,7.6976483400595,101,"ENSG00000079974.19"
"29661","ENSG00000198586.14_18688",18680,18688,9,"ENSG00000198586.14",1,1,"MVVVVUVVV",1,7,0.82815734989648,52,58,74,77,83,89,133,136,"TTGATGA","CAGA","TTTATAA","CTTA",2.356383653416,16,6,44,75,1.83077020286839,4.38499863974376,7.69762803932968,101,"ENSG00000079974.19"
"31711","ENSG00000224514.3_54160",54152,54160,9,"ENSG00000224514.3",1,1,"MVVVVVUVV",1,7,0.792132505175983,64,70,81,84,92,98,133,136,"ATGTGGA","GGGA","GTGAGGA","CTGA",2.41528937319511,11,8,35,63,2.01444908562674,4.52909456006521,7.69762458076914,101,"ENSG00000079974.19"
"34401","ENSG00000232973.14_77736",77728,77736,9,"ENSG00000232973.14",1,1,"MVVVVUVVV",1,7,0.82815734989648,116,122,133,136,137,143,156,159,"ATACTGA","CAAA","GTGGTAG","CTGA",2.27304215617087,11,1,13,34,2.38634217617838,4.38498913766271,7.69761853724863,101,"ENSG00000079974.19"
"15180","ENSG00000147251.16_86643",86635,86643,9,"ENSG00000147251.16",1,7,"VVVVUVMVV",1,7,0.775155279503105,106,112,133,136,149,155,176,179,"ATTTTGA","TTGA","ATGAGGA","CTGA",2.52355392686017,21,13,21,64,1.56424522288558,4.59698451715501,7.69760563516743,101,"ENSG00000079974.19"
"46154","ENSG00000286225.1_21024",21016,21024,9,"ENSG00000286225.1",1,1,"MVVVVUVVV",1,7,0.82815734989648,112,118,133,136,139,145,163,166,"ATCATTT","ATGA","TTTATAA","CTGA",2.29309048950484,15,3,18,45,2.25244228304904,4.38492805327032,7.69755745285624,101,"ENSG00000079974.19"
"19205","ENSG00000162517.13_12767",12759,12767,9,"ENSG00000162517.13",1,8,"VVVUVVVMV",1,7,0.764803312629399,114,120,133,136,149,155,207,210,"ATGTAGA","CTGA","AAGATGG","CTGA",2.52930093555094,13,13,52,87,1.69131526471915,4.63833037543135,7.69754362594894,101,"ENSG00000079974.19"
"8062","ENSG00000116688.18_15570",15562,15570,9,"ENSG00000116688.18",1,8,"VVVVVVUMV",1,7,0.770186335403727,116,122,133,136,147,153,174,177,"GTGATGG","GCGA","GTGTAGG","CTGA",2.42949631995016,11,11,21,52,2.2704847633677,4.6167817240922,7.6975270657071,101,"ENSG00000079974.19"
"17406","ENSG00000154122.14_165103",165095,165103,9,"ENSG00000154122.14",1,1,"MVUVVVVVV",1,7,0.789648033126294,55,61,72,75,111,117,133,136,"ATCATGT","CTGA","CTGATGA","CTGT",2.46090401508979,11,36,16,72,1.74969708428058,4.53893096288647,7.69752309539165,101,"ENSG00000079974.19"
"47404","ENSG00000288088.1_193626",193618,193626,9,"ENSG00000288088.1",0,NA,"VVVVVUUVV",2,7,0.808281573498965,84,90,133,136,140,146,192,195,"AAGAGGA","CTGA","ATAAAGA","CTGA",2.55198876099105,43,4,46,102,0.84425064780316,4.46437726360255,7.69750355759841,101,"ENSG00000079974.19"
"46442","ENSG00000286679.1_50401",50393,50401,9,"ENSG00000286679.1",1,1,"MVVUVVVVV",1,7,0.786749482401656,115,121,133,136,141,147,156,159,"ATAATGA","TAGA","GTGATTT","CTGC",2.2710177451522,12,5,9,35,3.06188807165969,4.55050159316859,7.69749952277521,101,"ENSG00000079974.19"
"4569","ENSG00000101098.13_23651",23643,23651,9,"ENSG00000101098.13",0,NA,"UVVVVUVVV",2,7,0.824844720496894,112,118,133,136,174,180,190,193,"GTGTTGG","CTCA","ATGAATC","CTGA",2.35078951295143,15,38,10,72,1.92048381961399,4.39810347648922,7.6974823584768,101,"ENSG00000079974.19"
"31309","ENSG00000222042.2_129664",129656,129664,9,"ENSG00000222042.2",1,2,"UMVVVVVVV",1,7,0.786749482401656,106,112,133,136,147,153,172,175,"ATGAACA","CTGA","ATCCTTA","CTGA",2.4572326384253,21,11,19,60,1.82015317224391,4.55042602376981,7.69742395337643,101,"ENSG00000079974.19"
"5770","ENSG00000106603.20_45324",45316,45324,9,"ENSG00000106603.20",1,8,"VVVVVUVMV",1,7,0.806211180124224,89,95,105,108,116,122,133,136,"ATGATGC","CTGA","ATGCTGT","CAGG",2.2407913942461,10,8,11,38,2.95154406691556,4.47253834047238,7.69738306096928,101,"ENSG00000079974.19"
"25504","ENSG00000182013.18_1408",1400,1408,9,"ENSG00000182013.18",1,8,"VVVVVUVMV",1,7,0.806211180124224,84,90,103,106,113,119,133,136,"ATGCTGA","CTCA","ATCAAGG","CTGT",2.25161555354238,13,7,14,43,2.87935588587557,4.47253156070619,7.69737628120309,101,"ENSG00000079974.19"
"43918","ENSG00000275406.1_1400",1392,1400,9,"ENSG00000275406.1",1,7,"VVUVVVMVV",1,7,0.768944099378882,113,119,133,136,149,155,166,169,"ATTATTT","CTAA","TTGAGGA","CTGA",2.37596712046372,14,13,11,47,2.6466001213307,4.62159523110554,7.69737162862106,101,"ENSG00000079974.19"
"801","ENSG00000034053.15_3793",3785,3793,9,"ENSG00000034053.15",1,2,"VMUVVVVVV",1,7,0.767701863354037,114,120,133,136,161,167,194,197,"GAGATAA","CTGA","GTGATAA","CTGA",2.57744014524404,13,25,27,74,1.32311520774583,4.6265123773432,7.69731983075935,101,"ENSG00000079974.19"
"7128","ENSG00000112902.12_32295",32287,32295,9,"ENSG00000112902.12",1,6,"VVVVUMVVV",1,7,0.792546583850932,112,118,133,136,159,165,184,187,"ATAATGA","ATAA","GGGATAA","CTGA",2.46759438112574,15,23,19,66,1.65784857090041,4.52711944460133,7.69730578000506,101,"ENSG00000079974.19"
"9720","ENSG00000126773.13_72606",72598,72606,9,"ENSG00000126773.13",1,6,"VVVVVMUVV",1,7,0.788819875776397,77,83,98,101,116,122,133,136,"ATAATGC","TTGT","GTTATGT","CTGA",2.35773438952998,15,15,11,50,2.44984611702836,4.54201884514038,7.69729834824597,101,"ENSG00000079974.19"
"2450","ENSG00000074935.14_13436",13428,13436,9,"ENSG00000074935.14",1,8,"UVVVVVVMV",1,7,0.786749482401656,78,84,99,102,111,117,133,136,"ATGATGA","CAGT","CAGTTGA","CTGC",2.33717437880845,15,9,16,49,2.61978481105164,4.55023683411033,7.69723476371696,101,"ENSG00000079974.19"
"35431","ENSG00000236039.3_98780",98772,98780,9,"ENSG00000236039.3",1,1,"MVVVVUVVV",1,7,0.82815734989648,64,70,85,88,94,100,133,136,"ATGCTGA","ATGA","GTAATCA","GTGA",2.3353844855689,15,6,33,63,1.96918749215196,4.38460434898616,7.69723374857208,101,"ENSG00000079974.19"
"1284","ENSG00000052126.16_140643",140635,140643,9,"ENSG00000052126.16",1,2,"VMVVUVVVV",1,7,0.773913043478261,110,116,133,136,181,187,195,198,"GTGATGA","TTGA","GTAATGA","CAGA",2.50027808255508,17,45,8,79,1.73775503844914,4.60156889720409,7.69722107111713,101,"ENSG00000079974.19"
"13878","ENSG00000143815.15_26143",26135,26143,9,"ENSG00000143815.15",0,NA,"UVVVVVUVV",2,7,0.788819875776397,114,120,133,136,138,144,152,155,"ATGCTGA","ATGA","ATTATTA","CTGC",2.3115246882716,13,2,8,32,2.75757226228217,4.54193421268988,7.69721371579547,101,"ENSG00000079974.19"
"37128","ENSG00000245526.13_82020",82012,82020,9,"ENSG00000245526.13",1,2,"UMVVVVVVV",1,7,0.786749482401656,114,120,133,136,160,166,177,180,"GTGAAGA","TTGG","CTGCTGT","CTGA",2.41090457422889,13,24,11,57,2.12807343632238,4.55019264946208,7.69719057906871,101,"ENSG00000079974.19"
"4804","ENSG00000101938.15_45678",45670,45678,9,"ENSG00000101938.15",1,1,"MVVVVUVVV",1,7,0.82815734989648,114,120,133,136,140,146,186,189,"ATTTTGA","GAGA","GTGTTGC","CTGA",2.35265142626821,13,4,40,66,1.85382463122404,4.38454186825303,7.69717126783895,101,"ENSG00000079974.19"
"32918","ENSG00000228262.11_494769",494761,494769,9,"ENSG00000228262.11",1,2,"UMVVVVVVV",1,7,0.786749482401656,110,116,133,136,143,149,165,168,"TTGATCA","TTGT","TTGACTA","CTGA",2.35284533719253,17,7,16,49,2.5147123053786,4.55008697166553,7.69708490127216,101,"ENSG00000079974.19"
"15080","ENSG00000147010.19_271924",271916,271924,9,"ENSG00000147010.19",1,2,"UMVVVUVVV",2,6,0.708902691511387,79,85,108,111,115,121,133,136,"ATGATAT","CTGA","ATGGGGA","CTGA",2.60628361689141,23,4,12,48,2.07067130614384,4.86147385468832,7.69708462073387,101,"ENSG00000079974.19"
"7243","ENSG00000113391.19_31070",31062,31070,9,"ENSG00000113391.19",1,1,"MVVVVUUVV",2,6,0.714285714285714,110,116,133,136,143,149,162,165,"ATGAGGG","ATGA","ATGAAGC","CTGA",2.50222927719867,17,7,13,46,2.67822954676562,4.83993951535586,7.69708237249871,101,"ENSG00000079974.19"
"2130","ENSG00000070476.15_17140",17132,17140,9,"ENSG00000070476.15",1,1,"MVVVVUVVV",1,7,0.82815734989648,111,117,133,136,154,160,168,171,"GTGGTGA","TTGA","TTCATGA","CGGA",2.30195873128275,16,18,8,51,2.19128641146447,4.38441948833736,7.69704888792328,101,"ENSG00000079974.19"
"18776","ENSG00000158467.17_193038",193030,193038,9,"ENSG00000158467.17",1,2,"VMUVVVVVV",1,7,0.767701863354037,43,49,68,71,77,83,133,136,"TTGAGGA","CTGA","ATAAAGG","CTGA",2.5412781452059,19,6,50,84,1.56309709919665,4.62623785014232,7.69704530355847,101,"ENSG00000079974.19"
"23167","ENSG00000172264.19_688687",688679,688687,9,"ENSG00000172264.19",1,7,"VVUVVVMVV",1,7,0.768944099378882,110,116,133,136,140,146,154,157,"GTGATGC","CCCA","GTAAAGC","CTGA",2.37783128330641,17,4,8,38,2.63273535038935,4.62123597644135,7.69701237395688,101,"ENSG00000079974.19"
"28376","ENSG00000188906.17_131876",131868,131876,9,"ENSG00000188906.17",0,NA,"UVVVVUVVV",2,7,0.824844720496894,116,122,133,136,147,153,171,174,"TTGTGGA","TTGT","CTGTTGA","CTGA",2.27150110260862,11,11,18,49,2.44715686390202,4.39762438698986,7.69700326897744,101,"ENSG00000079974.19"
"9141","ENSG00000122870.12_119727",119719,119727,9,"ENSG00000122870.12",1,1,"MVUVVVVVV",1,7,0.789648033126294,112,118,133,136,155,161,182,185,"TTGAGGA","TTTA","GTGAGGA","CTGA",2.46916361437344,15,19,21,64,1.69251181484054,4.53840064433253,7.69699277683771,101,"ENSG00000079974.19"
"31833","ENSG00000224957.7_154427",154419,154427,9,"ENSG00000224957.7",0,NA,"VVVVUUVVV",2,7,0.812008281573499,115,121,133,136,140,146,172,175,"CTGAGGA","GGGA","TTGTTCA","CTGA",2.35816002922517,12,4,26,51,2.07473822231583,4.44895127095424,7.69698439724824,101,"ENSG00000079974.19"
"38704","ENSG00000250910.8_169064",169056,169064,9,"ENSG00000250910.8",1,2,"VMVVVVUVV",1,7,0.770186335403727,114,120,133,136,151,157,172,175,"ATCCTGT","CTGA","GTGTATA","CTGA",2.41471412529325,13,15,15,52,2.36682688470098,4.61623026333067,7.69697560494557,101,"ENSG00000079974.19"
"4485","ENSG00000100678.20_105055",105047,105055,9,"ENSG00000100678.20",1,1,"MVVVVVUVV",1,7,0.792132505175983,108,114,133,136,180,186,196,199,"ATAATGA","AAGA","TTGACAA","CTGA",2.48000273362717,19,44,10,82,1.58005646137471,4.5283520047223,7.69688202542623,101,"ENSG00000079974.19"
"25669","ENSG00000182463.16_262427",262419,262427,9,"ENSG00000182463.16",1,8,"VVVVVUVMV",1,7,0.806211180124224,108,114,133,136,144,150,169,172,"AGGAAGA","TTGG","GTGGAGA","CTGA",2.36239164483867,19,8,19,55,2.13878600102379,4.4720159083204,7.69686062881729,101,"ENSG00000079974.19"
"21921","ENSG00000169306.10_277218",277210,277218,9,"ENSG00000169306.10",0,NA,"VVUVVVUVV",2,7,0.769772256728778,79,85,98,101,109,115,133,136,"GTGAAGA","GTGT","GTGGGAA","CTGA",2.37761972492402,13,8,18,48,2.62015654254086,4.61773867717524,7.69682770409036,101,"ENSG00000079974.19"
"10950","ENSG00000133195.12_207447",207439,207447,9,"ENSG00000133195.12",1,8,"VVVVVUVMV",1,7,0.806211180124224,112,118,133,136,176,182,191,194,"GAGTTGA","TTGA","GAGAGGA","CTGA",2.39586725774575,15,40,9,73,1.91548211594021,4.47198262522796,7.69682734572486,101,"ENSG00000079974.19"
"27544","ENSG00000186472.20_235554",235546,235554,9,"ENSG00000186472.20",1,2,"VMVVUVVVV",1,7,0.773913043478261,59,65,75,78,116,122,133,136,"ATGACAA","CTGA","GGAAAGA","CTGA",2.4732799357226,10,38,11,68,1.91609460067608,4.60115687637335,7.69680905028639,101,"ENSG00000079974.19"
"26238","ENSG00000183715.14_57129",57121,57129,9,"ENSG00000183715.14",1,1,"MVVVVVUVV",1,7,0.792132505175983,111,117,133,136,143,149,160,163,"AGGAGGA","AGGA","ATGAGTG","CTGA",2.29154425729596,16,7,11,43,2.83604865207137,4.52825259184444,7.69678261254837,101,"ENSG00000079974.19"
"24237","ENSG00000175497.17_878710",878702,878710,9,"ENSG00000175497.17",1,7,"VVVVVUMVV",1,7,0.807453416149068,93,99,133,136,187,193,205,208,"GTGACGA","CTGT","CTGAGGT","CTGA",2.53453713550355,34,51,12,106,0.970930626051745,4.46696121568551,7.69677488028178,101,"ENSG00000079974.19"
"22206","ENSG00000169946.14_389929",389921,389929,9,"ENSG00000169946.14",1,6,"UVVVVMVVV",1,7,0.805383022774327,89,95,133,136,143,149,157,160,"CTGATGG","GAGA","ATGAATT","CTGA",2.38766782940388,38,7,8,62,1.98308947778439,4.4752187517859,7.69675084288321,101,"ENSG00000079974.19"
"38070","ENSG00000249481.7_25211",25203,25211,9,"ENSG00000249481.7",1,2,"VMVVUVVVV",1,7,0.773913043478261,39,45,58,61,76,82,133,136,"ATGATCA","CTGA","GTGATTA","CTGC",2.52789878420612,13,15,51,88,1.55140727570142,4.60101645926889,7.69666863318194,101,"ENSG00000079974.19"
"43573","ENSG00000272442.2_94667",94659,94667,9,"ENSG00000272442.2",1,2,"VMVVUVVVV",1,7,0.773913043478261,39,45,58,61,76,82,133,136,"ATGATCA","CTGA","GTGATTA","CTGC",2.52789878420612,13,15,51,88,1.55140727570142,4.60101645926889,7.69666863318194,101,"ENSG00000079974.19"
"40496","ENSG00000256615.1_93371",93363,93371,9,"ENSG00000256615.1",1,2,"VMVUVVVVV",1,7,0.764803312629399,94,100,133,136,167,173,183,186,"AGGATGA","CTAA","AAGATGA","CTGA",2.6234410852542,33,31,10,83,1.0593931544524,4.63725009737009,7.69646334788769,101,"ENSG00000079974.19"
"31259","ENSG00000221823.11_24642",24634,24642,9,"ENSG00000221823.11",1,6,"VVVVVMUVV",1,7,0.788819875776397,114,120,133,136,145,151,199,202,"ATGATAA","CTAC","GTGAAAT","CTGA",2.43217446429012,13,9,48,79,1.95003565591614,4.54113302112923,7.69641252423482,101,"ENSG00000079974.19"
"43746","ENSG00000273398.6_29635",29627,29635,9,"ENSG00000273398.6",1,6,"VVVVVMUVV",1,7,0.788819875776397,114,120,133,136,145,151,199,202,"ATGATAA","CTAC","GTGAAAT","CTGA",2.43217446429012,13,9,48,79,1.95003565591614,4.54113302112923,7.69641252423482,101,"ENSG00000079974.19"
"35985","ENSG00000237585.1_16920",16912,16920,9,"ENSG00000237585.1",1,8,"UVVVVVVMV",1,7,0.786749482401656,114,120,133,136,145,151,183,186,"ATGCTAA","TTGA","CTGGTAA","CTGA",2.42415819644379,13,9,32,63,2.03654790910977,4.5494006380171,7.69639856762372,101,"ENSG00000079974.19"
"27174","ENSG00000185722.18_49860",49852,49860,9,"ENSG00000185722.18",1,3,"VVMUVVVVV",1,7,0.763561076604555,105,111,133,136,141,147,156,159,"ATGCTGT","CTGC","GTGAGTT","CTGA",2.44431703741201,22,5,9,45,2.27313569314105,4.64214565230528,7.6963899587235,101,"ENSG00000079974.19"
"19865","ENSG00000163848.21_13874",13866,13874,9,"ENSG00000163848.21",0,NA,"UVVVVUVVV",2,7,0.824844720496894,87,93,133,136,144,150,169,172,"CAGATGA","CTTG","TTGTTGA","CTGA",2.40368634052773,40,8,19,76,1.5633639035903,4.39698487677712,7.6963637587647,101,"ENSG00000079974.19"
"39405","ENSG00000253554.7_337997",337989,337997,9,"ENSG00000253554.7",1,2,"VMVVVUVVV",1,7,0.806211180124223,56,62,80,83,95,101,133,136,"ATAATGA","CTGA","TTGATTT","ATGA",2.45450203234034,18,12,32,71,1.52258250932601,4.47148234789873,7.69632706839562,101,"ENSG00000079974.19"
"13138","ENSG00000140386.13_3385",3377,3385,9,"ENSG00000140386.13",1,1,"MVVVVVUVV",1,7,0.792132505175983,116,122,133,136,143,149,157,160,"ATAAAGA","CTGG","ATGATGG","CTTA",2.25367220162032,11,7,8,35,3.08659389029706,4.52776880860814,7.69629882931207,101,"ENSG00000079974.19"
"39136","ENSG00000251685.3_6284",6276,6284,9,"ENSG00000251685.3",1,6,"VVVUVMVVV",1,7,0.78343685300207,82,88,133,136,145,151,162,165,"GTGATGA","CTGG","GTGCTGT","CTGG",2.4470423852428,45,9,11,74,1.93658756431223,4.56255086648273,7.69629827849101,101,"ENSG00000079974.19"
"7378","ENSG00000113805.9_160049",160041,160049,9,"ENSG00000113805.9",1,2,"VMVUVVVVV",1,7,0.764803312629399,13,19,58,61,110,116,133,136,"ATGCTGA","CTGA","ATCATGC","CTGA",2.67708472410307,39,49,17,114,0.700872320860424,4.63702595372023,7.69623920423783,101,"ENSG00000079974.19"
"1461","ENSG00000057294.17_72651",72643,72651,9,"ENSG00000057294.17",1,8,"VVVVVVUMV",1,7,0.770186335403727,116,122,133,136,143,149,159,162,"CTGATGG","ATGA","GTGACGG","CTCA",2.31120276055575,11,7,10,37,3.05362272147605,4.61541028129527,7.69615562291018,101,"ENSG00000079974.19"
"41247","ENSG00000258740.1_11404",11396,11404,9,"ENSG00000258740.1",0,NA,"UVVVVVUVV",2,7,0.788819875776397,105,111,133,136,144,150,159,162,"AAGAAGA","GAGA","GTGAAGC","CTGA",2.37589476487852,22,8,9,48,2.32412552027765,4.54085598820028,7.69613549130587,101,"ENSG00000079974.19"
"47789","ENSG00000289340.2_1092",1084,1092,9,"ENSG00000289340.2",0,NA,"UVVVVVUVV",2,7,0.788819875776397,105,111,133,136,144,150,159,162,"AAGAAGA","GAGA","GTGAAGC","CTGA",2.37589476487852,22,8,9,48,2.32412552027765,4.54085598820028,7.69613549130587,101,"ENSG00000079974.19"
"2170","ENSG00000070882.13_46264",46256,46264,9,"ENSG00000070882.13",1,2,"UMVVVVVVV",1,7,0.786749482401656,113,119,133,136,141,147,169,172,"GTGAGTA","GTGA","CTGAGTA","CTGA",2.3839217480922,14,5,22,50,2.30371899530741,4.54913266231385,7.69613059192048,101,"ENSG00000079974.19"
"42451","ENSG00000263317.1_62314",62306,62314,9,"ENSG00000263317.1",1,2,"VMVVVVUVV",1,7,0.770186335403727,78,84,97,100,111,117,133,136,"AAGATGA","CTGA","GGAAAGA","CTGG",2.38065467107898,13,11,16,49,2.59044008268446,4.61536780580275,7.69611314741766,101,"ENSG00000079974.19"
"39253","ENSG00000253376.2_22479",22471,22479,9,"ENSG00000253376.2",1,3,"UVMVVVVVV",1,7,0.785507246376811,82,88,102,105,113,119,133,136,"AAAATGA","TTGT","TTGGTAA","CTGA",2.30825765671035,14,8,14,45,2.8279150943933,4.55407486811558,7.69610385362282,101,"ENSG00000079974.19"
"40566","ENSG00000257042.1_8546",8538,8546,9,"ENSG00000257042.1",0,NA,"UVVVVUVVV",2,7,0.824844720496894,82,88,133,136,186,192,202,205,"AAGATGA","ATGC","ATGACGT","CTGA",2.48782833410371,45,50,10,114,1.0011545433222,4.39666919267006,7.69604807465764,101,"ENSG00000079974.19"
"45330","ENSG00000285424.1_196071",196063,196071,9,"ENSG00000285424.1",1,7,"VVVUVVMVV",1,7,0.766045548654244,77,83,104,107,109,115,133,136,"GTGATGA","CTGA","CTGCTGT","CTAA",2.54333179412021,21,2,18,50,1.57186239329907,4.63185192185845,7.69603411647543,101,"ENSG00000079974.19"
"46387","ENSG00000286546.1_25648",25640,25648,9,"ENSG00000286546.1",1,5,"VVUVMVVVV",1,7,0.770186335403727,116,122,133,136,152,158,176,179,"CTGGTGA","CTAA","TTGACCA","CTGA",2.45422772051331,11,16,18,54,2.09958612615639,4.61527606572795,7.69602140734285,101,"ENSG00000079974.19"
"5994","ENSG00000107614.22_30258",30250,30258,9,"ENSG00000107614.22",1,2,"VMVVVUVVV",1,7,0.806211180124223,110,116,133,136,166,172,181,184,"GAGATGA","CAGG","ATGGTTA","CTGA",2.41198897104627,17,30,9,65,1.80466473098681,4.47114780115716,7.69599252165405,101,"ENSG00000079974.19"
"12861","ENSG00000139220.17_439550",439542,439550,9,"ENSG00000139220.17",1,7,"VVVVUVMVV",1,7,0.775155279503105,88,94,106,109,116,122,133,136,"ATGAACT","CTTA","AAGATGT","CTGA",2.30260527917056,12,7,11,39,3.03072645176272,4.59535707822495,7.69597819623737,101,"ENSG00000079974.19"
"12654","ENSG00000138759.20_384413",384405,384413,9,"ENSG00000138759.20",1,2,"UMVVVVVVV",1,7,0.786749482401656,105,111,133,136,146,152,166,169,"GAAATGA","CTGT","GTGAGGC","CTGA",2.4133750639401,22,10,14,55,2.10662779549726,4.54894872210781,7.69594665171444,101,"ENSG00000079974.19"
"22123","ENSG00000169855.21_733724",733716,733724,9,"ENSG00000169855.21",1,2,"UMVVVVVVV",1,7,0.786749482401656,56,62,102,105,111,117,133,136,"ATGTGGA","CTGA","AAGATAC","CTGA",2.46779007085773,40,6,16,71,1.74376109201792,4.54892372443403,7.69592165404066,101,"ENSG00000079974.19"
"44917","ENSG00000284418.3_667908",667900,667908,9,"ENSG00000284418.3",1,2,"UMVVVVVVV",1,7,0.786749482401656,89,95,133,136,146,152,160,163,"AAGATTA","CTCA","GTGCTGT","CTGA",2.44715257061036,38,10,8,65,1.88131832380526,4.54891719863525,7.69591512824188,101,"ENSG00000079974.19"
"23856","ENSG00000174469.23_1555320",1555312,1555320,9,"ENSG00000174469.23",1,3,"VVMUVVVVV",1,7,0.763561076604555,116,122,133,136,147,153,171,174,"GTGCTTT","CTGA","GTGTAGA","CTGA",2.41792829350169,11,11,18,49,2.44715686390202,4.64166970514498,7.6959140115632,101,"ENSG00000079974.19"
"35173","ENSG00000235199.1_6877",6869,6877,9,"ENSG00000235199.1",1,8,"VVVVVUVMV",1,7,0.806211180124224,113,119,133,136,143,149,158,161,"ATGAAGT","CTAA","ATGGGGA","CTGG",2.23152684170578,14,7,9,39,3.0073188496743,4.47104111526154,7.69588583575843,101,"ENSG00000079974.19"
"2667","ENSG00000077232.19_33839",33831,33839,9,"ENSG00000077232.19",1,2,"VMUVVVVVV",1,7,0.767701863354037,105,111,133,136,144,150,162,165,"ATGAAGA","AAGA","GTCAGTA","CTGA",2.43269411149057,22,8,12,51,2.28219589181153,4.6250391587705,7.69584661218665,101,"ENSG00000079974.19"
"31685","ENSG00000224429.10_32973",32965,32973,9,"ENSG00000224429.10",1,6,"VVVVVMUVV",1,7,0.788819875776397,105,111,133,136,149,155,201,204,"TTGATGT","CTGT","TTGTTGA","CTGA",2.56874887900428,22,13,46,90,1.03716721068731,4.54053993434563,7.69581943745122,101,"ENSG00000079974.19"
"40276","ENSG00000255411.3_6525",6517,6525,9,"ENSG00000255411.3",1,2,"VMVVVVUVV",1,7,0.770186335403727,85,91,133,136,141,147,157,160,"GTGAGGA","CTGT","ATGCAGC","CTGA",2.47922185197725,42,5,10,66,1.93208985490681,4.61505888368879,7.6958042253037,101,"ENSG00000079974.19"
"39664","ENSG00000254081.2_6997",6989,6997,9,"ENSG00000254081.2",1,2,"VMVVVVUVV",1,7,0.770186335403727,114,120,133,136,148,154,173,176,"ATCATAA","GTTA","TTGATGA","CTGA",2.41849728704265,13,12,19,53,2.33691292363537,4.61505704264659,7.6958023842615,101,"ENSG00000079974.19"
"17758","ENSG00000155052.15_226604",226596,226604,9,"ENSG00000155052.15",1,1,"MVVVVUVVV",1,7,0.82815734989648,35,41,61,64,73,79,133,136,"ATGATTC","CTGC","ATGAAAC","CTGA",2.41359423848394,20,9,54,92,1.44189968440773,4.38313198524183,7.69576138482775,101,"ENSG00000079974.19"
"28161","ENSG00000188312.14_171325",171317,171325,9,"ENSG00000188312.14",1,1,"MVVVVVUVV",1,7,0.792132505175983,110,116,133,136,153,159,171,174,"ATAATAT","ATGA","CTGATGG","CTGA",2.39515321957789,17,17,12,55,2.14121275796925,4.52722522212213,7.69575524282606,101,"ENSG00000079974.19"
"22619","ENSG00000170962.13_129393",129385,129393,9,"ENSG00000170962.13",1,2,"VMVVVUVVV",1,7,0.806211180124223,112,118,133,136,156,162,176,179,"ATGATGA","TTGC","ATGTTTA","CTGC",2.37369543130651,15,20,14,58,2.05882974619865,4.47086648872718,7.69571120922407,101,"ENSG00000079974.19"
"42245","ENSG00000261272.1_13673",13665,13673,9,"ENSG00000261272.1",1,7,"UVVVVVMVV",1,7,0.787991718426501,113,119,133,136,151,157,169,172,"ATCTTCA","ATGA","CTGAAGA","CTGA",2.35474887513111,14,15,12,50,2.47654932043076,4.54371878865954,7.69568566236555,101,"ENSG00000079974.19"
"28381","ENSG00000188958.10_34145",34137,34145,9,"ENSG00000188958.10",0,NA,"VVUVVVUVV",2,7,0.769772256728778,75,81,93,96,101,107,133,136,"TTGATTT","ATGA","TTGAGGA","CTGA",2.44468657659404,12,5,26,52,2.1682450082525,4.61653887971986,7.69562790663498,101,"ENSG00000079974.19"
"41861","ENSG00000259867.6_301377",301369,301377,9,"ENSG00000259867.6",1,1,"MVVVVVUVV",1,7,0.792132505175983,116,122,133,136,144,150,180,183,"AAGAAGA","ATGA","ATGCAGC","CTGA",2.40304335433155,11,8,30,58,2.08801447155862,4.52707587510891,7.69560589581285,101,"ENSG00000079974.19"
"47687","ENSG00000289002.2_7750",7742,7750,9,"ENSG00000289002.2",1,1,"MVUVVVVVV",1,7,0.789648033126294,113,119,133,136,143,149,168,171,"AAGATGA","GTGA","TTGCAGA","CAGA",2.34112396697733,14,7,19,49,2.54036914903411,4.53696556555408,7.69555769805925,101,"ENSG00000079974.19"
"37097","ENSG00000245293.5_75550",75542,75550,9,"ENSG00000245293.5",1,7,"VVVUVVMVV",1,7,0.766045548654244,115,121,133,136,141,147,162,165,"GTGTTGA","CTTC","TAGAAGA","CTGA",2.3628827106393,12,5,15,41,2.77288109657987,4.63135812521046,7.69554031982744,101,"ENSG00000079974.19"
"37875","ENSG00000249001.6_124367",124359,124367,9,"ENSG00000249001.6",1,8,"UVVVVVVMV",1,7,0.786749482401656,92,98,107,110,115,121,133,136,"GAGATGA","CAGA","CTGAGGG","CTCA",2.30050810965341,9,5,12,35,2.8574286246152,4.54853733890948,7.69553526851611,101,"ENSG00000079974.19"
"6475","ENSG00000110079.19_42771",42763,42771,9,"ENSG00000110079.19",1,2,"UMVVVVVVV",1,7,0.786749482401656,90,96,133,136,140,146,199,202,"GTAATGA","CAGA","TTGAGGA","CTGA",2.60260716010395,37,4,53,103,0.843297118389436,4.54850287977061,7.69550080937724,101,"ENSG00000079974.19"
"23682","ENSG00000173517.11_310839",310831,310839,9,"ENSG00000173517.11",1,8,"VVVVVUVMV",1,7,0.806211180124224,112,118,133,136,164,170,188,191,"ATGATGA","CTGG","GAGAAGG","TTGA",2.43954553320753,15,28,18,70,1.61890390971661,4.47063519944171,7.6954799199386,101,"ENSG00000079974.19"
"18871","ENSG00000159082.18_21871",21863,21871,9,"ENSG00000159082.18",1,2,"VMVVVVUVV",1,7,0.770186335403727,114,120,133,136,139,145,168,171,"ATGTTGA","GTTA","TTGTAGA","CTGA",2.46027879155351,13,3,23,48,2.05702938586998,4.61472199905668,7.69546734067159,101,"ENSG00000079974.19"
"11298","ENSG00000134516.20_109040",109032,109040,9,"ENSG00000134516.20",1,1,"MVVVVUVVV",1,7,0.82815734989648,115,121,133,136,144,150,179,182,"GAAATGA","GGGA","GTGAGGG","CTGA",2.30930705663367,12,8,29,58,2.13572400114123,4.38277609467475,7.69540549426068,101,"ENSG00000079974.19"
"39224","ENSG00000253322.1_102130",102122,102130,9,"ENSG00000253322.1",1,1,"MVUVVVVVV",1,7,0.789648033126294,55,61,78,81,98,104,133,136,"AAGCTGA","CTGA","CTCATGT","CTGA",2.52226642220908,17,17,29,72,1.3320906905441,4.5368000429845,7.69539217548967,101,"ENSG00000079974.19"
"11258","ENSG00000134369.16_187028",187020,187028,9,"ENSG00000134369.16",1,8,"VVVVUVVMV",1,7,0.773913043478261,68,74,101,104,114,120,133,136,"ATGCTGA","CTGA","GTGGTGT","CTGG",2.47184823761659,27,10,13,59,1.91996613939546,4.59973859754318,7.69539077145622,101,"ENSG00000079974.19"
"16629","ENSG00000151914.22_433563",433555,433563,9,"ENSG00000151914.22",1,1,"MVVVVUVVV",1,7,0.82815734989648,74,80,96,99,109,115,133,136,"TTTATAA","CAGA","GTATTTA","CTGA",2.27380535194435,16,10,18,53,2.37232817465647,4.38275763023803,7.69538702982395,101,"ENSG00000079974.19"
"9156","ENSG00000122966.17_161279",161271,161279,9,"ENSG00000122966.17",1,8,"VVVVVUUMV",2,6,0.692339544513457,109,115,133,136,145,151,166,169,"GTGATGA","TTGC","GTGGTGT","CTGA",2.59044059415259,18,9,15,51,2.43450289211067,4.92602671328198,7.69538489133581,101,"ENSG00000079974.19"
"24471","ENSG00000176485.13_35927",35919,35927,9,"ENSG00000176485.13",0,NA,"UVVVUVVVV",2,7,0.792546583850932,111,117,133,136,139,145,155,158,"GTAAAGA","ATGA","GTATTAA","CTGA",2.32533230701042,16,3,10,38,2.59857356385691,4.52519723598159,7.69538357138531,101,"ENSG00000079974.19"
"29000","ENSG00000196914.9_22583",22575,22583,9,"ENSG00000196914.9",0,NA,"VVVVUUVVV",2,7,0.812008281573499,110,116,133,136,174,180,194,197,"GTGCTGA","CTAG","GTGAGGC","CTGA",2.42278432021757,17,38,14,78,1.63740570788195,4.44732529399977,7.69535842029377,101,"ENSG00000079974.19"
"27001","ENSG00000185420.19_157009",157001,157009,9,"ENSG00000185420.19",1,5,"VVUVMVVVV",1,7,0.770186335403727,83,89,104,107,116,122,133,136,"GTGATTA","CTGG","ATGATAA","GTGA",2.34058402097194,15,9,11,44,2.85453102015611,4.61460612332559,7.6953514649405,101,"ENSG00000079974.19"
"46612","ENSG00000286922.1_31110",31102,31110,9,"ENSG00000286922.1",1,2,"VMVVVUVVV",1,7,0.806211180124223,103,109,133,136,176,182,192,195,"ATAATGA","TGGA","CTGAGGT","CTGA",2.4984722943957,24,40,10,83,1.2254080318729,4.47047249862773,7.69531721912462,101,"ENSG00000079974.19"
"19182","ENSG00000162415.7_203772",203764,203772,9,"ENSG00000162415.7",1,8,"VVVVUVVMV",1,7,0.773913043478261,87,93,102,105,116,122,133,136,"ATAATGG","CTGA","GTGCTTA","CTTA",2.35625407013022,9,11,11,40,2.6902513741115,4.59965296041157,7.69530513432461,101,"ENSG00000079974.19"
"18487","ENSG00000157470.12_64775",64767,64775,9,"ENSG00000157470.12",1,8,"VVVUVVVMV",1,7,0.764803312629399,93,99,133,136,143,149,157,160,"CTGATGA","AGGA","GGGAGGG","CTGA",2.48281036240954,34,7,8,58,1.99224050797665,4.63607739767673,7.69529064819433,101,"ENSG00000079974.19"
"16856","ENSG00000152484.14_105332",105324,105332,9,"ENSG00000152484.14",1,1,"MVVVVUVVV",1,7,0.82815734989648,114,120,133,136,139,145,157,160,"TTGATGG","CTCA","TTCATAA","TTGA",2.21956789742649,13,3,12,37,2.73340942431075,4.38263218512184,7.69526158470776,101,"ENSG00000079974.19"
"884","ENSG00000038945.15_449811",449803,449811,9,"ENSG00000038945.15",1,2,"VMVVVUVVV",1,7,0.806211180124223,45,51,65,68,72,78,133,136,"CTGATGG","CTGA","GTGTTGC","CTGC",2.41189189870383,14,4,55,82,1.80235726060874,4.47040914632523,7.69525386682212,101,"ENSG00000079974.19"
"7669","ENSG00000115306.16_214788",214780,214788,9,"ENSG00000115306.16",0,NA,"UVVVUVVVV",2,7,0.792546583850932,48,54,66,69,116,122,133,136,"ATGCTGT","CTGA","CTGAAGA","GTGA",2.41689583855582,12,47,11,79,1.98761098469212,4.52506247709939,7.69524881250312,101,"ENSG00000079974.19"
"23157","ENSG00000172264.19_487900",487892,487900,9,"ENSG00000172264.19",1,8,"VVVVVUVMV",1,7,0.806211180124224,110,116,133,136,143,149,181,184,"TAGATGA","TAGA","ATGGGGA","CTGA",2.40543490250514,17,7,32,65,1.84534164642383,4.47039358244785,7.69523830294474,101,"ENSG00000079974.19"
"20969","ENSG00000166105.16_14134",14126,14134,9,"ENSG00000166105.16",1,7,"VVUVVVMVV",1,7,0.768944099378882,90,96,133,136,150,156,168,171,"ATGATCA","CGGA","GTGCCCA","CTGA",2.53390200493087,37,14,12,72,1.5851376770542,4.61945442748167,7.6952308249972,101,"ENSG00000079974.19"
"12716","ENSG00000138798.13_67714",67706,67714,9,"ENSG00000138798.13",1,8,"UVVVVVVMV",1,7,0.786749482401656,77,83,98,101,109,115,133,136,"ATGATGA","ATCA","CTAAAGA","CTGG",2.34899251175456,15,8,18,50,2.5329405623046,4.54822266016708,7.69522058977371,101,"ENSG00000079974.19"
"27090","ENSG00000185565.12_100788",100780,100788,9,"ENSG00000185565.12",0,NA,"UVVUVVVVV",2,7,0.78343685300207,93,99,133,136,144,150,163,166,"ATAATTA","CAGA","ATGGTGG","CTGA",2.44919731059319,34,8,13,64,1.91786292295078,4.561461248393,7.69520866040129,101,"ENSG00000079974.19"
"38787","ENSG00000251026.2_291297",291289,291297,9,"ENSG00000251026.2",1,1,"MVVUVVVVV",1,7,0.786749482401656,114,120,133,136,159,165,173,176,"CAGATGA","CTGG","GAAAGGA","CTGA",2.40656472736262,13,23,8,53,2.14902858689836,4.54819835899563,7.69519628860225,101,"ENSG00000079974.19"
"7599","ENSG00000115091.12_28071",28063,28071,9,"ENSG00000115091.12",1,8,"VVVUVVVMV",1,7,0.764803312629399,57,63,70,73,77,83,133,136,"ATGACCA","CTGA","ATGGAGA","CTGA",2.56379043563677,7,4,50,70,1.45190599211936,4.63596055742445,7.69517380794205,101,"ENSG00000079974.19"
"19562","ENSG00000163297.18_116947",116939,116947,9,"ENSG00000163297.18",1,1,"MVVVUVVVV",1,7,0.795859213250517,116,122,133,136,161,167,178,181,"GTGGTGA","TTTA","AAGATGT","CTGA",2.39436871317372,11,25,11,56,2.0844827223405,4.51173520254133,7.6951720555434,101,"ENSG00000079974.19"
"28546","ENSG00000196091.15_78926",78918,78926,9,"ENSG00000196091.15",1,1,"MVVVVVUVV",1,7,0.792132505175983,102,108,133,136,184,190,200,203,"ATTATCA","CTGG","CTGATGA","CTGA",2.53999100385082,25,48,10,92,1.17312475569297,4.52659952867462,7.69512954937855,101,"ENSG00000079974.19"
"43289","ENSG00000270792.6_84948",84940,84948,9,"ENSG00000270792.6",1,8,"UVVVVVVMV",1,7,0.786749482401656,65,71,84,87,93,99,133,136,"GTGATGA","CTGT","ATTAAGA","TTGA",2.42242082191074,13,6,34,62,2.04296431747788,4.54810911588737,7.695107045494,101,"ENSG00000079974.19"
"32561","ENSG00000227197.1_10929",10921,10929,9,"ENSG00000227197.1",0,NA,"UVVVVVUVV",2,7,0.788819875776397,85,91,133,136,146,152,163,166,"CTGATCA","ATGA","GTAAACA","CTGA",2.44118034674034,42,10,11,72,1.884665644113,4.53980032226214,7.69507982536773,101,"ENSG00000079974.19"
"41824","ENSG00000259786.7_369937",369929,369937,9,"ENSG00000259786.7",1,8,"UVVVVVVMV",1,7,0.786749482401656,104,110,133,136,137,143,152,155,"GTGATGC","CAAA","CTGCTGA","CTGA",2.48663071164589,23,1,9,42,1.61475293250962,4.54807275253722,7.69507068214385,101,"ENSG00000079974.19"
"14558","ENSG00000145362.21_69487",69479,69487,9,"ENSG00000145362.21",1,5,"VVVVMUVVV",1,7,0.808695652173913,75,81,99,102,110,116,133,136,"ATGATGT","TTCA","TTGAGGA","CTCA",2.32353244082113,18,8,17,52,2.35088773143414,4.46027600089375,7.6950586095894,101,"ENSG00000079974.19"
"31012","ENSG00000215244.4_75500",75492,75500,9,"ENSG00000215244.4",1,7,"UVVVVVMVV",1,7,0.787991718426501,110,116,133,136,144,150,161,164,"GTGATGA","TAGA","TTGGTAA","CTTA",2.31583809573516,17,8,11,45,2.73343017903204,4.54308770431662,7.69505457802262,101,"ENSG00000079974.19"
"17540","ENSG00000154359.13_24869",24861,24869,9,"ENSG00000154359.13",1,2,"VMVVVVUVV",1,7,0.770186335403727,79,85,104,107,114,120,133,136,"ATGAAGA","CTGA","GTCGGGA","CGGA",2.39389104533887,19,7,13,48,2.49779326601299,4.61426672540136,7.69501206701626,101,"ENSG00000079974.19"
"3600","ENSG00000086666.19_50993",50985,50993,9,"ENSG00000086666.19",1,8,"VVVUVVVMV",1,7,0.764803312629399,113,119,133,136,152,158,168,171,"ATGTGGA","AAGA","ATGAGGA","CTGA",2.41341625477005,14,16,10,49,2.4537111635099,4.63578821549423,7.69500146601183,101,"ENSG00000079974.19"
"37079","ENSG00000245164.10_253578",253570,253578,9,"ENSG00000245164.10",1,5,"VVVVMUVVV",1,7,0.808695652173913,80,86,101,104,112,118,133,136,"ATGCTGA","TTGA","AGGTCGA","ATGA",2.26868352219045,15,8,15,47,2.71598342368375,4.46013505957169,7.69491766826734,101,"ENSG00000079974.19"
"25360","ENSG00000181090.21_165791",165783,165791,9,"ENSG00000181090.21",0,NA,"VVVVUVUVV",2,7,0.775983436853002,37,43,53,56,107,113,133,136,"GTGAGGG","CTGA","GAGAGGA","CTGA",2.5391073523241,10,51,20,90,1.43639873746686,4.59094527157354,7.69487901898555,101,"ENSG00000079974.19"
"20437","ENSG00000164808.17_62631",62623,62631,9,"ENSG00000164808.17",1,8,"VVUVVVVMV",1,7,0.767701863354037,48,54,62,65,110,116,133,136,"ATAATGA","TTGA","TTTTTGA","CTGA",2.55973500031188,8,45,17,79,1.43134837186579,4.62406209348625,7.6948695469024,101,"ENSG00000079974.19"
"30552","ENSG00000205683.12_41550",41542,41550,9,"ENSG00000205683.12",0,NA,"UVVVVUVVV",2,7,0.824844720496894,89,95,105,108,116,122,133,136,"ATCATGG","GTGA","GTGAGCC","CTGG",2.19455940807046,10,8,11,38,2.95154406691556,4.39548503017965,7.69486391216723,101,"ENSG00000079974.19"
"17679","ENSG00000154767.15_22658",22650,22658,9,"ENSG00000154767.15",1,6,"VVVUVMVVV",1,7,0.78343685300207,88,94,104,107,116,122,133,136,"ATTATGA","GTGA","TTCATGG","CTGT",2.3015970634166,10,9,11,39,2.90046542025052,4.56111146075696,7.69485887276524,101,"ENSG00000079974.19"
"20192","ENSG00000164418.22_188870",188862,188870,9,"ENSG00000164418.22",1,3,"UVMVVVVVV",1,7,0.785507246376811,68,74,82,85,116,122,133,136,"ATGATAA","CTGA","TGGATGA","CTGT",2.46779368969736,8,31,11,59,1.75932263158833,4.55282014072601,7.69484912623326,101,"ENSG00000079974.19"
"17387","ENSG00000154027.19_210683",210675,210683,9,"ENSG00000154027.19",1,8,"UVVVVVVMV",1,7,0.786749482401656,53,59,70,73,85,91,133,136,"GTGAGGA","GGGA","CTGCTGA","CTGA",2.46552546629244,11,12,42,74,1.75435708627168,4.54779838205533,7.69479631166195,101,"ENSG00000079974.19"
"5265","ENSG00000104218.16_121807",121799,121807,9,"ENSG00000104218.16",1,1,"MVVVVUVVV",1,7,0.82815734989648,82,88,100,103,114,120,133,136,"GTGCTTA","TTGA","ATGAAGA","CTAA",2.21523962578497,12,11,13,45,2.76039948308047,4.38216591374507,7.69479531333099,101,"ENSG00000079974.19"
"17354","ENSG00000153956.17_150614",150606,150614,9,"ENSG00000153956.17",1,8,"VVVVVUVMV",1,7,0.806211180124224,110,116,133,136,142,148,156,159,"ATTATGT","TTGA","ATGAGAA","ATGA",2.26912310476879,17,6,8,40,2.75207265296066,4.46989000452149,7.69473472501838,101,"ENSG00000079974.19"
"31705","ENSG00000224506.3_35868",35860,35868,9,"ENSG00000224506.3",1,8,"VVUVVVVMV",1,7,0.767701863354037,63,69,79,82,88,94,133,136,"TTCATGA","CTCA","GTGCTCA","CTGA",2.48515634714625,10,6,39,64,1.9279905950341,4.62392489400227,7.69473234741842,101,"ENSG00000079974.19"
"1218","ENSG00000049618.25_393222",393214,393222,9,"ENSG00000049618.25",1,8,"VVVVVUVMV",1,7,0.806211180124224,83,89,133,136,145,151,174,177,"GTGATAA","AGGA","ATGATGG","CTGA",2.48545501040969,44,9,23,85,1.30964983973958,4.46983747728438,7.69468219778127,101,"ENSG00000079974.19"
"765","ENSG00000033122.21_134042",134034,134042,9,"ENSG00000033122.21",1,6,"UVVVVMVVV",1,7,0.805383022774327,107,113,133,136,148,154,165,168,"ATGATGT","CAGA","TTAATAA","CTGT",2.34754052917723,20,12,11,52,2.24227368608454,4.47313597014985,7.69466806124716,101,"ENSG00000079974.19"
"31821","ENSG00000224924.9_1622",1614,1622,9,"ENSG00000224924.9",1,6,"VVUVVMVVV",1,7,0.786335403726708,111,117,133,136,177,183,191,194,"GTGTTGA","CTCA","GGGCAGA","CTGA",2.45597521647429,16,41,8,74,1.8240637443708,4.54930796354985,7.69464957845669,101,"ENSG00000079974.19"
"10532","ENSG00000131437.16_34086",34078,34086,9,"ENSG00000131437.16",1,8,"VVVVVVUMV",1,7,0.770186335403727,113,119,133,136,158,164,182,185,"TTGATGA","CTTG","AAGAAGA","CTGA",2.49782138506415,14,22,18,63,1.80346706707773,4.61390240854301,7.69464775015792,101,"ENSG00000079974.19"
"44517","ENSG00000282890.1_512337",512329,512337,9,"ENSG00000282890.1",1,2,"UMVVVVVVV",1,7,0.786749482401656,80,86,99,102,114,120,133,136,"GTGAATA","CTGT","TTAATAA","CTGA",2.32607575201349,13,12,13,47,2.683370189747,4.54763546745924,7.69463339706586,101,"ENSG00000079974.19"
"6044","ENSG00000107798.18_84360",84352,84360,9,"ENSG00000107798.18",1,3,"UVMVVVVVV",1,7,0.785507246376811,111,117,133,136,142,148,161,164,"ATGAGGT","TTTA","GTGCCCA","CTGA",2.31909220828139,16,6,13,44,2.74952189876665,4.55253415516064,7.69456314066789,101,"ENSG00000079974.19"
"37096","ENSG00000245293.5_51625",51617,51625,9,"ENSG00000245293.5",1,1,"MVUVVVVVV",1,7,0.789648033126294,80,86,100,103,116,122,133,136,"TTTATGT","CTGC","GTTAAGG","CTGA",2.32455775581213,14,13,11,47,2.6466001213307,4.53591295668623,7.69450508919141,101,"ENSG00000079974.19"
"38112","ENSG00000249604.1_3156",3148,3156,9,"ENSG00000249604.1",1,1,"MVUVVVVVV",1,7,0.789648033126294,80,86,100,103,116,122,133,136,"TTTATGT","CTGC","GTTAAGG","CTGA",2.32455775581213,14,13,11,47,2.6466001213307,4.53591295668623,7.69450508919141,101,"ENSG00000079974.19"
"34155","ENSG00000231999.8_44680",44672,44680,9,"ENSG00000231999.8",1,7,"VVUVVVMVV",1,7,0.768944099378882,69,75,97,100,109,115,133,136,"TTGATGA","TGGA","ATGCATA","CTGA",2.48268844862333,22,9,18,58,1.92364713547655,4.61872586490801,7.69450226242354,101,"ENSG00000079974.19"
"20916","ENSG00000165973.19_863545",863537,863545,9,"ENSG00000165973.19",1,1,"MVVVVVUVV",1,7,0.792132505175983,114,120,133,136,141,147,158,161,"ATGATGT","TTAA","CTGAACA","CAGA",2.26966654426124,13,5,11,38,2.9726827964902,4.52594827289128,7.69447829359522,101,"ENSG00000079974.19"
"22209","ENSG00000169946.14_548592",548584,548592,9,"ENSG00000169946.14",1,2,"VMVVVVUVV",1,7,0.770186335403727,116,122,133,136,169,175,187,190,"CTGATGA","CTGG","ATGAAGA","ATGA",2.47390716053074,11,33,12,65,1.96200700953134,4.61368035326741,7.69442569488231,101,"ENSG00000079974.19"
"24294","ENSG00000175764.17_191536",191528,191536,9,"ENSG00000175764.17",1,8,"VVVVVVUMV",1,7,0.770186335403727,116,122,133,136,150,156,200,203,"ATAAAGA","ATGA","GTGATCA","CTGA",2.52720442215661,11,14,44,78,1.60668246111462,4.61367798553968,7.69442332715458,101,"ENSG00000079974.19"
"15454","ENSG00000148358.20_15832",15824,15832,9,"ENSG00000148358.20",1,6,"VVVVUMVVV",1,7,0.792546583850932,113,119,133,136,145,151,174,177,"TTGAGGT","CTTA","CTGGAGA","CTGA",2.37355956973494,14,9,23,55,2.27320554332361,4.52423400205581,7.69442033745953,101,"ENSG00000079974.19"
"23683","ENSG00000173517.11_316198",316190,316198,9,"ENSG00000173517.11",1,8,"VVVVVUVMV",1,7,0.806211180124224,97,103,133,136,142,148,202,205,"CTGATGT","CTGG","CTGAGCA","CTGA",2.52745500278271,30,6,54,99,1.02835262460618,4.4695131607894,7.6943578812863,101,"ENSG00000079974.19"
"13190","ENSG00000140538.17_177467",177459,177467,9,"ENSG00000140538.17",1,8,"VVVVVVUMV",1,7,0.770186335403727,98,104,133,136,142,148,190,193,"CTGATGG","CTAA","GTGAGGA","CTGA",2.60974071189213,29,6,42,86,1.05614507298841,4.61360412140064,7.69434946301555,101,"ENSG00000079974.19"
"3055","ENSG00000080546.14_80928",80920,80928,9,"ENSG00000080546.14",1,8,"UVVVVVVMV",1,7,0.786749482401656,109,115,133,136,148,154,170,173,"ATGATGT","CTTA","ATGTAGA","ATGA",2.39978866391128,18,12,16,55,2.19076444481377,4.54733888438891,7.69433681399554,101,"ENSG00000079974.19"
"3652","ENSG00000087258.16_7594",7586,7594,9,"ENSG00000087258.16",1,8,"VVVUVVVMV",1,7,0.764803312629399,45,51,57,60,71,77,133,136,"GTGTTGT","CTGA","TTGATGG","CTGA",2.58261529878502,6,11,56,82,1.3230552120219,4.63512263431385,7.69433588483144,101,"ENSG00000079974.19"
"17522","ENSG00000154309.9_31190",31182,31190,9,"ENSG00000154309.9",1,1,"MVVVVVUVV",1,7,0.792132505175983,114,120,133,136,145,151,194,197,"ATGAAAA","CAGA","ATCATGC","CTGA",2.4218755397221,13,9,43,74,1.95736283036165,4.52579994046058,7.69432996116452,101,"ENSG00000079974.19"
"30046","ENSG00000198963.11_67460",67452,67460,9,"ENSG00000198963.11",1,8,"VVVVVUVMV",1,7,0.806211180124224,91,97,107,110,116,122,133,136,"ATGAAAA","TTAA","AAGACTA","CTGA",2.23296752970959,10,6,11,36,2.99145553752933,4.46947643389831,7.6943211543952,101,"ENSG00000079974.19"
"41402","ENSG00000258983.2_5576",5568,5576,9,"ENSG00000258983.2",0,NA,"VVUVVUVVV",2,7,0.805797101449275,106,112,133,136,141,147,161,164,"GTAATGA","GTGT","GTCATCT","CTGA",2.3506040227363,21,5,14,49,2.2138187781879,4.47112806577414,7.69431647157124,101,"ENSG00000079974.19"
"37475","ENSG00000248288.1_602",594,602,9,"ENSG00000248288.1",0,NA,"VVVVVUUVV",2,7,0.808281573498965,85,91,102,105,112,118,133,136,"ATGAAGG","TTGA","ATGAATA","TTGA",2.25530413990338,11,7,15,42,2.80930442936659,4.46116634051396,7.69429263450981,101,"ENSG00000079974.19"
"36441","ENSG00000241058.4_62570",62562,62570,9,"ENSG00000241058.4",1,8,"UVVVVVVMV",1,7,0.786749482401656,77,83,94,97,105,111,133,136,"ATGCTGA","CTGA","ATTTTGT","CAGA",2.3728798495857,11,8,22,50,2.36979866126275,4.54724941462519,7.69424734423181,101,"ENSG00000079974.19"
"11101","ENSG00000133958.14_120215",120207,120215,9,"ENSG00000133958.14",0,NA,"VVVUVUVVV",2,7,0.802898550724638,111,117,133,136,145,151,196,199,"ATGATTT","CAGT","GTAATGA","CTGA",2.42021342242662,16,9,45,79,1.79583472623862,4.48264771893736,7.69424192183591,101,"ENSG00000079974.19"
"24848","ENSG00000178217.15_56656",56648,56656,9,"ENSG00000178217.15",1,1,"MVVUVVVVV",1,7,0.786749482401656,112,118,133,136,141,147,162,165,"ATGATGA","ATTA","TTCTTGA","CTCA",2.32832195378151,15,5,15,44,2.666730280727,4.5472191598176,7.69421708942423,101,"ENSG00000079974.19"
"20203","ENSG00000164418.22_681642",681634,681642,9,"ENSG00000164418.22",1,6,"VVVUVMVVV",1,7,0.78343685300207,90,96,133,136,159,165,174,177,"ATGTTAA","GTGA","ATGATGA","CTGA",2.5598722001321,37,23,9,78,1.17602503014932,4.56045992442416,7.69420733643245,101,"ENSG00000079974.19"
"35127","ENSG00000235050.6_53865",53857,53865,9,"ENSG00000235050.6",1,3,"VVMVVUVVV",1,7,0.804968944099379,82,88,133,136,156,162,183,186,"ATGATGA","CAGT","GGGAGGG","CTGA",2.5737815216656,45,20,21,95,0.738636241570434,4.47429492983527,7.69417070623278,101,"ENSG00000079974.19"
"24687","ENSG00000177570.15_104761",104753,104761,9,"ENSG00000177570.15",1,6,"VVVUVMVVV",1,7,0.78343685300207,109,115,133,136,174,180,191,194,"ATGAGGA","GTAA","GTGATTG","CTGA",2.48677695768598,18,38,11,76,1.66317364228991,4.56042167338244,7.69416908539072,101,"ENSG00000079974.19"
"30070","ENSG00000203496.9_1508",1500,1508,9,"ENSG00000203496.9",0,NA,"VVUVVUVVV",2,7,0.805797101449275,116,122,133,136,145,151,188,191,"ATACTGA","TTGG","ATGATGC","CTGA",2.38826800858774,11,9,37,66,1.96193366279356,4.47093009667796,7.69411850247506,101,"ENSG00000079974.19"
"33129","ENSG00000228786.5_4619",4611,4619,9,"ENSG00000228786.5",0,NA,"VVUVVUVVV",2,7,0.805797101449275,116,122,133,136,145,151,188,191,"ATACTGA","TTGG","ATGATGC","CTGA",2.38826800858774,11,9,37,66,1.96193366279356,4.47093009667796,7.69411850247506,101,"ENSG00000079974.19"
"36678","ENSG00000242588.7_125964",125956,125964,9,"ENSG00000242588.7",0,NA,"VVUVVUVVV",2,7,0.805797101449275,116,122,133,136,145,151,188,191,"ATACTGA","TTGG","ATGATGC","CTGA",2.38826800858774,11,9,37,66,1.96193366279356,4.47093009667796,7.69411850247506,101,"ENSG00000079974.19"
"23759","ENSG00000173905.9_72921",72913,72921,9,"ENSG00000173905.9",1,1,"MVVVVUVVV",1,7,0.82815734989648,116,122,133,136,144,150,189,192,"ATCAAGA","AAGA","AAGAGGA","CTGA",2.33094072834384,11,8,39,67,1.9863271070649,4.38148299067262,7.69411239025855,101,"ENSG00000079974.19"
"32183","ENSG00000226281.6_77441",77433,77441,9,"ENSG00000226281.6",1,8,"UVVVVUVMV",2,6,0.708902691511387,114,120,133,136,142,148,156,159,"GTGATGG","GAGA","GGGTTGA","CTGA",2.4557596178225,13,6,8,36,3.06214521483788,4.85846900008031,7.69407976612586,101,"ENSG00000079974.19"
"3879","ENSG00000090054.16_65177",65169,65177,9,"ENSG00000090054.16",1,8,"UVVVVVVMV",1,7,0.786749482401656,113,119,133,136,142,148,169,172,"GTGATGA","TTGA","AGGTTGC","ATGA",2.36692262888713,14,6,21,50,2.40877252320025,4.54706417894527,7.6940621085519,101,"ENSG00000079974.19"
"14633","ENSG00000145526.12_880248",880240,880248,9,"ENSG00000145526.12",1,2,"VMVVVUVVV",1,7,0.806211180124223,109,115,133,136,186,192,211,214,"ATGCTGA","TTGT","GTGATTT","CTGA",2.49514224110067,18,50,19,96,1.24253157117523,4.46920329462826,7.69404801512515,101,"ENSG00000079974.19"
"21881","ENSG00000169282.18_13157",13149,13157,9,"ENSG00000169282.18",1,1,"MVVVVUVVV",1,7,0.82815734989648,108,114,133,136,154,160,216,219,"ATGATGT","GTTA","GTGAGAG","CTGA",2.48631370305288,19,18,56,102,0.95020524928576,4.38140748407623,7.69403688366215,101,"ENSG00000079974.19"
"43574","ENSG00000272443.1_409",401,409,9,"ENSG00000272443.1",0,NA,"UVVVVVUVV",2,7,0.788819875776397,116,122,133,136,140,146,191,194,"CTAATGA","CTGT","GTGACTG","CTGA",2.45027049633438,11,4,45,69,1.81988326924007,4.53875497786732,7.69403448097291,101,"ENSG00000079974.19"
"22934","ENSG00000171735.20_32081",32073,32081,9,"ENSG00000171735.20",0,NA,"UVVVVUVVV",2,7,0.824844720496894,96,102,110,113,116,122,133,136,"ATGATGA","CTCA","GTCATGG","ATGT",2.2273421228756,8,3,11,31,2.72947355086852,4.39460525917647,7.69398414116404,101,"ENSG00000079974.19"
"25940","ENSG00000183111.12_71861",71853,71861,9,"ENSG00000183111.12",1,5,"VVVVMVUVV",1,7,0.772670807453416,111,117,133,136,142,148,179,182,"ACAATGA","GTGA","GTGACAA","CTGA",2.47264083724133,16,6,31,62,1.92884381782953,4.60327901652627,7.69396224633994,101,"ENSG00000079974.19"
"13429","ENSG00000141425.18_67292",67284,67292,9,"ENSG00000141425.18",1,1,"MVVVVVUVV",1,7,0.792132505175983,86,92,102,105,113,119,133,136,"AAAATGA","CTGA","AGGATAA","ATGA",2.29503846017607,10,8,14,41,2.80146926504232,4.52543141655404,7.69396143725797,101,"ENSG00000079974.19"
"27023","ENSG00000185420.19_713099",713091,713099,9,"ENSG00000185420.19",1,3,"VVMVVUVVV",1,7,0.804968944099379,115,121,133,136,140,146,159,162,"GAGAAGT","TAGA","GTGTTGA","CTGA",2.26184309262892,12,4,13,38,2.8168696944754,4.47395591133372,7.69383168773124,101,"ENSG00000079974.19"
"14478","ENSG00000145087.13_348161",348153,348161,9,"ENSG00000145087.13",1,5,"VVVVMUVVV",1,7,0.808695652173913,84,90,103,106,114,120,133,136,"GTGATGA","ATTA","GTCCTTA","CTCA",2.2383586224191,13,8,13,43,2.91376640783383,4.45903930599029,7.69382191468594,101,"ENSG00000079974.19"
"5471","ENSG00000104967.8_15222",15214,15222,9,"ENSG00000104967.8",1,3,"VVMUVVVVV",1,7,0.763561076604555,111,117,133,136,146,152,176,179,"AGGATGA","GGGA","AGGAAGA","CTGA",2.47625277131447,16,10,24,59,2.04990014480548,4.63956298839216,7.69380729481038,101,"ENSG00000079974.19"
"21811","ENSG00000169064.13_134753",134745,134753,9,"ENSG00000169064.13",1,8,"VVVVVUVMV",1,7,0.806211180124224,116,122,133,136,139,145,157,160,"CTGATTA","CAGA","GAGAAGA","GTGA",2.26656897121313,11,3,12,35,2.76538674811928,4.4689616390517,7.69380635954859,101,"ENSG00000079974.19"
"16017","ENSG00000150636.17_80929",80921,80929,9,"ENSG00000150636.17",1,8,"VVVVVUVMV",1,7,0.806211180124224,112,118,133,136,186,192,200,203,"AAGATGG","GGGA","ATCATGA","CTGA",2.39779935097459,15,50,8,82,1.89047145570123,4.46895011554962,7.69379483604651,101,"ENSG00000079974.19"
"11797","ENSG00000136111.14_165184",165176,165184,9,"ENSG00000136111.14",1,3,"UVMVVVVVV",1,7,0.785507246376811,101,107,133,136,150,156,165,168,"AGGATGA","TAGA","GGCATGA","CTGA",2.4677957261905,26,14,9,58,1.75499680139706,4.55174207733343,7.69377106284068,101,"ENSG00000079974.19"
"40460","ENSG00000256389.2_164148",164140,164148,9,"ENSG00000256389.2",1,8,"VVVVVVUMV",1,7,0.770186335403727,75,81,95,98,110,116,133,136,"GTGAAGG","CAGA","CTAAAGA","CTGA",2.40366013174179,14,12,17,52,2.42764947298967,4.61301258781706,7.69375792943197,101,"ENSG00000079974.19"
"17056","ENSG00000153046.18_88417",88409,88417,9,"ENSG00000153046.18",1,8,"VVVUVVVMV",1,7,0.764803312629399,114,120,133,136,140,146,189,192,"GTGATGA","CGGG","GGGAGGG","CTGA",2.50402292256987,13,4,43,69,1.84452436195051,4.63450262810407,7.69371587862167,101,"ENSG00000079974.19"
"30629","ENSG00000206120.11_226465",226457,226465,9,"ENSG00000206120.11",1,2,"UMVVVVVVV",1,7,0.786749482401656,112,118,133,136,146,152,165,168,"TGGGTGA","CAGA","TTTAAGA","CTGA",2.31857452787751,15,10,13,47,2.72958867563711,4.54668804870513,7.69368597831176,101,"ENSG00000079974.19"
"26637","ENSG00000184672.12_447410",447402,447410,9,"ENSG00000184672.12",0,NA,"VVUVVUVVV",2,7,0.805797101449275,46,52,62,65,116,122,133,136,"AAGATTA","ATGA","AGAATGA","CTGA",2.39641981344769,10,51,11,81,1.90573149622273,4.4704658964685,7.6936543022656,101,"ENSG00000079974.19"
"41110","ENSG00000258551.7_237080",237072,237080,9,"ENSG00000258551.7",1,1,"MVVVVUVVV",1,7,0.82815734989648,102,108,133,136,142,148,204,207,"GTTATGA","CTTA","AAGAAAA","CTGA",2.45518156090395,25,6,56,96,1.15614249586993,4.38100489214074,7.69363429172666,101,"ENSG00000079974.19"
"46725","ENSG00000287100.3_170965",170957,170965,9,"ENSG00000287100.3",1,8,"VVVVUVVMV",1,7,0.773913043478261,109,115,133,136,142,148,157,160,"TTGAGGT","GAGA","ATGAGGA","CTGA",2.35884998765599,18,6,9,42,2.66619820572753,4.5979661975252,7.69361837143825,101,"ENSG00000079974.19"
"31191","ENSG00000218336.9_530351",530343,530351,9,"ENSG00000218336.9",1,1,"MVVVUVVVV",1,7,0.795859213250517,116,122,133,136,148,154,206,209,"AAGATGA","TTCA","CTAATGT","CTGA",2.44476933721571,11,12,52,84,1.74218317149855,4.51016135490082,7.69359820790289,101,"ENSG00000079974.19"
"24601","ENSG00000177119.17_54190",54182,54190,9,"ENSG00000177119.17",1,8,"VVVVUVVMV",1,7,0.773913043478261,42,48,56,59,110,116,133,136,"GAGATGT","CTGA","CTGGAGA","CTGA",2.54434777270213,8,51,17,85,1.42940529119066,4.59793094396788,7.69358311788093,101,"ENSG00000079974.19"
"3140","ENSG00000081760.17_55930",55922,55930,9,"ENSG00000081760.17",1,7,"VVVVVUMVV",1,7,0.807453416149068,110,116,133,136,187,193,207,210,"ATGTTGT","GTCA","GTGATGC","CTGA",2.43420158367042,17,51,14,91,1.6270426747601,4.46376330814073,7.693576972737,101,"ENSG00000079974.19"
"14170","ENSG00000144468.17_38113",38105,38113,9,"ENSG00000144468.17",1,8,"VVVVVUVMV",1,7,0.806211180124224,115,121,133,136,183,189,197,200,"TTGAAAA","GTGA","CTGGTGA","CTGA",2.38394171557203,12,47,8,76,1.98197419281925,4.46872974082486,7.69357446132176,101,"ENSG00000079974.19"
"30978","ENSG00000214960.11_242749",242741,242749,9,"ENSG00000214960.11",1,2,"VMVVUVVVV",1,7,0.773913043478261,88,94,108,111,114,120,133,136,"ACTATGA","CTAA","GTAATAC","CTGA",2.36444290438101,14,3,13,39,2.62870264911643,4.59791383624747,7.69356601016051,101,"ENSG00000079974.19"
"233","ENSG00000006744.19_18514",18506,18514,9,"ENSG00000006744.19",1,8,"VVVUVVVMV",1,7,0.764803312629399,59,65,94,97,111,117,133,136,"GCGATGG","CTGA","GTGAACA","CTGA",2.56458973087413,29,14,16,68,1.43991204835812,4.63429423021309,7.69350748073068,101,"ENSG00000079974.19"
"13261","ENSG00000140836.17_317203",317195,317203,9,"ENSG00000140836.17",1,2,"VMVVVUVVV",1,7,0.806211180124223,107,113,133,136,140,146,162,165,"GTGATGA","ATGC","GGGATGA","CTGT",2.36801872934571,20,4,16,49,2.08785028724688,4.46866045405457,7.69350517455146,101,"ENSG00000079974.19"
"3462","ENSG00000084674.15_16032",16024,16032,9,"ENSG00000084674.15",1,8,"VVVVUVVMV",1,7,0.773913043478261,70,76,99,102,109,115,133,136,"ATGGTGT","CTTA","CTGAAAA","CTGA",2.4723428647625,23,7,18,57,1.90905161948311,4.59783434614162,7.69348652005466,101,"ENSG00000079974.19"
"40512","ENSG00000256717.1_29255",29247,29255,9,"ENSG00000256717.1",1,8,"UVVVVUVMV",2,6,0.708902691511387,112,118,133,136,141,147,155,158,"GTGAAGA","CAGA","ATGTCCA","CTGA",2.47970732175113,15,5,8,37,2.89994278903026,4.85783123350945,7.693441999555,101,"ENSG00000079974.19"
"26188","ENSG00000183644.14_16688",16680,16688,9,"ENSG00000183644.14",1,6,"UVVVVMVVV",1,7,0.805383022774327,114,120,133,136,145,151,164,167,"ATAATAA","CTAT","AGTATGA","CTGA",2.25200865954162,13,9,13,44,2.87402150436547,4.47185314199407,7.69338523309138,101,"ENSG00000079974.19"
"6955","ENSG00000112339.15_112059",112051,112059,9,"ENSG00000112339.15",1,5,"VVVVMUVVV",1,7,0.808695652173913,97,103,133,136,144,150,171,174,"TTGATTA","CTGG","GTGTGGG","CTGA",2.45158334778262,30,8,21,68,1.49050026063204,4.45859731146237,7.69337992015802,101,"ENSG00000079974.19"
"3003","ENSG00000080224.18_74162",74154,74162,9,"ENSG00000080224.18",1,2,"VMVUVVVVV",1,7,0.764803312629399,105,111,133,136,143,149,158,161,"GTGATGG","CTGA","CTGGAGA","CTGT",2.42973030874407,22,7,9,47,2.33841717154883,4.63415480746066,7.69336805797826,101,"ENSG00000079974.19"
"25900","ENSG00000183066.14_9825",9817,9825,9,"ENSG00000183066.14",1,6,"UVVVVMVVV",1,7,0.805383022774327,116,122,133,136,146,152,164,167,"CTAATGG","ATGT","GTTTTGA","CTGA",2.25582784578314,11,10,12,42,2.84848743502195,4.47183493506073,7.69336702615804,101,"ENSG00000079974.19"
"1077","ENSG00000047578.14_171576",171568,171576,9,"ENSG00000047578.14",1,5,"VVUVMVVVV",1,7,0.770186335403727,111,117,133,136,156,162,188,191,"CTGATGG","CTGG","TTGATGG","CTGA",2.56472773113916,16,20,26,71,1.35226789603989,4.61261319257523,7.69335853419014,101,"ENSG00000079974.19"
"587","ENSG00000020577.14_27804",27796,27804,9,"ENSG00000020577.14",1,1,"MVVVVVUVV",1,7,0.792132505175983,113,119,133,136,141,147,158,161,"CTGGTGC","AGGA","GTGCTGT","CTGA",2.27597617951458,14,5,11,39,2.92593659726229,4.52477778183987,7.6933078025438,101,"ENSG00000079974.19"
"39349","ENSG00000253500.6_210428",210420,210428,9,"ENSG00000253500.6",0,NA,"UVVVVUVVV",2,7,0.824844720496894,111,117,133,136,155,161,174,177,"TTTATGA","ATCA","TTAATAA","CTGA",2.32439227858208,16,19,13,57,2.07975136178488,4.39392497141635,7.69330385340393,101,"ENSG00000079974.19"
"19410","ENSG00000162924.16_5981",5973,5981,9,"ENSG00000162924.16",1,6,"VVUVVMVVV",1,7,0.786335403726708,33,39,48,51,74,80,133,136,"ATGATTA","TTGA","CTTAAGA","CTGA",2.57717108053466,9,23,53,94,1.01059282595309,4.54793334071271,7.69327495561954,101,"ENSG00000079974.19"
"490","ENSG00000013503.10_12068",12060,12068,9,"ENSG00000013503.10",1,6,"VVVVVMUVV",1,7,0.788819875776397,49,55,72,75,88,94,133,136,"ATGATGT","CTGA","ATGCTGC","CTTA",2.50166560286973,17,13,39,78,1.47408246365671,4.53796328736373,7.69324279046932,101,"ENSG00000079974.19"
"20067","ENSG00000164199.18_356259",356251,356259,9,"ENSG00000164199.18",1,5,"VVVVMVUVV",1,7,0.772670807453416,113,119,133,136,140,146,158,161,"TAGGTGA","TTGA","GAGATGG","CTGA",2.34084969828438,14,4,12,39,2.80452374081856,4.60254709901194,7.6932303288256,101,"ENSG00000079974.19"
"22365","ENSG00000170396.9_216645",216637,216645,9,"ENSG00000170396.9",0,NA,"UVVVUVVVV",2,7,0.792546583850932,62,68,100,103,112,118,133,136,"CTGATGA","GTGA","GTGAAGT","CAGA",2.4451506626038,32,9,15,65,1.79105372747402,4.52301453620817,7.69320087161189,101,"ENSG00000079974.19"
"29846","ENSG00000198796.7_123181",123173,123181,9,"ENSG00000198796.7",1,8,"VVVVVVUMV",1,7,0.770186335403727,77,83,98,101,115,121,133,136,"ATGAGGA","CAGA","GTGAAGC","TTGA",2.39380771313077,15,14,12,50,2.49110236331449,4.61245511271323,7.69320045432814,101,"ENSG00000079974.19"
"1013","ENSG00000044446.12_30922",30914,30922,9,"ENSG00000044446.12",0,NA,"VVVUVUVVV",2,7,0.802898550724638,84,90,105,108,115,121,133,136,"AGGAGGT","TTGA","GCATTGA","CTGA",2.25697406409338,15,7,12,43,2.87991769593812,4.48160286414016,7.69319706703871,101,"ENSG00000079974.19"
"383","ENSG00000010438.17_28372",28364,28372,9,"ENSG00000010438.17",1,6,"VVVUVMVVV",1,7,0.78343685300207,112,118,133,136,149,155,167,170,"ATGCGGA","CTGG","ATCCAGA","CTGA",2.35121844953928,15,13,12,49,2.56289048897069,4.55942003814147,7.69316745014975,101,"ENSG00000079974.19"
"33451","ENSG00000229876.1_1361",1353,1361,9,"ENSG00000229876.1",1,6,"VVVUVMVVV",1,7,0.78343685300207,114,120,133,136,145,151,187,190,"ATGCTGT","TTGA","GGGAAAA","CTGA",2.43709622930729,13,9,36,67,1.99029798614791,4.55940154538245,7.69314895739074,101,"ENSG00000079974.19"
"37014","ENSG00000244301.8_25890",25882,25890,9,"ENSG00000244301.8",1,8,"VVUVVVVMV",1,7,0.767701863354037,110,116,133,136,144,150,161,164,"ACAATGA","TGGA","CTCATGA","CTGA",2.36336308718214,17,8,11,45,2.73343017903204,4.62229602339491,7.69310347681106,101,"ENSG00000079974.19"
"44886","ENSG00000284084.1_8400",8392,8400,9,"ENSG00000284084.1",1,8,"VVUVVVVMV",1,7,0.767701863354037,110,116,133,136,144,150,161,164,"ACAATGA","TGGA","CTCATGA","CTGA",2.36336308718214,17,8,11,45,2.73343017903204,4.62229602339491,7.69310347681106,101,"ENSG00000079974.19"
"48298","ENSG00000290905.1_8389",8381,8389,9,"ENSG00000290905.1",1,8,"VVUVVVVMV",1,7,0.767701863354037,110,116,133,136,144,150,161,164,"ACAATGA","TGGA","CTCATGA","CTGA",2.36336308718214,17,8,11,45,2.73343017903204,4.62229602339491,7.69310347681106,101,"ENSG00000079974.19"
"25685","ENSG00000182541.18_59234",59226,59234,9,"ENSG00000182541.18",1,2,"VMVVVUVVV",1,7,0.806211180124223,110,116,133,136,182,188,211,214,"TTGTTGA","CTGT","TTGCTGA","CTGA",2.51357545399141,17,46,23,95,1.11585249456434,4.46825554696009,7.69310026745699,101,"ENSG00000079974.19"
"27696","ENSG00000187147.18_99430",99422,99430,9,"ENSG00000187147.18",1,8,"VVVUVVVMV",1,7,0.764803312629399,100,106,133,136,141,147,166,169,"ATAATGA","GTGA","GAGAGCA","CTGA",2.53891558499544,27,5,19,60,1.6093698688588,4.6338684422071,7.6930816927247,101,"ENSG00000079974.19"
"14809","ENSG00000145934.17_242291",242283,242291,9,"ENSG00000145934.17",1,8,"VVVVVVUMV",1,7,0.770186335403727,94,100,133,136,142,148,161,164,"GTGGTGA","ATGA","ATGTTTT","CTGA",2.47942224292375,33,6,13,61,1.91981386522994,4.61232387118039,7.6930692127953,101,"ENSG00000079974.19"
"27484","ENSG00000186297.12_7466",7458,7466,9,"ENSG00000186297.12",1,1,"MVVVVVUVV",1,7,0.792132505175983,112,118,133,136,182,188,202,205,"TTGATTT","CTCA","GTGATAA","CTGA",2.44727744186482,15,46,14,84,1.7829555588295,4.52453462614874,7.69306464685268,101,"ENSG00000079974.19"
"10339","ENSG00000130559.19_70079",70071,70079,9,"ENSG00000130559.19",1,1,"MVUVVUVVV",2,6,0.711801242236025,107,113,133,136,143,149,157,160,"ATGATGA","TAGA","GTGATGA","CTGT",2.53562768192383,20,7,8,44,2.47920207284263,4.84584665475038,7.69305162369448,101,"ENSG00000079974.19"
"45069","ENSG00000284977.3_221662",221654,221662,9,"ENSG00000284977.3",1,2,"UMVVVVVVV",1,7,0.786749482401656,107,113,133,136,159,165,176,179,"ACGATGA","TTGT","ATGATTC","CTGA",2.48024560708133,20,23,11,63,1.64921581842091,4.54604663307411,7.69304456268074,101,"ENSG00000079974.19"
"45135","ENSG00000285082.3_276895",276887,276895,9,"ENSG00000285082.3",1,2,"UMVVVVVVV",1,7,0.786749482401656,107,113,133,136,159,165,176,179,"ACGATGA","TTGT","ATGATTC","CTGA",2.48024560708133,20,23,11,63,1.64921581842091,4.54604663307411,7.69304456268074,101,"ENSG00000079974.19"
"26447","ENSG00000184271.18_10310",10302,10310,9,"ENSG00000184271.18",1,1,"MVVVVVUVV",1,7,0.792132505175983,81,87,95,98,111,117,133,136,"GTGATGT","CTGA","GAGAGTA","CTAA",2.3865152541328,8,13,16,46,2.18792049718829,4.52450554785174,7.69303556855567,101,"ENSG00000079974.19"
"1073","ENSG00000047410.14_63079",63071,63079,9,"ENSG00000047410.14",0,NA,"UVVVUVVVV",2,7,0.792546583850932,111,117,133,136,147,153,166,169,"ATAATGT","CTTG","TTGGTTA","CTGA",2.32469409625452,16,11,13,49,2.59331243076106,4.52281826811446,7.69300460351819,101,"ENSG00000079974.19"
"14630","ENSG00000145526.12_615463",615455,615463,9,"ENSG00000145526.12",1,2,"VMVVVUUVV",2,6,0.692339544513457,112,118,133,136,142,148,164,167,"AAGATGT","TTGA","ATGATCA","CTGA",2.55578441952644,15,6,16,46,2.65593009876324,4.92362322390154,7.69298140195537,101,"ENSG00000079974.19"
"641","ENSG00000021776.11_48096",48088,48096,9,"ENSG00000021776.11",0,NA,"VVVVVUUVV",2,7,0.808281573498965,103,109,133,136,142,148,171,174,"GTGATGA","ATGA","ATGGTGG","CTAA",2.44182822547021,24,6,23,62,1.5604917730087,4.45983665236919,7.69296294636505,101,"ENSG00000079974.19"
"32129","ENSG00000226051.10_97382",97374,97382,9,"ENSG00000226051.10",1,1,"MVVVVVUVV",1,7,0.792132505175983,102,108,133,136,141,147,158,161,"AAGATGG","CAGA","AGGACAA","CTGA",2.40114601741575,25,5,11,50,2.08975769953248,4.52434945390936,7.69287947461329,101,"ENSG00000079974.19"
"38047","ENSG00000249413.2_69565",69557,69565,9,"ENSG00000249413.2",1,7,"UVVVVVMVV",1,7,0.787991718426501,116,122,133,136,171,177,191,194,"GTGGTGA","TTAA","GTGAAAA","CTGA",2.44463741898842,11,35,14,69,1.86603011451685,4.54090322694325,7.69287010064925,101,"ENSG00000079974.19"
"5482","ENSG00000105088.9_47832",47824,47832,9,"ENSG00000105088.9",1,2,"UMVVVVVVV",1,7,0.786749482401656,75,81,95,98,109,115,133,136,"AAGATGA","CTGG","GTGAACA","CTGC",2.3622187853676,14,11,18,52,2.43533852907193,4.54586594121398,7.6928638708206,101,"ENSG00000079974.19"
"32082","ENSG00000225881.2_1425",1417,1425,9,"ENSG00000225881.2",1,7,"VVUVVVMVV",1,7,0.768944099378882,111,117,133,136,148,154,196,199,"ATTATAT","CTGA","ATGAAGA","CTGA",2.52761770680349,16,12,42,79,1.61747007485908,4.61706369672058,7.69284009423611,101,"ENSG00000079974.19"
"9021","ENSG00000122223.13_25124",25116,25124,9,"ENSG00000122223.13",1,8,"VVVVVVUMV",1,7,0.770186335403727,82,88,102,105,107,113,133,136,"CTGCTGT","CAGA","GTGGTGA","CTGA",2.46550835743749,14,2,20,45,2.01156115189909,4.61207088370392,7.69281622531883,101,"ENSG00000079974.19"
"23846","ENSG00000174469.23_1156433",1156425,1156433,9,"ENSG00000174469.23",1,1,"MVVVVUVVV",1,7,0.82815734989648,89,95,110,113,116,122,133,136,"AGGTTGA","CTGT","TTGATGG","CAGA",2.22966647964378,15,3,11,38,2.65595836413498,4.38010039044005,7.69272979002597,101,"ENSG00000079974.19"
"33262","ENSG00000229140.12_986313",986305,986313,9,"ENSG00000229140.12",0,NA,"UVUVVVVVV",2,7,0.786335403726708,112,118,133,136,170,176,186,189,"ATGCTGA","CATA","GTGCAGG","CTGA",2.43839690064131,15,34,10,68,1.9335456103633,4.54738123699301,7.69272285189984,101,"ENSG00000079974.19"
"35740","ENSG00000236922.10_6677",6669,6677,9,"ENSG00000236922.10",1,5,"UVVVMVVVV",1,7,0.789233954451346,65,71,87,90,101,107,133,136,"ATGGAGA","TTGA","ATTAAGA","CTGA",2.43500471030063,16,11,26,62,1.90931333192623,4.53566951681594,7.69260533462132,101,"ENSG00000079974.19"
"3483","ENSG00000085185.16_13317",13309,13317,9,"ENSG00000085185.16",1,1,"MVVVVVUVV",1,7,0.792132505175983,114,120,133,136,149,155,202,205,"ATGAGGA","CGTA","ATGCTAA","CTGA",2.46023353770154,13,13,47,82,1.69456846755712,4.52403134639184,7.69256136709578,101,"ENSG00000079974.19"
"27230","ENSG00000185760.18_546022",546014,546022,9,"ENSG00000185760.18",1,1,"MVVVVUVVV",1,7,0.82815734989648,66,72,83,86,93,99,133,136,"AAGATGG","CTGA","CAGAAGA","CAGA",2.3221931470928,11,7,34,61,2.03832987594811,4.37990438080837,7.69253378039429,101,"ENSG00000079974.19"
"46118","ENSG00000286203.1_5288",5280,5288,9,"ENSG00000286203.1",1,8,"VVVVVVUMV",1,7,0.770186335403727,85,91,99,102,113,119,133,136,"CTCATGG","ATGA","GTGGTAA","CTGA",2.39878938706153,8,11,14,42,2.4549890654275,4.61172957812609,7.692474919741,101,"ENSG00000079974.19"
"16879","ENSG00000152578.14_114209",114201,114209,9,"ENSG00000152578.14",0,NA,"UVVVVUVVV",2,7,0.824844720496894,112,118,133,136,141,147,200,203,"ATGAACA","ATGA","AAGATAC","CTGA",2.35952974545097,15,5,53,82,1.84212534870238,4.39308091292722,7.69245979491479,101,"ENSG00000079974.19"
"17748","ENSG00000155011.9_351657",351649,351657,9,"ENSG00000155011.9",0,NA,"UVUVVVVVV",2,7,0.786335403726708,43,49,65,68,113,119,133,136,"TTTAGGA","CTGA","ATGAACA","CTGA",2.47148047836121,16,45,14,84,1.71188166208456,4.54710454612316,7.69244616102999,101,"ENSG00000079974.19"
"38795","ENSG00000251027.2_2882",2874,2882,9,"ENSG00000251027.2",1,1,"MVVVUVVVV",1,7,0.795859213250517,110,116,133,136,139,145,175,178,"GCGAAGA","CTCA","GTGAAGA","CTGA",2.46798133427169,17,3,30,59,1.58244432614087,4.50891330532137,7.69235015832344,101,"ENSG00000079974.19"
"9582","ENSG00000125675.20_253383",253375,253383,9,"ENSG00000125675.20",1,6,"UVVVVMVVV",1,7,0.805383022774327,113,119,133,136,167,173,186,189,"GTCATGC","CTGG","AGGAAGA","CTGA",2.39366364923792,14,31,13,67,1.92546831714984,4.47080649468399,7.6923385857813,101,"ENSG00000079974.19"
"24258","ENSG00000175600.16_324656",324648,324656,9,"ENSG00000175600.16",1,1,"MVVUVVVVV",1,7,0.786749482401656,109,115,133,136,143,149,159,162,"GTAAGGA","GTGA","GAGTTGG","CTGA",2.32594512732888,18,7,10,44,2.67501603524971,4.54532922102723,7.69232715063385,101,"ENSG00000079974.19"
"28623","ENSG00000196277.16_128859",128851,128859,9,"ENSG00000196277.16",1,8,"VVVUVVVMV",1,7,0.764803312629399,109,115,133,136,141,147,155,158,"ATGAAGA","CTGG","CTGATAA","GTGA",2.38818440673173,18,5,8,40,2.6110837409858,4.63307827979933,7.69229153031693,101,"ENSG00000079974.19"
"38267","ENSG00000249859.14_196076",196068,196076,9,"ENSG00000249859.14",0,NA,"VVVVUVUVV",2,7,0.775983436853002,85,91,133,136,143,149,164,167,"ATCATGA","GTGG","GAGAAGA","CTGA",2.48033190927961,42,7,15,73,1.81777121736551,4.5883293198074,7.69226306721941,101,"ENSG00000079974.19"
"38338","ENSG00000250025.2_67900",67892,67900,9,"ENSG00000250025.2",1,8,"VVVVVVUMV",1,7,0.770186335403727,116,122,133,136,162,168,178,181,"GTGATGA","AGGA","ACAGTGA","CTGA",2.45504066434168,11,26,10,56,2.07911204100255,4.6115124508201,7.692257792435,101,"ENSG00000079974.19"
"13961","ENSG00000144040.13_21879",21871,21879,9,"ENSG00000144040.13",1,1,"MVVVVUVVV",1,7,0.82815734989648,87,93,133,136,152,158,166,169,"TTGAGGA","CCTA","CTGGTGA","CTGA",2.40723918603396,40,16,8,73,1.47022665718015,4.37962197435164,7.69225137393756,101,"ENSG00000079974.19"
"15219","ENSG00000147408.16_174450",174442,174450,9,"ENSG00000147408.16",1,2,"UMVVVUVVV",2,6,0.708902691511387,53,59,72,75,86,92,133,136,"TTGATGA","TTGA","CTGCTGC","CTGA",2.63685655994491,13,11,41,74,1.84748944201563,4.85663329374542,7.69224405979097,101,"ENSG00000079974.19"
"311","ENSG00000008086.13_205122",205114,205122,9,"ENSG00000008086.13",1,5,"VVUVMVVVV",1,7,0.770186335403727,114,120,133,136,138,144,162,165,"TTAATGA","CTAA","ATGAAAC","CTGA",2.44073119425875,13,2,18,42,2.17432901152422,4.61146757664565,7.69221291826055,101,"ENSG00000079974.19"
"38294","ENSG00000249894.1_82727",82719,82727,9,"ENSG00000249894.1",1,2,"VMVVVVUVV",1,7,0.770186335403727,113,119,133,136,177,183,230,233,"TTGATGA","ATGA","TGGAAGA","CTGA",2.62063643258977,14,41,47,111,0.974805233912822,4.61142869612782,7.69217403774273,101,"ENSG00000079974.19"
"38560","ENSG00000250421.5_95231",95223,95231,9,"ENSG00000250421.5",1,2,"VMVVVVUVV",1,7,0.770186335403727,113,119,133,136,177,183,230,233,"TTGATGA","ATGA","TGGAAGA","CTGA",2.62063643258977,14,41,47,111,0.974805233912822,4.61142869612782,7.69217403774273,101,"ENSG00000079974.19"
"66","ENSG00000003402.21_7946",7938,7946,9,"ENSG00000003402.21",1,1,"MVVVVUVVV",1,7,0.82815734989648,95,101,133,136,171,177,189,192,"ACGATGA","GGGA","ATGCTGC","CTGA",2.47750833836706,32,35,12,88,1.00139822917296,4.37953012123834,7.69215952082426,101,"ENSG00000079974.19"
"13253","ENSG00000140836.17_148594",148586,148594,9,"ENSG00000140836.17",1,3,"VVMVVUVVV",1,7,0.804968944099379,88,94,133,136,149,155,163,166,"TTGATGA","GTGA","GTGAAGC","CTGG",2.43191552300685,39,13,8,69,1.6763632539824,4.47228335184034,7.69215912823786,101,"ENSG00000079974.19"
"34349","ENSG00000232825.3_190708",190700,190708,9,"ENSG00000232825.3",1,2,"VMVVVVUVV",1,7,0.770186335403727,109,115,133,136,150,156,184,187,"ATCATGG","CTGA","TTAACGA","CTGA",2.54728388630338,18,14,28,69,1.46367658456619,4.61139228998052,7.69213763159542,101,"ENSG00000079974.19"
"33580","ENSG00000230426.5_305417",305409,305417,9,"ENSG00000230426.5",1,2,"UMVVVVVVV",1,7,0.786749482401656,116,122,133,136,149,155,165,168,"ATAATGA","CTGG","TTGATTT","CTTA",2.3248813010691,11,13,10,43,2.68131653712662,4.54513130273016,7.69212923233678,101,"ENSG00000079974.19"
"14445","ENSG00000145012.14_23838",23830,23838,9,"ENSG00000145012.14",1,1,"MVVVVUVVV",1,7,0.82815734989648,107,113,133,136,142,148,156,159,"CTGAGGG","CTAG","ATGAGGC","CTGA",2.2576920048959,20,6,8,43,2.46670614397083,4.37949654415254,7.69212594373846,101,"ENSG00000079974.19"
"44012","ENSG00000276644.5_94655",94647,94655,9,"ENSG00000276644.5",1,3,"VVMVVVUVV",1,7,0.768944099378882,106,112,133,136,144,150,195,198,"ATGATTA","AGGA","GTGATGC","CTGA",2.55923216618226,21,8,45,83,1.40381495094244,4.61634068137271,7.69211707888824,101,"ENSG00000079974.19"
"35605","ENSG00000236451.3_16977",16969,16977,9,"ENSG00000236451.3",1,6,"VVVUVMVVV",1,7,0.78343685300207,49,55,74,77,81,87,133,136,"ATGATGA","CTGG","GTGAGGC","GTGA",2.52189350618051,19,4,46,78,1.42053786839031,4.55829031073175,7.69203772274003,101,"ENSG00000079974.19"
"16459","ENSG00000151572.18_33826",33818,33826,9,"ENSG00000151572.18",1,8,"VVUVVVVMV",1,7,0.767701863354037,111,117,133,136,139,145,169,172,"CTGCTGA","CAGA","CTGAGCA","CTGA",2.49479111364112,16,3,24,52,1.85287469062785,4.62120386205882,7.69201131547497,101,"ENSG00000079974.19"
"16280","ENSG00000151276.24_582739",582731,582739,9,"ENSG00000151276.24",1,2,"UMVVVVVVV",1,7,0.786749482401656,111,117,133,136,146,152,163,166,"AAGATGG","GTGA","GTGATGG","GTGA",2.31810525187146,16,10,11,46,2.72599856804707,4.54500839513087,7.69200632473749,101,"ENSG00000079974.19"
"24315","ENSG00000175779.5_505704",505696,505704,9,"ENSG00000175779.5",0,NA,"UVVVVUVVV",2,7,0.824844720496894,101,107,133,136,143,149,190,193,"GTTCTCA","CTGA","ATGATGA","CTGA",2.46299519349978,26,7,41,83,1.15039804760173,4.39259150106673,7.69197038305431,101,"ENSG00000079974.19"
"28145","ENSG00000188215.10_12642",12634,12642,9,"ENSG00000188215.10",1,8,"VVVVVVUMV",1,7,0.770186335403727,115,121,133,136,142,148,157,160,"CAGATAA","CAGA","ATGCAAA","CTGA",2.30394432560396,12,6,9,36,3.08515402764691,4.61119571625166,7.69194105786657,101,"ENSG00000079974.19"
"28908","ENSG00000196678.14_12633",12625,12633,9,"ENSG00000196678.14",1,8,"VVVVVVUMV",1,7,0.770186335403727,115,121,133,136,142,148,157,160,"CAGATAA","CAGA","ATGCAAA","CTGA",2.30394432560396,12,6,9,36,3.08515402764691,4.61119571625166,7.69194105786657,101,"ENSG00000079974.19"
"27166","ENSG00000185666.15_3419",3411,3419,9,"ENSG00000185666.15",1,1,"MVUVVVVVV",1,7,0.789648033126294,110,116,133,136,143,149,170,173,"GTGTTGG","TTGA","TTTAGGA","CTGA",2.38764512638715,17,7,21,54,2.21537333202209,4.5332518769841,7.69184400948927,101,"ENSG00000079974.19"
"30111","ENSG00000203721.8_129367",129359,129367,9,"ENSG00000203721.8",0,NA,"VVUVVUVVV",2,7,0.805797101449275,75,81,94,97,107,113,133,136,"ATAATGA","GTGA","ATTCTGA","CTCA",2.31959246723482,13,10,20,52,2.41052112524927,4.46861772670369,7.69180613250079,101,"ENSG00000079974.19"
"21949","ENSG00000169372.13_56071",56063,56071,9,"ENSG00000169372.13",1,8,"VVUVVVVMV",1,7,0.767701863354037,106,112,133,136,180,186,196,199,"ATGAGGA","GTGT","GTGATGT","CTGA",2.56063300240404,21,44,10,84,1.41303174841317,4.62097960777669,7.69178706119284,101,"ENSG00000079974.19"
"47274","ENSG00000287918.2_44167",44159,44167,9,"ENSG00000287918.2",1,8,"VVVVUVVMV",1,7,0.773913043478261,114,120,133,136,158,164,212,215,"GTGGTGA","CTAA","ATGTTGA","CTGA",2.57721815758058,13,22,48,92,1.20303477507243,4.59612228973574,7.69177446364878,101,"ENSG00000079974.19"
"10403","ENSG00000130856.18_82357",82349,82357,9,"ENSG00000130856.18",1,8,"UVVVVVVMV",1,7,0.786749482401656,113,119,133,136,182,188,205,208,"GTGATGT","TAGA","TTGAGGC","CTGA",2.47731306153926,14,46,17,86,1.66364140268285,4.54476545323614,7.69176338284277,101,"ENSG00000079974.19"
"19652","ENSG00000163563.8_9835",9827,9835,9,"ENSG00000163563.8",1,1,"MVVVUVVVV",1,7,0.795859213250517,74,80,99,102,116,122,133,136,"AGGAAGA","CAGA","ATTAGCA","CTGA",2.37714033830686,19,14,11,53,2.18557171655287,4.50829349298298,7.69173034598505,101,"ENSG00000079974.19"
"14979","ENSG00000146426.19_357349",357341,357349,9,"ENSG00000146426.19",1,2,"VMVVVUVVV",1,7,0.806211180124223,87,93,133,136,147,153,171,174,"GGGAAGA","CTGA","TTTATAA","CTGA",2.45921955167941,40,11,18,78,1.47261288279368,4.46685247349744,7.69169719399434,101,"ENSG00000079974.19"
"13944","ENSG00000144028.15_46235",46227,46235,9,"ENSG00000144028.15",1,8,"VVVVUVVMV",1,7,0.773913043478261,116,122,133,136,143,149,160,163,"TGGATGT","GAGA","GTGATTC","CTGA",2.30452950185615,11,7,11,38,3.0203974279366,4.59598186007773,7.69163403399077,101,"ENSG00000079974.19"
"24070","ENSG00000175061.20_778",770,778,9,"ENSG00000175061.20",1,7,"VVVVUVMVV",1,7,0.775155279503105,96,102,133,136,137,143,158,161,"CTGATGA","ATAA","CTGACGA","CTGA",2.57837217108931,31,1,15,56,1.17487389082426,4.59100542452158,7.691626542534,101,"ENSG00000079974.19"
"44038","ENSG00000277108.1_40",32,40,9,"ENSG00000277108.1",1,7,"VVVVUVMVV",1,7,0.775155279503105,5,11,42,45,46,52,67,70,"CTGATGA","ATAA","CTGACGA","CTGA",2.57837217108931,31,1,15,56,1.17487389082426,4.59100542452158,7.691626542534,101,"ENSG00000079974.19"
"32757","ENSG00000227743.2_6025",6017,6025,9,"ENSG00000227743.2",1,1,"MVVVUVVVV",1,7,0.795859213250517,107,113,133,136,147,153,163,166,"GGGATTA","CTTA","TTGACTA","CTGA",2.35596762396066,20,11,10,50,2.32619689751981,4.50816193098105,7.69159878398312,101,"ENSG00000079974.19"
"946","ENSG00000041515.16_190091",190083,190091,9,"ENSG00000041515.16",1,8,"VVVVVUVMV",1,7,0.806211180124224,116,122,133,136,141,147,166,169,"GTCATCA","CTAT","ATGATGC","CTGA",2.30645967901558,11,5,19,44,2.49023833375704,4.46665904846522,7.69150376896212,101,"ENSG00000079974.19"
"33295","ENSG00000229267.3_113341",113333,113341,9,"ENSG00000229267.3",0,NA,"UVVVVVUVV",2,7,0.788819875776397,82,88,133,136,150,156,172,175,"CTGCTGA","CTGC","GTGTAGA","CTGA",2.51444670086163,45,14,16,84,1.38159849546814,4.53614412530308,7.69142362840867,101,"ENSG00000079974.19"
"9356","ENSG00000124209.4_42976",42968,42976,9,"ENSG00000124209.4",1,8,"VVVVUVVMV",1,7,0.773913043478261,113,119,133,136,150,156,164,167,"GTGATGA","GTGT","TTGATGT","ATGA",2.37148809078206,14,14,8,45,2.57287265732546,4.5956983156348,7.69135048954785,101,"ENSG00000079974.19"
"38789","ENSG00000251026.2_314138",314130,314138,9,"ENSG00000251026.2",1,2,"VMUVVVVVV",1,7,0.767701863354037,73,79,94,97,110,116,133,136,"ATGATTA","TTGA","ATGAGGA","CTAA",2.4271047195308,15,13,17,54,2.3013306921513,4.62050720558916,7.69131465900531,101,"ENSG00000079974.19"
"19288","ENSG00000162669.16_8296",8288,8296,9,"ENSG00000162669.16",0,NA,"UVUVVVVVV",2,7,0.786335403726708,110,116,133,136,150,156,166,169,"ATGATAT","GAGA","GGGATAA","CTGA",2.37079024257216,17,14,10,50,2.37853307465676,4.5459503396178,7.69129195452463,101,"ENSG00000079974.19"
"29454","ENSG00000198010.13_390176",390168,390176,9,"ENSG00000198010.13",1,1,"MVVVVUVVV",1,7,0.82815734989648,113,119,133,136,144,150,202,205,"TGGATGT","TGGA","TTGATGT","CTGA",2.33435510734274,14,8,52,83,1.95205863569821,4.37860650449578,7.6912359040817,101,"ENSG00000079974.19"
"8023","ENSG00000116539.14_87306",87298,87306,9,"ENSG00000116539.14",1,1,"MVUVVVVVV",1,7,0.789648033126294,111,117,133,136,149,155,178,181,"GTGATAA","GAGA","ATGGGGA","CTGA",2.43595426200797,16,13,23,61,1.89071680282797,4.53260297072028,7.69119510322546,101,"ENSG00000079974.19"
"39143","ENSG00000253108.1_42381",42373,42381,9,"ENSG00000253108.1",1,2,"VMVVVUVVV",1,7,0.806211180124223,115,121,133,136,139,145,163,166,"ATTATGC","TTGT","TTCAAGA","CTGA",2.32661760540287,12,3,18,42,2.35450764382418,4.46632291996083,7.69116764045772,101,"ENSG00000079974.19"
"19958","ENSG00000164066.13_37384",37376,37384,9,"ENSG00000164066.13",1,1,"MVVVVUVVV",1,7,0.82815734989648,103,109,133,136,158,164,189,192,"AGGATGG","AAGA","GTGATGA","CTGA",2.52291016558277,24,22,25,80,0.694640960509112,4.37851051609857,7.69113991568449,101,"ENSG00000079974.19"
"334","ENSG00000008394.13_43615",43607,43615,9,"ENSG00000008394.13",0,NA,"UVVUVVVVV",2,7,0.78343685300207,85,91,101,104,111,117,133,136,"TTGATGA","TTGA","GTCATTG","CTGC",2.33014806573642,10,7,16,42,2.69523991124441,4.5573900873718,7.69113749938008,101,"ENSG00000079974.19"
"35243","ENSG00000235450.1_69913",69905,69913,9,"ENSG00000235450.1",1,8,"UVVVVVVMV",1,7,0.786749482401656,97,103,133,136,145,151,160,163,"ATGATGA","CCTA","ATGGTGA","ATGA",2.42755611804814,30,9,9,57,1.99275396849073,4.54411535553625,7.69111328514287,101,"ENSG00000079974.19"
"29169","ENSG00000197381.18_47211",47203,47211,9,"ENSG00000197381.18",1,2,"VMUVVVVVV",1,7,0.767701863354037,88,94,102,105,111,117,133,136,"ATGCTAA","ATGA","GTGTCTA","CTGA",2.39442455557514,8,6,16,39,2.51825975201164,4.62027253062815,7.69107998404429,101,"ENSG00000079974.19"
"28308","ENSG00000188641.14_76214",76206,76214,9,"ENSG00000188641.14",0,NA,"UVVVVVUVV",2,7,0.788819875776397,114,120,133,136,159,165,188,191,"TTGATAA","CTTG","GTGATGA","CTGA",2.49234046086189,13,23,23,68,1.5274106480976,4.53575343012755,7.69103293323314,101,"ENSG00000079974.19"
"35453","ENSG00000236098.1_3732",3724,3732,9,"ENSG00000236098.1",0,NA,"VVVVVUUVV",2,7,0.808281573498965,81,87,104,107,114,120,133,136,"CAGATGA","TTGA","GGGAAGA","TTGA",2.27296403471351,17,7,13,46,2.67822954676562,4.45783077788059,7.69095707187645,101,"ENSG00000079974.19"
"22571","ENSG00000170871.12_26082",26074,26082,9,"ENSG00000170871.12",1,1,"MVVVVUVVV",1,7,0.82815734989648,68,74,93,96,103,109,133,136,"CTGATGA","CTCA","ATGCAGT","CTCA",2.34338811313318,19,7,24,59,1.89062365800564,4.37830276972337,7.69093216930929,101,"ENSG00000079974.19"
"27664","ENSG00000187097.13_16991",16983,16991,9,"ENSG00000187097.13",1,1,"MVVVUVVVV",1,7,0.795859213250517,113,119,133,136,137,143,158,161,"TTGATTT","CAGA","CTGCTGT","CTGA",2.38174895186042,14,1,15,39,2.15150064534778,4.50745674777098,7.69089360077305,101,"ENSG00000079974.19"
"40635","ENSG00000257242.9_81579",81571,81579,9,"ENSG00000257242.9",1,6,"UVVVVMVVV",1,7,0.805383022774327,20,26,43,46,96,102,133,136,"ATGATGA","GTGA","ATGCTGA","CTGT",2.55213797350453,17,50,31,107,0.86310319428995,4.4693390877467,7.69087117884401,101,"ENSG00000079974.19"
"38843","ENSG00000251138.7_481730",481722,481730,9,"ENSG00000251138.7",1,1,"MVUVVVVVV",1,7,0.789648033126294,44,50,58,61,111,117,133,136,"ATGAAGA","CTGA","AAGATGA","CTAA",2.49578535035817,8,50,16,83,1.49049525356423,4.53226606398801,7.69085819649319,101,"ENSG00000079974.19"
"7443","ENSG00000114279.15_201481",201473,201481,9,"ENSG00000114279.15",1,6,"VVVUVMVVV",1,7,0.78343685300207,101,107,133,136,150,156,171,174,"TTCATGA","GTGA","CTGAGGC","CTGA",2.49823646418444,26,14,15,64,1.57347298356681,4.5570956861991,7.69084309820738,101,"ENSG00000079974.19"
"43888","ENSG00000275016.5_140947",140939,140947,9,"ENSG00000275016.5",1,2,"VMVVVVUVV",1,7,0.770186335403727,116,122,133,136,143,149,160,163,"ATTATGC","CTCT","GTGAAAT","CTGA",2.31298834331851,11,7,11,38,3.0203974279366,4.61007992918166,7.69082527079657,101,"ENSG00000079974.19"
"15544","ENSG00000148655.15_687458",687450,687458,9,"ENSG00000148655.15",1,1,"MVVVVUVVV",1,7,0.82815734989648,52,58,64,67,72,78,133,136,"AGGATGA","CTGA","ATGACAC","TTGA",2.41397909639022,6,5,55,75,1.419568010416,4.3781904965877,7.69081989617362,101,"ENSG00000079974.19"
"12039","ENSG00000136928.7_262087",262079,262087,9,"ENSG00000136928.7",1,7,"VVVVUVMVV",1,7,0.775155279503105,68,74,88,91,96,102,133,136,"ATCCTGA","TTGA","GTGCTCA","CTGA",2.45373033209391,14,5,31,59,2.00249747773152,4.59017492292273,7.69079604093515,101,"ENSG00000079974.19"
"14854","ENSG00000145982.13_388824",388816,388824,9,"ENSG00000145982.13",1,7,"VVVVVUMVV",1,7,0.807453416149068,116,122,133,136,147,153,205,208,"CTCATGA","GTAA","GTGAGGC","CTGA",2.404874229711,11,11,52,83,1.81142231388203,4.46097929465551,7.69079295925178,101,"ENSG00000079974.19"
"8656","ENSG00000120156.22_114957",114949,114957,9,"ENSG00000120156.22",1,5,"UVVVMVVVV",1,7,0.789233954451346,82,88,102,105,113,119,133,136,"ATGTTTA","TCGA","TCGAAGA","CTGA",2.29609824590003,14,8,14,45,2.8279150943933,4.53380918343171,7.6907450012371,101,"ENSG00000079974.19"
"46811","ENSG00000287226.1_140318",140310,140318,9,"ENSG00000287226.1",1,8,"VVVVVUVMV",1,7,0.806211180124224,85,91,133,136,147,153,161,164,"GTGAAGA","CTCA","ACCATGC","CTGA",2.40714459553931,42,11,8,70,1.81591667644501,4.46588682834344,7.69073154884034,101,"ENSG00000079974.19"
"40142","ENSG00000255093.2_20258",20250,20258,9,"ENSG00000255093.2",1,8,"VVVVVUVMV",1,7,0.806211180124224,115,121,133,136,166,172,182,185,"TGGAAGA","TTGA","GTGATCC","CTGA",2.37185025379755,12,30,10,61,2.05116258935466,4.46587440366791,7.69071912416481,101,"ENSG00000079974.19"
"3750","ENSG00000088812.18_176972",176964,176972,9,"ENSG00000088812.18",1,8,"VVVUVVVMV",1,7,0.764803312629399,72,78,96,99,116,122,133,136,"CTGATAA","CTCA","TTGAGCA","CTGA",2.46685868506992,18,17,11,55,2.08028603514722,4.63150265057,7.6907159010876,101,"ENSG00000079974.19"
"37727","ENSG00000248724.6_146751",146743,146751,9,"ENSG00000248724.6",1,6,"UVVVVMVVV",1,7,0.805383022774327,105,111,133,136,146,152,168,171,"ATATTGA","CTTA","TTTATGC","CTGA",2.38243049517697,22,10,16,57,1.99375158695654,4.46915538870075,7.69068747979806,101,"ENSG00000079974.19"
"16501","ENSG00000151694.15_32201",32193,32201,9,"ENSG00000151694.15",1,7,"VVVVUVMVV",1,7,0.775155279503105,62,68,96,99,110,116,133,136,"GTGAAGA","TTGA","GTGCGGG","CTGA",2.51241237113719,28,11,17,65,1.61067602648479,4.59002295851651,7.69064407652894,101,"ENSG00000079974.19"
"1511","ENSG00000058272.19_58909",58901,58909,9,"ENSG00000058272.19",0,NA,"VVVVVUUVV",2,7,0.808281573498965,100,106,133,136,142,148,169,172,"GTGTTGA","GTGT","GTGTAGA","CTGA",2.44249764315629,27,6,21,63,1.54674661666196,4.45751605942598,7.69064235342184,101,"ENSG00000079974.19"
"22424","ENSG00000170545.17_17614",17606,17614,9,"ENSG00000170545.17",1,1,"MVVVVVUVV",1,7,0.792132505175983,97,103,133,136,141,147,167,170,"ATGATTC","CTGA","ATTCTGC","CTGA",2.48954538518759,30,5,20,64,1.49141107986836,4.52209507861307,7.690625099317,101,"ENSG00000079974.19"
"24901","ENSG00000178568.15_456989",456981,456989,9,"ENSG00000178568.15",1,2,"UMVVVVVVV",1,7,0.786749482401656,107,113,133,136,142,148,157,160,"CTGATGT","ATGT","ATAAAAA","CTGA",2.35394208122536,20,6,9,44,2.48149002712665,4.54360930882393,7.69060723843056,101,"ENSG00000079974.19"
"30755","ENSG00000213121.2_15035",15027,15035,9,"ENSG00000213121.2",1,6,"UVVVVMVVV",1,7,0.805383022774327,81,87,101,104,113,119,133,136,"ATGATTA","TAGA","ATGTAGA","CTTA",2.26293500298115,14,9,14,46,2.78995296156916,4.46904657869421,7.69057866979152,101,"ENSG00000079974.19"
"29285","ENSG00000197585.10_344657",344649,344657,9,"ENSG00000197585.10",1,8,"VVVVVUVMV",1,7,0.806211180124224,116,122,133,136,146,152,163,166,"AAGCTGA","TTGT","ATAGAGA","CTGA",2.24699623650398,11,10,11,41,2.88295945323706,4.4657335908159,7.69057831131279,101,"ENSG00000079974.19"
"34976","ENSG00000234548.7_2377",2369,2377,9,"ENSG00000234548.7",0,NA,"UVVVVUVVV",2,7,0.824844720496894,112,118,133,136,137,143,151,154,"GTGTTGA","CTTA","ATGTTGG","CTGG",2.27118183031592,15,1,8,33,2.42358477214728,4.39119924356335,7.69057812555093,101,"ENSG00000079974.19"
"13748","ENSG00000143341.12_5653",5645,5653,9,"ENSG00000143341.12",1,1,"MVVVVVUVV",1,7,0.792132505175983,90,96,104,107,116,122,133,136,"CTGATAA","CTGA","GGGAACA","CAGA",2.30126245987771,8,9,11,37,2.7463316740588,4.52202035164422,7.69055037234815,101,"ENSG00000079974.19"
"28175","ENSG00000188342.12_57308",57300,57308,9,"ENSG00000188342.12",1,8,"UVVVVVVMV",1,7,0.786749482401656,115,121,133,136,148,154,178,181,"GTGAAGA","CACA","CTGTGGA","CTGA",2.41415610485839,12,12,24,57,2.07981363993495,4.54354691808106,7.69054484768769,101,"ENSG00000079974.19"
"26498","ENSG00000184305.16_531806",531798,531806,9,"ENSG00000184305.16",1,2,"UMVVVVVVV",1,7,0.786749482401656,112,118,133,136,146,152,165,168,"TTGATTC","CTGG","CTCTTGA","CTGA",2.31668096789744,15,10,13,47,2.72958867563711,4.54353211540501,7.69053004501164,101,"ENSG00000079974.19"
"11037","ENSG00000133687.16_215918",215910,215918,9,"ENSG00000133687.16",0,NA,"UVVVVUVVV",2,7,0.824844720496894,114,120,133,136,179,185,225,228,"GTGATGG","CAGA","GAAATGC","CTGA",2.48162598794732,13,43,40,105,1.02016791491685,4.39108529197475,7.69046417396232,101,"ENSG00000079974.19"
"9349","ENSG00000124203.7_86972",86964,86972,9,"ENSG00000124203.7",1,8,"VVVVVUVMV",1,7,0.806211180124224,86,92,133,136,172,178,194,197,"ATGCTGA","CAGT","GTGAGGA","CTGA",2.56294394847137,41,36,16,102,0.775988157588367,4.46557028684938,7.69041500734627,101,"ENSG00000079974.19"
"29334","ENSG00000197776.8_36962",36954,36962,9,"ENSG00000197776.8",1,8,"VVVVVUVMV",1,7,0.806211180124224,113,119,133,136,141,147,174,177,"ATGTTGG","TTGT","ATGATAT","CTGA",2.36447982144743,14,5,27,55,2.09896081090654,4.46553990513901,7.69038462563591,101,"ENSG00000079974.19"
"38414","ENSG00000250137.1_43550",43542,43550,9,"ENSG00000250137.1",1,8,"VVUVVVVMV",1,7,0.767701863354037,116,122,133,136,150,156,168,171,"TTAATGA","ATTA","ATGGAGA","CTGA",2.38777648736162,11,14,12,46,2.55977849698248,4.61957210318165,7.6903795565978,101,"ENSG00000079974.19"
"4336","ENSG00000100227.19_22202",22194,22202,9,"ENSG00000100227.19",1,6,"VVVVVMUVV",1,7,0.788819875776397,95,101,108,111,116,122,133,136,"ATGAGGT","CGGA","ATGATGT","CTGC",2.30321864709728,7,5,11,32,2.78555061077569,4.53508539785606,7.69036490096165,101,"ENSG00000079974.19"
"47859","ENSG00000289517.1_34928",34920,34928,9,"ENSG00000289517.1",1,6,"VVVVVMUVV",1,7,0.788819875776397,95,101,108,111,116,122,133,136,"ATGAGGT","CGGA","ATGATGT","CTGC",2.30321864709728,7,5,11,32,2.78555061077569,4.53508539785606,7.69036490096165,101,"ENSG00000079974.19"
"43522","ENSG00000272168.10_304713",304705,304713,9,"ENSG00000272168.10",1,5,"VVUVMVVVV",1,7,0.770186335403727,115,121,133,136,144,150,200,203,"TTGAACA","CTGA","GTGCTGG","CTGA",2.46737939642183,12,8,50,79,1.98922381105587,4.60960494680035,7.69035028841525,101,"ENSG00000079974.19"
"29594","ENSG00000198382.9_132297",132289,132297,9,"ENSG00000198382.9",1,8,"VVVVVVUMV",1,7,0.770186335403727,114,120,133,136,142,148,164,167,"ATAATGG","CACA","CTGATAT","CTGA",2.35375924672644,13,6,16,44,2.74664955069004,4.60959446554992,7.69033980716483,101,"ENSG00000079974.19"
"27947","ENSG00000187699.10_304555",304547,304555,9,"ENSG00000187699.10",1,7,"UVVVVVMVV",1,7,0.787991718426501,101,107,133,136,145,151,160,163,"AGAATGA","GTGA","GTGTTTC","CTGA",2.41057445937794,26,9,9,53,2.08296029849765,4.53836417358764,7.69033104729365,101,"ENSG00000079974.19"
"10631","ENSG00000132122.12_120957",120949,120957,9,"ENSG00000132122.12",1,2,"VMVVVUVVV",1,7,0.806211180124223,111,117,133,136,145,151,165,168,"ATGATTA","CTAA","GAGAAAA","GTGA",2.28003668443867,16,9,14,48,2.66167142508141,4.46547899700147,7.69032371749836,101,"ENSG00000079974.19"
"9651","ENSG00000125971.18_22209",22201,22209,9,"ENSG00000125971.18",1,2,"VMUVVVVVV",1,7,0.767701863354037,83,89,102,105,110,116,133,136,"CTGAAGT","TTTA","TTGATGA","CTGA",2.37668646670707,13,5,17,44,2.6333919465228,4.61949209780915,7.6902995512253,101,"ENSG00000079974.19"
"47931","ENSG00000289720.1_175333",175325,175333,9,"ENSG00000289720.1",1,2,"VMUVVVVVV",1,7,0.767701863354037,83,89,102,105,110,116,133,136,"CTGAAGT","TTTA","TTGATGA","CTGA",2.37668646670707,13,5,17,44,2.6333919465228,4.61949209780915,7.6902995512253,101,"ENSG00000079974.19"
"10495","ENSG00000131374.15_172775",172767,172775,9,"ENSG00000131374.15",1,3,"VVMVUVVVV",1,7,0.772670807453416,106,112,133,136,142,148,163,166,"TTGTTGA","ATGA","GTCATTT","CTGA",2.42807214326516,21,6,15,51,2.21118019557176,4.59958195433487,7.69026518414853,101,"ENSG00000079974.19"
"6036","ENSG00000107779.14_55429",55421,55429,9,"ENSG00000107779.14",1,5,"VVVVMUUVV",2,6,0.694824016563147,84,90,100,103,114,120,133,136,"GAGATGA","TTGA","TTGAGGG","CTGA",2.54366803355684,10,11,13,43,2.68591169048766,4.91092464521665,7.69022071146924,101,"ENSG00000079974.19"
"42081","ENSG00000260658.7_287544",287536,287544,9,"ENSG00000260658.7",1,8,"VVVVVUVMV",1,7,0.806211180124224,104,110,133,136,146,152,160,163,"ATGCTCA","TTGT","GTGAGGT","CTGA",2.35635424924502,23,10,8,50,2.15213591951001,4.46529106195253,7.69013578244943,101,"ENSG00000079974.19"
"26817","ENSG00000185046.20_548076",548068,548076,9,"ENSG00000185046.20",1,7,"VVUVVVMVV",1,7,0.768944099378882,111,117,133,136,170,176,184,187,"ATAAGGA","CAGA","AAGATGA","CTGA",2.49228295975682,16,34,8,67,1.8421327533917,4.61433812127595,7.69011451879148,101,"ENSG00000079974.19"
"35199","ENSG00000235304.2_9450",9442,9450,9,"ENSG00000235304.2",1,1,"MVUVVVVVV",1,7,0.789648033126294,102,108,133,136,141,147,188,191,"ATGATGT","ATAA","GTGAAAA","CTGA",2.55089453466672,25,5,41,80,1.12001703923866,4.53149515092086,7.69008728342604,101,"ENSG00000079974.19"
"25850","ENSG00000182985.18_236696",236688,236696,9,"ENSG00000182985.18",1,2,"UMVVVVVVV",1,7,0.786749482401656,107,113,133,136,145,151,164,167,"CTGAAGA","AAGA","CTAAGGA","CTGA",2.37176737008791,20,9,13,51,2.36054269323156,4.54308129012108,7.6900792197277,101,"ENSG00000079974.19"
"9243","ENSG00000123329.20_4269",4261,4269,9,"ENSG00000123329.20",0,NA,"VVUVVUVVV",2,7,0.805797101449275,85,91,133,136,144,150,199,202,"GTTATGA","TTGA","GTTATCA","CTGA",2.53156029022777,42,8,49,108,0.990478952319691,4.46688688845954,7.69007529425664,101,"ENSG00000079974.19"
"36238","ENSG00000239268.5_304796",304788,304796,9,"ENSG00000239268.5",1,1,"MVVVUUVVV",2,6,0.718012422360248,104,110,133,136,152,158,169,172,"AGGATGT","CTGA","GTGGTGT","CTGA",2.62869368574644,23,16,11,59,1.74739992466421,4.81800612407678,7.69005581351778,101,"ENSG00000079974.19"
"7237","ENSG00000113391.19_156616",156608,156616,9,"ENSG00000113391.19",1,8,"VVUVVVVMV",1,7,0.767701863354037,84,90,101,104,112,118,133,136,"GTGAGCA","CTGG","ATTATGT","CTGA",2.35289929411003,11,8,15,43,2.79091879929339,4.61922852334007,7.69003597675622,101,"ENSG00000079974.19"
"844","ENSG00000037749.13_15022",15014,15022,9,"ENSG00000037749.13",1,8,"VVVVVVUMV",1,7,0.770186335403727,114,120,133,136,161,167,189,192,"AACATGA","CTGA","CTGGTCA","CTGA",2.5365026392836,13,25,22,69,1.52712229233656,4.60928497189014,7.69003031350505,101,"ENSG00000079974.19"
"28173","ENSG00000188342.12_163109",163101,163109,9,"ENSG00000188342.12",1,8,"VVUVVVVMV",1,7,0.767701863354037,73,79,98,101,113,119,133,136,"AAGAAGA","GTGA","GCGATGC","CTGA",2.43940690420809,19,12,14,54,2.21412747889105,4.61921004340291,7.69001749681906,101,"ENSG00000079974.19"
"47174","ENSG00000287741.1_3600",3592,3600,9,"ENSG00000287741.1",1,1,"MVVVUVVVV",1,7,0.795859213250517,66,72,81,84,103,109,133,136,"TTGATGC","CTGA","GTGAGGA","TTGA",2.48302068120015,9,19,24,61,1.47279993999726,4.50656778699957,7.69000464000164,101,"ENSG00000079974.19"
"17834","ENSG00000155463.14_4310",4302,4310,9,"ENSG00000155463.14",1,6,"UVVVVMUVV",2,6,0.691511387163561,109,115,133,136,144,150,174,177,"GTGCTGA","CTGA","TGGATGA","CTGA",2.6593342305785,18,8,24,59,1.96678215440399,4.92391925623182,7.68996480488607,101,"ENSG00000079974.19"
"47319","ENSG00000287996.1_54224",54216,54224,9,"ENSG00000287996.1",1,2,"VMVVVVUVV",1,7,0.770186335403727,57,63,93,96,102,108,133,136,"GTGATGA","CTGA","ATGAACA","ATGA",2.57044931342523,30,6,25,70,1.30042720504873,4.60918899030423,7.68993433191914,101,"ENSG00000079974.19"
"27574","ENSG00000186509.4_121747",121739,121747,9,"ENSG00000186509.4",1,2,"UMVVVVVVV",1,7,0.786749482401656,81,87,98,101,116,122,133,136,"ATGATGT","ATGA","CTCATCA","CTGC",2.34797815391085,11,15,11,46,2.51852225069635,4.54292748585884,7.68992541546546,101,"ENSG00000079974.19"
"15140","ENSG00000147162.15_5246",5238,5246,9,"ENSG00000147162.15",1,6,"UVVVVMVVV",1,7,0.805383022774327,113,119,133,136,157,163,178,181,"AAAATAA","CAGA","GTGATTA","CTGA",2.37813275185661,14,21,15,59,2.01934507273875,4.46839085461237,7.68992294570968,101,"ENSG00000079974.19"
"6743","ENSG00000111783.13_110249",110241,110249,9,"ENSG00000111783.13",1,1,"MVVVVUVVV",1,7,0.82815734989648,116,122,133,136,142,148,179,182,"ATGCAGA","ATGT","CTGGAGA","CTGA",2.31649679808054,11,6,31,57,2.06576099462834,4.37726824545798,7.6898976450439,101,"ENSG00000079974.19"
"33230","ENSG00000229105.1_41611",41603,41611,9,"ENSG00000229105.1",1,8,"UVVVVVVMV",1,7,0.786749482401656,114,120,133,136,148,154,184,187,"ATCATGA","CTAA","CTGATGA","CTAA",2.44253003428867,13,12,30,64,1.88805455654787,4.54289702961809,7.68989495922471,101,"ENSG00000079974.19"
"19212","ENSG00000162542.14_89456",89448,89456,9,"ENSG00000162542.14",1,6,"VVVVUMVVV",1,7,0.792546583850932,97,103,133,136,137,143,151,154,"GTGAAGA","CTTA","GTCCTGA","CTGA",2.5090910742458,30,1,8,48,1.35125504147923,4.51963221744615,7.68981855284988,101,"ENSG00000079974.19"
"13811","ENSG00000143549.22_607",599,607,9,"ENSG00000143549.22",0,NA,"VVVVUVUVV",2,7,0.775983436853002,66,72,80,83,89,95,133,136,"TTGATGA","CTGA","CTGATCC","CTGT",2.4897558313556,8,6,38,61,1.74511796794576,4.58587254424578,7.68980629165778,101,"ENSG00000079974.19"
"11977","ENSG00000136770.11_118262",118254,118262,9,"ENSG00000136770.11",0,NA,"UVVVVUVVV",2,7,0.824844720496894,110,116,133,136,164,170,180,183,"CTGTTGT","CTGT","CTGTTTA","CTGA",2.36000973892913,17,28,10,64,1.828308879702,4.39042678480738,7.68980566679496,101,"ENSG00000079974.19"
"11232","ENSG00000134317.18_6381",6373,6381,9,"ENSG00000134317.18",1,8,"VVVUVVVMV",1,7,0.764803312629399,63,69,106,109,114,120,133,136,"ATGAAGG","CTGA","AGGGTGG","CTGA",2.50012546729863,37,5,13,64,1.8548314653216,4.63058364516146,7.68979689567905,101,"ENSG00000079974.19"
"10237","ENSG00000130052.14_30225",30217,30225,9,"ENSG00000130052.14",1,1,"MVVVVUVVV",1,7,0.82815734989648,115,121,133,136,139,145,155,158,"GAGAGGA","GTGG","AAGAAAA","CTGA",2.19613774908201,12,3,10,34,2.86771789302922,4.37715905506066,7.68978845464658,101,"ENSG00000079974.19"
"14682","ENSG00000145715.15_1506",1498,1506,9,"ENSG00000145715.15",0,NA,"VVVVUVUVV",2,7,0.775983436853002,116,122,133,136,163,169,222,225,"ATGATTA","TTGA","GTAATAA","CTGA",2.59195148594007,11,27,53,100,1.06366172572857,4.58583457466559,7.68976832207759,101,"ENSG00000079974.19"
"4294","ENSG00000100095.19_115779",115771,115779,9,"ENSG00000100095.19",1,5,"UVVVMVVVV",1,7,0.789233954451346,112,118,133,136,173,179,190,193,"GTGACGA","CAGA","GTGATGA","CCGA",2.43339349734098,15,37,11,72,1.90870357214995,4.53283172193912,7.6897675397445,101,"ENSG00000079974.19"
"30002","ENSG00000198947.18_431636",431628,431636,9,"ENSG00000198947.18",1,1,"MVVUVVVVV",1,7,0.786749482401656,114,120,133,136,140,146,165,168,"AGGAGGA","GTGT","GTGTAGA","CTGA",2.36345741732708,13,4,19,45,2.4146880499628,4.54276770803583,7.68976563764245,101,"ENSG00000079974.19"
"31062","ENSG00000215421.10_133757",133749,133757,9,"ENSG00000215421.10",1,5,"VVVVMUVVV",1,7,0.808695652173913,114,120,133,136,143,149,165,168,"AAGATGA","CTGC","GTTTTCA","CTAA",2.2589445958039,13,7,16,45,2.7601645656331,4.45494880108145,7.6897314097771,101,"ENSG00000079974.19"
"44363","ENSG00000281327.4_23058",23050,23058,9,"ENSG00000281327.4",1,2,"UMVVVVVVV",1,7,0.786749482401656,112,118,133,136,145,151,161,164,"CTGTTGT","CTGG","ATTTTGT","CTGA",2.29477247021486,15,9,10,43,2.87242091295343,4.54272601192979,7.68972394153642,101,"ENSG00000079974.19"
"38849","ENSG00000251165.6_199890",199882,199890,9,"ENSG00000251165.6",1,3,"UVMVVVVVV",1,7,0.785507246376811,109,115,133,136,178,184,220,223,"ATGATTG","CAGA","GTGATGA","CTGA",2.62129046276088,18,42,36,105,0.715475358719648,4.54768627761471,7.68971526312196,101,"ENSG00000079974.19"
"20415","ENSG00000164796.18_83191",83183,83191,9,"ENSG00000164796.18",1,8,"UVVVVVVMV",1,7,0.786749482401656,111,117,133,136,146,152,171,174,"ATGATTT","CTCT","GTGAAAA","CTGA",2.37890069621481,16,10,19,54,2.31146845503012,4.54270160744887,7.6896995370555,101,"ENSG00000079974.19"
"29099","ENSG00000197157.11_330792",330784,330792,9,"ENSG00000197157.11",1,7,"UVVVVVMVV",1,7,0.787991718426501,114,120,133,136,146,152,188,191,"ATGTTGA","CTTG","TTGATAC","CTGA",2.43193466206733,13,10,36,68,1.93793254193788,4.53770757226336,7.68967444596936,101,"ENSG00000079974.19"
"34417","ENSG00000233005.2_422429",422421,422429,9,"ENSG00000233005.2",1,2,"VMVVVUVVV",1,7,0.806211180124223,113,119,133,136,145,151,172,175,"AGGATCA","CCTA","CTGAAGG","CTGA",2.32264949092248,14,9,21,53,2.37494295172615,4.46481822280233,7.68966294329922,101,"ENSG00000079974.19"
"45987","ENSG00000286103.1_12219",12211,12219,9,"ENSG00000286103.1",1,7,"VVVVUVMVV",1,7,0.775155279503105,87,93,133,136,141,147,155,158,"GAGATGA","TTTA","CTGATTA","CTGA",2.46646532239762,40,5,8,62,1.91300386977547,4.58902650477324,7.68964762278566,101,"ENSG00000079974.19"
"20169","ENSG00000164366.4_17319",17311,17319,9,"ENSG00000164366.4",0,NA,"UVVVVUVVV",2,7,0.824844720496894,64,70,81,84,102,108,133,136,"GTGATGG","CTGT","GTGATGG","CTGG",2.39104665313692,11,18,25,63,1.62060073812754,4.39022793976008,7.68960682174766,101,"ENSG00000079974.19"
"45725","ENSG00000285838.2_26992",26984,26992,9,"ENSG00000285838.2",1,2,"VMVVVUVVV",1,7,0.806211180124223,110,116,133,136,141,147,156,159,"ATGATGT","CTGT","AAAATAA","TTGA",2.27110815382628,17,5,9,40,2.7181999961723,4.46473025542022,7.68957497591711,101,"ENSG00000079974.19"
"10424","ENSG00000131018.25_152633",152625,152633,9,"ENSG00000131018.25",1,8,"VVVVVUVMV",1,7,0.806211180124224,94,100,108,111,116,122,133,136,"GTGATGG","CAGA","ATAATAT","CTTA",2.25032772539906,8,5,11,33,2.85660886966123,4.46469842641374,7.68954314691063,101,"ENSG00000079974.19"
"7685","ENSG00000115355.18_55407",55399,55407,9,"ENSG00000115355.18",1,2,"UMVVVVVVV",1,7,0.786749482401656,88,94,133,136,162,168,186,189,"AGGATGA","CTTA","GTGTTGT","CTGA",2.61413521727733,39,26,18,92,0.742545514147628,4.54252840733246,7.68952633693909,101,"ENSG00000079974.19"
"29567","ENSG00000198270.13_64740",64732,64740,9,"ENSG00000198270.13",1,6,"VVVVUMVVV",1,7,0.792546583850932,81,87,97,100,111,117,133,136,"TTGATCA","CTGA","TTGATTG","CTAA",2.33404578351539,10,11,16,46,2.51704519740886,4.5193376052112,7.68952394061493,101,"ENSG00000079974.19"
"24312","ENSG00000175779.5_460747",460739,460747,9,"ENSG00000175779.5",1,2,"UMVVVVVVV",1,7,0.786749482401656,111,117,133,136,150,156,166,169,"ATACTGA","ATTA","TTGATCA","CTGA",2.35623472373843,16,14,10,49,2.46186698304762,4.54252461865929,7.68952254826592,101,"ENSG00000079974.19"
"3807","ENSG00000089154.11_51602",51594,51602,9,"ENSG00000089154.11",1,2,"VMVVVUVVV",1,7,0.806211180124223,113,119,133,136,153,159,172,175,"ATGTTCA","TGGA","GTAAAGA","CTGA",2.33206778782491,14,17,13,53,2.31130807312388,4.46460666465582,7.68945138515272,101,"ENSG00000079974.19"
"19524","ENSG00000163166.15_65566",65558,65566,9,"ENSG00000163166.15",1,1,"MVVVUVVVV",1,7,0.795859213250517,112,118,133,136,171,177,192,195,"ATTATAA","TTGA","TTGCAGA","CTGA",2.44163391360414,15,35,15,74,1.74646593290458,4.50600633923305,7.68944319223512,101,"ENSG00000079974.19"
"26323","ENSG00000183840.7_202450",202442,202450,9,"ENSG00000183840.7",1,8,"VVVVVUVMV",1,7,0.806211180124224,116,122,133,136,147,153,168,171,"ATCCTTA","ATGA","TTGAGGC","CTGA",2.28408634818991,11,11,15,46,2.63110971553104,4.46458800919928,7.68943272969618,101,"ENSG00000079974.19"
"29874","ENSG00000198836.11_22550",22542,22550,9,"ENSG00000198836.11",1,1,"MVVVVUUVV",2,6,0.714285714285714,116,122,133,136,149,155,170,173,"TTGATCA","ATGA","GTGAATA","CTGA",2.52618965695033,11,13,15,48,2.48788991463968,4.83228857357714,7.68943143072,101,"ENSG00000079974.19"
"3942","ENSG00000091157.15_15387",15379,15387,9,"ENSG00000091157.15",0,NA,"UVVVVVUVV",2,7,0.788819875776397,104,110,133,136,146,152,173,176,"ATGAAGA","TTGC","CTGGAGA","CTGA",2.47574888012028,23,10,21,63,1.63150551705799,4.53412451279829,7.68940401590388,101,"ENSG00000079974.19"
"47722","ENSG00000289108.1_30774",30766,30774,9,"ENSG00000289108.1",1,6,"UVVVVMVVV",1,7,0.805383022774327,105,111,133,136,177,183,196,199,"ATGATGG","TTGG","TTGTTAA","CTGA",2.49138454476047,22,41,13,85,1.26221419794168,4.4678611240862,7.68939321518351,101,"ENSG00000079974.19"
"14878","ENSG00000145996.11_505278",505270,505278,9,"ENSG00000145996.11",1,2,"VMVVUVVVV",1,7,0.773913043478261,114,120,133,136,163,169,182,185,"ATCATGC","CTCA","ATGATTG","CTGA",2.455816668724,13,27,13,62,2.00232250746142,4.59360840807202,7.68926058198507,101,"ENSG00000079974.19"
"45378","ENSG00000285534.1_221945",221937,221945,9,"ENSG00000285534.1",1,1,"MVVVVUVVV",1,7,0.82815734989648,91,97,106,109,112,118,133,136,"AGGATGC","CTGA","ATCCTGT","CTGG",2.25744906206489,9,3,15,36,2.45679997055016,4.37661509607902,7.68924449566494,101,"ENSG00000079974.19"
"14060","ENSG00000144331.20_232661",232653,232661,9,"ENSG00000144331.20",1,8,"UVVVVVVMV",1,7,0.786749482401656,114,120,133,136,172,178,198,201,"ATAATGA","TTAA","ATGAGGG","CTGA",2.4960611301025,13,36,20,78,1.52841863876553,4.54220654319555,7.68920447280217,101,"ENSG00000079974.19"
"13417","ENSG00000141376.23_63776",63768,63776,9,"ENSG00000141376.23",1,1,"MVVVUVVVV",1,7,0.795859213250517,114,120,133,136,151,157,175,178,"CTGACGG","CTGT","GTGGTCA","CTGA",2.37561775167017,13,15,18,55,2.18554288757116,4.50574864134308,7.68918549434514,101,"ENSG00000079974.19"
"3251","ENSG00000082781.12_81216",81208,81216,9,"ENSG00000082781.12",0,NA,"VVUVUVVVV",2,7,0.773498964803312,92,98,104,107,113,119,133,136,"GGGAGGA","CTTA","GAGAGGA","CTGA",2.38596205690807,6,6,14,35,2.47425183241569,4.59516638628404,7.68916224549729,101,"ENSG00000079974.19"
"34180","ENSG00000232053.7_277067",277059,277067,9,"ENSG00000232053.7",0,NA,"VVVVUVUVV",2,7,0.775983436853002,116,122,133,136,138,144,192,195,"ATGTTGA","GTCA","ATGATGG","CTGA",2.52556204257675,11,2,48,70,1.50383279103297,4.5852282687195,7.6891620161315,101,"ENSG00000079974.19"
"23203","ENSG00000172318.6_177819",177811,177819,9,"ENSG00000172318.6",1,6,"VVVVVMUVV",1,7,0.788819875776397,75,81,95,98,113,119,133,136,"GAGATAT","CTGA","TTAAAGA","CTGA",2.36192428093231,14,15,14,52,2.38936625636005,4.53388203231053,7.68916153541612,101,"ENSG00000079974.19"
"32893","ENSG00000228222.1_177649",177641,177649,9,"ENSG00000228222.1",1,6,"VVVVVMUVV",1,7,0.788819875776397,75,81,95,98,113,119,133,136,"GAGATAT","CTGA","TTAAAGA","CTGA",2.36192428093231,14,15,14,52,2.38936625636005,4.53388203231053,7.68916153541612,101,"ENSG00000079974.19"
"11859","ENSG00000136237.19_216826",216818,216826,9,"ENSG00000136237.19",1,7,"VVVUVVMVV",1,7,0.766045548654244,112,118,133,136,186,192,200,203,"ATGAGGA","CGGA","GGCATTA","CTGA",2.49140584345535,15,50,8,82,1.89047145570123,4.62496093635089,7.68914313096787,101,"ENSG00000079974.19"
"33059","ENSG00000228566.2_98893",98885,98893,9,"ENSG00000228566.2",1,8,"UVVVVVVMV",1,7,0.786749482401656,84,90,106,109,116,122,133,136,"AGGATAG","TTGA","TTAATGT","CTGA",2.29986421076793,16,7,11,43,2.83604865207137,4.54211918096439,7.68911711057101,101,"ENSG00000079974.19"
"36914","ENSG00000243620.2_247471",247463,247471,9,"ENSG00000243620.2",1,1,"MVVVVVUVV",1,7,0.792132505175983,85,91,103,106,113,119,133,136,"ATGAGGA","CTGA","CTGAAGA","TTGC",2.27898973663022,12,7,14,42,2.88891902407969,4.52054598373695,7.68907600444089,101,"ENSG00000079974.19"
"5572","ENSG00000105879.13_11544",11536,11544,9,"ENSG00000105879.13",1,5,"VVUVMVVVV",1,7,0.770186335403727,81,87,100,103,112,118,133,136,"ATTATGC","CTGA","GTAAAGA","GTGA",2.34986679689948,13,9,15,46,2.76741358991009,4.60829805897666,7.68904340059156,101,"ENSG00000079974.19"
"39479","ENSG00000253642.6_7386",7378,7386,9,"ENSG00000253642.6",1,2,"UMVVVVVVV",1,7,0.786749482401656,109,115,133,136,139,145,159,162,"ATAATGT","TGGA","CTGAAGC","CTGA",2.38810845711099,18,3,14,44,2.24728178200999,4.54200120735415,7.68899913696078,101,"ENSG00000079974.19"
"18244","ENSG00000156671.15_48426",48418,48426,9,"ENSG00000156671.15",1,2,"UMVVVVVVV",1,7,0.786749482401656,50,56,67,70,76,82,133,136,"GTGATGA","CTAA","GTTAAGA","CAGA",2.43109373472164,11,6,51,77,1.96052339231342,4.54195373928109,7.68895166888771,101,"ENSG00000079974.19"
"18619","ENSG00000157884.11_3613",3605,3613,9,"ENSG00000157884.11",1,7,"VVVUVVMVV",1,7,0.766045548654244,110,116,133,136,144,150,170,173,"ATGTGGA","TTGA","AAGAGGA","CTGA",2.43613838631963,17,8,20,54,2.25811801375144,4.6247601473039,7.68894234192088,101,"ENSG00000079974.19"
"37347","ENSG00000247498.11_48022",48014,48022,9,"ENSG00000247498.11",1,2,"VMVVVVUVV",1,7,0.770186335403727,114,120,133,136,142,148,157,160,"GTAATGG","CTAA","GGCCTGA","CTGA",2.3063813473229,13,6,9,37,3.05690452077254,4.60819504239797,7.68894038401287,101,"ENSG00000079974.19"
"27448","ENSG00000186174.13_3931",3923,3931,9,"ENSG00000186174.13",1,8,"VVVVVUVMV",1,7,0.806211180124224,115,121,133,136,146,152,165,168,"GTGGAGA","TTGG","GGGATGC","CTGA",2.25451331175965,12,10,13,44,2.82618681826955,4.46406889083346,7.68891361133036,101,"ENSG00000079974.19"
"688","ENSG00000025039.15_11541",11533,11541,9,"ENSG00000025039.15",1,8,"VVVVVUVMV",1,7,0.806211180124224,115,121,133,136,144,150,158,161,"GTGTTGG","CAGC","AGGAGGC","CTGA",2.22155649786501,12,8,8,37,3.04579407461945,4.46404268176321,7.6888874022601,101,"ENSG00000079974.19"
"28772","ENSG00000196482.18_148968",148960,148968,9,"ENSG00000196482.18",1,8,"VVVVVUVMV",1,7,0.806211180124224,105,111,133,136,138,144,155,158,"ATGACTA","CAGA","GTGTCCA","CTGA",2.39991608026264,22,2,11,44,1.85672999711407,4.46404263304959,7.68888735354648,101,"ENSG00000079974.19"
"40357","ENSG00000255733.6_177708",177700,177708,9,"ENSG00000255733.6",1,2,"VMVVVUVVV",1,7,0.806211180124223,116,122,133,136,143,149,157,160,"CAGATTA","CAGG","GTTATTA","CTGA",2.21538886661933,11,7,8,35,3.08659389029706,4.46396325027315,7.68880797077005,101,"ENSG00000079974.19"
"26779","ENSG00000185008.19_907165",907157,907165,9,"ENSG00000185008.19",1,3,"VVMVVVUVV",1,7,0.768944099378882,88,94,133,136,141,147,164,167,"TTGATGA","ATGT","ATGTTTA","CTGA",2.52313279628764,39,5,17,70,1.63113903132377,4.613006084977,7.68878248249253,101,"ENSG00000079974.19"
"35692","ENSG00000236780.7_233782",233774,233782,9,"ENSG00000236780.7",1,2,"VMVVUVVVV",1,7,0.773913043478261,80,86,101,104,110,116,133,136,"TAGATGA","TTGC","GTAATTA","CTGA",2.36681346269862,15,6,17,47,2.59367527348776,4.59310792286964,7.68876009678269,101,"ENSG00000079974.19"
"24789","ENSG00000178031.18_247094",247086,247094,9,"ENSG00000178031.18",0,NA,"VVUVVVUVV",2,7,0.769772256728778,116,122,133,136,139,145,157,160,"AGGATGT","GTGA","TTGATGA","CAGA",2.35098730596911,11,3,12,35,2.76538674811928,4.609658863645,7.68874789056012,101,"ENSG00000079974.19"
"5046","ENSG00000102804.15_51387",51379,51387,9,"ENSG00000102804.15",1,1,"MVUVVVVVV",1,7,0.789648033126294,111,117,133,136,155,161,173,176,"ATGATGT","CTAA","ATGAAGT","CTGG",2.40028661683023,16,19,12,56,2.11870318681201,4.53015349142006,7.68874562392523,101,"ENSG00000079974.19"
"12346","ENSG00000137936.18_192138",192130,192138,9,"ENSG00000137936.18",1,6,"VVVVVMUVV",1,7,0.788819875776397,101,107,133,136,147,153,207,210,"ATGCTCA","CTGA","GTGAGTA","CTGA",2.57461429981499,26,11,54,100,0.969678143043686,4.5334433687859,7.68872287189149,101,"ENSG00000079974.19"
"18142","ENSG00000156265.16_60386",60378,60386,9,"ENSG00000156265.16",1,7,"UVVVVVMVV",1,7,0.787991718426501,113,119,133,136,151,157,175,178,"GCGATGA","CTTA","ATGATGA","CGGA",2.39888908424164,14,15,18,56,2.15379127911578,4.53659629351501,7.68856316722101,101,"ENSG00000079974.19"
"1408","ENSG00000055147.19_13690",13682,13690,9,"ENSG00000055147.19",1,2,"UMVVVVVVV",1,7,0.786749482401656,112,118,133,136,177,183,194,197,"TTGATGA","TTAA","ATTCTGT","CTGA",2.43973674378958,15,41,11,76,1.90128099762839,4.54154815572307,7.68854608532969,101,"ENSG00000079974.19"
"11178","ENSG00000134146.12_74768",74760,74768,9,"ENSG00000134146.12",1,8,"VVVVVUVMV",1,7,0.806211180124224,111,117,133,136,147,153,166,169,"GTAATTA","GTGA","GACATTA","CTGA",2.28919393762471,16,11,13,49,2.59331243076106,4.46365133706478,7.68849605756168,101,"ENSG00000079974.19"
"17001","ENSG00000152952.13_51708",51700,51708,9,"ENSG00000152952.13",1,3,"VVMVUVVVV",1,7,0.772670807453416,49,55,65,68,73,79,133,136,"TTGAGGA","CTGT","ATGCTGC","CTGA",2.48093667106593,10,5,54,78,1.85166501274247,4.59781070496216,7.68849393477583,101,"ENSG00000079974.19"
"36112","ENSG00000237917.1_39661",39653,39661,9,"ENSG00000237917.1",1,1,"MVVVUVVVV",1,7,0.795859213250517,35,41,50,53,102,108,133,136,"GTTATGT","CTGA","ATAAAGA","CTGA",2.53646300234603,9,49,25,92,1.11042334401065,4.50504417324604,7.68848102624811,101,"ENSG00000079974.19"
"46134","ENSG00000286215.1_391908",391900,391908,9,"ENSG00000286215.1",1,1,"MVVVVUVVV",1,7,0.82815734989648,110,116,133,136,144,150,170,173,"GAGATGG","CAAA","CTGATTG","CTGA",2.2867824644926,17,8,20,54,2.25811801375144,4.37583361092552,7.68846301051144,101,"ENSG00000079974.19"
"13887","ENSG00000143858.12_3480",3472,3480,9,"ENSG00000143858.12",0,NA,"VVVVUUVVV",2,7,0.812008281573499,110,116,133,136,138,144,156,159,"GTTATGA","TCGA","AGCATGT","CTGA",2.32354160978262,17,2,12,40,2.27140773700793,4.44042128388968,7.68845441018367,101,"ENSG00000079974.19"
"4698","ENSG00000101695.9_1797",1789,1797,9,"ENSG00000101695.9",1,7,"UVVVVVMVV",1,7,0.787991718426501,107,113,133,136,145,151,201,204,"ATGTTGT","TTGA","GTGGTGG","CTGA",2.5053695131769,20,9,50,88,1.44341357450745,4.5364692489217,7.6884361226277,101,"ENSG00000079974.19"
"42526","ENSG00000263917.1_1793",1785,1793,9,"ENSG00000263917.1",1,7,"UVVVVVMVV",1,7,0.787991718426501,107,113,133,136,145,151,201,204,"ATGTTGT","TTGA","GTGGTGG","CTGA",2.5053695131769,20,9,50,88,1.44341357450745,4.5364692489217,7.6884361226277,101,"ENSG00000079974.19"
"8703","ENSG00000120318.16_19300",19292,19300,9,"ENSG00000120318.16",1,1,"MVVUVVVVV",1,7,0.786749482401656,85,91,133,136,152,158,166,169,"GTGATCA","CTTA","TTGATTT","CTGA",2.50443447913623,42,16,8,75,1.46948228079732,4.54142803542638,7.688425965033,101,"ENSG00000079974.19"
"7512","ENSG00000114529.13_38638",38630,38638,9,"ENSG00000114529.13",1,6,"VVVVVMUVV",1,7,0.788819875776397,116,122,133,136,139,145,155,158,"TTGATGT","CTCA","ATGTTGT","ATGA",2.28729637563375,11,3,10,33,2.88390446837489,4.53313674314998,7.68841624625557,101,"ENSG00000079974.19"
"15461","ENSG00000148408.14_218231",218223,218231,9,"ENSG00000148408.14",1,8,"UVVVVVVMV",1,7,0.786749482401656,83,89,133,136,163,169,182,185,"GTGATTA","TTGA","GTGAATA","CTGA",2.57377869511819,44,27,13,93,1.00713300964374,4.54141441094125,7.68841234054788,101,"ENSG00000079974.19"
"1945","ENSG00000067798.16_9154",9146,9154,9,"ENSG00000067798.16",1,6,"UVVVVMVVV",1,7,0.805383022774327,53,59,103,106,112,118,133,136,"TTGTTGT","CTGA","ATTCTGT","CTGA",2.40992133408991,44,6,15,74,1.80123264333332,4.46684371764985,7.68837580874716,101,"ENSG00000079974.19"
"41906","ENSG00000259986.2_114413",114405,114413,9,"ENSG00000259986.2",0,NA,"VVVVUUVVV",2,7,0.812008281573499,115,121,133,136,141,147,161,164,"GTCAGGA","TTGG","GTGTACA","CTGA",2.23877208314571,12,5,14,40,2.83609251362198,4.44030993364835,7.68834305994235,101,"ENSG00000079974.19"
"278","ENSG00000007237.19_28077",28069,28077,9,"ENSG00000007237.19",1,6,"VVVVVMUVV",1,7,0.788819875776397,106,112,133,136,145,151,166,169,"ATTAGGA","CTGG","ATGGAGT","CTGA",2.39318740994287,21,9,15,54,2.17756188674515,4.53303615492441,7.68831565803,101,"ENSG00000079974.19"
"22918","ENSG00000171723.16_673552",673544,673552,9,"ENSG00000171723.16",1,8,"VVVVVUVMV",1,7,0.806211180124224,107,113,133,136,140,146,154,157,"ATGATGG","TTGA","ATGTCCA","TTGA",2.32820242854135,20,4,8,41,2.33244697434894,4.46344912448949,7.68829384498638,101,"ENSG00000079974.19"
"24706","ENSG00000177640.16_119818",119810,119818,9,"ENSG00000177640.16",1,8,"VVVUVVVMV",1,7,0.764803312629399,114,120,133,136,146,152,173,176,"ATGCTGA","CTAT","TTGCTAA","CTGA",2.42426870407804,13,10,21,53,2.35429579200826,4.62902178813213,7.68823503864973,101,"ENSG00000079974.19"
"40741","ENSG00000257522.7_34811",34803,34811,9,"ENSG00000257522.7",1,3,"UVMVVVVVV",1,7,0.785507246376811,103,109,133,136,137,143,161,164,"GTGCTGA","CATA","GTGATGA","CTGA",2.5507139746843,24,1,18,52,1.18006371418928,4.5462058863545,7.68823487186174,101,"ENSG00000079974.19"
"35135","ENSG00000235066.7_987",979,987,9,"ENSG00000235066.7",1,1,"MVVVVVUVV",1,7,0.792132505175983,114,120,133,136,141,147,158,161,"GGGAAGA","AAGA","CTAAGGA","CTGA",2.26590992478093,13,5,11,38,2.9726827964902,4.51968724042409,7.68821726112803,101,"ENSG00000079974.19"
"15812","ENSG00000149646.12_32563",32555,32563,9,"ENSG00000149646.12",1,8,"VVVVVVUMV",1,7,0.770186335403727,108,114,133,136,140,146,158,161,"AGGAGGA","CAGA","TGGATCA","CTGA",2.40726798712716,19,4,12,44,2.38135489927203,4.60745203669662,7.68819737831152,101,"ENSG00000079974.19"
"8191","ENSG00000117148.8_53499",53491,53499,9,"ENSG00000117148.8",1,1,"MVVVVUVVV",1,7,0.82815734989648,64,70,81,84,90,96,133,136,"GTGTGGA","CTGA","GTGATGG","CGGA",2.32603499239107,11,6,37,63,1.99514846533083,4.37551210365116,7.68814150323708,101,"ENSG00000079974.19"
"39393","ENSG00000253553.9_3034",3026,3034,9,"ENSG00000253553.9",1,2,"UMVVVVVVV",1,7,0.786749482401656,115,121,133,136,170,176,186,189,"AGGAGGA","TTTA","GTGATGT","CTGA",2.42104735238103,12,34,10,65,2.0242095106938,4.5411312983085,7.68812922791512,101,"ENSG00000079974.19"
"15506","ENSG00000148498.17_678431",678423,678431,9,"ENSG00000148498.17",1,8,"VVVVVVUMV",1,7,0.770186335403727,100,106,133,136,140,146,200,203,"ATGATGA","CATA","ATGCCGA","CTGA",2.62322096032202,27,4,54,94,0.941382475950399,4.60738055285764,7.68812589447255,101,"ENSG00000079974.19"
"22593","ENSG00000170927.15_155994",155986,155994,9,"ENSG00000170927.15",1,8,"VVVUVVVMV",1,7,0.764803312629399,115,121,133,136,144,150,162,165,"ATTATGT","CAGC","GTGACAG","CTGA",2.33197993956712,12,8,12,41,2.9690210902687,4.62888850517904,7.68810175569664,101,"ENSG00000079974.19"
"9813","ENSG00000127481.15_59526",59518,59526,9,"ENSG00000127481.15",1,2,"UMVVVVVVV",1,7,0.786749482401656,111,117,133,136,142,148,163,166,"ATGATAG","ATGG","CTAAGGA","CTGA",2.32821389860848,16,6,15,46,2.64291398431127,4.54108499375862,7.68808292336524,101,"ENSG00000079974.19"
"39882","ENSG00000254394.2_287301",287293,287301,9,"ENSG00000254394.2",1,2,"UMVVVVVVV",1,7,0.786749482401656,78,84,110,113,116,122,133,136,"ATGCTGA","CTGA","ATGCTGG","CAGA",2.451427146883,26,3,11,49,1.82144419352115,4.54107295985195,7.68807088945857,101,"ENSG00000079974.19"
"28839","ENSG00000196569.14_55162",55154,55162,9,"ENSG00000196569.14",0,NA,"UVVVVUVVV",2,7,0.824844720496894,69,75,90,93,100,106,133,136,"ATAATGA","CTGA","GTGAAGA","GTTA",2.3162599956608,15,7,27,58,2.11301993906822,4.38868831086839,7.68806719285596,101,"ENSG00000079974.19"
"27030","ENSG00000185442.13_126949",126941,126949,9,"ENSG00000185442.13",1,8,"VVUVVVVMV",1,7,0.767701863354037,116,122,133,136,141,147,163,166,"GCCATGA","TGGA","GTGATGT","CTGA",2.36699955268787,11,5,16,41,2.68895975093365,4.6172391922132,7.68804664562935,101,"ENSG00000079974.19"
"1529","ENSG00000059377.18_163483",163475,163483,9,"ENSG00000059377.18",0,NA,"VVVVVUUVV",2,7,0.808281573498965,108,114,133,136,151,157,166,169,"CTGCTGA","CCGG","CTGTTGG","CTGA",2.35350650534697,19,15,9,52,2.12957283464349,4.45490405090581,7.68803034490167,101,"ENSG00000079974.19"
"35483","ENSG00000236130.2_64765",64757,64765,9,"ENSG00000236130.2",1,1,"MVVVVUVVV",1,7,0.82815734989648,81,87,100,103,109,115,133,136,"AGGGTGA","CTGT","CTGCTGA","GTGA",2.23229703545668,13,6,18,46,2.61960602599267,4.37539656559263,7.68802596517855,101,"ENSG00000079974.19"
"18930","ENSG00000159307.20_93371",93363,93371,9,"ENSG00000159307.20",0,NA,"VVVVUUVVV",2,7,0.812008281573499,73,79,89,92,100,106,133,136,"AGGATGA","CTAA","GTGCTTA","CTCA",2.34753012965574,10,8,27,54,2.10959308304732,4.43994848685473,7.68798161314873,101,"ENSG00000079974.19"
"3502","ENSG00000085276.19_313376",313368,313376,9,"ENSG00000085276.19",1,8,"VVVVUUVMV",2,6,0.696066252587992,112,118,133,136,143,149,189,192,"GTTATGA","CTGA","CTGTGGA","CTGA",2.6527390017929,15,7,40,71,1.92993392688567,4.90371515137625,7.68798016172822,101,"ENSG00000079974.19"
"18460","ENSG00000157445.15_301796",301788,301796,9,"ENSG00000157445.15",1,8,"UVVVVVVMV",1,7,0.786749482401656,87,93,108,111,116,122,133,136,"GTGAGGA","CTGG","ATGAAAA","CTAA",2.29559051955642,15,5,11,40,2.85983504323997,4.54094296007069,7.68794088967731,101,"ENSG00000079974.19"
"24763","ENSG00000177822.10_73136",73128,73136,9,"ENSG00000177822.10",1,1,"MVVVVUVVV",1,7,0.82815734989648,108,114,133,136,186,192,211,214,"ATCATGC","AAGA","GTGATGG","CTGA",2.45221366412366,19,50,19,97,1.15301988414465,4.37527774457559,7.68790714416151,101,"ENSG00000079974.19"
"25864","ENSG00000183023.19_123572",123564,123572,9,"ENSG00000183023.19",1,7,"VVVUVVMVV",1,7,0.766045548654244,82,88,100,103,114,120,133,136,"TTGATAA","CAAA","AAGAAGA","CTGA",2.36016563506613,12,11,13,45,2.76039948308047,4.62370926254701,7.68789145716399,101,"ENSG00000079974.19"
"13906","ENSG00000143919.15_294132",294124,294132,9,"ENSG00000143919.15",1,1,"MVVVVVUVV",1,7,0.792132505175983,116,122,133,136,169,175,185,188,"TTAATGA","ATTA","GTGAAAA","CTGA",2.41100283871297,11,33,10,63,2.00391499990792,4.5193168144986,7.68784683520253,101,"ENSG00000079974.19"
"23849","ENSG00000174469.23_1221871",1221863,1221871,9,"ENSG00000174469.23",1,3,"UVMVVVVVV",1,7,0.785507246376811,116,122,133,136,139,145,158,161,"GTCATCA","CTTA","TAGTTGA","CTGA",2.32286690680031,11,3,13,36,2.69737098893804,4.54578759190169,7.68781657740893,101,"ENSG00000079974.19"
"29146","ENSG00000197321.16_16327",16319,16327,9,"ENSG00000197321.16",1,8,"VVVVVUVMV",1,7,0.806211180124224,116,122,133,136,183,189,203,206,"ATAATAA","CTTA","GTGTATA","CTGA",2.40059494138041,11,47,14,81,1.84784791149728,4.46295354684166,7.68779826733856,101,"ENSG00000079974.19"
"22191","ENSG00000169946.14_1074052",1074044,1074052,9,"ENSG00000169946.14",1,5,"VVUVMVVVV",1,7,0.770186335403727,116,122,133,136,145,151,170,173,"CTGATTA","GAGA","GTTATGT","CTGA",2.38883846016167,11,9,19,48,2.50250234349654,4.60702301947691,7.68776836109182,101,"ENSG00000079974.19"
"20247","ENSG00000164506.15_27489",27481,27489,9,"ENSG00000164506.15",1,1,"MVVVVVUVV",1,7,0.792132505175983,111,117,133,136,144,150,159,162,"ATAATTA","ATGA","GTGATAA","TTGA",2.28545177895615,16,8,9,42,2.84056922269602,4.51922860393425,7.68775862463819,101,"ENSG00000079974.19"
"31472","ENSG00000223797.8_44007",43999,44007,9,"ENSG00000223797.8",1,2,"VMVVUVVVV",1,7,0.773913043478261,75,81,97,100,112,118,133,136,"TTGATGA","CTCA","CTGAAGT","CTAA",2.39207985577561,16,12,15,52,2.42112557014971,4.59208115216344,7.68773332607648,101,"ENSG00000079974.19"
"21745","ENSG00000168843.14_359942",359934,359942,9,"ENSG00000168843.14",1,2,"VMVVUVVVV",1,7,0.773913043478261,87,93,133,136,144,150,158,161,"TTGATGT","CAGA","AGGGTGT","CTGA",2.46000388949036,40,8,8,65,1.96818970382981,4.59205390844139,7.68770608235443,101,"ENSG00000079974.19"
"46119","ENSG00000286206.1_18109",18101,18109,9,"ENSG00000286206.1",1,2,"VMVVVVUVV",1,7,0.770186335403727,102,108,133,136,147,153,168,171,"ATGATAC","CTGT","GTGAGGG","CTGA",2.49057589744827,25,11,15,60,1.82392251472021,4.6069404577605,7.68768579937541,101,"ENSG00000079974.19"
"24235","ENSG00000175497.17_851501",851493,851501,9,"ENSG00000175497.17",1,2,"UMVVVVVVV",1,7,0.786749482401656,115,121,133,136,137,143,151,154,"ATGATCC","ATGC","TTGATCC","CTGA",2.32250356155417,12,1,8,30,2.67934450310494,4.54067539503318,7.6876733246398,101,"ENSG00000079974.19"
"32024","ENSG00000225689.2_1172203",1172195,1172203,9,"ENSG00000225689.2",1,2,"UMVVVVVVV",1,7,0.786749482401656,80,86,101,104,114,120,133,136,"ATGAAGA","CAGA","CTTATTA","ATGA",2.31496505465795,15,10,13,47,2.72958867563711,4.54067226000586,7.68767018961248,101,"ENSG00000079974.19"
"42330","ENSG00000261645.7_618143",618135,618143,9,"ENSG00000261645.7",1,5,"UVVVMUVVV",2,6,0.711387163561077,115,121,133,136,174,180,200,203,"AAGGTGA","CTGA","ATGATGA","CTGA",2.67612151671785,12,38,20,79,1.52761893883855,4.84210726257272,7.68765591681702,101,"ENSG00000079974.19"
"24923","ENSG00000178645.13_14923",14915,14923,9,"ENSG00000178645.13",1,1,"MVVVVVUVV",1,7,0.792132505175983,102,108,133,136,143,149,157,160,"ATGGTAA","CAGG","GTGCTGA","CTGA",2.38847949871226,25,7,8,49,2.15309983959121,4.51907412441823,7.68760414512217,101,"ENSG00000079974.19"
"12839","ENSG00000139174.12_58533",58525,58533,9,"ENSG00000139174.12",1,2,"UMVVVVVVV",1,7,0.786749482401656,114,120,133,136,145,151,186,189,"ATGAAGA","ATGC","TTCATTA","CTGA",2.42447807708946,13,9,35,66,1.99922361310955,4.54060269842649,7.68760062803312,101,"ENSG00000079974.19"
"34371","ENSG00000232860.10_3178",3170,3178,9,"ENSG00000232860.10",0,NA,"VVVUVUVVV",2,7,0.802898550724638,65,71,91,94,103,109,133,136,"ATGATGG","CTGG","TTGAGGA","CAGA",2.4223786520785,20,9,24,62,1.75474062672592,4.47598291014564,7.68757711304419,101,"ENSG00000079974.19"
"18264","ENSG00000156689.7_33376",33368,33376,9,"ENSG00000156689.7",1,1,"MVVUVVVVV",1,7,0.786749482401656,114,120,133,136,147,153,163,166,"AGGATGC","CAGC","GAGATAT","CTGA",2.29788442468032,13,11,10,43,2.84307618458625,4.54057642061376,7.68757435022039,101,"ENSG00000079974.19"
"32411","ENSG00000226965.2_86874",86866,86874,9,"ENSG00000226965.2",1,5,"UVVVMVVVV",1,7,0.789233954451346,112,118,133,136,147,153,164,167,"ATGCTTT","CTGT","ATAAAGA","CTGA",2.30819204261602,15,11,11,46,2.73446683986213,4.5306034476589,7.68753926546428,101,"ENSG00000079974.19"
"30983","ENSG00000214960.11_91297",91289,91297,9,"ENSG00000214960.11",1,6,"VVVVVMUVV",1,7,0.788819875776397,89,95,133,136,139,145,160,163,"GTGATTA","GAGA","ATGATAA","CTGA",2.49113632966137,38,3,15,65,1.52092817597213,4.53212592676198,7.68740542986757,101,"ENSG00000079974.19"
"34630","ENSG00000233642.1_16825",16817,16825,9,"ENSG00000233642.1",1,1,"MVVUVVVVV",1,7,0.786749482401656,114,120,133,136,142,148,158,161,"CCAATGA","AAGA","TTAATGA","CTGA",2.26834178501095,13,6,10,38,3.03922922923171,4.54037694899285,7.68737487859947,101,"ENSG00000079974.19"
"36135","ENSG00000237978.6_25758",25750,25758,9,"ENSG00000237978.6",1,6,"VVVUVMVVV",1,7,0.78343685300207,59,65,76,79,83,89,133,136,"AATATGA","CAGA","TTGAAGT","CTGA",2.45891581085068,11,4,44,68,1.82160507445038,4.55359428669706,7.68734169870534,101,"ENSG00000079974.19"
"21152","ENSG00000166669.14_120617",120609,120617,9,"ENSG00000166669.14",1,2,"VMVVVUVVV",1,7,0.806211180124223,112,118,133,136,184,190,200,203,"TTGATGG","CTGA","CTGCAGA","CTCA",2.39087442319954,15,48,10,82,1.9108048179167,4.46249190981174,7.68733663030863,101,"ENSG00000079974.19"
"9648","ENSG00000125966.10_28790",28782,28790,9,"ENSG00000125966.10",1,5,"VVUVMUVVV",2,6,0.692339544513457,52,58,75,78,116,122,133,136,"ATGATGA","CTTA","CAGGTGA","CTGA",2.68799999154348,17,38,11,75,1.75181178382527,4.91795293186212,7.68731110991595,101,"ENSG00000079974.19"
"2097","ENSG00000070159.14_37897",37889,37897,9,"ENSG00000070159.14",0,NA,"VVVVVUUVV",2,7,0.808281573498965,115,121,133,136,151,157,172,175,"TACATGA","CTGG","TTGACAA","CTGA",2.31676322199346,12,15,15,51,2.3715522356526,4.45416009556891,7.68728638956477,101,"ENSG00000079974.19"
"7203","ENSG00000113296.14_58793",58785,58793,9,"ENSG00000113296.14",1,2,"VMVVVVUVV",1,7,0.770186335403727,116,122,133,136,138,144,158,161,"GTGGTGA","AGGA","GTGAACT","CTGA",2.39282169916973,11,2,14,36,2.47395934281073,4.60652600098557,7.68727134260047,101,"ENSG00000079974.19"
"19534","ENSG00000163219.12_103003",102995,103003,9,"ENSG00000163219.12",1,6,"VVUVVMVVV",1,7,0.786335403726708,42,48,64,67,73,79,133,136,"ATAATGC","GTGA","TTGTTCA","CTGA",2.45173279970486,16,6,54,85,1.82262894396571,4.54187856883286,7.68722018373969,101,"ENSG00000079974.19"
"35525","ENSG00000236230.2_96407",96399,96407,9,"ENSG00000236230.2",1,8,"VVVVVUVMV",1,7,0.806211180124224,110,116,133,136,146,152,163,166,"AAGGTGC","CTGC","GTGAATT","CTGA",2.2811463685074,17,10,11,47,2.64175466940634,4.46234928153058,7.68719400202748,101,"ENSG00000079974.19"
"35606","ENSG00000236451.3_170434",170426,170434,9,"ENSG00000236451.3",1,2,"VMVVVUVVV",1,7,0.806211180124223,83,89,133,136,185,191,204,207,"TTGTTGA","TTGA","GTGAAGT","CTGA",2.53930916251219,44,49,13,115,0.92063649059364,4.46234106016873,7.68718578066562,101,"ENSG00000079974.19"
"26988","ENSG00000185352.9_620139",620131,620139,9,"ENSG00000185352.9",1,5,"VVVVMUVVV",1,7,0.808695652173913,115,121,133,136,140,146,158,161,"AGGATGA","GTGT","CTGAAAA","ATGA",2.24020489112157,12,4,12,37,2.87483027044181,4.4523823861464,7.68716499484205,101,"ENSG00000079974.19"
"23045","ENSG00000172071.15_110035",110027,110035,9,"ENSG00000172071.15",1,8,"VVVVVUVMV",1,7,0.806211180124224,114,120,133,136,158,164,200,203,"AGCATGT","ATGA","GTGATGA","CTGA",2.49089281503079,13,22,36,80,1.24329697458273,4.46231226869699,7.68715698919389,101,"ENSG00000079974.19"
"46840","ENSG00000287277.1_249307",249299,249307,9,"ENSG00000287277.1",0,NA,"UVVVVUVVV",2,7,0.824844720496894,115,121,133,136,177,183,233,236,"ATGATGT","CCCA","ATCACGA","CTGA",2.48135342753957,12,41,50,112,1.0087172063902,4.38776834749683,7.6871472294844,101,"ENSG00000079974.19"
"1065","ENSG00000047365.13_19576",19568,19576,9,"ENSG00000047365.13",1,8,"UVVVVVVMV",1,7,0.786749482401656,116,122,133,136,140,146,163,166,"CATATGA","CAGA","GTAATCA","CTGA",2.34393501539396,11,4,17,41,2.53435147947551,4.54014622885882,7.68714415846544,101,"ENSG00000079974.19"
"17270","ENSG00000153774.9_117369",117361,117369,9,"ENSG00000153774.9",0,NA,"UVVVUVVVV",2,7,0.792546583850932,112,118,133,136,153,159,175,178,"ATGATGG","CCCA","ATCCTCA","CTGA",2.3957376423825,15,17,16,57,2.0961182613874,4.51692563598434,7.68711197138807,101,"ENSG00000079974.19"
"23473","ENSG00000173011.12_12621",12613,12621,9,"ENSG00000173011.12",1,8,"VVUVVVVMV",1,7,0.767701863354037,112,118,133,136,152,158,172,175,"AAGAAGG","CTGA","AGGAGGA","CTGA",2.4293443275668,15,16,14,54,2.26955844261028,4.61629682326391,7.68710427668006,101,"ENSG00000079974.19"
"12507","ENSG00000138433.16_32227",32219,32227,9,"ENSG00000138433.16",1,1,"MVUVVVVVV",1,7,0.789648033126294,84,90,98,101,111,117,133,136,"CTTATAA","TTGA","ATGGTGT","CTGA",2.35705852355284,8,10,16,43,2.40024687182319,4.52849259054386,7.68708472304904,101,"ENSG00000079974.19"
"5439","ENSG00000104695.13_7639",7631,7639,9,"ENSG00000104695.13",1,1,"MVUVVVVVV",1,7,0.789648033126294,107,113,133,136,149,155,193,196,"ATGAAGC","ATGA","TTGAAGA","CTGA",2.53486806012415,20,13,38,80,1.21477826735667,4.52847466704608,7.68706679955126,101,"ENSG00000079974.19"
"12627","ENSG00000138698.15_97380",97372,97380,9,"ENSG00000138698.15",1,2,"UMVVVVVVV",1,7,0.786749482401656,114,120,133,136,137,143,151,154,"CTAATGC","ATGA","AATATGA","CTGA",2.33206075166891,13,1,8,31,2.6131738857098,4.54006139087563,7.68705932048225,101,"ENSG00000079974.19"
"20309","ENSG00000164627.18_154374",154366,154374,9,"ENSG00000164627.18",1,7,"UVVVVVMVV",1,7,0.787991718426501,78,84,98,101,114,120,133,136,"ATGACGA","TTGA","CAGAGGA","ATGA",2.33429546882304,14,13,13,49,2.57837416635746,4.53508598962776,7.68705286333377,101,"ENSG00000079974.19"
"20193","ENSG00000164418.22_195773",195765,195773,9,"ENSG00000164418.22",1,1,"MVVUVVVVV",1,7,0.786749482401656,74,80,91,94,108,114,133,136,"ATGAGGG","CTGA","ATGGTGA","CTGG",2.39807406206489,11,14,19,53,2.17304229459415,4.54005067709002,7.68704860669664,101,"ENSG00000079974.19"
"15065","ENSG00000146950.13_96683",96675,96683,9,"ENSG00000146950.13",0,NA,"VVVVUVUVV",2,7,0.775983436853002,114,120,133,136,143,149,189,192,"GTGATGT","CTCC","GTGGTTA","CTGA",2.44744411640514,13,7,40,69,2.0160668013969,4.58309022769112,7.68702397510313,101,"ENSG00000079974.19"
"45973","ENSG00000286084.3_67530",67522,67530,9,"ENSG00000286084.3",1,1,"MVUVVVVVV",1,7,0.789648033126294,108,114,133,136,144,150,159,162,"CTGTTGA","GTAA","GAAATGA","CTGA",2.33179981001961,19,8,9,45,2.56812167267675,4.52836343486854,7.68695556737371,101,"ENSG00000079974.19"
"22769","ENSG00000171385.11_6378",6370,6378,9,"ENSG00000171385.11",1,1,"MVVVVUVVV",1,7,0.82815734989648,116,122,133,136,141,147,168,171,"GGGAGGA","TTGT","CTGATCT","CTGA",2.26897566344327,11,5,21,46,2.37068326431302,4.37429692181703,7.68692632140295,101,"ENSG00000079974.19"
"29409","ENSG00000197959.15_207968",207960,207968,9,"ENSG00000197959.15",1,8,"VVVVVUVMV",1,7,0.806211180124224,116,122,133,136,144,150,161,164,"AAGATGA","GTGC","CTGAAAA","CAGA",2.22843295540882,11,8,11,39,2.99201626321764,4.46205899148577,7.68690371198266,101,"ENSG00000079974.19"
"23946","ENSG00000174482.11_836753",836745,836753,9,"ENSG00000174482.11",1,1,"MVVVVUVVV",1,7,0.82815734989648,113,119,133,136,145,151,161,164,"GTTTTGA","ATAA","ATATGGA","CTGA",2.18477767901431,14,9,10,42,2.93186797411539,4.37426312521937,7.68689252480529,101,"ENSG00000079974.19"
"17051","ENSG00000153046.18_154575",154567,154575,9,"ENSG00000153046.18",1,8,"VVVVUVVMV",1,7,0.773913043478261,116,122,133,136,140,146,156,159,"ATGAGAA","AAGA","ATTCTGA","CTGA",2.30784759286538,11,4,10,34,2.97925104248428,4.59122541539671,7.68687758930975,101,"ENSG00000079974.19"
"19009","ENSG00000160188.10_14605",14597,14605,9,"ENSG00000160188.10",0,NA,"UVVVUVVVV",2,7,0.792546583850932,106,112,133,136,150,156,184,187,"ATGAGGT","TTGA","GTGTGGA","CTGA",2.52889627079196,21,14,28,72,1.20714015171394,4.51661215591509,7.68679849131881,101,"ENSG00000079974.19"
"14614","ENSG00000145495.16_55667",55659,55667,9,"ENSG00000145495.16",1,8,"VVVVVUUMV",2,6,0.692339544513457,88,94,106,109,114,120,133,136,"ATAGTGA","CTGA","GTGACAG","CTGA",2.51607650346182,12,5,13,39,2.89554315851381,4.91734662873149,7.68670480678532,101,"ENSG00000079974.19"
"25240","ENSG00000180190.13_14696",14688,14696,9,"ENSG00000180190.13",0,NA,"UVVVVUVVV",2,7,0.824844720496894,116,122,133,136,138,144,153,156,"CTGCTGG","AAGA","AGGAAGT","CTGA",2.21082143606285,11,2,9,31,2.81035846144707,4.38729200879985,7.68667089078743,101,"ENSG00000079974.19"
"15757","ENSG00000149403.13_235734",235726,235734,9,"ENSG00000149403.13",1,8,"UVVVVVVMV",1,7,0.786749482401656,88,94,133,136,174,180,193,196,"GTGATGA","CAAA","GTGTTAA","CTGA",2.58394863207161,39,38,13,99,0.932319791082748,4.53966100122337,7.68665893082999,101,"ENSG00000079974.19"
"16766","ENSG00000152217.20_19811",19803,19811,9,"ENSG00000152217.20",1,2,"VMVVVUVVV",1,7,0.806211180124223,108,114,133,136,143,149,180,183,"TTGATGG","AAGA","GTCATGT","CTGA",2.42448926541302,19,7,31,66,1.68398614787456,4.46181197932367,7.68665669982057,101,"ENSG00000079974.19"
"26610","ENSG00000184611.13_273547",273539,273547,9,"ENSG00000184611.13",1,2,"UMVVVVVVV",1,7,0.786749482401656,116,122,133,136,141,147,167,170,"ATGTTGT","CCTA","GGGAAGA","CTGA",2.35948561692145,11,5,20,45,2.42869259692044,4.53964917743252,7.68664710703914,101,"ENSG00000079974.19"
"19591","ENSG00000163393.13_45886",45878,45886,9,"ENSG00000163393.13",1,8,"VVUVVVVMV",1,7,0.767701863354037,84,90,133,136,142,148,157,160,"ATGATGG","CTCT","TTGATTT","CTGA",2.47204660544443,43,6,9,67,1.98287866777957,4.61579734268561,7.68660479610176,101,"ENSG00000079974.19"
"20740","ENSG00000165490.13_57519",57511,57519,9,"ENSG00000165490.13",1,8,"VVVVUVVMV",1,7,0.773913043478261,115,121,133,136,139,145,153,156,"ATGAAGA","AAGA","GTGGTGA","CTGT",2.31390791457937,12,3,8,32,2.93775089458213,4.59095091461116,7.6866030885242,101,"ENSG00000079974.19"
"36623","ENSG00000242279.1_71",63,71,9,"ENSG00000242279.1",1,8,"VVVVUVVMV",1,7,0.773913043478261,55,61,73,76,79,85,93,96,"ATGAAGA","AAGA","GTGGTGA","CTGT",2.31390791457937,12,3,8,32,2.93775089458213,4.59095091461116,7.6866030885242,101,"ENSG00000079974.19"
"17340","ENSG00000153930.13_624127",624119,624127,9,"ENSG00000153930.13",1,7,"VVVVUVMVV",1,7,0.775155279503105,116,122,133,136,147,153,163,166,"ATGAGAA","GAGA","ATGCTCA","CTGA",2.32647465625543,11,11,10,41,2.83404292477404,4.58596849161923,7.68658960963165,101,"ENSG00000079974.19"
"26172","ENSG00000183580.10_357045",357037,357045,9,"ENSG00000183580.10",0,NA,"UVVVVUVVV",2,7,0.824844720496894,70,76,88,91,105,111,133,136,"CTGATCA","CTGA","TTGCTCA","CTGG",2.32773459106601,12,14,22,57,2.03053853817762,4.38719228632109,7.68657116830867,101,"ENSG00000079974.19"
"29550","ENSG00000198216.14_346904",346896,346904,9,"ENSG00000198216.14",1,8,"VVUVVVVMV",1,7,0.767701863354037,63,69,81,84,94,100,133,136,"TTGATAA","GTGA","GTGAAAT","CTGA",2.47330959880459,12,10,33,64,1.97427137145221,4.61575050753737,7.68655796095352,101,"ENSG00000079974.19"
"30705","ENSG00000206579.9_395264",395256,395264,9,"ENSG00000206579.9",1,8,"VVUVVVVMV",1,7,0.767701863354037,83,89,104,107,115,121,133,136,"TTGAATA","CTGA","ACAATAA","CTGA",2.33999015335024,15,8,12,44,2.86287027441583,4.61570115752103,7.68650861093718,101,"ENSG00000079974.19"
"15943","ENSG00000150361.12_195475",195467,195475,9,"ENSG00000150361.12",1,7,"VVVVUVMVV",1,7,0.775155279503105,115,121,133,136,140,146,159,162,"ATGGTGA","TTGC","TTGATGA","TTGA",2.3290018039724,12,4,13,38,2.8168696944754,4.58588709690618,7.6865082149186,101,"ENSG00000079974.19"
"25123","ENSG00000179603.18_184190",184182,184190,9,"ENSG00000179603.18",1,6,"UVVVVMVVV",1,7,0.805383022774327,115,121,133,136,149,155,164,167,"ATGCTTA","ATGC","ATGAAAG","CTGA",2.27314871976813,12,13,9,43,2.70531919494812,4.46491099835058,7.68644308944789,101,"ENSG00000079974.19"
"5277","ENSG00000104237.11_216797",216789,216797,9,"ENSG00000104237.11",1,1,"MVVUVVVVV",1,7,0.786749482401656,116,122,133,136,182,188,202,205,"ATTCTGA","TTGA","CTGAACA","CTGA",2.44641239974731,11,46,14,80,1.84826210656559,4.53941952622025,7.68641745582687,101,"ENSG00000079974.19"
"46800","ENSG00000287204.1_8749",8741,8749,9,"ENSG00000287204.1",1,7,"VVVUVVMVV",1,7,0.766045548654244,114,120,133,136,146,152,206,209,"AAGATGA","ATAA","TGGATGA","CTGA",2.48912588086825,13,10,54,86,1.89476316470513,4.62223392595669,7.68641612057367,101,"ENSG00000079974.19"
"21125","ENSG00000166477.13_6701",6693,6701,9,"ENSG00000166477.13",0,NA,"UVVVVUVVV",2,7,0.824844720496894,116,122,133,136,146,152,168,171,"ATAATAT","CAAA","GTGATCT","CTGA",2.23686942733759,11,10,16,46,2.63565755816795,4.3870301017713,7.68640898375888,101,"ENSG00000079974.19"
"37593","ENSG00000248515.2_133155",133147,133155,9,"ENSG00000248515.2",0,NA,"VVVUVUVVV",2,7,0.802898550724638,69,75,96,99,110,116,133,136,"CAGATGA","CTGA","GTGAGAA","CTGC",2.39350930033269,21,11,17,58,1.94249317316176,4.4748054605116,7.68639966341015,101,"ENSG00000079974.19"
"37625","ENSG00000248550.4_286933",286925,286933,9,"ENSG00000248550.4",1,1,"MVVVVVUVV",1,7,0.792132505175983,115,121,133,136,140,146,157,160,"GGGATTA","CAAA","ATGTTGG","CTGA",2.27177824449984,12,4,11,36,2.92626049687161,4.51786219838431,7.68639221908824,101,"ENSG00000079974.19"
"18740","ENSG00000158321.19_431945",431937,431945,9,"ENSG00000158321.19",1,2,"VMVVVVUVV",1,7,0.770186335403727,99,105,133,136,145,151,206,209,"TTGATGA","TTGA","ATGAATG","CTGA",2.60898493832329,28,9,55,101,1.02933224380816,4.60564129149085,7.68638663310576,101,"ENSG00000079974.19"
"36080","ENSG00000237844.2_576467",576459,576467,9,"ENSG00000237844.2",1,1,"MVVVVUUVV",2,6,0.714285714285714,86,92,133,136,137,143,152,155,"ATGATGA","ATGA","ACAATGA","CTGA",2.69874980972838,41,1,9,60,1.32527342559108,4.82923470594507,7.68637756308792,101,"ENSG00000079974.19"
"24316","ENSG00000175779.5_524468",524460,524468,9,"ENSG00000175779.5",1,8,"VVVUVVVMV",1,7,0.764803312629399,114,120,133,136,141,147,165,168,"ATGGTGA","CTGG","CTGAAGA","CGGA",2.39090040973443,13,5,18,45,2.56916671540426,4.62712569507511,7.68633894559271,101,"ENSG00000079974.19"
"45262","ENSG00000285280.2_681183",681175,681183,9,"ENSG00000285280.2",1,2,"VMVVVUVVV",1,7,0.806211180124223,110,116,133,136,146,152,160,163,"AAAATGA","CCGC","CTTATAA","CTGA",2.28055463688828,17,10,8,44,2.64205247418349,4.46143751335967,7.68628223385656,101,"ENSG00000079974.19"
"3439","ENSG00000083896.13_15886",15878,15886,9,"ENSG00000083896.13",1,1,"MVUVVVVVV",1,7,0.789648033126294,113,119,133,136,150,156,176,179,"AAGCTGA","CTTA","AAGATAA","CTGA",2.40114479213094,14,14,20,57,2.10309024369348,4.52768054780828,7.68627268031345,101,"ENSG00000079974.19"
"20059","ENSG00000164199.18_192520",192512,192520,9,"ENSG00000164199.18",0,NA,"VVVVUVUVV",2,7,0.775983436853002,66,72,80,83,114,120,133,136,"ATGATGA","TTGA","GAGGTGA","GTGA",2.49546583476691,8,31,13,61,1.69267261996368,4.58227787960244,7.68621162701445,101,"ENSG00000079974.19"
"23661","ENSG00000173482.17_456555",456547,456555,9,"ENSG00000173482.17",1,6,"UVVVVMVVV",1,7,0.805383022774327,109,115,133,136,143,149,160,163,"ATAATAA","CTTG","CTCAGGA","CTGA",2.28008376609373,18,7,11,45,2.65814522852365,4.46467591728713,7.68620800838444,101,"ENSG00000079974.19"
"26954","ENSG00000185345.24_521250",521242,521250,9,"ENSG00000185345.24",1,2,"VMVVUVVVV",1,7,0.773913043478261,116,122,133,136,153,159,173,176,"TTGATGT","AGGA","AGGAGGA","CTGA",2.41311461911861,11,17,14,51,2.27475839959276,4.59054729842921,7.68619947234225,101,"ENSG00000079974.19"
"37832","ENSG00000248932.8_333098",333090,333098,9,"ENSG00000248932.8",1,1,"MVVVVVUVV",1,7,0.792132505175983,82,88,103,106,115,121,133,136,"GTGAAGA","CTGA","ACACTGA","TTGA",2.28697549389923,15,9,12,45,2.82414445701873,4.51766193742007,7.686191958124,101,"ENSG00000079974.19"
"34500","ENSG00000233219.1_3668",3660,3668,9,"ENSG00000233219.1",1,7,"VVVVVUMVV",1,7,0.807453416149068,93,99,133,136,148,154,164,167,"AAGATAA","CAGA","CTAATTA","CTGA",2.40710079673635,34,12,10,65,1.77793322518778,4.45631796752419,7.68613163212047,101,"ENSG00000079974.19"
"1812","ENSG00000066032.19_952376",952368,952376,9,"ENSG00000066032.19",0,NA,"VVVVVUUVV",2,7,0.808281573498965,104,110,133,136,168,174,188,191,"CTAATGA","CTGG","GTTAGGA","CTGA",2.49483052491741,23,32,14,78,1.17962493576177,4.45295710880279,7.68608340279865,101,"ENSG00000079974.19"
"40192","ENSG00000255240.6_36970",36962,36970,9,"ENSG00000255240.6",1,3,"UVMVVVVVV",1,7,0.785507246376811,89,95,101,104,110,116,133,136,"CTGATGA","CTGT","CTGAAGC","CTGT",2.39212464160023,6,6,17,38,2.22868979995866,4.54404685265671,7.68607583816395,101,"ENSG00000079974.19"
"42824","ENSG00000267057.6_15280",15272,15280,9,"ENSG00000267057.6",1,1,"MVVVUVVVV",1,7,0.795859213250517,111,117,133,136,146,152,173,176,"GTCATGG","CTAA","TGGAGGA","CTGA",2.37210952256942,16,10,21,56,2.19641383076227,4.50261932863961,7.68605618164168,101,"ENSG00000079974.19"
"35067","ENSG00000234828.9_291755",291747,291755,9,"ENSG00000234828.9",1,3,"UVMVVVVVV",1,7,0.785507246376811,115,121,133,136,139,145,189,192,"ATGATCA","TTAA","GTCATGT","CTGA",2.46985604799145,12,3,44,68,1.71007192499532,4.54394472790125,7.6859737134085,101,"ENSG00000079974.19"
"34844","ENSG00000234265.2_53719",53711,53719,9,"ENSG00000234265.2",1,5,"UVVVMVVVV",1,7,0.789233954451346,82,88,95,98,113,119,133,136,"ATAATGA","CTGA","TTAATTA","CTGC",2.41094508253339,7,15,14,45,2.04295597208228,4.52898079724288,7.68591661504826,101,"ENSG00000079974.19"
"10830","ENSG00000132938.22_245515",245507,245515,9,"ENSG00000132938.22",1,7,"UVVVVVMVV",1,7,0.787991718426501,86,92,102,105,108,114,133,136,"AAAATGA","CAGA","ATAAAGC","CTGA",2.38741435173454,10,3,19,41,2.21963384810273,4.53393238158325,7.68589925528925,101,"ENSG00000079974.19"
"18011","ENSG00000156011.18_131567",131559,131567,9,"ENSG00000156011.18",1,2,"UMVVVVVVV",1,7,0.786749482401656,101,107,133,136,141,147,159,162,"TTGATCA","GTGA","GTTTTAA","CTGA",2.41981672034038,26,5,12,52,2.02339795185701,4.53887735519822,7.68587528480485,101,"ENSG00000079974.19"
"32811","ENSG00000227963.2_42698",42690,42698,9,"ENSG00000227963.2",1,6,"UVVVVMVVV",1,7,0.805383022774327,114,120,133,136,143,149,166,169,"ACCATGG","GTGA","ATGACAC","CTGA",2.27397722788392,13,7,17,46,2.69734627205426,4.46429861448676,7.68583070558407,101,"ENSG00000079974.19"
"41678","ENSG00000259495.3_44815",44807,44815,9,"ENSG00000259495.3",1,1,"MVVUVVVVV",1,7,0.786749482401656,81,87,102,105,112,118,133,136,"AAAATGG","CTGT","GTAATGC","CTGA",2.31369323232019,15,7,15,46,2.73068460625846,4.53882653876494,7.68582446837156,101,"ENSG00000079974.19"
"17070","ENSG00000153071.15_90345",90337,90345,9,"ENSG00000153071.15",0,NA,"UVVVVUVVV",2,7,0.824844720496894,109,115,133,136,143,149,160,163,"TTGATTA","CTGT","ATGTTTA","TTGA",2.2331273249911,18,7,11,45,2.65814522852365,4.38641518211607,7.68579406410365,101,"ENSG00000079974.19"
"47914","ENSG00000289699.1_52913",52905,52913,9,"ENSG00000289699.1",0,NA,"UVVVVUVVV",2,7,0.824844720496894,109,115,133,136,143,149,160,163,"TTGATTA","CTGT","ATGTTTA","TTGA",2.2331273249911,18,7,11,45,2.65814522852365,4.38641518211607,7.68579406410365,101,"ENSG00000079974.19"
"26314","ENSG00000183826.18_83944",83936,83944,9,"ENSG00000183826.18",1,3,"UVMVVUVVV",2,6,0.707660455486542,87,93,133,136,145,151,164,167,"ATGATGA","AGGA","GGGATGT","CTGA",2.63241953624463,40,9,13,71,1.87113304569335,4.85514915516439,7.68579097711056,101,"ENSG00000079974.19"
"5716","ENSG00000106459.15_93895",93887,93895,9,"ENSG00000106459.15",1,1,"MVVVVUVVV",1,7,0.82815734989648,111,117,133,136,147,153,162,165,"GTGTTCT","CTAA","GTGAGTC","CTGA",2.2222142475308,16,11,9,45,2.67763915973854,4.37310020248597,7.68572960207189,101,"ENSG00000079974.19"
"13405","ENSG00000141376.23_201982",201974,201982,9,"ENSG00000141376.23",1,1,"MVVUVVVVV",1,7,0.786749482401656,87,93,104,107,115,121,133,136,"ATCATGG","CAAA","AGGAACA","CTGA",2.28031747135903,11,8,12,40,2.95261791259771,4.53868359708114,7.68568152668776,101,"ENSG00000079974.19"
"15607","ENSG00000148942.15_15538",15530,15538,9,"ENSG00000148942.15",1,8,"UVVVVVVMV",1,7,0.786749482401656,100,106,133,136,144,150,160,163,"GTGATGC","CAAA","TGGAGGA","CTGA",2.40977260353778,27,8,10,54,2.08934808204538,4.53862469307431,7.68562262268094,101,"ENSG00000079974.19"
"11886","ENSG00000136267.14_805160",805152,805160,9,"ENSG00000136267.14",1,8,"UVVVVVVMV",1,7,0.786749482401656,70,76,87,90,96,102,133,136,"ATGATGA","TTGA","AAGTTCA","CAGA",2.41329884634993,11,6,31,57,2.06576099462834,4.53860499257363,7.68560292218025,101,"ENSG00000079974.19"
"36111","ENSG00000237917.1_14167",14159,14167,9,"ENSG00000237917.1",0,NA,"UVVUVVVVV",2,7,0.78343685300207,78,84,99,102,114,120,133,136,"CTAATGC","CAGA","CAGGTGA","CTGA",2.34175826207042,15,12,13,49,2.5956537505644,4.55184387442513,7.68559128643342,101,"ENSG00000079974.19"
"21324","ENSG00000167117.10_572",564,572,9,"ENSG00000167117.10",0,NA,"UVVVVUVVV",2,7,0.824844720496894,112,118,133,136,167,173,183,186,"GTGCTGA","CTTT","GAGAGGG","CTGA",2.33893531554958,15,31,10,65,1.95189201534315,4.38619852975175,7.68557741173932,101,"ENSG00000079974.19"
"37242","ENSG00000246250.3_26793",26785,26793,9,"ENSG00000246250.3",1,5,"UVVVMVVVV",1,7,0.789233954451346,46,52,67,70,74,80,133,136,"ATAATGT","CTTA","TTGCTGC","CTGA",2.45491810937903,15,4,53,81,1.74842391058351,4.52863615994427,7.68557197774965,101,"ENSG00000079974.19"
"35089","ENSG00000234899.11_134497",134489,134497,9,"ENSG00000234899.11",0,NA,"VVUVVUVVV",2,7,0.805797101449275,116,122,133,136,146,152,182,185,"ATGGTGT","AGGA","GTGCTTA","CTGA",2.377488760815,11,10,30,60,1.99958572681945,4.46237769972987,7.68556610552697,101,"ENSG00000079974.19"
"47511","ENSG00000288605.1_118242",118234,118242,9,"ENSG00000288605.1",0,NA,"VVUVVUVVV",2,7,0.805797101449275,116,122,133,136,146,152,182,185,"ATGGTGT","AGGA","GTGCTTA","CTGA",2.377488760815,11,10,30,60,1.99958572681945,4.46237769972987,7.68556610552697,101,"ENSG00000079974.19"
"13957","ENSG00000144036.16_635482",635474,635482,9,"ENSG00000144036.16",1,1,"MVVVVUVVV",1,7,0.82815734989648,108,114,133,136,158,164,180,183,"ATGAATA","GTGG","ATGAGGA","CTGA",2.39292530940168,19,22,16,66,1.53888206884611,4.37292936621433,7.68555876580025,101,"ENSG00000079974.19"
"41558","ENSG00000259240.1_10400",10392,10400,9,"ENSG00000259240.1",1,1,"MVUVVVVVV",1,7,0.789648033126294,92,98,133,136,149,155,166,169,"TTGATCA","ATGT","GTGAGGA","CTGA",2.46289210172928,35,13,11,68,1.68854572763118,4.52695660145659,7.68554873396177,101,"ENSG00000079974.19"
"32298","ENSG00000226674.11_432941",432933,432941,9,"ENSG00000226674.11",1,1,"MVVVVUVVV",1,7,0.82815734989648,112,118,133,136,159,165,181,184,"AGGATCA","TAGA","TTGAAGG","CTGA",2.34758881541593,15,23,16,63,1.84108381693805,4.37291897992773,7.68554837951365,101,"ENSG00000079974.19"
"29972","ENSG00000198947.18_1219355",1219347,1219355,9,"ENSG00000198947.18",1,2,"VMVVVVUVV",1,7,0.770186335403727,112,118,133,136,179,185,199,202,"TTGATCA","CTGC","ATGAAAA","CTGA",2.49515424105885,15,43,14,81,1.78483586942156,4.60479936912014,7.68554471073504,101,"ENSG00000079974.19"
"5080","ENSG00000102974.16_32583",32575,32583,9,"ENSG00000102974.16",1,6,"VVVUVMVVV",1,7,0.78343685300207,83,89,133,136,145,151,160,163,"AAGGTGA","CTGG","ATGGAGA","CTGA",2.43863399007982,44,9,9,71,1.94952394319459,4.55177096926501,7.6855183812733,101,"ENSG00000079974.19"
"35956","ENSG00000237505.8_674525",674517,674525,9,"ENSG00000237505.8",1,6,"VVVUVMVVV",1,7,0.78343685300207,2,8,20,23,72,78,133,136,"ATGATAA","CTGT","ATGATTG","CTGA",2.58071476381994,12,49,55,125,1.00204093290187,4.55170150625869,7.68544891826698,101,"ENSG00000079974.19"
"21058","ENSG00000166349.11_3685",3677,3685,9,"ENSG00000166349.11",1,8,"VVVVVVUMV",1,7,0.770186335403727,116,122,133,136,143,149,177,180,"GCTATGA","CTGC","CTGAGGA","CTGA",2.44041175598379,11,7,28,55,2.14934927732014,4.60469024596969,7.6854355875846,101,"ENSG00000079974.19"
"41722","ENSG00000259616.2_264314",264306,264314,9,"ENSG00000259616.2",1,2,"UMVVVVVVV",1,7,0.786749482401656,89,95,133,136,174,180,189,192,"ATTATGA","CTCA","AAGAAGA","CTGA",2.57115449464096,38,38,9,94,1.01271261920785,4.53843564587022,7.68543357547685,101,"ENSG00000079974.19"
"38068","ENSG00000249464.8_83659",83651,83659,9,"ENSG00000249464.8",0,NA,"VVVUVUVVV",2,7,0.802898550724638,90,96,133,136,142,148,157,160,"GTGAAGT","GTGA","TAGATAA","CTGA",2.3862966861036,37,6,9,61,1.98666919225874,4.47382844157069,7.68542264446924,101,"ENSG00000079974.19"
"5699","ENSG00000106351.13_4814",4806,4814,9,"ENSG00000106351.13",1,2,"UMVVVVVVV",1,7,0.786749482401656,90,96,106,109,115,121,133,136,"AGGATGA","TTGA","AAGACGT","CTGC",2.28203180374401,10,6,12,37,2.94002531109953,4.53839266734823,7.68539059695485,101,"ENSG00000079974.19"
"36682","ENSG00000242593.8_204677",204669,204677,9,"ENSG00000242593.8",1,6,"UVVVVMVVV",1,7,0.805383022774327,84,90,133,136,142,148,193,196,"ATGCTGA","CTGG","TTTATAA","CTGA",2.52954652178937,43,6,45,103,0.99171547428252,4.46383973821958,7.68537182931689,101,"ENSG00000079974.19"
"36683","ENSG00000242593.8_209676",209668,209676,9,"ENSG00000242593.8",1,6,"UVVVVMVVV",1,7,0.805383022774327,84,90,133,136,142,148,193,196,"ATGCTGA","CTGG","TTTATAA","CTGA",2.52954652178937,43,6,45,103,0.99171547428252,4.46383973821958,7.68537182931689,101,"ENSG00000079974.19"
"47176","ENSG00000287747.1_2032",2024,2032,9,"ENSG00000287747.1",1,8,"VVUVVVVMV",1,7,0.767701863354037,109,115,133,136,141,147,161,164,"CTGAAGT","TTGA","TTGAAAA","CTGA",2.39772363732575,18,5,14,46,2.47328676243841,4.61452775281918,7.68533520623533,101,"ENSG00000079974.19"
"41746","ENSG00000259664.3_181675",181667,181675,9,"ENSG00000259664.3",1,1,"MVVVVUVVV",1,7,0.82815734989648,86,92,133,136,144,150,173,176,"GTGATGA","TAGA","ATGAGGA","ATGA",2.4216537328008,41,8,23,81,1.34635245804469,4.37267766917917,7.6853070687651,101,"ENSG00000079974.19"
"1960","ENSG00000068305.19_2479",2471,2479,9,"ENSG00000068305.19",1,8,"UVVVVVVMV",1,7,0.786749482401656,111,117,133,136,150,156,165,168,"GTGAGCA","GTGA","ATAATCA","CTGA",2.35379409927189,16,14,9,48,2.46115777463775,4.53827960911259,7.68527753871921,101,"ENSG00000079974.19"
"15263","ENSG00000147485.13_41861",41853,41861,9,"ENSG00000147485.13",1,5,"VVVVMUVVV",1,7,0.808695652173913,106,112,133,136,139,145,179,182,"GTGAAGA","TTCA","GTGTTGA","CTGA",2.49415845154175,21,3,34,67,1.17423600301288,4.4504897533228,7.68527236201845,101,"ENSG00000079974.19"
"12192","ENSG00000137575.12_5684",5676,5684,9,"ENSG00000137575.12",1,8,"UVVVVVVMV",1,7,0.786749482401656,116,122,133,136,143,149,205,208,"AGGATGA","TTTA","GTAAATA","CTGA",2.42665583003653,11,7,56,83,1.9753192655649,4.53825619978543,7.68525412939206,101,"ENSG00000079974.19"
"14483","ENSG00000145103.15_14593",14585,14593,9,"ENSG00000145103.15",1,8,"VVVVVUVMV",1,7,0.806211180124224,50,56,73,76,88,94,133,136,"GTGATGT","CTGA","CTGGAGA","CAGA",2.44436998386253,17,12,39,77,1.5457766696875,4.46039414052609,7.68523886102299,101,"ENSG00000079974.19"
"36339","ENSG00000240057.8_132036",132028,132036,9,"ENSG00000240057.8",1,8,"VVVVVVUMV",1,7,0.770186335403727,109,115,133,136,141,147,155,158,"ATCATCA","CTTA","ATGTTTT","CTGA",2.37102280573029,18,5,8,40,2.6110837409858,4.6044756114636,7.6852209530785,101,"ENSG00000079974.19"
"10461","ENSG00000131148.9_24698",24690,24698,9,"ENSG00000131148.9",1,8,"UVVVVVVMV",1,7,0.786749482401656,115,121,133,136,187,193,204,207,"GCCATGA","CTTA","CTGTTGA","CTGA",2.42494096171266,12,51,11,83,1.98658866451506,4.53821543564987,7.6852133652565,101,"ENSG00000079974.19"
"18789","ENSG00000158486.15_31286",31278,31286,9,"ENSG00000158486.15",1,2,"VMVUVVVVV",1,7,0.764803312629399,76,82,100,103,111,117,133,136,"ATGATGA","CTGG","GTCTTCA","TTGA",2.4137853980724,18,8,16,51,2.41198921695561,4.6259729676929,7.6851862182105,101,"ENSG00000079974.19"
"35822","ENSG00000237311.3_59814",59806,59814,9,"ENSG00000237311.3",0,NA,"VVUVVVUVV",2,7,0.769772256728778,107,113,133,136,144,150,162,165,"GTGATCA","TAGA","CAGACGA","CTGA",2.39821323129264,20,8,12,49,2.43625606679422,4.60608606885295,7.68517509576807,101,"ENSG00000079974.19"
"14530","ENSG00000145348.17_96346",96338,96346,9,"ENSG00000145348.17",1,8,"VVUVVVVMV",1,7,0.767701863354037,110,116,133,136,160,166,187,190,"ATGATGG","CTTC","ATGAGGA","CTGA",2.56429557374941,17,24,21,71,1.36200110152543,4.61432623163037,7.68513368504652,101,"ENSG00000079974.19"
"20947","ENSG00000166016.6_42184",42176,42184,9,"ENSG00000166016.6",1,7,"VVVVUVMVV",1,7,0.775155279503105,70,76,92,95,105,111,133,136,"GTGAGGG","CTGG","GTGTTGG","CTGA",2.42915360946985,16,10,22,57,2.14369019301076,4.58451189736911,7.68513301538153,101,"ENSG00000079974.19"
"9225","ENSG00000123130.17_52291",52283,52291,9,"ENSG00000123130.17",1,8,"VVVVUVVMV",1,7,0.773913043478261,104,110,133,136,139,145,164,167,"AGGAGGA","CAGA","CTGAGGA","CTGA",2.52128825739743,23,3,19,54,1.549248916659,4.58945932482714,7.68511149874018,101,"ENSG00000079974.19"
"12060","ENSG00000137033.12_3927",3919,3927,9,"ENSG00000137033.12",1,7,"VVVVUVMVV",1,7,0.775155279503105,107,113,133,136,143,149,158,161,"GTGATGG","GTCA","GTAATTT","CTGA",2.37644013485393,20,7,9,45,2.49500504206971,4.58448481860731,7.68510593661973,101,"ENSG00000079974.19"
"39231","ENSG00000253322.1_209874",209866,209874,9,"ENSG00000253322.1",1,8,"VVUVVVVMV",1,7,0.767701863354037,90,96,133,136,147,153,199,202,"GTGATGA","TTGG","ATGATGT","CTGA",2.64174205205605,37,11,46,103,0.845398203441873,4.61425297095388,7.68506042437003,101,"ENSG00000079974.19"
"24274","ENSG00000175611.14_5858",5850,5858,9,"ENSG00000175611.14",1,2,"UMVVVVVVV",1,7,0.786749482401656,113,119,133,136,139,145,156,159,"TTGCTAA","CTCA","TTGAAAA","CTGA",2.31341217884245,14,3,11,37,2.72940261748816,4.53803761910945,7.68503554871608,101,"ENSG00000079974.19"
"3779","ENSG00000089048.15_9084",9076,9084,9,"ENSG00000089048.15",1,2,"VMVVVVUVV",1,7,0.770186335403727,87,93,133,136,147,153,163,166,"CTGATGA","CAGT","TTTATGG","CTGA",2.4870946451278,40,11,10,70,1.83649350474075,4.60428111806486,7.68502645967976,101,"ENSG00000079974.19"
"39583","ENSG00000253868.4_66431",66423,66431,9,"ENSG00000253868.4",1,2,"VMVVVUVVV",1,7,0.806211180124223,116,122,133,136,149,155,185,188,"ATAGTGA","CTGC","TTGATTC","CTGA",2.40676387027169,11,13,30,63,1.79553462948755,4.46015677449137,7.68500149498826,101,"ENSG00000079974.19"
"46951","ENSG00000287401.1_22815",22807,22815,9,"ENSG00000287401.1",1,1,"MVVVVVUVV",1,7,0.792132505175983,115,121,133,136,140,146,157,160,"GGGACGA","CAAA","ATGATTG","CTGA",2.2709393123249,12,4,11,36,2.92626049687161,4.51646397809274,7.68499399879667,101,"ENSG00000079974.19"
"4933","ENSG00000102452.18_55416",55408,55416,9,"ENSG00000102452.18",1,2,"UMVVVVVVV",1,7,0.786749482401656,61,67,83,86,97,103,133,136,"ATTTTGA","ATGA","GTAAAGA","CTGA",2.45285744815368,16,11,30,66,1.79957986881109,4.53799071412557,7.68498864373219,101,"ENSG00000079974.19"
"16104","ENSG00000150676.13_38222",38214,38222,9,"ENSG00000150676.13",1,6,"UVVVVMVVV",1,7,0.805383022774327,114,120,133,136,143,149,171,174,"GTTATGC","TAGA","CTGAATA","CTGA",2.31752077101302,13,7,22,51,2.40368439608716,4.46345571737683,7.68498780847414,101,"ENSG00000079974.19"
"1632","ENSG00000064309.16_36328",36320,36328,9,"ENSG00000064309.16",1,5,"VVVUMVVVV",1,7,0.767287784679089,103,109,133,136,145,151,163,166,"GTGATAA","GTGA","AGGACAA","CTGA",2.45047991485105,24,9,12,54,2.12673662934742,4.61581734875528,7.68496848747164,101,"ENSG00000079974.19"
"45790","ENSG00000285914.1_1747",1739,1747,9,"ENSG00000285914.1",1,8,"VVVVVUVMV",1,7,0.806211180124224,95,101,133,136,153,159,172,175,"CTGAGGA","CAGA","GTGGGAA","CTGA",2.47045939836903,32,17,13,71,1.37065147467463,4.46009519928371,7.68493991978061,101,"ENSG00000079974.19"
"3946","ENSG00000091157.15_319531",319523,319531,9,"ENSG00000091157.15",1,1,"MVVVVVUVV",1,7,0.792132505175983,106,112,133,136,144,150,158,161,"TGGATGA","TTGT","ATTATCA","CTGA",2.35273477099825,21,8,8,46,2.38070738542802,4.51640146468742,7.68493148539135,101,"ENSG00000079974.19"
"27715","ENSG00000187231.14_1944",1936,1944,9,"ENSG00000187231.14",0,NA,"UVVVVUVVV",2,7,0.824844720496894,87,93,103,106,114,120,133,136,"GTGATGG","CTGA","ATGCAGA","GTAA",2.20259469098345,10,8,13,40,2.85818679787468,4.38553785110776,7.68491673309533,101,"ENSG00000079974.19"
"4862","ENSG00000102174.10_111061",111053,111061,9,"ENSG00000102174.10",1,2,"UMVVVVVVV",1,7,0.786749482401656,73,79,94,97,102,108,133,136,"GTGATGG","CTGA","ATCATTA","CTCA",2.40562919870546,15,5,25,54,2.11407273456934,4.53790018148477,7.68489811109139,101,"ENSG00000079974.19"
"46806","ENSG00000287212.1_198",190,198,9,"ENSG00000287212.1",1,8,"VVVVVUVMV",1,7,0.806211180124224,115,121,133,136,139,145,159,162,"CTAATGA","CTGA","GACAGGA","CTGT",2.28118388167127,12,3,14,38,2.63221583451699,4.46002709474803,7.68487181524492,101,"ENSG00000079974.19"
"621","ENSG00000021645.20_256227",256219,256227,9,"ENSG00000021645.20",1,1,"MVVVVVUVV",1,7,0.792132505175983,113,119,133,136,143,149,160,163,"TTGATGA","ATGG","TTGATAG","GTGA",2.2637292630946,14,7,11,41,2.97383677531519,4.51634129898646,7.6848713196904,101,"ENSG00000079974.19"
"42725","ENSG00000266049.1_72699",72691,72699,9,"ENSG00000266049.1",1,2,"UMVVVVVVV",1,7,0.786749482401656,63,69,82,85,98,104,133,136,"GTGCTGG","TTGA","ATGAAGT","CTGA",2.44690562630132,13,13,29,64,1.8387128822897,4.53785426440795,7.68485219401458,101,"ENSG00000079974.19"
"45791","ENSG00000285915.1_11548",11540,11548,9,"ENSG00000285915.1",0,NA,"VVVVVUUVV",2,7,0.808281573498965,14,20,57,60,110,116,133,136,"ATGAGGA","CTGG","TTGTTGC","CTGA",2.5656033200308,37,50,17,113,0.702846602633545,4.45171718404305,7.68484347803891,101,"ENSG00000079974.19"
"18043","ENSG00000156052.11_166552",166544,166552,9,"ENSG00000156052.11",1,8,"UVVVVVVMV",1,7,0.786749482401656,113,119,133,136,149,155,168,171,"ATGATAT","TTCA","ATTTTGA","CTGA",2.33593882356868,14,13,13,49,2.57837416635746,4.53782491420383,7.68482284381046,101,"ENSG00000079974.19"
"34594","ENSG00000233539.5_57878",57870,57878,9,"ENSG00000233539.5",0,NA,"UVVVUVVVV",2,7,0.792546583850932,102,108,133,136,170,176,189,192,"ATGATTA","CCAA","GTGATGG","CTGA",2.54152210631012,25,34,13,81,1.11502745215121,4.51462704022134,7.68481337562507,101,"ENSG00000079974.19"
"18074","ENSG00000156110.15_187077",187069,187077,9,"ENSG00000156110.15",1,2,"UMVVVVVVV",1,7,0.786749482401656,108,114,133,136,146,152,169,172,"ATGTGGA","GTGA","ATGAATG","CTGA",2.3967378899221,19,10,17,55,2.17269725720247,4.53773746417079,7.68473539377741,101,"ENSG00000079974.19"
"4858","ENSG00000102144.15_128125",128117,128125,9,"ENSG00000102144.15",1,6,"UVVVVMVVV",1,7,0.805383022774327,113,119,133,136,154,160,203,206,"ATGCTCA","CTCA","ATGATTA","CTGA",2.47570159643576,14,18,43,84,1.34786719535752,4.46313612623232,7.68466821732963,101,"ENSG00000079974.19"
"20644","ENSG00000165240.22_128174",128166,128174,9,"ENSG00000165240.22",1,6,"UVVVVMVVV",1,7,0.805383022774327,113,119,133,136,154,160,203,206,"ATGCTCA","CTCA","ATGATTA","CTGA",2.47570159643576,14,18,43,84,1.34786719535752,4.46313612623232,7.68466821732963,101,"ENSG00000079974.19"
"22521","ENSG00000170743.17_183187",183179,183187,9,"ENSG00000170743.17",1,1,"MVVUVVVVV",1,7,0.786749482401656,64,70,79,82,92,98,133,136,"GAGATGT","CTTA","GTGAAGC","CTGA",2.45447614262399,9,10,35,63,1.78748331919223,4.53766440083804,7.68466233044467,101,"ENSG00000079974.19"
"15976","ENSG00000150471.17_699737",699729,699737,9,"ENSG00000150471.17",1,8,"VVVUVVVMV",1,7,0.764803312629399,110,116,133,136,138,144,154,157,"CTGAGGA","CTGA","TTGAGGA","TTGA",2.4242647326793,17,2,10,38,2.34002972362185,4.62544865203762,7.68466190255522,101,"ENSG00000079974.19"
"2579","ENSG00000075891.23_29463",29455,29463,9,"ENSG00000075891.23",1,8,"UVVVVVVMV",1,7,0.786749482401656,105,111,133,136,138,144,160,163,"AAAATGA","CTTA","TTGATGC","CTGA",2.47929810422921,22,2,16,49,1.6219837880096,4.53765945405108,7.68465738365771,101,"ENSG00000079974.19"
"42001","ENSG00000260289.2_173314",173306,173314,9,"ENSG00000260289.2",1,8,"VVUVVVVMV",1,7,0.767701863354037,116,122,133,136,140,146,201,204,"GAGATGA","CAAA","ATGAAGA","CTGA",2.49627560044789,11,4,55,79,1.81324918664519,4.61377163074111,7.68457908415726,101,"ENSG00000079974.19"
"19226","ENSG00000162599.18_400821",400813,400821,9,"ENSG00000162599.18",1,1,"MVVVVUVVV",1,7,0.82815734989648,107,113,133,136,145,151,162,165,"GTGATGT","TGGA","TTGCTGA","CTCA",2.25897248530014,20,9,11,49,2.4279168125345,4.37193334530052,7.68456274488644,101,"ENSG00000079974.19"
"16074","ENSG00000150672.19_2083766",2083758,2083766,9,"ENSG00000150672.19",0,NA,"VVVUVVUVV",2,7,0.766873706004141,87,93,106,109,110,116,133,136,"ATCATCA","ATGA","ATGAGGG","CTGA",2.46243140769897,13,1,17,40,2.05206075712125,4.61706753544525,7.68456235946182,101,"ENSG00000079974.19"
"17102","ENSG00000153113.24_165971",165963,165971,9,"ENSG00000153113.24",1,3,"VVMVVVUVV",1,7,0.768944099378882,116,122,133,136,145,151,194,197,"TTGTTGA","CTTA","ATGACTA","CTGA",2.4747547575127,11,9,43,72,1.93653653544686,4.60872539638288,7.68450179389841,101,"ENSG00000079974.19"
"32034","ENSG00000225689.2_50901",50893,50901,9,"ENSG00000225689.2",1,3,"VVMUVVVVV",1,7,0.763561076604555,112,118,133,136,142,148,162,165,"ATAATGG","TTTA","GTAATGT","CTGA",2.3621438829271,15,6,14,44,2.77333864836149,4.63024113363554,7.68448544005376,101,"ENSG00000079974.19"
"5463","ENSG00000104885.19_42874",42866,42874,9,"ENSG00000104885.19",1,2,"VMVVUVVVV",1,7,0.773913043478261,113,119,133,136,145,151,172,175,"AACTTGA","CTCA","ATGATGA","CTGA",2.3970526736068,14,9,21,53,2.37494295172615,4.5888235272762,7.68447570118924,101,"ENSG00000079974.19"
"28026","ENSG00000188001.10_118968",118960,118968,9,"ENSG00000188001.10",1,2,"VMUVVVVVV",1,7,0.767701863354037,68,74,85,88,93,99,133,136,"ATGAAGA","CTGA","ATGAATA","CCGA",2.47270981947014,11,5,34,59,1.96979659432385,4.6136321810312,7.68443963444734,101,"ENSG00000079974.19"
"42033","ENSG00000260372.7_268084",268076,268084,9,"ENSG00000260372.7",1,8,"UVVVVVVMV",1,7,0.786749482401656,45,51,65,68,75,81,133,136,"CTGATGA","ATGA","GTGACAA","CTTA",2.42763967064232,14,7,52,82,1.96541182633349,4.53741907432057,7.6844170039272,101,"ENSG00000079974.19"
"45222","ENSG00000285219.4_709635",709627,709635,9,"ENSG00000285219.4",1,1,"MVVVVVUVV",1,7,0.792132505175983,61,67,81,84,94,100,133,136,"ATGCTGA","CTCA","GTGAAGA","CTCA",2.41881511917945,14,10,33,66,1.9380219264766,4.5158640135849,7.68439403428883,101,"ENSG00000079974.19"
"36963","ENSG00000243944.5_32348",32340,32348,9,"ENSG00000243944.5",1,2,"VMVVVVUVV",1,7,0.770186335403727,110,116,133,136,151,157,177,180,"GTGAGGA","ATAA","GTGGTGA","CTGA",2.48840615752811,17,15,20,61,1.82520311944125,4.6036443757405,7.6843897173554,101,"ENSG00000079974.19"
"28526","ENSG00000196090.13_146063",146055,146063,9,"ENSG00000196090.13",1,8,"VVVVUVVMV",1,7,0.773913043478261,95,101,108,111,116,122,133,136,"GTGGTGG","CAGA","GGAAGGA","CTGA",2.33536986061321,7,5,11,32,2.78555061077569,4.58867075371594,7.68432292762899,101,"ENSG00000079974.19"
"5250","ENSG00000104093.14_130941",130933,130941,9,"ENSG00000104093.14",1,6,"UVVVVMVVV",1,7,0.805383022774327,80,86,96,99,106,112,133,136,"TTTATGT","TTGA","ATTCAGA","CTGA",2.32029302878849,10,7,21,47,2.38237603257782,4.46274905612527,7.68428114722258,101,"ENSG00000079974.19"
"26709","ENSG00000184903.10_829277",829269,829277,9,"ENSG00000184903.10",0,NA,"UVVVVUVVV",2,7,0.824844720496894,108,114,133,136,140,146,154,157,"ATAATAA","AAGA","AAGGAGA","CTGA",2.26675153915465,19,4,8,40,2.42787061583007,4.38488688588194,7.68426576786951,101,"ENSG00000079974.19"
"14967","ENSG00000146416.19_34720",34712,34720,9,"ENSG00000146416.19",1,1,"MVVUVVVVV",1,7,0.786749482401656,101,107,133,136,143,149,163,166,"ATAATGA","TGGA","GTAACAA","CTGA",2.4216141862876,26,7,14,56,2.00494811245048,4.53726067192528,7.6842586015319,101,"ENSG00000079974.19"
"35920","ENSG00000237480.3_67734",67726,67734,9,"ENSG00000237480.3",1,8,"UVVVVVVMV",1,7,0.786749482401656,110,116,133,136,158,164,177,180,"CTGATTA","CTTA","ATGGAGT","CTGA",2.44071020440278,17,22,13,61,1.87762134684687,4.53725567738302,7.68425360698964,101,"ENSG00000079974.19"
"21727","ENSG00000168803.16_3425",3417,3425,9,"ENSG00000168803.16",1,7,"VVUVVVMVV",1,7,0.768944099378882,116,122,133,136,141,147,158,161,"ATGCTGA","GTGA","CTCATGT","ATGA",2.31585397173887,11,5,11,36,2.9946049370839,4.60840785383576,7.68418425135129,101,"ENSG00000079974.19"
"8762","ENSG00000120616.16_69950",69942,69950,9,"ENSG00000120616.16",0,NA,"UVVVVVUVV",2,7,0.788819875776397,82,88,133,136,150,156,172,175,"CTGTTGA","CTGC","GTGCAGA","CTGA",2.51008484959611,45,14,16,84,1.38159849546814,4.52887437319388,7.68415387629947,101,"ENSG00000079974.19"
"42836","ENSG00000267101.7_61279",61271,61279,9,"ENSG00000267101.7",1,8,"VVVVVVUMV",1,7,0.770186335403727,115,121,133,136,147,153,186,189,"CTGCTGA","CAGA","CTGGTCA","CTGA",2.47536543796544,12,11,33,65,1.91115884894851,4.60339877551286,7.68414411712777,101,"ENSG00000079974.19"
"9142","ENSG00000122870.12_149690",149682,149690,9,"ENSG00000122870.12",1,8,"UVVVVVVMV",1,7,0.786749482401656,99,105,133,136,146,152,168,171,"ATGTTGC","CAGA","GTTTTGA","CTGA",2.46206173200118,28,10,16,63,1.7346959603388,4.53711021008667,7.6841081396933,101,"ENSG00000079974.19"
"10077","ENSG00000129116.20_193039",193031,193039,9,"ENSG00000129116.20",1,2,"VMVVVUVVV",1,7,0.806211180124223,113,119,133,136,175,181,191,194,"ATGAGAA","CTTA","GTGGTAC","CTGA",2.37961329238844,14,39,10,72,1.97290063505935,4.45924731274556,7.68409203324246,101,"ENSG00000079974.19"
"36070","ENSG00000237844.2_219002",218994,219002,9,"ENSG00000237844.2",1,2,"VMVUVVVVV",1,7,0.764803312629399,87,93,103,106,115,121,133,136,"ATGATGT","TTGA","TAGGTGA","CTGG",2.34573785655556,10,9,12,40,2.86106706963059,4.62482986166692,7.68404311218452,101,"ENSG00000079974.19"
"5071","ENSG00000102935.12_322221",322213,322221,9,"ENSG00000102935.12",1,1,"MVUVVVVVV",1,7,0.789648033126294,98,104,133,136,139,145,163,166,"GTGATCA","ATGT","GTGAGGA","CTGA",2.50594079615412,29,3,18,59,1.39549913079425,4.52544277628876,7.68403490879394,101,"ENSG00000079974.19"
"9943","ENSG00000128573.28_219314",219306,219314,9,"ENSG00000128573.28",0,NA,"UVVVUVVVV",2,7,0.792546583850932,107,113,133,136,142,148,192,195,"ATGAGGA","TAGA","AAGAGGA","CTGA",2.48579864442278,20,6,44,79,1.48325464600783,4.51381140220659,7.68399773761031,101,"ENSG00000079974.19"
"42904","ENSG00000267313.7_74675",74667,74675,9,"ENSG00000267313.7",0,NA,"UVVVVVUVV",2,7,0.788819875776397,95,101,108,111,115,121,133,136,"TTGATGA","TTGA","ATAATAC","CTGG",2.31759980318815,7,4,12,32,2.66413775433196,4.52870077722991,7.6839802803355,101,"ENSG00000079974.19"
"20625","ENSG00000165185.15_72910",72902,72910,9,"ENSG00000165185.15",1,7,"VVUVVVMVV",1,7,0.768944099378882,113,119,133,136,140,146,159,162,"ATGAGGC","ATTA","ATGTTAA","CTGA",2.35181326805551,14,4,13,40,2.753905864183,4.60816524613827,7.68394164365379,101,"ENSG00000079974.19"
"29242","ENSG00000197558.13_39572",39564,39572,9,"ENSG00000197558.13",0,NA,"VVUVVUVVV",2,7,0.805797101449275,116,122,133,136,147,153,164,167,"GTGGGGA","ATGG","GGGATGG","CTGA",2.25448502241401,11,11,11,42,2.81308666297025,4.46074670309924,7.68393510889634,101,"ENSG00000079974.19"
"40028","ENSG00000254733.1_155326",155318,155326,9,"ENSG00000254733.1",1,1,"MVVVVVUVV",1,7,0.792132505175983,97,103,133,136,141,147,158,161,"TTGATAG","CTGA","ATAAGGG","CTGA",2.41510513027141,30,5,11,55,1.96082984329636,4.51538267794311,7.68391269864705,101,"ENSG00000079974.19"
"32783","ENSG00000227906.10_158127",158119,158127,9,"ENSG00000227906.10",1,6,"UVVVVMVVV",1,7,0.805383022774327,116,122,133,136,139,145,156,159,"ATAATCA","CATA","AGGAAAA","CTGA",2.25318451818122,11,3,11,34,2.8281652332091,4.46234883860432,7.68388092970162,101,"ENSG00000079974.19"
"32646","ENSG00000227463.3_623",615,623,9,"ENSG00000227463.3",1,8,"UVVVVVVMV",1,7,0.786749482401656,81,87,101,104,111,117,133,136,"AATATGA","ATCA","CTGCTGT","CTGA",2.31314343490777,14,7,16,46,2.72653488024608,4.53687277824115,7.68387070784777,101,"ENSG00000079974.19"
"25299","ENSG00000180592.17_10244",10236,10244,9,"ENSG00000180592.17",1,1,"MVVUVVVVV",1,7,0.786749482401656,66,72,85,88,103,109,133,136,"ATAAGGA","CTGA","ACTCTGA","CTGA",2.44261942341071,13,15,24,61,1.86324247763262,4.53684299175934,7.68384092136596,101,"ENSG00000079974.19"
"36750","ENSG00000242808.12_764606",764598,764606,9,"ENSG00000242808.12",1,6,"UVVVVMVVV",1,7,0.805383022774327,114,120,133,136,141,147,157,160,"AAGCTCA","TTAA","ATGTTGA","CTGA",2.22649747020054,13,5,10,37,3.00590809002966,4.46230613950831,7.68383823060562,101,"ENSG00000079974.19"
"14044","ENSG00000144290.17_232187",232179,232187,9,"ENSG00000144290.17",1,3,"UVMVVUVVV",2,6,0.707660455486542,113,119,133,136,144,150,171,174,"ATGAGGA","TTAA","GTGATCA","CTGA",2.55024840002945,14,8,21,52,2.41112108518388,4.85319427134505,7.68383609329122,101,"ENSG00000079974.19"
"7049","ENSG00000112562.20_219281",219273,219281,9,"ENSG00000112562.20",1,8,"VVVVVUVMV",1,7,0.806211180124224,88,94,133,136,143,149,171,174,"GTGTTGA","CTGG","ATGTTTT","CTGA",2.46393755537765,39,7,22,77,1.40968140633854,4.45898294388072,7.68382766437761,101,"ENSG00000079974.19"
"19349","ENSG00000162814.11_4421",4413,4421,9,"ENSG00000162814.11",1,1,"MVVVVUVVV",1,7,0.82815734989648,87,93,105,108,116,122,133,136,"ATTCTGA","TTGA","ATTATCA","ATGA",2.17185882831874,12,8,11,40,3.00568632882915,4.37118629607185,7.68381569565777,101,"ENSG00000079974.19"
"2169","ENSG00000070882.13_43919",43911,43919,9,"ENSG00000070882.13",1,5,"UVVVMVVVV",1,7,0.789233954451346,115,121,133,136,149,155,167,170,"ATGATTT","ATTA","GTGTTTC","CTGA",2.31764116149235,12,13,12,46,2.65648561885893,4.52685667386865,7.68379249167403,101,"ENSG00000079974.19"
"4821","ENSG00000101972.20_24843",24835,24843,9,"ENSG00000101972.20",1,8,"UVVVVVVMV",1,7,0.786749482401656,115,121,133,136,142,148,204,207,"ATGAAGC","TTGA","GAGAGGC","CTGA",2.4243989982901,12,6,56,83,1.98448610371589,4.53678652307914,7.68378445268577,101,"ENSG00000079974.19"
"37360","ENSG00000247708.8_195386",195378,195386,9,"ENSG00000247708.8",0,NA,"UVVVVUVVV",2,7,0.824844720496894,114,120,133,136,151,157,174,177,"AAGCTGA","GTGG","CTCAAGA","CTGA",2.29354090382462,13,15,17,54,2.24714575044516,4.38435461065231,7.68373349263989,101,"ENSG00000079974.19"
"22471","ENSG00000170624.14_262588",262580,262588,9,"ENSG00000170624.14",1,1,"MVVVVVUVV",1,7,0.792132505175983,110,116,133,136,144,150,205,208,"ATCATGA","AAGA","TGGATAA","CTGA",2.44775793590073,17,8,55,89,1.74235544808738,4.51518542185639,7.68371544256032,101,"ENSG00000079974.19"
"22842","ENSG00000171517.6_56468",56460,56468,9,"ENSG00000171517.6",1,1,"MVVVVUVVV",1,7,0.82815734989648,114,120,133,136,142,148,185,188,"ATAAGGC","CAGA","CTGTTAA","CTGA",2.32021841770948,13,6,37,65,2.01597385432981,4.37102415976491,7.68365355935083,101,"ENSG00000079974.19"
"28984","ENSG00000196876.19_194398",194390,194398,9,"ENSG00000196876.19",1,8,"VVUVVVVMV",1,7,0.767701863354037,59,65,80,83,112,118,133,136,"ATGATTA","CTTA","ATCATAT","CTGA",2.49952545931895,15,29,15,68,1.78784611332247,4.6128372938622,7.68364474727835,101,"ENSG00000079974.19"
"41740","ENSG00000259647.1_29759",29751,29759,9,"ENSG00000259647.1",1,5,"UVVVMVVVV",1,7,0.789233954451346,95,101,111,114,116,122,133,136,"CAGAAGA","CAGA","CAGATCA","CTGA",2.31296277197906,10,2,11,32,2.68688258497362,4.52665859954184,7.68359441734722,101,"ENSG00000079974.19"
"26405","ENSG00000184178.17_490878",490870,490878,9,"ENSG00000184178.17",0,NA,"VVUUVVVVV",2,7,0.764389233954451,108,114,133,136,141,147,199,202,"ATGTGGA","CAGA","TTGATGA","CTGA",2.54912590450114,19,5,52,85,1.5098300769564,4.62600069340766,7.68355762922547,101,"ENSG00000079974.19"
"36889","ENSG00000243321.3_1205",1197,1205,9,"ENSG00000243321.3",1,1,"MVVVVVUVV",1,7,0.792132505175983,52,58,97,100,110,116,133,136,"AGGATGA","CTGA","ATGCTGG","GTGA",2.46930004233617,39,10,17,75,1.59791069392014,4.51497774404031,7.68350776474424,101,"ENSG00000079974.19"
"40771","ENSG00000257599.5_39724",39716,39724,9,"ENSG00000257599.5",1,6,"VVUVVMVVV",1,7,0.786335403726708,6,12,27,30,80,86,133,136,"ATGATGG","CTCA","TTGGTAA","CTGA",2.58559753904386,15,50,47,121,0.915217862896758,4.53813369746396,7.68347531237079,101,"ENSG00000079974.19"
"8290","ENSG00000117868.18_63477",63469,63477,9,"ENSG00000117868.18",1,5,"VVVVMUVVV",1,7,0.808695652173913,114,120,133,136,144,150,158,161,"GTGGTGT","GTGC","ATTATTT","CTGA",2.21587283583895,13,8,8,38,3.0222337442241,4.44867982912094,7.68346243781659,101,"ENSG00000079974.19"
"5802","ENSG00000106723.17_86096",86088,86096,9,"ENSG00000106723.17",1,3,"VVMVVVUVV",1,7,0.768944099378882,115,121,133,136,145,151,167,170,"AAGATGA","GTGA","GGGAAGA","CAGA",2.35759356157193,12,9,16,46,2.71337994093988,4.60766758785484,7.68344398537037,101,"ENSG00000079974.19"
"20509","ENSG00000164989.17_381797",381789,381797,9,"ENSG00000164989.17",1,8,"VVVVUVVMV",1,7,0.773913043478261,58,64,77,80,92,98,133,136,"TTGATGA","CATA","TGGACGA","CTGA",2.48049609669693,13,12,35,69,1.81450669694981,4.587786835399,7.68343900931205,101,"ENSG00000079974.19"
"252","ENSG00000007001.13_59934",59926,59934,9,"ENSG00000007001.13",1,8,"VVVVUVVMV",1,7,0.773913043478261,77,83,100,103,108,114,133,136,"GTGCTCA","CTGA","GTTCTGC","CTGA",2.41328272520933,17,5,19,50,2.26249922614084,4.58776268188409,7.68341485579714,101,"ENSG00000079974.19"
"3774","ENSG00000088992.18_22288",22280,22288,9,"ENSG00000088992.18",0,NA,"VVVUVUVVV",2,7,0.802898550724638,74,80,95,98,110,116,133,136,"GTGTTGA","CTGA","ATGCCCA","CTCA",2.32711885614695,15,12,17,53,2.37310739038926,4.4718082745089,7.68340247740745,101,"ENSG00000079974.19"
"26554","ENSG00000184408.10_179568",179560,179568,9,"ENSG00000184408.10",0,NA,"VVVUVVUVV",2,7,0.766873706004141,78,84,91,94,100,106,133,136,"GTGATGA","CTTA","GTGCTGA","CAGA",2.49949056944748,7,6,27,49,1.80032098271796,4.61589786142529,7.68339268544185,101,"ENSG00000079974.19"
"45576","ENSG00000285713.1_491534",491526,491534,9,"ENSG00000285713.1",1,1,"MVVUVVVVV",1,7,0.786749482401656,114,120,133,136,139,145,199,202,"GAGAAGA","ATGA","GTGCTGA","CTGA",2.46721853648265,13,3,54,79,1.69739989673611,4.53638086832178,7.68337879792841,101,"ENSG00000079974.19"
"45661","ENSG00000285783.1_264313",264305,264313,9,"ENSG00000285783.1",1,1,"MVVUVVVVV",1,7,0.786749482401656,114,120,133,136,139,145,199,202,"GAGAAGA","ATGA","GTGCTGA","CTGA",2.46721853648265,13,3,54,79,1.69739989673611,4.53638086832178,7.68337879792841,101,"ENSG00000079974.19"
"15014","ENSG00000146592.17_323152",323144,323152,9,"ENSG00000146592.17",1,1,"MVVVVUVVV",1,7,0.82815734989648,84,90,133,136,171,177,190,193,"ATGAAGA","CAAA","GAGAAGA","CTGA",2.48150353966092,43,35,13,100,0.939573823190387,4.3707326885658,7.68336208815172,101,"ENSG00000079974.19"
"47801","ENSG00000289368.2_10724",10716,10724,9,"ENSG00000289368.2",1,2,"VMUVVVVVV",1,7,0.767701863354037,35,41,59,62,73,79,133,136,"ATGATGA","CTGA","GAGATCC","ATGA",2.5421694015444,18,11,54,92,1.50240361744823,4.61254990693606,7.68335736035221,101,"ENSG00000079974.19"
"16850","ENSG00000152422.16_33609",33601,33609,9,"ENSG00000152422.16",1,8,"VVVVVVUMV",1,7,0.770186335403727,113,119,133,136,138,144,155,158,"TTGGTGA","TTGT","GTCAGGA","CTGA",2.37493801252488,14,2,11,36,2.57747349206256,4.60259839389044,7.68334373550535,101,"ENSG00000079974.19"
"6789","ENSG00000111880.16_158881",158873,158881,9,"ENSG00000111880.16",1,5,"UVVVMVVVV",1,7,0.789233954451346,91,97,103,106,114,120,133,136,"ATGATGA","CTGA","AAGATGG","TGGA",2.34145752895753,6,8,13,36,2.49576769928879,4.52637113975141,7.68330695755679,101,"ENSG00000079974.19"
"39056","ENSG00000251574.8_133250",133242,133250,9,"ENSG00000251574.8",1,8,"VVVVVUVMV",1,7,0.806211180124224,108,114,133,136,179,185,200,203,"GAGATAA","ATGA","ATGAGGA","CTGA",2.46537914416161,19,43,15,86,1.39795207555469,4.45845325915802,7.68329797965492,101,"ENSG00000079974.19"
"6946","ENSG00000112320.12_133540",133532,133540,9,"ENSG00000112320.12",1,2,"UMVVVVVVV",1,7,0.786749482401656,84,90,133,136,146,152,181,184,"TAGATGA","CAGA","ATGTTGA","CTGA",2.56462037082703,43,10,29,91,1.04771139828354,4.53629513428259,7.68329306388922,101,"ENSG00000079974.19"
"28356","ENSG00000188811.14_7670",7662,7670,9,"ENSG00000188811.14",1,1,"MVVUVVVVV",1,7,0.786749482401656,57,63,72,75,112,118,133,136,"GTGAAGA","CTCA","GGGAGGT","CTGA",2.4717560820258,9,37,15,70,1.66679675375398,4.5362926584815,7.68329058808812,101,"ENSG00000079974.19"
"28688","ENSG00000196353.13_327973",327965,327973,9,"ENSG00000196353.13",1,8,"VVUVVVVMV",1,7,0.767701863354037,114,120,133,136,139,145,193,196,"ATGCTGA","CTGT","ATGTTCC","CTGA",2.51243581753067,13,3,48,73,1.70030700601368,4.6124697807212,7.68327723413735,101,"ENSG00000079974.19"
"27570","ENSG00000186487.21_474852",474844,474852,9,"ENSG00000186487.21",1,3,"UVMVVVVVV",1,7,0.785507246376811,100,106,133,136,140,146,173,176,"TTGATGT","CTGT","GTGAGCA","CTGA",2.55312387900428,27,4,27,67,1.14398339764785,4.5412023144191,7.68323129992634,101,"ENSG00000079974.19"
"39","ENSG00000002746.15_215230",215222,215230,9,"ENSG00000002746.15",1,1,"MVVVVUVVV",1,7,0.82815734989648,113,119,133,136,140,146,179,182,"CTAATGG","CATA","GTGATTA","CTGA",2.34072492997622,14,4,33,60,1.87755546356525,4.37059708251835,7.68322648210427,101,"ENSG00000079974.19"
"26633","ENSG00000184672.12_258553",258545,258553,9,"ENSG00000184672.12",1,7,"VVUVVVMVV",1,7,0.768944099378882,84,90,99,102,110,116,133,136,"AATAAGA","CTGA","TTGTTCA","CTGA",2.38449587775849,9,8,17,43,2.53289790922988,4.60738427357162,7.68316067108715,101,"ENSG00000079974.19"
"36101","ENSG00000237880.2_256465",256457,256465,9,"ENSG00000237880.2",1,2,"UMVVVVVVV",1,7,0.786749482401656,114,120,133,136,158,164,186,189,"ATGAAGT","CTAA","GTGCTCA","CTGA",2.48068224711118,13,22,22,66,1.60673574437601,4.53615434794597,7.6831522775526,101,"ENSG00000079974.19"
"25818","ENSG00000182901.18_371080",371072,371080,9,"ENSG00000182901.18",1,2,"VMVVVUVVV",1,7,0.806211180124223,103,109,133,136,142,148,158,161,"AGGAAGA","ATGA","GTGATGA","CTGC",2.34451811748063,24,6,10,49,2.20299377505002,4.45827863956355,7.68312336006045,101,"ENSG00000079974.19"
"2535","ENSG00000075539.15_3207",3199,3207,9,"ENSG00000075539.15",1,2,"VMVVVUVVV",1,7,0.806211180124223,113,119,133,136,147,153,164,167,"ATTATGT","ATGA","ATGGAGA","CTGG",2.25634168397736,14,11,11,45,2.79079292182895,4.45826770375284,7.68311242424973,101,"ENSG00000079974.19"
"42826","ENSG00000267061.1_2855",2847,2855,9,"ENSG00000267061.1",1,8,"VVUVVVVMV",1,7,0.767701863354037,39,45,58,61,105,111,133,136,"ATGATGG","ATGA","GTTTTCA","CTGA",2.55640194404336,13,44,22,88,1.40648645521465,4.61229152054259,7.68309897395874,101,"ENSG00000079974.19"
"11605","ENSG00000135525.19_155159",155151,155159,9,"ENSG00000135525.19",1,8,"VVVVVUVMV",1,7,0.806211180124224,108,114,133,136,145,151,159,162,"ACTATGA","TTGG","TTCAGGA","CTGA",2.29791337422508,19,9,8,45,2.51359288605256,4.4582538452216,7.6830985657185,101,"ENSG00000079974.19"
"7695","ENSG00000115364.14_15660",15652,15660,9,"ENSG00000115364.14",1,2,"UMVVVVVVV",1,7,0.786749482401656,83,89,133,136,143,149,157,160,"ATCATGA","CACA","ATGTGAA","CTGA",2.42458866603637,44,7,8,68,1.98044975278937,4.53609354825796,7.68309147786458,101,"ENSG00000079974.19"
"38553","ENSG00000250412.1_9298",9290,9298,9,"ENSG00000250412.1",1,3,"UVMVVVVVV",1,7,0.785507246376811,102,108,133,136,153,159,184,187,"AGGATGA","GTGA","ATGCTCA","CTGA",2.59368101777119,25,17,25,76,0.872967053546763,4.54104345967201,7.68307244517926,101,"ENSG00000079974.19"
"21247","ENSG00000166896.9_5851",5843,5851,9,"ENSG00000166896.9",1,2,"UMVVVVVVV",1,7,0.786749482401656,115,121,133,136,143,149,160,163,"ATTAAAA","CTAA","GTATTGA","CTGA",2.26703438524084,12,7,11,39,3.03072645176272,4.53607225500875,7.68307018461538,101,"ENSG00000079974.19"
"12433","ENSG00000138180.16_10481",10473,10481,9,"ENSG00000138180.16",1,1,"MVVUVVVVV",1,7,0.786749482401656,116,122,133,136,176,182,193,196,"GTTATGG","CTAA","GTGCTGT","CTGA",2.42644699562823,11,40,11,71,1.9679473498259,4.53606516350352,7.68306309311014,101,"ENSG00000079974.19"
"38105","ENSG00000249550.8_33029",33021,33029,9,"ENSG00000249550.8",1,2,"UMVVVVVVV",1,7,0.786749482401656,114,120,133,136,146,152,177,180,"ATGCTGA","TTCA","ATAAAAA","CTGA",2.3966047956452,13,10,25,57,2.16687022337664,4.5360588819195,7.68305681152612,101,"ENSG00000079974.19"
"39617","ENSG00000253925.1_40248",40240,40248,9,"ENSG00000253925.1",0,NA,"VVUVVUVVV",2,7,0.805797101449275,116,122,133,136,145,151,163,166,"AGGATAA","GGGA","AAGCTGC","CTGA",2.2397752254906,11,9,12,41,2.90761341977754,4.45986206409538,7.68305046989248,101,"ENSG00000079974.19"
"18454","ENSG00000157429.16_22336",22328,22336,9,"ENSG00000157429.16",1,8,"VVVVVVUMV",1,7,0.770186335403727,83,89,133,136,141,147,160,163,"ATGATCA","TTGT","ATGATAT","CTGA",2.4837458764933,44,5,13,71,1.85090319134031,4.60230225865724,7.68304760027215,101,"ENSG00000079974.19"
"38078","ENSG00000249484.9_33279",33271,33279,9,"ENSG00000249484.9",1,2,"UMVVVVVVV",1,7,0.786749482401656,75,81,97,100,111,117,133,136,"ATTTTGA","CTGA","GTTATGA","CTTA",2.3568465380392,16,11,16,52,2.43180036479835,4.53602765459825,7.68302558420488,101,"ENSG00000079974.19"
"6512","ENSG00000110427.17_147503",147495,147503,9,"ENSG00000110427.17",1,6,"VVUVVMVVV",1,7,0.786335403726708,114,120,133,136,143,149,164,167,"ATGTAGA","AGGA","ATCATAA","CTGA",2.29938939071448,13,7,15,44,2.82140405818526,4.53766666573712,7.68300828064396,101,"ENSG00000079974.19"
"32221","ENSG00000226367.6_28872",28864,28872,9,"ENSG00000226367.6",0,NA,"UVVVVUVVV",2,7,0.824844720496894,99,105,133,136,145,151,175,178,"ATTTTGC","CTGT","ATGATGA","CTGA",2.42879621683258,28,9,24,70,1.34238543310727,4.38359005299779,7.68296893498536,101,"ENSG00000079974.19"
"27463","ENSG00000186231.17_18134",18126,18134,9,"ENSG00000186231.17",1,8,"VVVVVUVMV",1,7,0.806211180124224,110,116,133,136,141,147,167,170,"AAGAAGA","TAGA","TTGAAAA","CTGA",2.3443493153301,17,5,20,51,2.2033348791655,4.45808257867488,7.68292729917177,101,"ENSG00000079974.19"
"28569","ENSG00000196132.14_131514",131506,131514,9,"ENSG00000196132.14",0,NA,"UVVVVUVVV",2,7,0.824844720496894,115,121,133,136,141,147,160,163,"GAGATGA","CTAA","GGGCTTA","CTGG",2.19576746950719,12,5,13,39,2.89554315851381,4.3834982388071,7.68287712079467,101,"ENSG00000079974.19"
"1055","ENSG00000047249.18_58323",58315,58323,9,"ENSG00000047249.18",1,1,"MVVVVVUVV",1,7,0.792132505175983,95,101,133,136,165,171,186,189,"GTGATAA","ATGA","GTGAAAA","CTGA",2.5733224460556,32,29,15,85,0.901826085985828,4.51432726492246,7.68285728562639,101,"ENSG00000079974.19"
"41328","ENSG00000258859.1_122731",122723,122731,9,"ENSG00000258859.1",1,8,"VVUVVVVMV",1,7,0.767701863354037,111,117,133,136,156,162,172,175,"AGGAAGA","GTGA","ATGGTGG","CTGA",2.44983678318728,16,20,10,55,2.11591820187731,4.61204085578146,7.68284830919761,101,"ENSG00000079974.19"
"16400","ENSG00000151468.11_41377",41369,41377,9,"ENSG00000151468.11",0,NA,"VVVVVUUVV",2,7,0.808281573498965,85,91,102,105,112,118,133,136,"ATGAAGG","GTGA","ATGAATA","TTGA",2.24842053539775,11,7,15,42,2.80930442936659,4.4496936663379,7.68281996033376,101,"ENSG00000079974.19"
"31923","ENSG00000225251.1_401",393,401,9,"ENSG00000225251.1",0,NA,"VVVVVUUVV",2,7,0.808281573498965,85,91,102,105,112,118,133,136,"ATGAAGG","GTGA","ATGAATA","TTGA",2.24842053539775,11,7,15,42,2.80930442936659,4.4496936663379,7.68281996033376,101,"ENSG00000079974.19"
"36445","ENSG00000241061.3_405",397,405,9,"ENSG00000241061.3",0,NA,"VVVVVUUVV",2,7,0.808281573498965,85,91,102,105,112,118,133,136,"ATGAAGG","GTGA","ATGAATA","TTGA",2.24842053539775,11,7,15,42,2.80930442936659,4.4496936663379,7.68281996033376,101,"ENSG00000079974.19"
"36697","ENSG00000242697.2_397",389,397,9,"ENSG00000242697.2",0,NA,"VVVVVUUVV",2,7,0.808281573498965,85,91,102,105,112,118,133,136,"ATGAAGG","GTGA","ATGAATA","TTGA",2.24842053539775,11,7,15,42,2.80930442936659,4.4496936663379,7.68281996033376,101,"ENSG00000079974.19"
"36775","ENSG00000242882.1_365",357,365,9,"ENSG00000242882.1",0,NA,"VVVVVUUVV",2,7,0.808281573498965,85,91,102,105,112,118,133,136,"ATGAAGG","GTGA","ATGAATA","TTGA",2.24842053539775,11,7,15,42,2.80930442936659,4.4496936663379,7.68281996033376,101,"ENSG00000079974.19"
"36955","ENSG00000243859.3_398",390,398,9,"ENSG00000243859.3",0,NA,"VVVVVUUVV",2,7,0.808281573498965,85,91,102,105,112,118,133,136,"ATGAAGG","GTGA","ATGAATA","TTGA",2.24842053539775,11,7,15,42,2.80930442936659,4.4496936663379,7.68281996033376,101,"ENSG00000079974.19"
"32991","ENSG00000228432.2_2330",2322,2330,9,"ENSG00000228432.2",1,2,"VMVVUVVVV",1,7,0.773913043478261,90,96,133,136,155,161,175,178,"ATGATGG","GTGA","GTCAGAA","CTGA",2.57249522364962,37,19,14,79,1.19840882028654,4.58709424448767,7.68274641840071,101,"ENSG00000079974.19"
"35029","ENSG00000234745.14_2043",2035,2043,9,"ENSG00000234745.14",1,2,"VMVVUVVVV",1,7,0.773913043478261,90,96,133,136,155,161,175,178,"ATGATGG","GTGA","GTCAGAA","CTGA",2.57249522364962,37,19,14,79,1.19840882028654,4.58709424448767,7.68274641840071,101,"ENSG00000079974.19"
"12761","ENSG00000138892.12_33270",33262,33270,9,"ENSG00000138892.12",1,2,"VMUVVVVVV",1,7,0.767701863354037,87,93,101,104,115,121,133,136,"ATGATGC","GTGA","ATGGTGT","ATGA",2.38351213802089,8,11,12,40,2.5573981424906,4.61186976565747,7.68267721907362,101,"ENSG00000079974.19"
"25097","ENSG00000179399.15_666429",666421,666429,9,"ENSG00000179399.15",1,8,"VVVVUVVMV",1,7,0.773913043478261,112,118,133,136,154,160,178,181,"TTGATAA","CTCA","ATCAAGA","CTGA",2.46445245473937,15,18,18,60,1.91828147650271,4.58699112702463,7.68264330093768,101,"ENSG00000079974.19"
"41946","ENSG00000260126.2_153673",153665,153673,9,"ENSG00000260126.2",1,1,"MVVVVUVVV",1,7,0.82815734989648,116,122,133,136,149,155,167,170,"ATGAGGA","CAGT","TTGTGGA","GTGA",2.22704732007188,11,13,12,45,2.63304008119191,4.3700055537511,7.68263495333702,101,"ENSG00000079974.19"
"41533","ENSG00000259200.2_135770",135762,135770,9,"ENSG00000259200.2",0,NA,"VVUVUVVVV",2,7,0.773498964803312,109,115,133,136,139,145,157,160,"ATGATAA","CACA","ACGAGGT","CTGA",2.40177328714301,18,3,12,42,2.34270310926573,4.58863125588811,7.68262711510136,101,"ENSG00000079974.19"
"30571","ENSG00000205822.11_61550",61542,61550,9,"ENSG00000205822.11",1,2,"VMVVVUVVV",1,7,0.806211180124223,102,108,133,136,144,150,176,179,"ATGAAGA","TTCA","GGGATGC","CTGA",2.46545624236362,25,8,26,68,1.3947397190866,4.45777866704435,7.68262338754125,101,"ENSG00000079974.19"
"8141","ENSG00000117000.9_36545",36537,36545,9,"ENSG00000117000.9",1,5,"UVVVMVVVV",1,7,0.789233954451346,95,101,133,136,140,146,164,167,"GTGATGT","CCAA","TTGATAA","CTGA",2.49081811853618,32,4,18,63,1.49719486474793,4.52566224708062,7.682598064886,101,"ENSG00000079974.19"
"1040","ENSG00000046651.16_9639",9631,9639,9,"ENSG00000046651.16",1,7,"UVVVVUMVV",2,6,0.710144927536232,75,81,92,95,113,119,133,136,"ATGATAA","CTAA","CTGAGCA","CTGA",2.57231480018296,11,18,14,52,2.21920948616046,4.84199370517838,7.6825734153233,101,"ENSG00000079974.19"
"8690","ENSG00000120254.16_38456",38448,38456,9,"ENSG00000120254.16",1,7,"UVVVVVMVV",1,7,0.787991718426501,97,103,133,136,175,181,193,196,"CTGATGC","CTCA","ATGATCA","CTGA",2.56674466181943,30,39,12,90,1.01072214576771,4.53058830614097,7.68255517984697,101,"ENSG00000079974.19"
"30006","ENSG00000198947.18_531569",531561,531569,9,"ENSG00000198947.18",1,1,"MVVVVUVVV",1,7,0.82815734989648,100,106,133,136,141,147,163,166,"ATGTTTT","CAGA","ATGAAAA","CTGA",2.35302439102577,27,5,16,57,1.79262961981597,4.36986472333028,7.6824941229162,101,"ENSG00000079974.19"
"31200","ENSG00000218819.6_9495",9487,9495,9,"ENSG00000218819.6",1,6,"VVVVVMUVV",1,7,0.788819875776397,95,101,133,136,144,150,166,169,"ATGATTA","GTGG","ATAATGT","CTGA",2.45104319263424,32,8,16,65,1.76854005231896,4.52720700080348,7.68248650390907,101,"ENSG00000079974.19"
"38166","ENSG00000249738.10_318249",318241,318249,9,"ENSG00000249738.10",1,5,"UVVVMVVVV",1,7,0.789233954451346,115,121,133,136,148,154,208,211,"AATATGA","CTGT","ATGTGGA","CTGA",2.45026215171595,12,12,54,87,1.76694253071585,4.52550588553887,7.68244170334426,101,"ENSG00000079974.19"
"19084","ENSG00000160973.8_2231",2223,2231,9,"ENSG00000160973.8",1,8,"VVVVVUVMV",1,7,0.806211180124224,113,119,133,136,145,151,169,172,"ATGGTGA","AAGA","CTGATGC","GTGA",2.29185919750485,14,9,18,50,2.55130451144728,4.45759145703658,7.68243617753347,101,"ENSG00000079974.19"
"34824","ENSG00000234222.6_25820",25812,25820,9,"ENSG00000234222.6",1,1,"MVVVUUVVV",2,6,0.718012422360248,78,84,100,103,110,116,133,136,"ATAATGG","CTAA","GTGAGGT","CTGA",2.50571967868531,16,7,17,49,2.53670137874385,4.81037480916148,7.68242449860248,101,"ENSG00000079974.19"
"44314","ENSG00000280778.1_25152",25144,25152,9,"ENSG00000280778.1",1,1,"MVVVUUVVV",2,6,0.718012422360248,78,84,100,103,110,116,133,136,"ATAATGG","CTAA","GTGAGGT","CTGA",2.50571967868531,16,7,17,49,2.53670137874385,4.81037480916148,7.68242449860248,101,"ENSG00000079974.19"
"11074","ENSG00000133812.18_335790",335782,335790,9,"ENSG00000133812.18",1,8,"VVVVVUVMV",1,7,0.806211180124224,111,117,133,136,146,152,160,163,"GTGAGGA","GGGA","GTGAAGA","CTGC",2.26523589100287,16,10,8,43,2.7286426117718,4.4575538046144,7.68239852511129,101,"ENSG00000079974.19"
"13760","ENSG00000143344.16_77575",77567,77575,9,"ENSG00000143344.16",1,8,"VVVVVUVMV",1,7,0.806211180124224,46,52,67,70,111,117,133,136,"CTGATGA","CTTA","GTGAGGT","CTGT",2.42340529647287,15,41,16,81,1.6740529774557,4.45752207181871,7.68236679231561,101,"ENSG00000079974.19"
"11727","ENSG00000135917.16_7805",7797,7805,9,"ENSG00000135917.16",1,1,"MVVVVUVVV",1,7,0.82815734989648,116,122,133,136,187,193,243,246,"ATGATTA","GTGG","GTTAAGA","CTGA",2.47511413858019,11,51,50,121,0.978004330143868,4.36969131350295,7.68232071308887,101,"ENSG00000079974.19"
"14792","ENSG00000145916.19_14757",14749,14757,9,"ENSG00000145916.19",1,7,"VVVVVUMVV",1,7,0.807453416149068,114,120,133,136,166,172,186,189,"CTGCTGC","CTTA","GTGGAGA","CTGA",2.38378262138575,13,30,14,66,1.91802636073548,4.45247762582678,7.68229129042305,101,"ENSG00000079974.19"
"25861","ENSG00000183011.14_8608",8600,8608,9,"ENSG00000183011.14",1,8,"VVVVVUVMV",1,7,0.806211180124224,86,92,133,136,187,193,208,211,"GTGATGA","CTTT","TTGAGGT","CTGA",2.55163099685191,41,51,15,116,0.818859073664257,4.45743309650258,7.68227781699947,101,"ENSG00000079974.19"
"5026","ENSG00000102763.18_68306",68298,68306,9,"ENSG00000102763.18",1,1,"MVVVVUVVV",1,7,0.82815734989648,115,121,133,136,138,144,158,161,"GGGAAGG","ATGA","TTCAAGA","CTGA",2.25041879302007,12,2,14,37,2.47559753261237,4.36959737151987,7.68222677110579,101,"ENSG00000079974.19"
"18890","ENSG00000159216.19_1030880",1030872,1030880,9,"ENSG00000159216.19",1,1,"MVVVVUVVV",1,7,0.82815734989648,111,117,133,136,186,192,230,233,"ATGCTGG","TTAA","GTGATGA","CTGA",2.49135387123813,16,50,38,113,0.869076065648044,4.36952546847556,7.68215486806148,101,"ENSG00000079974.19"
"31725","ENSG00000224577.4_193358",193350,193358,9,"ENSG00000224577.4",1,8,"VVUVVVVMV",1,7,0.767701863354037,116,122,133,136,145,151,162,165,"AGGATGT","CCCA","GTGTGCA","CTGA",2.32514068030044,11,9,11,40,2.94427865833799,4.6113041317519,7.68211158516805,101,"ENSG00000079974.19"
"31703","ENSG00000224504.2_5348",5340,5348,9,"ENSG00000224504.2",1,1,"MVVVVUVVV",1,7,0.82815734989648,96,102,133,136,143,149,184,187,"ATGTTGA","CTGG","AACCTGA","CTGA",2.45888399484817,31,7,35,82,1.08515099346251,4.36942773977925,7.68205713936517,101,"ENSG00000079974.19"
"34617","ENSG00000233620.5_8017",8009,8017,9,"ENSG00000233620.5",1,1,"MVVVVUVVV",1,7,0.82815734989648,115,121,133,136,150,156,173,176,"GTGATTT","GTGG","CTAATGT","CTGA",2.27352007804117,12,14,17,52,2.32085406700248,4.36941364681925,7.68204304640517,101,"ENSG00000079974.19"
"47373","ENSG00000288061.3_6295",6287,6295,9,"ENSG00000288061.3",1,8,"VVVVVUVMV",1,7,0.806211180124224,100,106,133,136,138,144,154,157,"ATGGTGA","AAGA","GAGAGAA","CTGA",2.42985992144308,27,2,10,48,1.62970231676119,4.45719211492876,7.68203683542566,101,"ENSG00000079974.19"
"3970","ENSG00000091436.17_63069",63061,63069,9,"ENSG00000091436.17",0,NA,"UVVVVVUVV",2,7,0.788819875776397,61,67,78,81,94,100,133,136,"ATGATGA","CTGT","TTGCTTA","CTGT",2.45431827489478,11,13,33,66,1.74486831378787,4.52674753660493,7.68202703971052,101,"ENSG00000079974.19"
"1802","ENSG00000066032.19_751157",751149,751157,9,"ENSG00000066032.19",1,2,"VMVVVVUVV",1,7,0.770186335403727,113,119,133,136,137,143,153,156,"AGGAGGA","CTTA","TTTATGC","CTGA",2.39231052340562,14,1,10,34,2.45628827474698,4.60125627436278,7.68200161597769,101,"ENSG00000079974.19"
"34834","ENSG00000234261.6_346000",345992,346000,9,"ENSG00000234261.6",1,5,"VVVVMVUVV",1,7,0.772670807453416,51,57,71,74,82,88,133,136,"CTAATGA","CTCA","CGGAGGA","CTGA",2.46110805087892,14,8,45,76,1.95788048308034,4.59131687223494,7.68200010204861,101,"ENSG00000079974.19"
"29892","ENSG00000198846.6_112031",112023,112031,9,"ENSG00000198846.6",1,8,"UVVVVVVMV",1,7,0.786749482401656,57,63,75,78,84,90,133,136,"GTGGTGA","CTGA","GTGGAGA","CTGG",2.42171973049267,12,6,43,70,1.99510725174064,4.53497636375627,7.6819742933629,101,"ENSG00000079974.19"
"41160","ENSG00000258594.1_5275",5267,5275,9,"ENSG00000258594.1",1,7,"VVVVVUMVV",1,7,0.807453416149068,109,115,133,136,162,168,181,184,"ATTATGA","GGGA","GAGAGCA","CTGA",2.41781987873594,18,26,13,66,1.68979981626451,4.45214975195936,7.68196341655563,101,"ENSG00000079974.19"
"17766","ENSG00000155052.15_485521",485513,485521,9,"ENSG00000155052.15",0,NA,"VVVVVUUVV",2,7,0.808281573498965,80,86,105,108,114,120,133,136,"AAGATTA","CTGA","CTGATCC","ATGA",2.29684954039885,19,6,13,47,2.48254156689008,4.44871795905394,7.6818442530498,101,"ENSG00000079974.19"
"28862","ENSG00000196600.13_70462",70454,70462,9,"ENSG00000196600.13",1,2,"VMVVVVUVV",1,7,0.770186335403727,116,122,133,136,148,154,167,170,"CTTATGA","GTGT","CTGATCC","CTGA",2.36077045019057,11,12,13,45,2.66580334278561,4.60106825268068,7.68181359429559,101,"ENSG00000079974.19"
"1385","ENSG00000054654.20_243470",243462,243470,9,"ENSG00000054654.20",0,NA,"UVVVVUVVV",2,7,0.824844720496894,115,121,133,136,152,158,169,172,"GTAATGT","TTGA","TTGAAGA","ATGA",2.25799615212808,12,16,11,48,2.47640955718845,4.38242930951058,7.68180819149816,101,"ENSG00000079974.19"
"8757","ENSG00000120594.17_77078",77070,77078,9,"ENSG00000120594.17",0,NA,"VVVVUUVVV",2,7,0.812008281573499,111,117,133,136,145,151,191,194,"TTGATGT","TTAA","TGGAAGA","CTGA",2.38891682542379,16,9,40,74,1.80894959203931,4.43376544038281,7.68179856667681,101,"ENSG00000079974.19"
"25372","ENSG00000181171.5_21399",21391,21399,9,"ENSG00000181171.5",1,6,"VVVVUMVVV",1,7,0.792546583850932,85,91,133,136,165,171,186,189,"ATGGTGA","CTGT","CTGGAGA","CTGA",2.57507469582322,42,29,15,95,0.879140135790658,4.51157619365302,7.68176252905675,101,"ENSG00000079974.19"
"39046","ENSG00000251567.5_162815",162807,162815,9,"ENSG00000251567.5",1,3,"VVMVVVUVV",1,7,0.768944099378882,98,104,133,136,145,151,198,201,"ATGATGG","TTGA","TTGGTGC","CTGA",2.61147342274985,29,9,47,94,1.01401065916292,4.60595836937381,7.68173476688934,101,"ENSG00000079974.19"
"12352","ENSG00000137941.17_63371",63363,63371,9,"ENSG00000137941.17",1,8,"VVVVVUVMV",1,7,0.806211180124224,113,119,133,136,154,160,178,181,"AGGACGA","ATTA","TTGATGT","CTGA",2.37821683287651,14,18,18,59,1.97270088216071,4.45686994200102,7.68171466249792,101,"ENSG00000079974.19"
"30835","ENSG00000213988.11_3059",3051,3059,9,"ENSG00000213988.11",1,8,"VVVUVVVMV",1,7,0.764803312629399,75,81,98,101,109,115,133,136,"GTGATTC","GTGA","CTGAAAA","CTGA",2.41679000802468,17,8,18,52,2.37797578627502,4.62247729327655,7.68169054379415,101,"ENSG00000079974.19"
"5420","ENSG00000104490.18_196204",196196,196204,9,"ENSG00000104490.18",0,NA,"UVVVUVVVV",2,7,0.792546583850932,111,117,133,136,151,157,174,177,"ACACTGA","CTGA","GAGATCA","CTGA",2.39349733687463,16,15,17,57,2.0893254008163,4.51149357832846,7.68167991373219,101,"ENSG00000079974.19"
"45437","ENSG00000285579.1_441696",441688,441696,9,"ENSG00000285579.1",1,8,"VVVVVUVMV",1,7,0.806211180124224,107,113,133,136,143,149,189,192,"CTGATGT","TTTA","GTGATTT","CTGA",2.44747326885855,20,7,40,76,1.51083789798341,4.4568315892601,7.681676309757,101,"ENSG00000079974.19"
"47725","ENSG00000289130.2_128648",128640,128648,9,"ENSG00000289130.2",1,8,"UVVVVVVMV",1,7,0.786749482401656,68,74,98,101,107,113,133,136,"ATGATGA","CTGA","GTGAAGA","AAGA",2.46304898648649,24,6,20,59,1.71820113171845,4.53463192707376,7.68162985668038,101,"ENSG00000079974.19"
"13926","ENSG00000143951.16_668374",668366,668374,9,"ENSG00000143951.16",1,2,"VMUVVVVVV",1,7,0.767701863354037,116,122,133,136,141,147,164,167,"AAGATTA","ATAA","GAGATGA","CTGA",2.37328648377885,11,5,17,42,2.62129231770413,4.61080055239078,7.68160800580693,101,"ENSG00000079974.19"
"30840","ENSG00000214013.10_20275",20267,20275,9,"ENSG00000214013.10",1,8,"VVVVVUVMV",1,7,0.806211180124224,116,122,133,136,143,149,166,169,"ATGATCT","TTCA","ATTATTC","CTGA",2.27188851267204,11,7,17,44,2.6811065779692,4.4567574989457,7.68160221944259,101,"ENSG00000079974.19"
"39242","ENSG00000253351.2_2028",2020,2028,9,"ENSG00000253351.2",1,8,"VVVVVUVMV",1,7,0.806211180124224,91,97,133,136,144,150,159,162,"CTGCTGA","CAGC","CTGAGGC","CTGA",2.37534334531585,36,8,9,62,1.99131959447832,4.45673547414599,7.68158019464289,101,"ENSG00000079974.19"
"14405","ENSG00000144847.13_50113",50105,50113,9,"ENSG00000144847.13",1,2,"UMVVVVVVV",1,7,0.786749482401656,109,115,133,136,144,150,166,169,"ATGATAT","AAGA","AAGATGC","CTGA",2.35891993593887,18,8,16,51,2.41198921695561,4.53453053080369,7.68152846041032,101,"ENSG00000079974.19"
"6826","ENSG00000111962.8_238453",238445,238453,9,"ENSG00000111962.8",1,8,"UVVVVVVMV",1,7,0.786749482401656,19,25,63,66,78,84,133,136,"CTGAGGA","CTGA","AGGAAGA","CTGA",2.60491748364455,38,12,49,108,0.772000613701366,4.53452929283292,7.68152722243955,101,"ENSG00000079974.19"
"12943","ENSG00000139668.9_138612",138604,138612,9,"ENSG00000139668.9",0,NA,"UVVUVVVVV",2,7,0.78343685300207,90,96,102,105,115,121,133,136,"CTAATGT","CTTA","CTGTTCA","CTGA",2.36527515176016,6,10,12,37,2.42256377807442,4.5477661974522,7.68151360946048,101,"ENSG00000079974.19"
"26877","ENSG00000185104.21_409679",409671,409679,9,"ENSG00000185104.21",1,6,"UVVVVMVVV",1,7,0.805383022774327,101,107,133,136,176,182,194,197,"ATGATTA","TAGA","GTGTTAA","CTGA",2.51112515742131,26,40,12,87,1.09908938835008,4.4599809427897,7.68151303388701,101,"ENSG00000079974.19"
"44602","ENSG00000283154.3_453756",453748,453756,9,"ENSG00000283154.3",0,NA,"UVUVVVVVV",2,7,0.786335403726708,111,117,133,136,163,169,182,185,"ATATTCA","CTGA","TTGATGG","CTGA",2.44500061988594,16,27,13,65,1.84460729250439,4.53615285626933,7.68149447117617,101,"ENSG00000079974.19"
"46285","ENSG00000286434.1_444",436,444,9,"ENSG00000286434.1",1,5,"VVVVMUVVV",1,7,0.808695652173913,94,100,133,136,180,186,197,200,"TTGCTGA","CTTA","CTGGTGA","CTGA",2.51712336553498,33,44,11,97,1.00598856177432,4.44670274966854,7.68148535836419,101,"ENSG00000079974.19"
"16684","ENSG00000152061.24_762457",762449,762457,9,"ENSG00000152061.24",1,3,"UVMVVVVVV",1,7,0.785507246376811,92,98,133,136,149,155,171,174,"AAGATGC","ATGA","GTGAGCA","CTGA",2.5044683171384,35,13,16,73,1.46131763943501,4.53944327175608,7.68147225726333,101,"ENSG00000079974.19"
"47907","ENSG00000289695.1_8072",8064,8072,9,"ENSG00000289695.1",1,6,"UVVVVMVVV",1,7,0.805383022774327,86,92,105,108,112,118,133,136,"ATGATGA","CTGA","ATAATAC","CTAG",2.27476472007722,13,4,15,41,2.67464895969158,4.45993677338493,7.68146886448224,101,"ENSG00000079974.19"
"1903","ENSG00000067369.14_99859",99851,99859,9,"ENSG00000067369.14",1,8,"VVVUVVVMV",1,7,0.764803312629399,111,117,133,136,166,172,182,185,"ATGCTGA","GTAA","GTGGAGA","CTGA",2.4899938080932,16,30,10,65,1.88891497777641,4.62221842459943,7.68143167511703,101,"ENSG00000079974.19"
"10240","ENSG00000130052.14_62451",62443,62451,9,"ENSG00000130052.14",1,8,"VVVUVVVMV",1,7,0.764803312629399,112,118,133,136,144,150,166,169,"ATAATGC","CTGA","GTGAAAA","CTCA",2.37483010612311,15,8,16,48,2.65648061531143,4.62217033069971,7.68138358121731,101,"ENSG00000079974.19"
"32014","ENSG00000225647.2_5781",5773,5781,9,"ENSG00000225647.2",1,2,"UMVVVVVVV",1,7,0.786749482401656,115,121,133,136,150,156,180,183,"TTGATGT","TTCA","GTGCTGC","CTGA",2.43011380306476,12,14,24,59,1.93674848997233,4.53437679426768,7.68137472387431,101,"ENSG00000079974.19"
"41849","ENSG00000259849.2_154217",154209,154217,9,"ENSG00000259849.2",1,1,"MVVVVVUVV",1,7,0.792132505175983,103,109,133,136,187,193,205,208,"ATGATGA","CAGA","CAGATGA","TTGA",2.53117294754302,24,51,12,96,1.17678527943393,4.51281789909685,7.68134791980078,101,"ENSG00000079974.19"
"4100","ENSG00000095015.6_1713",1705,1713,9,"ENSG00000095015.6",1,6,"UVVVVMVVV",1,7,0.805383022774327,105,111,133,136,142,148,198,201,"CTGATTA","TTGA","ATTTTGA","CTGA",2.47739298778065,22,6,50,87,1.32329885962364,4.45981302787366,7.68134511897097,101,"ENSG00000079974.19"
"38766","ENSG00000251003.9_128073",128065,128073,9,"ENSG00000251003.9",1,6,"VVVVVMUVV",1,7,0.788819875776397,91,97,133,136,149,155,171,174,"GGGAAGA","CTGA","TTGAGTA","CTGA",2.49680401113887,36,13,16,74,1.45878632627259,4.52603660013293,7.68131610323852,101,"ENSG00000079974.19"
"8207","ENSG00000117394.24_31408",31400,31408,9,"ENSG00000117394.24",0,NA,"VVVVUUVVV",2,7,0.812008281573499,102,108,133,136,138,144,154,157,"ATGCTGA","CAGG","CACATGA","CTGA",2.40480127435169,25,2,10,46,1.7010834283654,4.43327298101084,7.68130610730483,101,"ENSG00000079974.19"
"9118","ENSG00000122741.16_32689",32681,32689,9,"ENSG00000122741.16",1,2,"UMVVVVVVV",1,7,0.786749482401656,115,121,133,136,141,147,156,159,"AAGATTA","CCAA","TTAATTA","CTGA",2.26128150711884,12,5,9,35,3.06188807165969,4.53427452977965,7.68127245938627,101,"ENSG00000079974.19"
"47816","ENSG00000289405.1_57722",57714,57722,9,"ENSG00000289405.1",1,8,"UVVVVVVMV",1,7,0.786749482401656,103,109,133,136,167,173,189,192,"ATGGTGA","CTGG","AAGAAGA","CTGA",2.56769215683867,24,31,16,80,1.019039486398,4.53424679966396,7.68124472927058,101,"ENSG00000079974.19"
"25653","ENSG00000182348.7_429220",429212,429220,9,"ENSG00000182348.7",1,2,"UMVVVUVVV",2,6,0.708902691511387,115,121,133,136,139,145,166,169,"GTGATGA","CAGC","GTGATCC","CTGA",2.58222878800977,12,3,21,45,2.16736013697865,4.84555468092762,7.68116544697317,101,"ENSG00000079974.19"
"867","ENSG00000038382.23_97074",97066,97074,9,"ENSG00000038382.23",1,2,"VMVVVVUVV",1,7,0.770186335403727,114,120,133,136,144,150,160,163,"CTTATGT","CTGT","GAGCTAA","CTGA",2.30794528032797,13,8,10,40,3.01535129197326,4.60041329020661,7.68115863182151,101,"ENSG00000079974.19"
"24912","ENSG00000178568.15_835797",835789,835797,9,"ENSG00000178568.15",0,NA,"VVVVVUUVV",2,7,0.808281573498965,113,119,133,136,145,151,166,169,"ATAAATA","TTGA","ATGTAAA","CTGA",2.25866623350344,14,9,15,47,2.73434737282643,4.44803056571234,7.68115685970819,101,"ENSG00000079974.19"
"47372","ENSG00000288059.1_1414",1406,1414,9,"ENSG00000288059.1",0,NA,"UVVVVVUVV",2,7,0.788819875776397,103,109,133,136,145,151,186,189,"ATTATGA","TTGG","GTAATGA","CTGA",2.53226244630351,24,9,35,77,1.22166210810484,4.52585293753206,7.68113244063765,101,"ENSG00000079974.19"
"39761","ENSG00000254186.3_348662",348654,348662,9,"ENSG00000254186.3",1,1,"MVVVVUVVV",1,7,0.82815734989648,115,121,133,136,178,184,197,200,"AAGGTGA","AAGA","ATGTTCA","CTGA",2.33247405198152,12,42,13,76,1.92418297289279,4.36850249652573,7.68113189611165,101,"ENSG00000079974.19"
"36073","ENSG00000237844.2_266881",266873,266881,9,"ENSG00000237844.2",0,NA,"UVVVVUVVV",2,7,0.824844720496894,113,119,133,136,142,148,169,172,"ATGAATA","CTCC","AGGATCA","CTGA",2.26773292364922,14,6,21,50,2.40877252320025,4.38174800354876,7.68112688553634,101,"ENSG00000079974.19"
"44178","ENSG00000279161.1_1743",1735,1743,9,"ENSG00000279161.1",1,3,"VVMVVVUVV",1,7,0.768944099378882,98,104,133,136,141,147,161,164,"ATGATGG","GCGA","GTGTGGG","CTGA",2.4839866783396,29,5,14,57,1.86139040052476,4.60532539736386,7.68110179487939,101,"ENSG00000079974.19"
"37467","ENSG00000248242.1_290017",290009,290017,9,"ENSG00000248242.1",1,1,"MVVVVUVVV",1,7,0.82815734989648,45,51,73,76,88,94,133,136,"AAGATGA","CTGA","TTGAGAA","CTGT",2.45190225795157,22,12,39,82,1.12782860174482,4.36846091368882,7.68109031327474,101,"ENSG00000079974.19"
"23823","ENSG00000174343.6_19016",19008,19016,9,"ENSG00000174343.6",1,6,"UVVVVMVVV",1,7,0.805383022774327,83,89,104,107,116,122,133,136,"AGGGTAA","CCGA","GTGCACA","CTGA",2.24754503429288,15,9,11,44,2.85453102015611,4.45954114552715,7.68107323662446,101,"ENSG00000079974.19"
"18231","ENSG00000156639.12_299298",299290,299298,9,"ENSG00000156639.12",1,8,"VVVVVUVMV",1,7,0.806211180124224,115,121,133,136,155,161,200,203,"CTGTTGG","CTGA","AGGATGT","CTGA",2.47155975223636,12,19,39,79,1.34783806005696,4.4562257687415,7.6810704892384,101,"ENSG00000079974.19"
"37313","ENSG00000247081.8_70497",70489,70497,9,"ENSG00000247081.8",0,NA,"VVUVVUVVV",2,7,0.805797101449275,116,122,133,136,149,155,165,168,"ATGATAA","CAGA","ATCAGGC","CTGC",2.27252479361104,11,13,10,43,2.68131653712662,4.45787045696671,7.68105886276381,101,"ENSG00000079974.19"
"28827","ENSG00000196566.2_3447",3439,3447,9,"ENSG00000196566.2",1,2,"VMVVVVUVV",1,7,0.770186335403727,54,60,68,71,109,115,133,136,"ATGCTGA","CTGA","GTGAAGA","TTGA",2.55344210827296,8,38,18,73,1.37821824093653,4.60029140735573,7.68103674897063,101,"ENSG00000079974.19"
"27490","ENSG00000186314.12_108602",108594,108602,9,"ENSG00000186314.12",0,NA,"VVVVVUUVV",2,7,0.808281573498965,115,121,133,136,153,159,170,173,"AGGTTGA","GTCA","CTGGTGT","CTGA",2.30642699804033,12,17,11,49,2.41525322939905,4.44785830408365,7.68098459807951,101,"ENSG00000079974.19"
"36475","ENSG00000241316.8_274912",274904,274912,9,"ENSG00000241316.8",1,7,"VVVVVUMVV",1,7,0.807453416149068,54,60,74,77,87,93,133,136,"ATGATGA","ATAA","ATGAATA","CTAA",2.38830349743405,14,10,40,73,1.88257929254791,4.45115065219373,7.68096431679,101,"ENSG00000079974.19"
"45536","ENSG00000285694.1_4787",4779,4787,9,"ENSG00000285694.1",1,2,"VMVVVVUVV",1,7,0.770186335403727,86,92,100,103,110,116,133,136,"AAGAGGA","CAGA","GAGAGCA","CTGA",2.3921928378777,8,7,17,41,2.4529023258973,4.60021364460383,7.68095898621874,101,"ENSG00000079974.19"
"25208","ENSG00000179915.25_693890",693882,693890,9,"ENSG00000179915.25",0,NA,"UVVVVUVVV",2,7,0.824844720496894,107,113,133,136,137,143,159,162,"ATGATTA","CTCT","GGGAACA","CTGA",2.39213615512114,20,1,16,46,1.57871102976398,4.38157134930955,7.68095023129713,101,"ENSG00000079974.19"
"6037","ENSG00000107779.14_87182",87174,87182,9,"ENSG00000107779.14",1,8,"VVVVVUVMV",1,7,0.806211180124224,116,122,133,136,186,192,243,246,"ATGATGT","CTTT","ATGAAGT","CTGA",2.52700751795664,11,50,51,121,0.977681007327606,4.4560994484263,7.6809441689232,101,"ENSG00000079974.19"
"29183","ENSG00000197410.14_82945",82937,82945,9,"ENSG00000197410.14",1,7,"UVVVVVMVV",1,7,0.787991718426501,105,111,133,136,143,149,202,205,"GTGGTGA","GTGA","CTGCTGG","CTGA",2.51663038739488,22,7,53,91,1.33824184266605,4.52894443965797,7.68091131336397,101,"ENSG00000079974.19"
"10676","ENSG00000132323.9_6193",6185,6193,9,"ENSG00000132323.9",1,1,"MVVVVUUVV",2,6,0.714285714285714,47,53,67,70,78,84,133,136,"GTGAGGA","CTGA","TTTATTA","CTGA",2.60121873152263,14,8,49,80,1.95359948015112,4.8237644225755,7.68090727971835,101,"ENSG00000079974.19"
"16205","ENSG00000151136.15_146259",146251,146259,9,"ENSG00000151136.15",1,8,"VVVUVVVMV",1,7,0.764803312629399,64,70,86,89,95,101,133,136,"ATGGTGA","CTGA","GTGAGGG","CTCA",2.48619440355392,16,6,32,63,1.91204830351095,4.62166941513427,7.68088266565187,101,"ENSG00000079974.19"
"1119","ENSG00000047932.14_35286",35278,35286,9,"ENSG00000047932.14",1,1,"MVVVVUVVV",1,7,0.82815734989648,116,122,133,136,154,160,175,178,"ATGGTCA","CTAC","CTGTAGA","CTGA",2.29619235038369,11,18,15,53,2.16482442848079,4.36819335775968,7.6808227573456,101,"ENSG00000079974.19"
"44445","ENSG00000282218.1_6315",6307,6315,9,"ENSG00000282218.1",1,1,"MVVVVUVVV",1,7,0.82815734989648,116,122,133,136,154,160,175,178,"ATGGTCA","CTAC","CTGTAGA","CTGA",2.29619235038369,11,18,15,53,2.16482442848079,4.36819335775968,7.6808227573456,101,"ENSG00000079974.19"
"13338","ENSG00000140992.19_29105",29097,29105,9,"ENSG00000140992.19",1,2,"VMVVVUVVV",1,7,0.806211180124223,112,118,133,136,147,153,161,164,"GTGCTTA","CAAA","GTAAAGA","CTGA",2.26301490503123,15,11,8,43,2.73711088358685,4.4559692292821,7.68081394977899,101,"ENSG00000079974.19"
"30590","ENSG00000205918.10_9324",9316,9324,9,"ENSG00000205918.10",1,2,"VMVVVUVVV",1,7,0.806211180124223,112,118,133,136,147,153,161,164,"GTGCTTA","CAAA","GTAAAGA","CTGA",2.26301490503123,15,11,8,43,2.73711088358685,4.4559692292821,7.68081394977899,101,"ENSG00000079974.19"
"48240","ENSG00000290728.1_10188",10180,10188,9,"ENSG00000290728.1",1,2,"VMVVVUVVV",1,7,0.806211180124223,112,118,133,136,147,153,161,164,"GTGCTTA","CAAA","GTAAAGA","CTGA",2.26301490503123,15,11,8,43,2.73711088358685,4.4559692292821,7.68081394977899,101,"ENSG00000079974.19"
"1302","ENSG00000053108.17_169701",169693,169701,9,"ENSG00000053108.17",1,6,"UVVVVMVVV",1,7,0.805383022774327,96,102,133,136,147,153,181,184,"ACGATGA","TAGA","GTGTTGG","CTGA",2.51930467162147,31,11,28,79,1.04173112946185,4.45927390173457,7.68080599283188,101,"ENSG00000079974.19"
"22713","ENSG00000171189.18_192642",192634,192642,9,"ENSG00000171189.18",1,1,"MVVUVVVVV",1,7,0.786749482401656,115,121,133,136,140,146,158,161,"CTGATCA","CACA","AGGATTT","CTGA",2.28904285646533,12,4,12,37,2.87483027044181,4.53377899505267,7.68077692465929,101,"ENSG00000079974.19"
"24044","ENSG00000174945.14_63063",63055,63063,9,"ENSG00000174945.14",1,8,"VVVVVUVMV",1,7,0.806211180124224,83,89,103,106,112,118,133,136,"GTAATTC","CTTA","GTGCTCA","CTGA",2.25751602751594,14,6,15,44,2.77349567328223,4.45590063084713,7.68074535134402,101,"ENSG00000079974.19"
"22650","ENSG00000171055.15_94481",94473,94481,9,"ENSG00000171055.15",0,NA,"UVVVVUVVV",2,7,0.824844720496894,72,78,88,91,115,121,133,136,"AAAATGA","CTGA","ATGATAT","CTTA",2.32520255284017,10,24,12,55,2.02408981247239,4.38136004118504,7.68073892317262,101,"ENSG00000079974.19"
"45362","ENSG00000285517.1_11083",11075,11083,9,"ENSG00000285517.1",1,6,"VVVUVMVVV",1,7,0.78343685300207,113,119,133,136,147,153,170,173,"GTGGTGA","ATGT","GTCAATA","CTGA",2.35362468770269,14,11,17,51,2.49708326756014,4.54697862972786,7.68072604173614,101,"ENSG00000079974.19"
"45425","ENSG00000285572.2_145217",145209,145217,9,"ENSG00000285572.2",1,1,"MVUVVVVVV",1,7,0.789648033126294,112,118,133,136,148,154,165,168,"ATGATGC","ATGA","ATGTTCC","CTCA",2.31369660937988,15,12,11,47,2.66387970553764,4.52213094201754,7.68072307452272,101,"ENSG00000079974.19"
"44244","ENSG00000280070.1_81",73,81,9,"ENSG00000280070.1",1,6,"UVVVVMVVV",1,7,0.805383022774327,65,71,83,86,98,104,132,135,"GTGCTCA","ATGA","ATGCTGT","CTGA",2.38441429169446,12,12,28,61,1.94050296136106,4.45914955983104,7.68068165092835,101,"ENSG00000079974.19"
"9452","ENSG00000124749.17_73739",73731,73739,9,"ENSG00000124749.17",1,8,"VVVVUVVMV",1,7,0.773913043478261,94,100,133,136,142,148,158,161,"TTGAAGA","GAGA","CTGAGGA","CTGA",2.45091050044472,33,6,10,58,2.00066744212664,4.58501769460619,7.68066986851923,101,"ENSG00000079974.19"
"30033","ENSG00000198959.12_39146",39138,39146,9,"ENSG00000198959.12",1,1,"MVVVVUVVV",1,7,0.82815734989648,63,69,81,84,89,95,133,136,"CTCATGA","ATGA","ATGATGG","ATGA",2.3265498975342,12,5,38,64,1.96181244568965,4.36803627397941,7.68066567356533,101,"ENSG00000079974.19"
"15397","ENSG00000148123.15_5751",5743,5751,9,"ENSG00000148123.15",1,7,"VVVUVVMVV",1,7,0.766045548654244,90,96,133,136,144,150,158,161,"CTGATGA","CAGG","GTTAGGC","CTGA",2.4742222412784,37,8,8,62,1.97102634948442,4.6164603228351,7.68064251745207,101,"ENSG00000079974.19"
"15280","ENSG00000147536.12_2141",2133,2141,9,"ENSG00000147536.12",1,6,"VVVVVMUVV",1,7,0.788819875776397,75,81,95,98,104,110,133,136,"ATGATAA","CTGG","TTGATTA","CTCA",2.36921180977748,14,6,23,52,2.306681976536,4.52535684376313,7.68063634686872,101,"ENSG00000079974.19"
"29236","ENSG00000197555.10_198448",198440,198448,9,"ENSG00000197555.10",1,8,"VVUVVVVMV",1,7,0.767701863354037,110,116,133,136,160,166,184,187,"ATCATGA","CTTC","ATGAAGA","CTGA",2.53521100223364,17,24,18,68,1.53774685365126,4.60978838380222,7.68059583721837,101,"ENSG00000079974.19"
"42541","ENSG00000264058.2_16192",16184,16192,9,"ENSG00000264058.2",1,8,"VVVUVVVMV",1,7,0.764803312629399,113,119,133,136,148,154,170,173,"ATGATTT","CTGG","GGGCTGC","CTGA",2.39948491466354,14,12,16,51,2.48875095851114,4.62132926406702,7.68054251458462,101,"ENSG00000079974.19"
"27638","ENSG00000186952.15_391447",391439,391447,9,"ENSG00000186952.15",1,8,"VVVVVUVMV",1,7,0.806211180124224,107,113,133,136,138,144,165,168,"ATAATTA","CTTA","GTGACAA","CTGA",2.45197633335813,20,2,21,52,1.4761831861751,4.45567301880732,7.68051773930422,101,"ENSG00000079974.19"
"28085","ENSG00000188107.15_437429",437421,437429,9,"ENSG00000188107.15",1,1,"MVVVUVVVV",1,7,0.795859213250517,105,111,133,136,164,170,190,193,"ATGATTA","GTCA","GTGAAGA","CTGA",2.55921261048764,22,28,20,79,0.926831633073909,4.49706225908121,7.68049911208328,101,"ENSG00000079974.19"
"16857","ENSG00000152484.14_43177",43169,43177,9,"ENSG00000152484.14",1,1,"MVVVVUVVV",1,7,0.82815734989648,111,117,133,136,184,190,204,207,"ATCAAGA","CTTG","TTGAAGA","CTGA",2.36412092825589,16,48,14,87,1.71062261857509,4.36785720173693,7.68048660132285,101,"ENSG00000079974.19"
"36351","ENSG00000240086.7_64644",64636,64644,9,"ENSG00000240086.7",1,8,"VVVVUVVMV",1,7,0.773913043478261,115,121,133,136,151,157,168,171,"GTGGGGT","CTGA","TTGGTGT","CTGA",2.36951430744435,12,15,11,47,2.54253125666672,4.58482332657394,7.68047550048698,101,"ENSG00000079974.19"
"48554","ENSG00000291286.1_10749",10741,10749,9,"ENSG00000291286.1",1,8,"VVVVVUVMV",1,7,0.806211180124224,89,95,133,136,158,164,178,181,"AAGATGT","CAGA","GTGACCA","CTGA",2.51167734311336,38,22,14,83,1.07791311870944,4.45560718486629,7.68045190536318,101,"ENSG00000079974.19"
"15504","ENSG00000148498.17_590870",590862,590870,9,"ENSG00000148498.17",1,6,"VVVVVMUVV",1,7,0.788819875776397,108,114,133,136,146,152,191,194,"CTGAGGA","CTGT","CTGTGGA","CTGA",2.49009965815322,19,10,39,77,1.49997817426859,4.52516064048919,7.68044014359478,101,"ENSG00000079974.19"
"4214","ENSG00000099219.15_45076",45068,45076,9,"ENSG00000099219.15",1,7,"VVVUVVMVV",1,7,0.766045548654244,111,117,133,136,142,148,161,164,"GTCATGC","AGGA","ATGGTGA","CTGA",2.35732071212058,16,6,13,44,2.74952189876665,4.61624832822596,7.68043052284293,101,"ENSG00000079974.19"
"9388","ENSG00000124406.17_152576",152568,152576,9,"ENSG00000124406.17",0,NA,"UVVVUVVVV",2,7,0.792546583850932,107,113,133,136,142,148,177,180,"TTGATGT","GTTA","TTGATGT","CTGA",2.46267667726562,20,6,29,64,1.62310864412144,4.51023828980639,7.68042462521012,101,"ENSG00000079974.19"
"47711","ENSG00000289084.1_657188",657180,657188,9,"ENSG00000289084.1",1,1,"MVVVUVVVV",1,7,0.795859213250517,116,122,133,136,147,153,166,169,"ATGATGA","TTTA","ATCTTTA","CTCA",2.28753194600152,11,11,13,44,2.73771762998642,4.49698265083247,7.68041950383454,101,"ENSG00000079974.19"
"42518","ENSG00000263765.5_73081",73073,73081,9,"ENSG00000263765.5",1,3,"VVMVVUVVV",1,7,0.804968944099379,90,96,108,111,116,122,133,136,"GTGATAA","CTGG","TGGATAA","CAGA",2.2268836135502,12,5,11,37,2.99624312688554,4.46053347097172,7.68040924736923,101,"ENSG00000079974.19"
"28843","ENSG00000196569.14_597261",597253,597261,9,"ENSG00000196569.14",0,NA,"UVVVVUVVV",2,7,0.824844720496894,115,121,133,136,148,154,165,168,"TTCATAA","CTCC","GTGACTA","CTGA",2.21453508705115,12,12,11,44,2.76047784817007,4.38101127379444,7.68039015578202,101,"ENSG00000079974.19"
"10196","ENSG00000129682.16_461452",461444,461452,9,"ENSG00000129682.16",1,2,"UMVVVVVVV",1,7,0.786749482401656,114,120,133,136,161,167,178,181,"GTAATGA","GTGT","GTAATCA","CTGA",2.40423577949305,13,25,11,58,2.10527522409098,4.53337843851117,7.68037636811779,101,"ENSG00000079974.19"
"10533","ENSG00000131446.17_13467",13459,13467,9,"ENSG00000131446.17",0,NA,"VVVUVUVVV",2,7,0.802898550724638,116,122,133,136,140,146,155,158,"GTGTGGA","CCGG","GTGCAGT","CTGA",2.22835093781754,11,4,9,33,3.01944027565145,4.46877829860877,7.68037250150732,101,"ENSG00000079974.19"
"22109","ENSG00000169855.21_1152319",1152311,1152319,9,"ENSG00000169855.21",0,NA,"UVVVVUVVV",2,7,0.824844720496894,86,92,103,106,115,121,133,136,"ATGTTGT","TTGA","GTGGTAC","CTGG",2.1924472158796,11,9,12,41,2.90761341977754,4.38098204807706,7.68036093006463,101,"ENSG00000079974.19"
"43284","ENSG00000270792.6_292248",292240,292248,9,"ENSG00000270792.6",1,3,"VVMVVVUVV",1,7,0.768944099378882,98,104,133,136,151,157,167,170,"AGGATGA","GTGG","TTGATGC","CTGA",2.52088943707911,29,15,10,63,1.6123693302935,4.60457472770523,7.68035112522075,101,"ENSG00000079974.19"
"14119","ENSG00000144451.20_609652",609644,609652,9,"ENSG00000144451.20",1,1,"MVVVVVUVV",1,7,0.792132505175983,100,106,133,136,139,145,155,158,"GTGAAGA","TGGA","ATGATAT","CTGA",2.43636925981561,27,3,10,49,1.80470511861652,4.51179171268014,7.68032173338407,101,"ENSG00000079974.19"
"15787","ENSG00000149557.14_140017",140009,140017,9,"ENSG00000149557.14",0,NA,"UVVVUVVVV",2,7,0.792546583850932,69,75,91,94,113,119,133,136,"ATGGAGA","CTTA","CTAAAGA","CTGA",2.40127800800384,16,19,14,58,2.03197473248807,4.51012369646175,7.68031003186548,101,"ENSG00000079974.19"
"15685","ENSG00000149212.12_41987",41979,41987,9,"ENSG00000149212.12",1,3,"UVMVVVVVV",1,7,0.785507246376811,85,91,133,136,143,149,180,183,"TTGATGA","GAGA","ATGTAGA","CTGA",2.55674797827187,42,7,31,89,1.10790620163019,4.53822318086067,7.68025216636791,101,"ENSG00000079974.19"
"16582","ENSG00000151812.15_402067",402059,402067,9,"ENSG00000151812.15",0,NA,"UVVVVUVVV",2,7,0.824844720496894,9,15,25,28,79,85,133,136,"ATGATGG","CTGA","GAGATGC","TTGA",2.48992168064702,10,51,48,118,0.923897375956764,4.38084381173423,7.68022269372181,101,"ENSG00000079974.19"
"44112","ENSG00000278305.1_13148",13140,13148,9,"ENSG00000278305.1",1,3,"VVMVVVUVV",1,7,0.768944099378882,30,36,77,80,113,119,133,136,"ATGATGA","CTGA","ATGAAGG","CTGT",2.62741312741313,41,33,14,97,0.901603005563483,4.60442263041275,7.68019902792828,101,"ENSG00000079974.19"
"1971","ENSG00000068489.13_28879",28871,28879,9,"ENSG00000068489.13",0,NA,"VVVVUUVVV",2,7,0.812008281573499,85,91,133,136,181,187,195,198,"ATGAGGA","CTGC","GAGCTGG","CTGA",2.51176807834356,42,45,8,104,0.98352550119638,4.43216150587169,7.68019463216569,101,"ENSG00000079974.19"
"900","ENSG00000039560.14_56269",56261,56269,9,"ENSG00000039560.14",1,7,"UVVVVUMVV",2,6,0.710144927536232,116,122,133,136,141,147,170,173,"ATGATGT","CTTT","ATGATAA","CTGA",2.5637473828215,11,5,23,48,2.26679467221333,4.83961097275584,7.68019068290077,101,"ENSG00000079974.19"
"21638","ENSG00000168658.19_207669",207661,207669,9,"ENSG00000168658.19",1,7,"UVVVVVMVV",1,7,0.787991718426501,71,77,103,106,110,116,133,136,"ATGAAGA","CTCA","GTGATGA","CTGT",2.46658186512567,26,4,17,56,1.66897696586263,4.5282140166751,7.6801808903811,101,"ENSG00000079974.19"
"667","ENSG00000023171.20_69819",69811,69819,9,"ENSG00000023171.20",1,6,"VVUVVMVVV",1,7,0.786335403726708,115,121,133,136,144,150,171,174,"TGGAGGA","GTGA","CTGTGGA","CTGA",2.35370916297709,12,8,21,50,2.44785841623421,4.53481320902037,7.6801548239272,101,"ENSG00000079974.19"
"9933","ENSG00000128536.16_15777",15769,15777,9,"ENSG00000128536.16",0,NA,"VVVVUUVVV",2,7,0.812008281573499,82,88,133,136,140,146,157,160,"ATAATGT","CTTT","GTGAGAA","CTGA",2.38570839199582,45,4,11,69,1.82374909590108,4.43211792730163,7.68015105359563,101,"ENSG00000079974.19"
"35595","ENSG00000236432.8_38068",38060,38068,9,"ENSG00000236432.8",1,1,"MVVVVUVVV",1,7,0.82815734989648,48,54,66,69,74,80,133,136,"TTGAAGA","CTAA","GTGAAGA","GTGA",2.33059076710285,12,5,53,79,1.93278889437266,4.36751516876457,7.6801445683505,101,"ENSG00000079974.19"
"5541","ENSG00000105778.20_52559",52551,52559,9,"ENSG00000105778.20",1,2,"VMVVVUVVV",1,7,0.806211180124223,114,120,133,136,139,145,155,158,"AAGAGGA","CACA","GTCATCC","CTGA",2.24893891828226,13,3,10,35,2.82812012749484,4.45526156234415,7.68010628284104,101,"ENSG00000079974.19"
"20691","ENSG00000165325.15_24716",24708,24716,9,"ENSG00000165325.15",1,2,"VMVVVUUVV",2,6,0.692339544513457,87,93,106,109,112,118,133,136,"ATGATGG","ATGA","AAGAAGC","CTGA",2.564425592692,13,3,15,40,2.54671263256553,4.91072081262806,7.68007899068188,101,"ENSG00000079974.19"
"34875","ENSG00000234323.10_592671",592663,592671,9,"ENSG00000234323.10",1,1,"MVUVVVVVV",1,7,0.789648033126294,82,88,100,103,111,117,133,136,"ATTATGA","CTAA","CAGATAA","ATGA",2.30016745908493,12,8,16,45,2.75134207376402,4.52144795024922,7.68004008275439,101,"ENSG00000079974.19"
"3404","ENSG00000083223.18_31456",31448,31456,9,"ENSG00000083223.18",1,1,"MVVVVUVVV",1,7,0.82815734989648,67,73,85,88,94,100,133,136,"ATGATGA","CTGC","ATGAAGA","CTCT",2.31144629538129,12,6,33,60,2.05985659642896,4.36737464140939,7.68000404099532,101,"ENSG00000079974.19"
